########
#. \*..#
#...#..#
#.#*#.L#
#.R#.#.#
#**#**.#
# #.###L
########