########
# *. .\#
##.\.*.#
#.. .*.#
#\ . *.#
#.R*. \L
#*.... #
########