###L####
#..*.. #
# *R.. #
#.. *. #
## *. .#
#.#.#..#
#\*. \##
########