########
# *...##
# \ .\ #
L.#....#
# ..  .#
#R...#.#
#..  ..#
########