########
# ..*..#
#\.#*..#
#*. .*.#
# .. ..#
##. ...L
#..R...#
########