########
# ##.. #
#.... *#
#.*....L
#*.. ..#
#* *.#.#
#. R\ .#
########