########
#......#
#....# #
#......#
#..... #
# R....L
#.#...*#
########