########
L.*. .*#
#*.  .##
#.... \#
#.*..*.#
##.#*.\#
#*.R.. #
########