########
#*.*\..#
#.\R.* #
#......#
# .\* .#
#\. .. #
L.*  *\#
########