###L####
#\.\ #.#
#.\##\##
# *....#
#*\#.R.#
#. \...#
#......#
########