########
# ...\ #
##.R...#
# \*. .#
#.L....#
#.. ...#
#.*...*L
########