#####L##
#*.....#
#*R*# .#
#. ....#
#*... .#
#....#.#
#..# ..#
########