########
#..#.\.#
#..\..*#
#\.\R.##
#.*.\..#
# .*\..#
#. *..*#
###L####