#####L##
#.#... #
#R. ..##
# ..\ *#
#.\.\ .#
#.#. ..#
#.  ...#
########