########
#..##\.#
#. ..  #
#** .**#
#..*...#
#.R#.###
#. *.**#
###L####