########
#..*..*#
#*....##
#.. .. #
L.. . ##
#.. ..\#
#R# .. #
########