########
#....**#
#..*.#.#
#\.. ..#
#.R..#.#
#. *...#
#..##..#
######L#