####L###
#... \.#
# #... #
#.  .# #
#.#.#. #
#.... R#
#... ..#
########