########
##.  # #
L.*.. \#
# #.. \#
#.*....#
#.\R..##
#.#...##
########