########
#.. * *#
#**. . #
L* ..#.#
#.###. #
#. R.*.#
##.**#*#
########