########
#.R#  .#
#\.\ .*#
#..#.*##
#.... .#
#*... .#
#. \#.##
####L###