###L####
#...\ \#
#\\\.*##
#.  *.*#
#R. .*.#
##.#.*.#
#.*  \##
########