########
#\#*..##
# *.**\#
#\.*.. #
L.\  # #
#.\ ..*#
#.\.R#.#
########