########
#..R   L
# *\*. #
# #..\.#
#.# .# #
#..#.\.#
##.##..#
########