########
#.. .#.#
#. *...#
#..*.#*#
LR..*..#
#*\.*  #
##.*.. #
########