####L###
#. \#.##
#*... .#
#.... .#
#..#.*##
#\.\ .*#
#.R#  .#
########