###L####
#..*#..#
# *. ..#
#..#...#
# ... .#
#.... .#
#.*R#..#
########