########
#.  \.##
# . \.##
#\.##**#
# \#.*R#
#.*##\.#
#*\.. .#
###L####