########
#*.R.. #
##.#*.\#
#.*..*.#
#.... \#
#*.  .##
L.*. .*#
########