########
#.....##
# #**.##
#R\***.#
#*...**#
#...*. #
#L  ..##
###L####