########
#.. ...#
#..... #
L ..# .#
#. #R .#
# #.* .#
# \.  .#
########