########
#. . ..#
#.*...*#
L*.#..R#
## ...##
#...  .#
#......#
########