########
#.#..###
#...\**#
L.. ***#
#\ #\\.#
#...# ##
#R#*.  #
########