########
###....#
#*.#*..#
# \ .* #
# R.  ##
#.... *#
#..# ..#
######L#