########
#\.# ..#
# #*R.##
##..# .#
#*. *.*#
L.#... #
#*.#*.*#
########