########
#..R*. #
# *..*##
#. *..\#
L...\.*#
#...#..#
#..#\\##
########