########
#\. *..#
#.\*\ .#
L\#.#\.#
# #....#
##\.R..#
#.#....#
########