########
#. .#.\#
#.*. #*#
L*R *..#
#..*.# #
#... .\#
#   ..##
########