########
##..*.##
##* .  #
#.*..R.#
##.\  ##
#......#
#..\\..#
####L###