########
#..... #
# . .*.#
#R\. ..#
#....# #
#. ... #
L.* # .#
########