###L####
#. .#. #
# \*.  #
##* .*##
#.... R#
##....##
#......#
########