########
#.\#..##
##.R.  L
#\*....#
#..*\ ##
#..##.##
# . #. #
########