########
#.#.. .#
##.R ..#
## \ .##
L*.. .\#
#...*\##
#...##.#
########