########
#.*# ..#
#..# ..L
#....\.#
#.... \#
#.\*.R##
#*.....#
########