########
#..R...#
#\. ...#
# \\...#
L...*..#
# .\...#
# # .#.#
########