########
#....#.#
#..R.\##
#....# #
#.\#.#\L
#. \*\.#
#..* .\#
########