########
#..#..*#
#.##...#
#* #. .#
#. R..##
#...\..#
L\# .\.#
########