########
# .. #R#
#\.. ..#
## . ..L
# .. ..#
##....*#
#*..*..#
########