########
# *....#
# .....#
#.**...#
#  ..###
#...*.##
#*R ...#
####L###