########
#R *. .#
#*\.*..#
#...*. #
#.*....L
#.... *#
#\ ..\.#
########