########
#......#
#.# . .L
# ...#.#
##...*.#
#... R.#
#..*.**#
########