########
##..#*.#
#.  *. #
L#...  #
#\..#\##
# ....R#
#.*..\.#
########