########
# .....#
#.. *..L
#. #.*.#
#.   *.#
##*..\ #
#.R.. .#
########