######L#
#*.. \.#
#.\...*#
#*R.\  #
#\..*. #
#.*. .*#
#. .. \#
########