#####L##
#.** ..#
#..*...#
#.. .\*#
#.....##
#..#.R##
#.\  ..#
########