########
# #*...#
L..  ..#
#..\\ .#
#. ... #
##..\# #
#.R ...#
########