########
#.....*#
#R ##.*#
#*.....#
#*  . #L
# #.  .#
#.#..#*#
########