########
#** .  #
#......#
##.*...#
#....*.#
##*  #*#
#R ....L
########