########
#...*. #
#...R#.#
##.*# .#
#.#. *.#
# *\...#
##  ...#
#####L##