########
# . . *#
# ..##.#
#.  # ##
#..#.R #
#* ..# #
#\. #**#
#####L##