########
#...R..#
#... .\#
#...\\ #
#..*...L
#...\. #
#.#. # #
########