########
# * .. #
## ...\#
#..# . #
#... # #
#R.. . #
#.#*. .#
####L###