########
#.\.#..#
#.#*...L
#  .*..#
#R\.# *#
#.\. .##
##. ...#
########