########
#.#...##
#......#
# .\. .#
L .....#
# .#..*#
#R .# .#
########