#####L##
#. .*.*#
#.\. ..#
#....# #
#.#.R ##
#..**. #
# .*.*.#
########