########
# .*R..#
##*..* #
#\..* .#
#*.\...L
#..#...#
##\\#..#
########