########
# .# *##
#.**...L
#.\R. *#
#.    .#
#\...# #
##....L#
########