########
#....#.#
#...  *L
##\ *.*#
###\.. #
#\.R..##
#..#..\#
########