########
### . .#
# . R..L
##... .#
#.. . .#
# .....#
#.. ...#
########