########
#.\.. R#
#*....*#
#**. ..#
L*#... #
#* \. .#
#.  *..#
########