########
#.\#*..#
#.#... #
#R .* \#
#..*.\##
#*..# \#
#**..*##
#####L##