########
#.#\*. #
#R. #  L
#..* \##
#..#...#
#\..*. #
#\\..*.#
########