########
# #....#
#....*.#
# *.. .#
#*...#\#
#..* . #
#.#.R..#
#L######