########
#R ....L
##*  #*#
#....*.#
##.*...#
#......#
#** .  #
########