########
#. \...#
#..# *.#
#R ....#
#.*....#
##..*.##
L..* . #
########