########
#.....*#
#*...\.#
###..*.#
#  ....#
#..\ R.#
#...\#.#
##L#####