########
#R *.*.#
#...# .#
# #..**#
#..#...#
L .*...#
#.*....#
########