########
#.#R.\.#
#*.. \.#
# #  \.L
# ..*.\#
#\**.* #
##..*#\#
########