########
#* \ #.L
##..\  #
#.....R#
#.*..#.#
#......#
#.... ##
########