########
#.**.. #
#  .*.##
#R*...##
#\. ...#
# #.. .#
#....* #
####L###