#L######
#  . ..#
# .\#\.#
# *...##
#R\. ###
#.*##..#
#.  ..##
########