########
L..*.  #
#..... #
#* # .*#
####.#.#
#  * ..#
#.\.R. #
########