########
L.\....#
#. ....#
##.. .R#
#. *.  #
# ##.#.#
# . ..*#
########