########
#..... #
L..* #.#
#.. #R*#
# \.*..#
# *#...#
## .#..#
########