########
#.... .L
#*#...##
#  ....#
#..* . #
#...R..#
# .* . #
########