#####L##
#.....R#
# ... .#
#. #.# #
#...  .#
#**. ..#
#....\##
########