########
##*  ..#
##.\R..#
#.# ..##
#.*. . #
#..*  .#
#.. #*.L
########