########
L.\....#
#R..\..#
#*\ .. #
#...#..#
#*  .#*#
#. . #.#
########