########
#.#...\#
#\.*#\.#
#R.....#
# . \. #
# .....#
L ...# #
########