########
#.... \#
#.#...*#
#R\  .*#
L#..*..#
#. . .##
#.. #..#
########