########
#....\##
#**. ..#
#...  .#
#. #.# #
# ... .#
#.....R#
#####L##