########
#..#. ##
#...#* #
#..*.\ #
#*R# ..#
#.# *..L
# .....#
########