########
#.... .#
L ..R#.#
#... .##
#.....##
#**.*.##
#..*..*#
########