########
#..#*###
#.\.. ##
#*. R *#
# ... .#
L...\ *#
#. ...*#
########