####################################################################################################
#* ..... * .**.. ...... *....*...#.*.... #......*..#.#.....*# .* *.#... *.#..*.. ..*#\#\  *. ... .*#
##....*.*..... ..*. ...#*..#.#....*..... #...#....#.  ## #... ......... #.#. .*\.... ..........*. *#
#.....*.. .*...#..**.  .\. # ....  # #. .**...  .## \.  . ...*....\\ *.  \.#..*....##. ..#.#\ ..# .#
#*.  \ ..##.... . .....*\...\....*. .. .# *# ..\.  #. ....#..*  ...\#...*...#.\.##...*....*.*# .*###
#.*#. .*#..   *#..... .. .\..*. .#*..*....# ..**.......# .. ... \ .. *.. .# . ...*....\#... ..*...\#
#..* ..*. .. .. ## ..*..*..#.  ...*.  .   .....#..\..##..\*. .......*.  .**# .  ....#  . ....#.* ..#
#*..\ *...#. .*#..#..\ .#. .*...\.. # .\..* #...  ##.#...*  . . .*..*...*  *.. #..*.**......####*. #
#...* .. *#.. .# ....## .\\.#.*.....#...#. #   #. ... \.# ##.......*.. ..#....  .#.\## \.##.#..... #
##.\\.*.#*. ... #**.# .#*  * .# .*.. ..* *.*. ......*........   .\. ..  ..*  ... ..#...  ...#\  *#.#
#...* ..... .. #\. ...#...*. ..#  ##*#  ..# . .#.*. .#..  .\ .. ... \..  ...#*.... #.. .. **..\...##
#.......*##. #....*.. * # *..  *..*.. .. *......\ .. ..  . ..\..*\.. .\.** . ..**.**. ..*. .. *.\.\#
#...... ....\.\.\\. . ...*......*..#.\......* .  .*# .  .... .#. ......\ .. ***#   \.#..*. *.  #.*.#
#....  .........#.... \ . .#...#. #.*.......*.*#...# . ** \*  .. . ...*... . \*#.... .. .*..*# .. .#
#.....#. .  .\...\*..*.*. . ....#...#\.. ........\....# \...\. .#.* .... . .. ... .. *. ..  ..**. .#
#...#... *....... .*.#.*. #.*  .#.. ....##.......\ #.#..  .# ...#.. .*#. **......*...\.....*  .*..\#
## *\*\  ..#.*. *.*.#..#..... #....#..*...#.\. ...#* ..  #.#.*#.\#...\..#.  *#.* ***# .\.\. *..\.*.#
#.. . ..\\ ##..\#.......#. . #.# ....*. *.. ..# .###..#*##\  ..* . #...**. .\... *.....\ **...#. ..#
#  ... .#.* .* ...*#..#.....\ *  \.. . ...\....#.*.#. .. ... . ....  **.....#. *..\. ........#.*. *#
#..... .. ... \\.#.. ......#.#.\ .....*.# .*. ...*\..##..... .#.. # ....* ... \. #*.#*.. .. ...*..\#
#..*\*\....*.*# *\.....*. .. * .. . ..  * *.#.. ... ..\.#*#...*.... #.# .#..  .... ...# . .\*....\.#
# *..*#*...#.\...  ....#*\\ ...* .* **. *... ..*.#...*...**\.**... #...*\..\.\ \.... .. .#... ....*#
#..*  ..#. \.. *\#\.   . . ...  #. . ... .....*..# ..*.#..\..\..*# .......*. .## ..   ..#*. .....#.#
#.... \.......... #\* \ #.....*.. ... *..  .\*.. *..  .. #... .. ......... ..\*.*.......**.*.......#
#\.*......#\#.\..*..... .#..  ..\....  . ...#*\ . ...*.#... #  .*\*..*#.\.#. \. .* .   ...*.# *.  .#
#..* ... .\. .. * . ...... ..* .. \.. *..#.. #.  ........#*.# .**.   *.#.# #..  ##.**\* .. .*#. *..#
# ...#.  .  ........\.*.  # # ... \.**  . ...* #..*.*#.*..\#***\  .* .\..... #...  .#.#*. *..*.  ..#
#*\ ....*.#   .*#...\..#.*.#\..#\.*#\ .#.. .* .# .*. .*.**.* ..  . . .#....... ......#*.\..# ..#...#
## .#.#..\. . .*.\ *....# ....*...# .\.#.**.....#..**... #   .. ...#.\ ..  .... . .. .* #.#\. \ ...#
#....**.  \......##..##. ..\.........*... .#.# ........    ..\..#..## ..#.* . ..#     \.....*\.....#
#.  *...*# . #..  ....... .. ..**.... .. ...*. ...#.......... .*...... ..**\... ...**.*...* #.#....#
# . ... . .......... .. ..#..#...*# .. ..#  . ..... #.\... ..#... ..* #.. .*#\..#. #.** .. #.. ..\.#
#. .. ... ..**#.*...# . .. \**\ #\# .\ # * *..#.. ..*..  . .....   .....*.*....*. ..*.*...*... #. .#
#..**.. \.#.. #*.........#\..... ....#...* . #.. . *...#.....* **..\ \*..**. ##..#. ..  ..#.#. ...*#
#.....**..# \ \.#.\........ *# \...  ..  .#*\# .#* ..\....*.  . . .......##......  .. .*  *.*#. *. #
#\....#...\ ...\.\* ...*....\...*. .#.\. . .. ....#.. ...*.*..*\.  #.....*.\. .. *.\...#...*.. #**.#
#.*#.*....# .#.. \##.*.  \ .* ..\ *#\..\*.......*.* ..*.  .*\#.....*.\...\... . *.\ . #. .#..#. \ .#
#. .. ..\.*#......*.#\.  .....# .......\... *#.*#.  . ...#......\.. . ..   . .........*..\#... .  .#
#..#. . *...   . #. \ .# .**. .#   *. ..... *...... ...  .. ..# .\.\ ... ..#.*.\. *.... .*..*. . ..#
# ....\.# . *# ...#. .#..\.#*## *** . ..#... #.* . .**.#*.. ....... .#..\  *\... *.*.*.#. .#. .....#
#....\*\..   \. ....\ ..  .#.....#.... *#..*  ....  ....  .*#.. .#....\..#. .*#.. .*...*. .\##.*.*##
#* #....#*.*... \#*#..#...  # ..#*. ...\..*...  ...#..\........ ... .....  .  .* ...*.. *...*...#. #
#   ...#..#.... # ..*. ..* .. .* ##\#\. . .*.\..**... *....#*.# ##\*.*.. ..*. .... . .. #*  .  . \ #
##...* ..# . # .*\  ... ..*. *. .... ..... .*..# ...*.\..... ....\. . .# ...#.. ..... .**.*#* . .. #
#.\ ... .* .#..\\.\......*.#..*..*..#..\*#.. .......#..#..\R\..  ..## ..\..*. # ..#  ***. \.. #.*..#
#.\..  . # * .*... ....#.\.#.*## #.\.#.  .....#. ...*..  . . . #*.  #.*.\. .*.#... .*#. \  * .\..*.#
# ... ......*\..*.. \ ..#\......  .....#... .. ..... .\.. **...*.. \   .  #.. . . #*...*.#.*. . .. #
#**..*  #\.#\.\*#\.* .. ..  .. .....\* ..  ...*   * ...#..........#.\#... ......\ .**... .. .#.....#
#......#..# \... ..*.\*. ..\...... .\.# ......... ...**. ...#...#. ...## .*..... ......#*.... \... #
#* .\... ..  ..*. ..**..  #.\.\. ...  .... ..\.  .... ..##. #*.. \. #.. * ... .....*. .....*# . **.#
#. .....*...*...#...*.#... #  .\#....#.*\...\ * .#. . ## ... *. .. .. .... .  *...*\..\\\..#.. # ..#
#..#\ ....*  * *.#..#.*#..\.* .   ..#....  * . ..#  ..#. #. ...  ##*#.....#. .. *. \  * .. .# *.\  #
# .*#* . . ...**  .. ......*.*..**#...\#.... #......\.  ...#. ....*#...... .. .. .*#.  ....#.*\.*..#
# ......#.....*..*#*  ***..*. ..**.   ..* ..*..\#..# *...#..*.. ## . #......... *....#.*. #  \....##
#*.\..#..  ... . ..\. . .*..\\. \..... .#......* *#....... #..#. \.  ..*# ...# .. *\..** ...... ...#
## .#*..*.....  #... .. . ..*. * *. ..*....*...  ..* .... *\\.... .\\. # . ... .*....*...#..#.  .\.#
#\#\##  .... .\...... ....**. ..*..  ..# .  ...\# .. ... . * ..*.\..\#..**..*.... #.   .... ..#.*..#
##*..# .# . .*. .. # *.#. .*.  .#*# .. *..* .**..*.*. ......... . * ... ..   ....#.. .#.\  *..*.**.#
# ..** ....**... . *#......*.*.... \# #..*#.. .#.#.#.. ..*.... . ..  ..*.... \.... *.**#. .*# .. ..#
#. ..#*.\. *  *....\....# .... ......*#..#. . . .. .. .*..  . ..#.... .*..#...*..# .\.. # ...#...*.#
#.*.#.#.  . *. .. #. ....#.*..##\.  ....... ....\    .. . ..#.  .* . ......*.# ..#\#.*. #*.*# .*..##
# . ...#.#........*.\ . ...##.*. #   .. . *#.#.#. ***....# # \ .. .#.* .. # . ....##... .# ..#..* .#
# \.........*..*.* ...# .......**.* .*.##*# .. . \.\\#* .. .#*. .....#**...\..#. ...## . ...  . .. #
#\. ..*. .. *. *.... . \...#.... .*\\* .. ...*..*.*.\..  ....*....#*.\ .\#**\ .\ \...  .... ..*. \ #
#.. .#.. .* .#.. ..#.. .. \. ....#.#............... ...# ....*#  .. .  ...  ... .. ..........*.. \.#
# ..\ ...\..\..**#..*...##....#.*#..# ... #...# ........#..*#* .  .#*.....*. # #\...*......* *.*. .#
#..#..  ..  \....*.. #...\. *..# *. # ..  *...#* ..* . ....# * .. .....\ ..  * #.*.*.*..#. .#... . #
#\  .. .. . ..#...........\.. ....*.##..*.....*\\ ....  **...*  ..*....*.*... .\..\#...  ..#. ..\ *#
#..#.. .. * . ..*#.## *# ...* ..  ...\#. ...... .. . ......\. \.. \  ............  . \........ . *.#
#......*...\#.   .#*. #. #.. *.. . .\#.  #... *. ........ # **\... .. ...# ....#.... .\ ...#...#. ##
#. #..... .. ....  ..*. . ..\...#.*\.*....\.....\*..... ..\*. \......  ...# .\.#.....*\. .\ . ...  #
#...\.# ..## ......*.*. ..#*.. . .....\ ..# # #  .*.# .... . .. . ..  .. ..... ..\.. .   * #. . .**#
#  .# .......... . ..\. . .....#..\*  *...\.....#*.*.. . **.#. ... .. #. .........    .*... # .... #
#.  ...... ... .\..* ......  .. . #. #... #... #*#\..  .*#..*\...\. .  .\. *   ..*.\. ..** *..*... #
# . ...*... .... *. ....\  *. *\\*........ #......# ..*\#..  ..#\.#..##..# . ...*. .. .. \ .#.  ...#
#.\ ...  #.  .#.** ..\#..\\..#.** .#... #\.....\....... ....* .....#.... #.\........   .  .* ....*.#
#. . #.*#. # .. .. . #. .....\.\..\... ..#.. ... .. .. . .*.*#. . .....#. ..........#\....#.....##\#
#.**.. . ..*.......**.. ..* .   ...\#...#*.*....... *..#*.... * ..##.. .   \#.*. .*. ..............#
# \ ..*..# *.*.* *. ..*...  \**.#.. ....**\*... .. .\#.. .*.*.#. *......  ......* **\*##.. .* .*...#
#.*...*. ..*.. . #...# .   \.\.*# .. .*#  *........*.... . ... *..*........*.*.. .. #...  ...  *#.\#
#. . .. .#.. ....#.*.. . ..*. .\#.#  *.*..*.......\. #...#.. \ *.# *.#.*..#.......  **#\  #.. .  .##
## ..... ....*\ *... ...  *.#.* ...* .**.\...##*....* #.*#... .     ...*... .. ...#.. *......*#... #
#.\.....*.\..*.... .... * . ..\* \ *** ..## *. ........ ........ ** # ...#..*. . .*\.. * ..  ##. ..#
#*.\#.*. . ...\\ ..*#..*.. \.. ...*..*....*. ....#*..... #.... ...*.. ..  . ..\  ....  #*  #. ... .#
#........ ... ..#..*#*. .  *. ...* .*..#. .....\. .\. #.  .....* ...*  .*. \*##... .. *.\...**## ###
##.. .*......* . * .. .... .\.#.\ .*#.*.....\. # .* *#.#.#..... . . ... *..#...\.*.#...#. ...... ..#
#... .  . .  . \. ..  . .*. .... #.......#.......*..#..*....  ....##..*  ...#.#. ........  ..... .##
#.....     .. ... ... # . .#.#* ... ..........* \ .... .   #.. . * .. \. .....\. .. . ..#* .....#.##
#..#.. *.*#.#  #.\ ..... *..... . ...... * .#. .#.*#..*\*  .*.*.\.#*# .**...\..\#..*..** . ..\.. *\#
#.. .\# * .. #.... .*#*..\....*..... *... ........ *. .  *#..#..#.## #. .. .....*.....#  .*.*.. ..\#
#. . ....# ..\.... . ..  ..\.# . .......#.*   .. ......* *#..*..* ..*.. *........*..  # .#*.....#..#
#.... *....  #    ....*.* ....** .*... ... ...#.# .* .\. ..  .*... #. ......*.#  .. .... ***.\ .\.*#
#. .*.\.  ..#..##*.\. .*....... .*\...# .* ... .\..*..#\# ..*...*... .*..#.# . ..... .   ...#.. ...#
# ...# ...\.  \. .. *\..\..\.....*#\.....**#.  . ...#**.  ..\. * .* . *.....##....\.....# .#.... ..#
# .........# \#  *..*.. .#..  .. . ....* . .#.....*.# .. .#. ..##*\.#. ...#*. #..*# ... #.*..*.#  ##
#..\.#..#....  ....* #.*. ..  * *....#.# #*.  ....  .* .##...#.#  *   . . .\...\. ...*.. \ #.#..  \#
#.....   .##. ##......\. #.#.*...  ....*...#*. ....\.*#...... ##.. ......#   ##.   . * ..#....\*..\#
# .\*  ... ..*.. .....  .#..\.*. ..#......*  ..  .*...##.   #.*.*.\ .#.*.*.#.*.....#...... .....#..#
#.  ..# ...#.    . ...#.  *.*.  .*..... ...\.#.\...   .. ...  #*..#... .# .. .....#.*.#  \.##. . *.#
####################################################L###############################################