#############################################L######################################################
#.*#.#. .#. .. #.*.  ......#.....# #.. ..#.\..... .*\ ....\. ..#.. ........... *.* .#... ....  \. .#
#.#.  #*. ...   ... .. #. # .... .......#. . .. ....*.#...# *#..\. .#...#..\.#... . * .*.. ...##.#.#
#*#. ..#.. ...*.. ....*.#..  .....*. . ..#*.......*#* ..*....*  .   #.#.#.. ....  \.. .  ..  *   * #
#.# ...###.*. .. . ..*.  ...  #.\. *.. ..**. *... .... ....  ..*.*  .. ........  # .  .#. .. # ..*.#
#.... ...#.#.\#*#.\*..   ..... .#....*..#*... ...  .**  ..\.*..*...##.#.  ...*.......\..*.*..*...\ #
#\ .. . #.\#......* . ....* *.\#... .\...\........##... .. . \.. .. ..**... *..... \ ... ....  ....#
#.\.\.# .....\.... #.... **.*.... *.#..*... . .....#. #.... * .....#.\ .......*. \* ..#  ....  ... #
#. #.*. \* #.# . . ..   .\..\....*..... ..*.. \.. #.. . .. \ .#....#. #\.# ...  .  ....*....... #\*#
#... *. .#...*. .*.... .#...\* ... . *..*#..#. .... ..# . \.. ..*..#.. . ..  #.. ..*#*..\*.  ... #.#
##*...*#........  .... . ............*.\..\.  #..  .  # .#. .\..#* ... .#\ ###.# .\.....#\....#  ..#
###... \....*..* ....  #.# .*.#...#. .. ..##.#*.....##* .*...#. .. ....\*.* *.. #.##.. \...*.\  . .#
#*...*.\. . . . ..\...##..... . .*.*. ..#.. . ..# #* #...#. *..... . ..  #.. .#...*# ... ... #... .#
#  . * . .. ..... ..  ....\#. *#  .** \..#.* ..... .# * .....*..#  ...*#*....\  *.#.\.#..*.. ..**..#
#. ..\*...   ..**......\..#\\... . #.\. .... ..*.. ..*.....*.......#*.*... ..  .\.*. . . ......*..*#
#..... *\*  . ........*. #. .* # *.... .#*...... \* ...#.*.......\\.*..... \. ..... . \#.#.\. **...#
#  .#.#.\.. ...  .*\\.........**. \#.#....*#...##..\....\\. .  ..... #...... *#. ..# . *. # .... #.#
#.*#. .. #.#  ..... ..** *. ..*\#...... .. . . #..*.. .. #**...\.* .#.\.. * #..*.# ..    .#.....\\.#
#.*#....  . .#. \.#.. ..#...\ *..#.*  \..#... # ..*    ...#.. .... ... **.#. ... .#*.. .... .......#
#  #.*.. ....#.* .* * *.. . .*.. ..#.* #*.. .. #. .....#\.*.#.....  #..*..# ...#.*. ....... ..*.#. #
#.\ .\. .#*. ..*#.  .#.\ .*#...*#*  .*#.\\# #   ... ...\....*.. *..##.#**..  .#.#....\\#.#.#  #....#
#..#.*.*.##...\ ..... .. ........*. \\  .#.*.*.. *#.. .#.#  ..\. .... .\....#\.*#. .\ ....# . ### .#
# ... #..# \\.*.#..##*..*.*\#.#.. **. ...#*.#* \. ..*..#\* ..#........\\#*. ... .. ##.#\ ###...\.. #
#. ...... ** \ ....#.. ..\.#. .*\ *#.#. .. .\...*#.  *.* .... ....*..  # *\.*..*.* .**.....#..#. .*#
# ..#* .\..*. #....*..... .\.. ..**.\* \ . #......*...*...  .# .\   ...   # .  .#.#* ....#.* # ....#
#.#  ...  #.. ..*... ... . .  .....\.\... #..\# ..# . .... ........... ...  .#.. #.*. .#.*.. #..\  #
#....#. . . ..  ..  \.\.....\ \.. .#*#...\.... .... ...#.\.. . .\.#.\. ..#....*....#.  #.. ......* #
#.. *. * .  ....#..*.\ .* \#..*.#.... ..* *.* #.  #.*.. ....\.. ..*..**..#.....*. .. .....#*.   \ .#
#....#.#..   *#....  ...##* .   ... *. . *....\. #. .... .#.    ... . * \.\. #  #*. .#...*.\.#. . .#
#.... ... . *  .  .... ##.* .#\ ...#.\*\... #.....*...  ..*\#  .......#*# \. .*...#*. . .  \.*... .#
#*  # ..#**..*\...... #..*. # .# ..  *..#.##...#..# ........ \..  \* *... ..# ..#....... .....* *  #
## ..  *.#.. *...\   .#.. . #.*.*# ..*..*..*#. # . \*.**. #..... #. .# \ *.#..  ..\#...*\ \..###..\#
#**.\** . .***.## .*. ..  .. .\.. ..*... . #.....#\.....*... ..  .........*...\. .\. ..*. *..\. ...#
#\.............. #.#.. \.#  ..*. ..  ...#.   ... .# .....\.. .. ... \.###*.#.#.. *  ......\...\....#
##.\*# \.... .....#  ..  **\ .... ...#... #. .#.......#  *.#. ...   \*.... .... *. ...  ..\. *\ . ##
#\**.... .. ...* *  #...#\.*. ##...*.\..*. . ...#....*.... ..\\.*#. ..........#..  .  *...  ##\. #\#
# #..  .  . .....*  .. ....\..\##..*#. .   #..#..### .........#....#.... .*#....* . .##.#.*.*...##.#
#..#.#.. .  .#.. .\. ... . .*.. .*.\ ... . ......  #....##. ...  ..  .. *..# .....*##\..... ... .. #
#... ..... .. *#* ..*..*.*.* ...  ..... ..#.# *\..* ............ ....#..#..\..#.#..#..*. .**. ....*#
###..#** ...*......... ..#.##. ..\ ..*...#*... # . ..#. #  ...#.\  ...... *..... ....**.... . ..#. #
#..*.*.. *...#.... ..**. *.# .#.. . . .\#..# ..  ..*.\..... ..#.....  ...#.* # *#.  .. .. \ ..#.*. #
#.....*. ..** ##* ...... .... .*.##..* . * .......\.. . # ..#.*..# *.... .\ .**\  ..#....#  ..  .. #
#.* .   ...*..#. ... ...#..*.##... #.. #.. ... *.* *.#*# .. . #... .**.. *.#...*... .#..** ...#\ . #
#........ ....\..*. ... . ..  ..**...##.\.*.. \ ..  ....*##.... * . .*.. . .. #..#\.... * *.. ..* .#
#..\.\.  ...#\................  . \.* ....#*\... *#.*#.   *....* . .. ..#...*.*#.*...#....*... \#..#
# .##....\ *...#...#. ..**.... ##......*.. \ .\#...# ...  . .. ....\ .. #. *..#.   ......... # ....#
#.#   *.....#.. ...\.. ......   .\.*... .. **.*.. ...\\..*\ ..*.#*.......... ...# ... ...... \ ..#.#
#.. #  ...*.#....#...\.*.*  #......#..#..\. *....#**.#.... ...#.*. *.....*..#. ### . . .*.. ...*..##
# . .*.... ...#..*......... .\ #.#.. .*. ..*#. \..  .## #.*. ...#*  *#  .#...... #** ...*. .*\.#...#
#.*..*..*..*  \....*.***.*....# .\.#\.*.# #*.# .\ .....#. \..#.. . ....#...#.*... ....... . .. *...#
# .. ..#..*\.# .#...#  \  . #..\  #. *..... .*# ...#...\ .# *..*.. ...*.*.. \.....#.# . # ..**.. #.#
#*.# .*  .\...... ..\..... \..#\. #.....*\.\... \. ..*...*#. .... *   .. \. .......*##* ..  ...... #
#..  ...*  ... . \. ....... . # *.*#....\ ..\.\ *.*#\....*##. * ... . ...*......*.  .#*.. \...#* .*#
#.***. . ...* ... *. . *\\ *#.#  . *. **#....#. .  .. *....#.#\.. ##. ...\.. .#*.\. *\...\ .\ .. ..#
##... \ .#. \.#. ......*...*. ...#... ..  ..**.#..   .....*.#. .\#.# . *..\..*.*.#.. . .\ .*..* ...#
#.*.#..... . ..\....      #.*..*.....##. ..*# .....  *....#\..#.\.#....*.##. .  .. ..#\#* \..*#..*.#
#.\#.. ..##.*\.  .*.*..# .#..*.... ....... .. . .*..# #.*. *# \.  .. .\...#*... . ...*..#.  * .....#
#. #.... .......... .. #  *.*\ ..\*...*#... \..*.#..#.. .#...*...*  .*..#...#.**..###.* #. *#.\#...#
#*  ..*. \........##*..\. ..  ....#. # ..*... .#\ ..*.#..#. ..\...\*. . **.* \ .....*......#..*. ###
#..#.*  # #.##....##. *. #. .* *.... .#.....*.....#*##.....\.........*. \..** ...\ ..\. . *. *.#* .#
#*#. ..\*.....#..*.....  \...*.  .#. *#... .\. ....#..*#..#. #.# .##  ....   #*#. *..\...* . .... .#
#.  ..\.......# * .* ..... .*.#... . ..  .\.. *.#. #.##\.. * *.......# ..*.....#..\*. #... #..# ...#
#..## .* .. ##... ......# ..**#. *..*#... . . ..*. ....##. ...* \. ..*#.......#.. .....##.. .\ # .\#
#.\.*\*.. *  #.\ ...#**..... ..* .#....\.#.* \\..... . ...*.\##..  .*..... **. ..  . ..*\....  ....#
#*... ..# .##*...* .# *.\  *.\. .. *..... *..*.......##...\*.....\....\. #.. # *. ..**.\.*. ...#...#
##.*........... .........#. .#*..#* .......... .# #...  ... ....  ...\# #\ .. \.\. .... *.#..*.#  ##
##.#..*.. .\ . ........ ..# .. *# * # \.\*........   .. #  #..\* .....\# \ .\#* . **.#  #...*   ..*#
#. *. ......\#.#..# ..#*. ...*... *.*\. *. ......  \.# #\.*.#.. ...  .#\ #...#*..# .##..# * .. . **#
#.....# ...#*. #. . .. .. . . *........*\#. *.... . .# ......\# ..* #.. . *\#. .##...\ .... ... . \#
#..#... . *.** .... .. \#.   .#.  ....*......\###*...#*. .....#..#..*#..* * .\. .\ .\*...# *.\...#.#
# ......*#.. #. .\........\... ..\ \......#\ .**.  \*.#...... ..\. .* ..#\ #* ..\*#. .. . .\# \*. .#
#.#*.. . *...*....*    .. . *...#. ...  .. .*.... .....*.. ..... . ......*## ... .*   \ \   . .*\ .#
# ....\.*.* .#*#... ....\. .....\ \ ...* #....##  .. ....  . #.....*.... *.....#.*..##. . ......**.#
# ....... .#  #...#.. *#\  .... #.....#*  #.#\  .......# *.\ .. #.... **.*...\**.. ... . \* ..#....#
#..*...#.....*..  .#** ..\.#.. .......#  #. ...*..  ...#.. ...  #.*. . *#.*####....# .#  .....*   .#
#  ...\\ .\#.#\#.*... .. ... .\...*.#.*..... *.... ##...#..**. # .. .*#....#.. #... \..#*.*  ... * #
#  ...*.*#....\.#. .**  # .#..*.. \..#.* . .*.. * *..#..\...*.....*.#\*. \*...#   .  *....#. #.#*# #
## ..... .. ....  ..*.....#*#. \........*. ..*.*..\..*#**.\  .. . .#....# *.\.. .# .*.. ... . ..  .#
#.. .#..  ** ...\....... .#*..*#........*.*...\...# . ...*..*.#\ ..* .... . . ....#. .#*.   . #....#
##.  .   .. .....#.#..*..* .*.#..* ... .#*. .........##....#..*.##*.  *  #..#*.*.#  ....\...**## .\#
#*...*.......*.....  .\#.. .. . ... .. . ..  ..* . *.... . *..*... *.. * .*.....*#.**.*.....# *. ..#
#. .*  # *  . ###....*. ...##...\...  * ... ..#... ..*.*.\.... . ##*....*... . ..*  ......#...#\ ..#
##... ...  .\... ..## .. .  \.*.  ...* .\.#...\   ..*#.\..   .#..*.#... *  #.#... \    ....#..*.. .#
#..*#...**. . ...*\. .. \ * \R.. .#. \#*.. . ..\. ... . #\*.. **..##   ... ...    . . ... ...#... .#
##.... ..#   .#. ..  #.#.  ..*.#.#..\. ....  * . ...  ...#.##. ...... ..*. ..##*. #*...   .  .. ...#
#*. ..#..\# ...#...#....*.**.....*.. ..#   .#\..  ...#. .#*.#.\..* ...#.#*#  #**.# *.... ... ..# . #
##*#*#..... . *.. ..\......  .##.. ... . ... ..#.  ... ....*.# #....*.*\ .#* .#\.*.*# #\   .#...\..#
#* .. .*..#... .#.* .... \ . ....*# .\ .. .#..  ... .....#..*#*...#. .\.   .... \**.\*...*\.#... ..#
#..#. #.\. ....*\..  .# * .  . .*.*# ....# ... *# * .# .. *.\ .\*.*.#  ... \....... #.. ... ... *. #
# *.\# ..#......... .#  ..\..... . *#.  ... ..* ##.#*.#...#.. .\...#***   ..#* ..#...#. \.# . .\# *#
# .#\....*....\*..#.#\.  . .*\.#...**\#. ##.. ##.#*  \ \. ..*#.#* \..*..#....    *..*#.# ..*\. .#..#
#.#.\.\\.\ ..#. . ... \ # ......#...#.*\. . ....*.#*..\*. .. . .# ..# #... #  . .. .# ..\.#..*#....#
#  .....*# . .*##\. . . #. # ......*.*\.##.....*.... ..... ** \ *....  . ##*. ...** .... # .. #....#
#..*.* .* \..*#\.\ ... *# * ..\..... #..\..... *......  \...*.#*...#. ..#..# ..#. .* \.\...*...#  .#
#* ....*...#\ .. .. **.*.\..*#... ..  # #\. *. .*.\ .\.*..#*....*......*.....\....#.....*...*...* .#
#...**.......  *.#.... .... ..  .... .. \\.*.............. ..\# ...#.... ...  #. .##*......  .#....#
#.. .* ...# .... ....*. \.........\* .\.....#. ..#.... . #... .......*.. \. #\..#..... #**#..*#*. .#
#. .#..... ...  .......#.....*.. ...  .#.  \*. . .*. .......*   . ..  ...  #. ..#  .*.    .. *#...*#
#.*.*....  . \ *.*.*. ...*#.  . . *...\\*#.#...#.*#... *.......#.. . ... ......   . . ..#  #.. ..###
####################################################################################################