####################################################################################################
# ..#..#..#.....#*. . .*.. .... ...\\...#. .\ ..\. *...*. *.*....* .*.#\.. \.*\#...#......#*.... *.#
#. *#... # ..\ *....###...*#.#..#......*....*.\.*. *\#.# ..   *. ...\*.. *...\... . #*  *.........##
#**.\  #.#*.    ....# # #..#..#.# . *#\#..  ..#* ...*...\# .#... .#.  .# ..\. .. *..\..\    .. .  \#
#. . .* #... ... ....... .#.#  .  .  *.. . .........*. ..#.\#. ....\.#.  .**. .... \. #*.#*#.#.#** #
#.. ..#.#. *...##.. ...... .\..\\*\ #..\. .. . ... ...#.# *. . ..#.... ..#... .#..*   .. .\...# .* #
# *. .**.# ...... .....*..\.... ...\...#  .  .##.  \ .....  .*\.*#\..*. ....*..*.*....* \.#.. ... .#
#*...#.*\......*. ..  #\#.*...\*.. .#.. .*...\ ..#..*# . #*. ..\ ...\.*. . ...\\**.. ##.\ # ###.*.##
#..*....*..*.  ...\ *# #.*.\........ ...#.. ..*.. ..#....\.\.. ..... .  . .\*.\ *..#\.... . #*#*..*#
#.\.   . *.... .*. .#.. .#..... . *.  ...*..* ..*..*## .# ...\. . .#.\. #..*..#.#. ** \.*R.*#...*.##
#.##\ #..#\.*...#..**.##\... .\..**...*..\.  # ...*\#....#... ..... * ....*. *. .. \# ..* .#..# ...#
# #..... ..\.#... * ..# . .##.#  .\.**\...##.. .**. ....** .. * ..*..** .\.  ...........\.   #*...##
##.#.\... *.# \....#...  . ..#** #... .#.. .\......... #.....\.. . ...** *#..... .... #.*....#*.*..#
# .\\.. ..\..#   #. .. *# . . .. *... ..  ..#**.. ...*.#..#....\.\ .# *.\. \..*\#. #.\......#..\\ *#
#. ...#..*.#.\\*#*# .. . .. ..  ..*.*...\\  ..* * \*.*.........*#*.#..*#...   *.. #. **.. ....*....#
# ...#*.....*. .. . .*.*. .. ...*  ...#.\... ....*.\# ...\.##*#..*** *#. \. .  . .\... ..***.**## ##
#.*....#.* #...# .  #..\... # . .*  #  \.* # ......#..# .#\..\...*.\...#.. . ..*..#..\ \*#...\.....#
#..*...\.# .\..*.#......* . .#*..\. ... * ...\.... *\.......#.*.#*..# * .#  ...#... . \.....#..#..*#
#.. *. ..\.\*....*...## ..#*.*... \.. ... . .#. .. .*.# .. *  . .# . . ..  .#.. *#...*. . . . ... .#
##*..#.#. .....*  #\*##...#. ..#\*#. \#..*  *#..*\*  . #. .\...##.*..  ..##..* . **.  .\#.\*  #...\#
#\ # .#\... .. ..#.*.*. .. .. ....\ .*#..*..*.\.#.. ..*# .\ .......* #. . ............  ..*....*.# #
#.. ...*.. **..#.    ... ..\*..\..##... *.#......#\.  ..  .*.  .. ...# ....*.#.\.\  *\\...#. * *..##
#\. *. .#... .#.** .....#. .....#\..#.\.#.... ...#*.. #.\. .#\.. ......# .\  #..... \... #..  \\.###
#..... #. \ ...#.#.*.  .#....\..... *...\.... .. ... * .#### ......#\. .*.......*....*\.  .....#\..#
#............*   .  .*..* ... ..**.. .##\.. .\ .. # #.. .*.\.....#...\. .....  ..#...##.#.... \*\..#
#**.....#.* ....#.. .... *#.*....* \# . * .*.##\*..*.. .#\ .. #\.. * \.. ..##... . .*.......\.#. **#
#* #.#  .. . .........*#....*...# ..   ..*. .......\. ..#. # #**.*# .* . ..**. .....*#..... *.  .*.#
# ....##..   . . .#.... ..# ..*.#. #....*.  #.#....#.#  ....  .... * .#. #..  . .*.#*......#...***.#
#...\..... .. .*... ..###...#.#..*.... *..*..* *##*.. .... **\.\*.  .. *.   ... .*.** .**..*. .#. *#
#*.#...#  ....\** .#. . .*. ..# .....* #.*. *.. ## .*  ..*.*  #. .....##...#. \.... ...#.\. .*..#*.#
#...  .....*.#...   ..#....#..# #. ......*.....*..#* .## . .#.#....#... .......#... \#...*.... .. .#
##* .#...........\  ....  ...**\ *.......# ....#* *#...#..*#.. \.**...#...\.*......  * ...#*\#. .*.#
#.   .. ..# **... . .. \*..\.. #\#. ..#*# ....#.. ...\.   .#.\.........#....... #.  #..*.#.....*.. #
#. ...*.#.  .  ..#.# ..#. ...  \#..\.*... .........\ .... .*..#.# .\... ..  ....#  ..*\..# .......##
#. ..#  *.\ ... * ...#.\....... . *\*.  .. \\....  #........... #.... \.\#*...#.. . *..*. .... . *.#
#..\#..***#*\ .....##. #..\ ..**... ..#. \..\**  *.....*...* .. .*.#.. \ . . . ..*.*   ........ ..##
#*.#. #..  .# .\* \. *.....*.* ....#. . .#  . ...... \... ..\  .   *\. ... .*.* ..\.#..... ..#.**# #
#. * * .*..#*. .. .*  .......#....# .....\*  #*.#...# *...# ..*.#.*.*. ...#.#.. *. . ... * *. ....\#
#.  ...\*#*.....*. ... .#.#* .#  *... \   .... **## .....\. ....* .*...\#\#*..#*... ..\. **. ..*# *#
# ..  .  ....*. .\.\#...***.\..... .*#.*.. .. #\ .*. .... ...... ....  ...\ ..... \.*# \.* .*.. . .#
#. * ..* #\. .*.\.....*... .  ..#*. .. *# .. ...*. ..  ..  ... . . .*......#. .. .. #......#. ..*#.#
# *.#  . \*. * ## .#....*.. . .... ..#. .* .\.. .# . ......   .*.*  * ...\ .  .....**.#  ....*.....#
#..#...  ...\#...#.*#.....#  ... . .**.*. ....\ #*.*.#....  .#.... \#..#. . .#.  .....#...*....... #
#.  .# .. #..*#*. . .. .\.......#.\ *...##  . \\ ..*..#*.#\. #..###.#\..\\ *\ .....##...  ...\. #. #
#*.#*.** .\. ..##.\*  ..*#. *# ..*\ . ..*. ...# .*.* #.**.*#. .*.. .#.   . ........ ..#... ..  #*  #
##...* \. .  ..  \* ....  .. *#.....*#*..\*\\*..  .#..#.. ....#.* .## .... *###*  .\#.  . . *.*...##
#..#. . ...  .*...  \. .**...\.... .\. #..*.. .. .....  .*...#...##...\...*.#.*.*#..... ..* *.....*#
#.# ..#.  \ *.... ...\  #....#*...  .. .## *....# *....##.  .#**...... . .#...#. *\.\#......\ .\# ##
#. #. ........*... .. *......\#.. *#.\.... .. ..#.....\. . . .#  . \*#\ ..#..#. .##*...  .#  *...#.#
#*. .. .  .\. #*\......  #..*......\.  .\#\ *.... \...# .  .* .#.\##\.\#.   ..... ......\ ..##..# .#
#..*.#.......**.....#.......  # .* ..#. ....#....*#.. .....*... .* #\..# ..##..#\\*   *..  . .#... #
#*.*. \   #.. .#*... . .\. ..\..*#.. .. ..\.*.\. .\ .*.# .* . .*...\..#.* ...\...*.. *.\\......#*.##
#.  ## . .. .. *.....#........#..\.. ...*  .........* #..#. .. ......# \ * \ .. \.*..\ #.#\\.. \...#
##.. ...   #.  ..... ....#....  ...*..\..#..* *... ....##. *.  . .# \....   ..*#\*\.#\##**#...\.\# #
##*#*.***   ......# .  ...**. *...#....\..# ....\.#.. .. * ...* . \.  ...\ .  .#...  ..\........*..#
#  . ..#... . ....**.*.*## #. ..\. #...# ....# ...*..\   .**... #. \.#. .. .. .. . ....#...... *...#
# .  .... ## *..*.. *#.  .. . .*.. .#*.. .\... ... ....##. .. ..\*  .. . * .##..# .\.#*..#.## ..*  #
#. *.** .*### ....*. .#. #.# .*#*.*#..#...# *... \.#\..*# ...* ..*# .  #..*.......#  .... *.. ...*.#
#* ... .  ..#. ..#. .. . ..  ..\ *.\.....# ..# ...\.. ... *....... ...# \ ..\#*..\....*.\..... .#\ #
#.........#...\..*#..\.##. . *........ .*.*... .*.**....#*# .*. *\*  ..#..... . ..*.# #. .#.# .  . #
#..........*.. .#\.....*....# .# *.. .\..*.#  .#.* \ . ....#*...#..#*.\... ... .. .\.\... .*.\*#...#
# ..#.#*#..  ....  ...\ ... *... ..*.*. .. . *\#..#..  # \ ...#.\ . ..*. .#..... ...\#.#. *..... *.#
#  #. *#. .  #*.*  ... .. \. .#.. .\.\ . \ .....**.\..\....*.  ..  ..* *.. ..* .....   *#......*.#.#
#.*.#... ..**........\  .#. ...  #..* .   ...\*\..#.. ..\....... \*.\ ...... .*. .   *...* .#... #.#
# . #*. .*.*..#...* . \..  . .* ##..* *#.... *  ... *.#..#*\. ....*..#.*..\ ..\*..#. ...... ...#..*#
#..#\..#..\.#....  \*\\.*.* *. *.*. #...#*.....*. ... ..   .  ..##*. . ...#. .....##..\... *.......#
#... \..*.##... ......# .*..... ## ...*.\*# ....... ....##...  .  .  .\ .#. . ***.. .**.\  . .....##
#.#..\# .#..\.#.#  ..*#  #.. .*.... *...# ......#..#. *......# \*#...#.*.. #.#..# *.\*... ...\#*.#.#
#.#...**.* .*  ..# *. *#. ....##..* .   *#....\..# ........#.*#.#....\* ... ..#\ ... . .\#... .*.. #
# ..# .. ..## .#. ##.#. ....*...#.......*.. # #.*... ..*. .#.. *......  *.\ ...#.*.# ..#.*.. #. .  #
#... ...... *..\#. ....... \ .. .\..#. . ....*...#...... .#..#.**#.....#...*...##.... . . ........##
#* . ..* *........ #......**   #. ..*....#......\..#... .#. ...*....#.....*# ...###.. ...* #..  # .#
##  .  .*......... ..#.**... .... *..**.... *.*..* .*... .\.\.....\##...\ . .*........ . . . ......#
#. # . ...  ...  .. *....*#.*...*  ... .#\*.* ......#... #.*   . *#..**........ *..\ ...... . ..##.#
##\.  # ..\.....  ..*..*..... . #...\. ....**....... ...#... \ #.. .. . \# .......\\......*  .#....#
# . .*#  .. .# ..*.....#.*... #.# #.*........  .\.*....   *.....\\.*... ..   .\ ....\..... \ ..#.###
##..# ... . ..#.\# .*.. .*##..\.*..... ... ...*. ...#*.#....\....##.. *\ .\. #.\..\*... .... ....*.#
#....\.....#...#.#*..#. ..#.. #.  ..... *..* . ...*#......*..... ..# .*.\.*.#\#..*.......\ #. ..\ .#
# ..  .*..... ..#.*. *.  .*...... .. *.#.* ..... ...\.#...#. **.*.. .*....**.. * .. .. . .*. . *...#
# .  ..*.*. ...#.. \..##..#.. .***.......*... . .. .*..* *. ... #...#...\.. #.# .#.... .*...##.*...#
#.#....* .  ... ..**..... . \# *... .*.... #....#*..\*  . #\.*..... *... *.. ...#..\  *...#  #.....#
#..#..\# .*....*\ #..**.#... .*..  * *...........# .. #\.....*.\.....* ... . .......#.* .#\... .#\.#
#\....*.... ....#*... \. . .#  . ..#.. #...\.. ..\ ..*#.. . ..*..... ....#* .#.  .. .  ..\\.   ...##
#.*..... ... . \##  #\\*.##. .#*... \ *.. ......*.  .*....\*. .  . ..\.#.**  ** .* .   \ . .... ...#
#   * . *..#....*.# .#*... #.....\.  ...... ..\\...   *... ......*..#.....#. #.#.......#* .. ..\#.##
# **. ...*## .#...** ..*...#.*##.*..........*# .. .#\\\ .   .\#*# ...#. ...#*. #\#..#.\.. .  ....*.#
#...*....\\...\..#. .#...*.#.* .\# #*.#*...\.....* ... .\ .....*. . .*.....  . *#.....#. ...#... .\#
##*...##...*.. ..... ...*.\..  ..#.#\.# ***...*....*.... ..*.. *.\.##  *. . .**...#. ...* .#.* #. .#
##.. ....#.#.. * #.\\\...\\..*   #.#*. *.. .. .. ..*\  .... ... ...#*..... .# #.#. * .....*#\.  **.#
#\.** .... ..*\. *... . ............#.  ..#...  .* ..#.#\.......*.......*. .. .  ...#.\*.*\ .#....\#
###..#.#* .*.....# .\*#... .  .  * ....  .*..\ .# \#..# .. *.. *.\\.. . \. \. ...  \###*# .. #...*.#
#........#.. *..*# .**.. . .... #  .....* *.*.\...\#\.*.*.*... .... * #... ..#.......\*. .\#... #..#
#. .. *#. .*#.*..#\. .... ...... #... ..... #......*.\\.... #... ..\#. *.*......#.*.**\ ... ..... *#
#... ... ..*.. .*.*.. . ...#.#.   . .....#.. \.. #.*... * # ..#.\.*.* .#. .###\.........* ...#\.. ##
#...#\.*......* * \#\ .  ... ..*.#.....  ..... \.###. ...... ....\... .#...\.# ........  ...# ## . #
# .# ..# ..\#..* ... *... .# . #**.*.*..  ..#....#..  ...  #*.....\#. ..*\* #.... ...\. .... # #*. #
#.*....*.\\.. . \ #...#.....**... ..*#.. ... . .....##.. ... .....   \ . **......## ..*.\..... .\ \#
##  ..#....*.# .... .* .##*....## . ..#. .*..... .*. ..#  * # \..\ ..***\.\##.. . #* *...#.. .   ..#
##.* . \ .  #.**..... .#   * .\...#.*. .#.... ....    ... # \..##.#.........#... .. ...\.#.....#.* #
#####################################################################L##############################