####################################################################################################
# \\**.\....*.#. .#..\...\. ....\*..#. # ... * ...  .... \# #*.#*.. ... # *..#.. . .\. ...*.*. .#  #
#.\ .\ #.*\*.**\... .. ..##...*.  ....#\.. . . #...... #...*###....*#...* . .   .#* #*... ..\*... \#
#.\. #.... .. . . .. . \.*..#**\. ...* . *. #..R......**..*.... . .  .. ... . .#....* ....#*.. ... #
#*.#.... #  ...\ ....#....# *\\ .#*\\...#.. ......\..#....*#.*......*#.* ...  *.###.... .#*#. ..#*#L
#...**.#.   #  .*.  ....*. \.*\ ....#..*#.#.* ..##.. ...*..  ......#*... .*....*...*\ #*.....##.*#.#
#. .#....#.....\. ..   \*... .## .#.... .#\*.....* #.#. #*...#...**.. *...\...\\.#. . #*#.#. *...#.#
#. *#*#.# .\ * ##...**... .. .\ *. ..... .#.\# *.#. ... ... .#\..........  ...**...*#. .*. .. .*# .#
#*.#..\..*.\...*....... # ...*... .#. *  .*. .*#. #*....#. .**\*  . . .........#.#\#\* . . . #...\.#
#*... ....*.. .**. \#.... #......#......*..#.  .*.. *.\.... . # ...* \#..  \.#...#.. *  .#.*.. ###.#
# . .  ..\  ..*.*#...#.. .. .........#......\.# .\   .*. * .. .\ .#.*..... ..*.... ..*...  .......##
# #*. ..*... ...* . #...#..#*....\.*##*#  ..... *.. ..*.*... .#. ....*....*##.... .... .. #...   .##
#.........#.# .#.. * ..  *   . .  ..   . *...*...   ...*.*. \.*..# #.. #*..  *\..# . .  .* .... *..#
#* ...*.*. *.##..*.......#.\#..#*.*##..  \.#..*..... .... .*..#. \.... .... . .#.\....*.. # *.....\#
#* ##....#..*..##... \... ..#*..# ..#. *....#.... \. .#..\... ##.. ..*. ..\..........#.. . .# .*. .#
#... *.....*. ..... *#....... ........**...#... #....  .*#.# # .  .  . \#.#...... .#.. \\.*..*. . .#
# .\..#... ......#  ..\#. *...*.* ...  . * .#. .\ # . .***..**... \.   #.....*.\.... #...... .#* . #
##*.  ..*.#. .#..*\*#.. ..#*\ . ......  #...* ..* ..\ .#\.#......*.\#..# ..** ...#.....##\..*..\\  #
#... .\........\....# .... #**#....#    ...#. ...*\. .* .**. .#. .* # ...#.. . #.*.## .#...#*....  #
#. *...**  ..#.... . .* ....# .  *..# .  .#.#..*. ..*#.. ..\*.#.*....#.... ....##*##..#.........*..#
## #..#...\ . *.\ #.........*.  .....  .. . ***##. \ .. * ...#. *. . .. .*  ...*... .. ..*#...#\...#
#*## ..*.. .#.. .*.. \...#...\ ...#.*.*.. ..... *..** #. ..#.#..#\. ..... ..*...#... ....\. .. ..*\#
##...#........\...\... .# . ....*..... \\..*#\*....*.\......\*#...#.\ .#..\.\  #* *.#..**#.. *..  \#
#*.\\*..* * \....  .  ...#  *.....* \*.#\.....#......*  ..#.*. ..## #..##..  ##......#..** #. ..#. #
# .. .... .#. ....#. ..#. ..\*. .\. #.......#.# ......... .  . ..#*  . .  . * ... ....*.#.#.. .*.* #
#.#. #* .*..\\.#.. ....#. *\..\***.#..*...\*..  .** *..* ..#..#.. ..  ...*. ....#* .*...  ..  # ...#
#...\.#.. \   ...... * ....#.\......\##.#.* . . .. \ ****\ ...#.#. .#.#..\. *..#.*.*......*. *  .*.#
# .* .#.......* ..\ #*......* . .# \*.. ..*..*.....#* . \*..*. *#.\ *.\  .. ..#..... .\  .*...* **.#
# ... ...*.....*\*.. \##....*\.  . *.. *..##.. *.. ..* . #..... . .    ... \. . .*....**.##.  *..  #
#.#.. .*.*.. * \. \.#*.*##.# ....*..........#..#.###.#...\#.....  .*\  #....#.#.*...\...*. ... .# ##
#... ...*......   *...\.#\* .#.\.........#........*\..\.#*... .\. .*.... . .  #.*.. .#.. .....\. \.#
##. . .\...\..*  .. *.... .\* .. \.. \*..#   .*..#.... . . ...* ..#.*.#.. .\# ... .*\ .#.\.....\\.##
#....  . \#..#... *.. \.#*  .# .#.....\.  ...  . .......##  ....# ....*.#.\# ... ......  .*#.. ....#
#. # *...*.# #\.#.  ..#..\. ...*\*  ...  \*.# . .  . ...#.. ...... . *...*# \ ...*.....#..#.# ....##
#*.  *#*.. # ... .#\..*..  ......   .*..\...* .*  . \... ...#\.  \ .*\. #..*.#..   . ..*...\.. \..*#
#......# .** . .....#*...... ... #.#.*..#*. *. ..*.#.**.#..#..\..*#..#*.. .. ....*.*# . #.#...*..  #
#*... .#*..**. #...*. ......*. . *  .#..  .. .. .... .*\ . \.. *..\..#.\. .#....#* .....\..#. #.. .#
#\. \ .**. *....\ ..#...... *..#..*...#... \... .#.* . #*...# #.  ..\#.. ... .## *\..\#..... .#....#
#* ..\... ...\ #. #..... ...*..  ..#.##.\#.*#. . .*.. #.. \.### *# ...... ....... .\. ...*...*#... #
#**.* \.\#....\.#..  #*   .\.#.....*. # . * ... ... *..... #.*.#... #...\*.#...  .. ..  #. ..  ....#
#..   .. ............. ...* # \.#*.... .\.... **.#....\.#..##....\.**.*...... ...#.....* ..#.....# #
#. ..   .#. .*  .*... *. .. .#.....  \ . .#..... \. ..... .*. .  ..#..*##...##.. ...........#**. .*#
#..\ ..##...\.#.#****  .\..\. .\ .. ..# .  *..#..*.\*. #.. .#. .\ ........\#. ... .  #....* #*..#\.#
# .#.#..\ ..* ... \.#.\.. \...\#.*.*......... .\\.. \#. *.\..  .*##*\. #.* . #. ....# .*# .#...... #
#..**.\ .*#. .........*.#.......    . .*.....  ....# ...**\....*.##. .. *.. \.....* . ...*.  ..*...#
#.... ...*.*  .# . .  .#.....  \.* #... .  .\#.# \..... *. \.#.  .#. .*.......\*#. .......#....  .##
#\. .\..#. .. *\ ...*... .*......*#..* ...  .*.\ ..*#.. .# .*..**...*....  ... .# * .#\*..#** *. ..#
#.*  ..*.#. ..... * ...*...  .......*...... #.... ..*.. .\.\ ...#  \ ... .\.# ** ....#* . # ...\.#*#
#.. .**...\.#. ..\..\..*... .....  ......\#\..\.#.*.*....*..\*...*\.. ..  . .* ..*.. ####..* ##*.\.#
# #......*.\. *. *.*.. # ...  . ....*. ...*  ..* .#.*.\  *..* ........ .#... .**.. ..........\  \.\#
# .*...## ..*.*.... \..  *. . ... ## ..\. . .......*.#.*.. . .  .# #... .. ...#.... *. ..##...\* ..#
#.\  ...# * . ....\.. .#.*.*.. .\*......#*..# ** ..* #.#.. .*..*... ... .**.. ....... .##..*#. \.. #
#... . #... \#.*#..# # ..#\  #...#.  *  ..... * *. *... # . . ...#. ..#  ...  ...*.*..\. .**...*...#
# #.  .. #.*..*....*# . ..*........*\\.\..\..#..\ .  \.  . #*#.*\..* .# #\.#. *.#. .#*  \. ..#...#*#
#*.#. ##...*. . . ........ ..#. .#*....**   # *.  .\.#.#.*.#\##... . *..# ...#* *.  .\##..\ ..#.* .#
#**... . *\#.... . .. .. ..*#.....*#   ..**... ...\* .#..#...*. .... . #.\.#  # *..#.. ...... #\..*#
#\..\ ... .*.. .\#*.# ..*##*\ ..*....*.. .. .. .. \  .. ....\.* ...#....   \*...*.... ...\#* ....# #
#.*#.*  \.  .*.......  .  .#**. . .*# *.  .#...*## .##  ..........  #....*  ..... #.*..*.#. #*. *..#
#......#.*.* ..... *... ..*..... . .. .* ...*.#  .**......  #....  . *.## ....#....\ *. \ ...*.*.#.#
# .. *.*##\.*....#..#...\..\ .. *#*  ....*...#.# ..#..  ..*..#..... *\* .#.#..*. ...#.. .    ......#
#*# .   .  . *.  ......\.  ..\ \..* **..# . ...*...#.*..... .....\.*.#.*#.. ...*... . .*..*\\..  # #
#...*# ........#....*... #.\ .... .* . .#*..##*... \..   *  # ....\...... ...#.#...#..## ##  #...# #
## *\ ..*.*.#.#..#\.*..#**..#... .... .#.#..*\#....* . #** \..... .#..... *.   . \... .*.#* .#..\..#
#. *..#\#...\*.*.  .. .#..\ ......#*..*\* ..** . .   ...*...# ... .#..*...\.##...*\. ..* \.*# ..\..#
##*... *.*.  .  .*...#   ....  # .\.* ## .  . ....\.......  **..#   .#. .. .#*\..\*. ..\..*.... . .#
# * ......... \.. ...#.....*...\....*. ..#. .........#. . .*    ..\.. .... \  ...#\...  .......  ..#
#*..* ...*##.......* ..... ##.*..# \...#..# \..*. \...#....#....*. . .  . .   ... #.##...   * .....#
#..#\.#.. ...*...\\.*#  . .  ... ..#.#....   # #.. *........*\*\...# *.. .. ##.... .#..*\.#..#. .#.#
#....\.....\.*...  . .*.....\*#.. . .***\........*.##*\#... *.*#..#*#.#......  # . .. ............ #
## . \ .... .. .  *.. .###\....** .#....###..#*.# . *..  .. ...*. ..#\#... .. #..#...\\*.#. *.* \..#
##...* .*...*#..#   ......#\...... .#. #.... * \#.# ...#.#......*.*\\.#...... ... \..#  ...*.\\\.. #
# \.*.#..#.  . . ##...# ..#.#**..  \. #..#..*. . ..  *\#..   #  \.* .\#  .....  ..... #*##   *.* ..#
#.**# . #.*\..#*#..  .**.*.. .  .*  ....# \... ..# . #. *.##*  ...#**.* ...#... *#.......... #**#..#
####.*.\*..*  #*..\... *\..*... .. ..*.#\...#............\...#... #.  #. ....# *. .\.  \....  .....#
#*  #.\....\*# .#.*.. ... ##  # ...* .. . ...*  .#.  ..\*. ..... ...*.\ .## .. .  .#.  ...#. #. . \#
##........... .. \.*.#.#.. .\*.\. ...#\....#. ......\..*.... #.\..#\.#.. #..#.#.#. ....  .. ... *..#
##.....#..  # .#...  **. *#*.*#  . .\.*\. ..*  . .\...\*... .*.... .\ .\..#  *# .. .\... #.. .#.#..#
#.*..## ...# ......**# . ...*. . ... .. #. \.*.*#.. \###.. .......* ... . *...\ #.*....... #. . .. #
#.... #.. .#....*#.*... *..  #*.\\.  ....\ ...*.....*.#.. .*..*..\. #. ......\....* ......*.....*. #
#**.#..# #.#.....* ...#... #...#**#.... . .#\.*.. #.\*. ... #.#. .. ..# .... .\ ...  ..... *  .....#
#....#.##.  ..  .\#.*\..#.*\ \....\.....*... . #.# \*.......#.  . \ ..# .....## ..*##.#.*#  .*.....#
#* .\.*.   *. *#* .\. .*.......\ ....**.\.........*  #..#..#*. .. . .#*...*. ..##..\.##..  ... ....#
#...... ... ...\.#...... .   . ..  * ...*.. .# #..* ..... . *.. .......*.. . *\ \. \..*....* .. .  #
# *. \... #. ..#.#.*.*. \. ..#\  .  ..* . ##.#.\#. ..#..*.\.......\*. *##*\..*..\.... .#......*...##
#*..\...#*....#. .#......*#  . ..*  . ..#.#*..... ##**..... .. #..... ...*#.   . #.#.. .. ..\ .#...#
#..* ...\..# ##   . ..* ..*. * *.. ... ..  ##... .... ..# ......#. \ ....#\*.. \...* ....*...#*.\\.#
#*. .* \*...#.. .#..... .. .. *.#... \... . #. ..# *. ....* ..#* ... . . #*.... **#.\.     .#*.\. *#
#.\\..#.\...\. ... .. .....  # \.#\.. .....#. ...... .  .#  . \.......  .*.*\. \.  #.......... .##.#
##*.....\.*.... .*# . \.**. . #....    . #... ... .\......\ #... ...... .*...\. ..#.#... .*........#
#.##. ..#.. .\\*... .#...*..\..#...#\.. ..#.....#*..... .\ ..... ... . ##..*..#... ***...##.# .\.. #
###.. ... *. #* . *. .# ..#\.... . .#. \.#  .. ... ..... #.#.. ..*.#...*..... \*. .\...#... .\.. ..#
#  .*.\ *......... \\.#...#..*..#..# .... ...........\\ .... #.##...**.*\......  . .#.\........ \#*#
#* .\..**.....* .. .*#*....*#........  \...*. ...#...#**..#.#**.......  *.*.#..\.#..\*  ..#..\  ..*#
#.. . ..#...*#.#... ....*#......#.#*..#..  .. .#.. *..#....** .#...   .* ... *..*# ... \  ....*\.#.#
#.... ..#.. ...* .. # #....\..# .*. ..\  ###.. .  .... # . *.#..#....  * *. . ......*.......  \# ..#
##.  ...## *..*.......*.*\... .#. ###.. \.*.   .. .  ** ..  #\ .....\### *.#. *. .*#. #.\*....#..*.#
##..  **# #.    ... .  ..**.\ *#.... *.*... .. . .*.*. .....  #*......\. ##  ... . .. ....**....*. #
#....... ..... . .....***#.. *# .... .*..*. ..* ... ....\. .#*..*#*.  .#.*... ..  .*..*\. .....\** #
#*.# \*. ..\.. .#*.  .. *... .\..*.*...\  .#.......*.   .#..   ..\#*.....*#..#. .... .*..\..    .  #
####################################################################################################