####################################################################################################
#.# \.  #*.... ..##**. \.. . .*.##..*.* ...\...#.  #.. *  ..\ . # ... .*.**.. *..... .......#.. \.\#
##\.*... .#. . ........*...#.....#.  . . ....*#*..*# .. ..*.#.*.\..#. ..  ....* ..# #.# ..*#*# \*..#
##.. . #....\... . ... *. . \. .\* ... .. . **...#.  * . ... .#\......#. .*# ...   * ... * .*...*..#
#..*.#*.. .#.#...   ....#. ..... * .#.*.\# .#\......... ..*#...  *.. .*. # ... .*##.#**....... ..  #
#. ... ......... *....\.. \* ...*...#..\.... ...# ***..##. . # .. . #..**.\ \...*..\#..##..... .#.\#
#. #.### # . . ...***..*. ..*\  ## .... *... ..*....# *#.. ..##...  \#...#\#..\*.#  . .\... .....\.#
#\.....*...\#..*.\..*....#.#\..*...\.#... ..*...#.*.... #.  ..\. ..*.#   ... # #*....*  *.....#  .*#
#.. ....*.......\#  * .*.# *. \ #.\#....#..  .#  #. #*. .. *.*... .  ....#..*\ ...*.#.*... .*...*..#
#  * .#.  ........ ... ....  #. * .#.*... ...* * ..  . .. .* ..* \ #..*#.  *.. . *...  .*#..**.....#
##........\.. .#.\#.#. .. *..*..*#* ...* #  ..\....#.*.*#.*.* .*#.\*...#....\ #. .\. .\..#..##.*#.##
# ...# ...*   \#.* . ... * ...\....* \.*#\...#...\.*#. *...   ..    .**. \.\... #\ .# *\..#... \ ..#
#.\ #.. # #\. ..*#.......\.*..\\....\. .......   .*...   ...#...\ .#.*** . # # *. . .. ..*#...#*..*#
##.. #   ........... .**..*.    #.*.**\..*. . #. ...# ...*..     .** ....*... .*... .#\.... .* ....#
###.##..#. \..#.....*....*.  **...#.#..*\.... .#.... .#. .\*.. ..\...# #\. ...*  ......* ..# ....* #
#*... ...### . ..#..... .#.. .. #**# . .\ .# .*  .\ ... .. ....*#*. .*#.*\.#.......#..*.*.*# . .* .#
##\.\... *.## .##..*.* .**...  .. # *..  .. *. .*....\..#. .. \..\ .* \.#..\*\#.\. .*.\.# ...* *#..#
####..\..# .   *.    ..*\*....\. .....*\#*..*.*#.. ...#... .....#.\....#...  ......   . #..\#... *.#
#..\.....*..\ . \.#..#. #.. .*.##*.#. #  .#........  ** .#\ *#*## .*. *...##  ..**..*...#.*.*  .*#*#
#..*.#...*..#..\..  . \*....* .  ... ...... ..*..  ..*.... ... . .... . ...   . \.#.. .. . *..  .. #
#...#.. .**..*..#..*. ##... \........ ..*.# .. #.. ..#. #...\...*#.**......*#.    .*. . .... ...*..#
# .#.....*....*.\ . . *. ..\...#....\.*.  \**... ..*....\#*\...*. ....#*#.#.. .. . ... * *...*...#.#
#. #.# .*.* .#.## ...  ..  .#.. ...\. \* ... . *..........****....\..\ #*. ..#..#* .  *\** .*.. ...#
#..*.#. . .. ....#.** .#..\#....\. ....*...#..#...*.*. ......\..\**..*...  ..* #..#..#........*\...#
#..\.. ..#  ... .....#. ...#.\.#..#..*   ..........#. . .\..#.#.#..\  .#.#....... #.#..*.... .*...*#
#*....*\.  .   #. .. ..#. ...*.  ..* ...***.. \ . .. ... #.#.\........***   . ...#*..\#\.* *..\*...#
#..\.\. ...*.*. *.....#......\*....#. .. .*..\.   ....*...*.  .*. # .* . ...  . . ..... ... #...**.#
#...*#..*.*#. .... .....#  . ##..*.*.. #...........#...#.#\.# .#.#. ## #\###..*...# ..* \.*.# *....#
#  *.  . ##.** .#.# .......* ..**..#\**..# ...... . *...... . #*... ..\ .  . .. ##........#. \... .#
#..##.*. ..\#.. *..\*..... ..*.#....*.*# . .........*\ . ..... . .*.\.....#.* ...... ....*.# . .*.*#
# .....*.#.##. .....*.  \\#.\ \..*  . \...#.##....\ .... ..#.....\ .. .......#..... .*.. ....... .*#
#**\ .#... **  ..\# .\*....# ............\*...... . .. ... * \.....#..   #........#.......#. ....*.#
#\..#... .#.  *...# ........  ...... .#...*# #...*....*... \.# .\.\.....*.\.....#.*...*..   .. ... #
#...**... ..#.#. ........*... ..*#....\ ..#.#*##  .#\* ...#*.*. ..#.... .. #\..... * .\. .#.*... .\#
###\..\ .   \..  ...*#..\\*... ...\. \# *##...*...*.#...R . .#..... .\ .#.# .#..#............ ..\#.#
## ..##*  *. .......*  *\.. ..#. *.\# .*.  #...\...\ # #.  ...*.\.\ .  .** *...\*. ..*.. # #.\. .* #
#... .*#..*# .#...\ # #* \ . #.\. .... ...  .#..#.*..#.   . **.#  ..*. ....  .##..  .*..\.\. .#. ..#
# .. *##.* ..##. #.....\*.#..*.\#...* .. .. ##*.... ..\.. .#\*..... \ \.....*# ...*.\ ...... .... .#
#.##*..*#.*\ \. **....  #  #.#  #*  .*#..#*. # *..... .....*.......#.\ *....*. .. .*. ...*.#...*...#
#\.#*....#... . ..#. *... ..*.*...\  #\ ...\ ..#.   .#**..*.\. .. *#... ....\#....  .#..#*...... ..#
#..  #.\\...  .. . .# .#..**.***.\... \.*..* *.#..#.....#.. ..... ...\....*# .. . .* **#.. *...*.\.#
#...\#.#.....*... #*. ....  ....#..#..*. .#. *.*#* .\..   *...* ..#. .#.  #.#...\* ...... ...*.... #
#....#.*\ .*\. .#. . .. **\*. .* .\ #........ #.......##. ....*.\#......#. \. .. ..\#.. * .. .  \. #
#.#. #.\...... ..... . .. . .... . \.. #.. .#**#.. .#. #.   . ... . ..##  ...\*. .*..* \*..*.. .*. #
#.#..#.#......#*...*.#.  ... ......   #.. #.. ....# ..\. .. ..  . . ... .*.*. .\#..#. . #.#*.  .. .#
# . *..# ## .*  *.    . ..\ ....* ..  .#*..\.##..  .. *...... ..  ..*..  \.. \..... ... ....  .#..##
#  .*. . .\. .**\ ...#.........##...\.\* ...\#*.....#.  ....##.* .#\.#...... ... *...#.....*. .  . #
#.  #.#.. .#.*. ..#* ..##.....#.#**. . . . .*..#\#.#. ..##.# ..*..*  ..  .*   .... ... * \.. ...\.*#
#.... .. #\.....\*.*.. . ..\..\.*. .... ...... *.... .#..* . .. . . . \.*..* ...\    #..** .*. .. .#
##.  *#.\..\ .\.... *. * ....*#..#. .*....\.\\.......#. .##\\.. .#..#  .  ......... ... . . \. ....#
#  *...\.* .  ##.... ..... . *\  .\ .* ..* .#. . # .#*...#.#.*. .\ .  . . ....#.*....*....\. ....* #
# #.....# \.. ##....  ....*\* . \..*\.. #.#. ...  \. ..\.\ .... . ..#. #...  . ... .#..*.  .\ ..\. #
#... . .. .\*.*.....  ##.*#.. .. ...#.#..#\.*. .\ .. .... .. #.. ... #.*. ...#*.*.#...#* .... .... #
# *..*. *.. *.. ..\*#..* \ ..* .....\.#. ....*#... *. . ...*#*##..*.. *.. ##  #.  #..\#.... ...\ \*#
#*..*. . #...*#.. ...*#..#...##..............#.... *....\ \....* \.\ ... *...*\ ##.. .##      ..* .#
#.#*...  ..# ..*.*.*... * #...  .  \ .*.*... .**.......#. * #...  *..##. ......# **\.#.......**....#
###.. .\#.# . *. .  #.*\ #   .#.\   ##*.......\.\. ..#..  .*. ..*....#....*.#*.*..#..... ..###.#. .#
#* ** ....*#...###  .  * .\ .\ ..#...  ...*#  *.\..  ...#... .# . ....... ....# .\...*...... *# ...#
#\..\ ..... \# .  *. ... ..#.....#......##.  * .\..\ . .. ..* ... .  .*\ .. ..***.....#* # *\\.. ###
##..*...\* **.... .  .... ...# ... ... .. .. ... .......\.. *... .. *.. ..#*..#.. * .. .  . ..  ...#
# .\...*..\..  # ... *. . ..... .#. ......##.. ## . ..* .*\.#.#\# .....*.. ..# .#\..#*.#*.#.#.\#. .#
#**.##....\#.#* ......\...  ..#.... .. ...\ \*....\.#.. ..# * .#.* ...# .......\..*..*.* .*.. ..  .#
#..\.   ...   *.#.\..##...*..**.* .#...*..#.. .*#.** .*. . #.. . *. ..\ .. ... ..# *. #**.\...... .#
#.* .... ..\ . * ... #...#....**  .**..\..#  ... ....*.*.......#...*#* .*..*##.... . ...#.**   ....#
#.#.*..   ...* \..#* ...*... .\#  * ..*. ..  #. \..#. .#. .. *.... # .#..* .....##.*.* \\.....*..  #
#.. ...# ....*.*..*  . #\**#** .* .*. ..#. . ....... ..*.. . .. ..... . ... .* ...\.\ \#..\*. #*.*.#
# ..  ..#.\*..#... ........* ... *..*. ..*.\..\ ....*#. . **.*.. .* *.\#**.#. \**...##.*\\. .......#
#... .*..  \#...#..*  ..#.#..# #.  \....*\..\*.\ #. ....\*. . # ...*.......... .  ..... * .#..# ...#
#.#.*.*.\....\\ #.#.#..* \  . ..* #.... .  ......  .....* .....#. ... .#....# #..#.#...# .....#.# .#
##..\ .\   ..#.#......\ . .....\.. *\.*\....*.......... #.* *. .. ...#.*... .... . \\*#.... *....* #
#....*....*....**  .  . .##. ..#.. .#....#\*.#.....#* ..*#.# #*##......\..\  ....#.*. ...\# . ... .#
#.. .#....... \.*. .*....#..#\. .........   \. .** .*..* ..#..*#.... . . .***#...... . ..* #.#.# ..#
#.*.  .# .##... .* ....#.*... *# # \.*....# .. ... #...... #.... .\.. .\*..*.*#.*#  ..... ..* . ...#
#.. \.*. .\. . . . .***. . .#...* ..   . #**\.. .*..# ...*.. \* .. . .... . ...# ..# * . ..**.. . .#
##...* ...#*....#.# .* #......#  . .............. *....#*. .\#. ..*...*  .#.** .#.. .  .*..##..#\..#
#* ... # .... .  ..*....... # *.... .....*..........#*..*.##*.\ ....* # *...*# ....  ... .#.\...#. #
#. .. *.  *.. ..\ #\......   .....*... ....*..... . ##...* .##..* *............ .*.#.\ \ .#*\.. ...#
#. .#.. .   ..#....*.... .#.*....#.  *....#. ..... *. \ ....* #..*... ...\..#*\. ....*#. #.#.   \.##
#*. . #.....#. * ..#.. #..  ...\....  #... #........ .\....#. #.. #.#\..*.. #.\....*...... .. .  ..#
#  # ..#..# ... . .  ...*#. .....  ...\   .. ..\*#\ *. ..... #..#.. . ...# ....  ....##.  .*...**..#
#..\...* ....*..#.#..# .    .......#.*# .....# .  .. ...*##.#..\.  .. ##..\*.#....\**. *.*... ..  .#
#... .#...*#  *..#* .. ...****\.. ...    ..*. ....# .... .** #..##... .#   .. .*..*.... ..... . #*.#
# *\. .#...**.. ...## .*\ ... ....#.*...  ....* ... * \#...... ...... ..*...... #*.\  ..* . *..#...#
#.* ....#.## ..# .... .## ..  #. ..#* .. ...\.**.#* ..*...*... .*. ..\* **#  ..\.\.* .. .#.... ..#.#
#..#.\  ...# ..#..\.... . .*...*... \.  ..*.. .....\...*\.*. .....*..  #.. .\\*#. \#\... ....\##...#
# ** *\. \.. #.. #\... #.  \  #..... #\\ .. * #.#... ...* .   .*......  .#*.  .....  \... .*....#..#
# .    . .\##.. ...#* .\. ...#.. . ..#.\. ..*......*. ..# .....#....*..*..* ....*. #... .....*.#***#
#.#....*.#....#.\#.# **  *\ **.*\ ... ..# . .#.\.#*.#.\ . .. ..*. # .# ..#*.# #* .\.... ..* ... .\.#
##.. .\... *..#..\* # ......*..* .#*...  ...  ..  ..... . .\#...#....\.*#..* \.*. .  . . *.# . ... #
#. # .*......**. .  * .. ..*.\ *#.. ...\.\\ .\.... *.*..#..#. *.*. ...#....#*....*.#..  ...* ...\. #
#. ..* .**.#.\#. . .*. .#  ... *....# # ...\.. .......# #\ .......\ #. #*........#..*#.*... .....#.#
# .. . #**#.#...........*..*##.\*..*.#.\ \ .....   .#. *#...    \..\. .\ ....##.. *. ...*..\ *.. ..#
#. #.. \.*...... \\   .\......  ......#...#\.... ..\. .#...  ..# .*.*... .## ...  *.\#... . ..#. ..#
# #..** . .. .\#*.*... .*...*..#...## * ...*.*.. * ..#.*\  .\##..#.    .\......#..#.  # .*##...#..\#
#.  .....*.* .*.....#.. . #...#*\  ... . ... ...\ * .#. \#.#\.  *.. . .#.... * *..#. *. ...* *..#*.#
# * . .....#\..##*.\.#. #*   .#..*.    . .# #...#..# .#.*... ....*. . * .*..........#...# #\.*..* *#
#.. #\*.....*...** ..*..**.**..*. .# ..*........ *...# # #.....*\ \ ...*.*. * *.#...*#.....\.*..\#*#
#...#...... ...  .*. ....... ...*.\.  \.*. \....##..#..   #.. .#....#..**. #  ....#* ... ...#.. \.##
# .* #..*...#...#. ....#   .*.\... *..  *.*..... ......* * *. .##.*..* . ..\....#  .*# .##. .\. #..#
#######################################L############################################################