###################################################################################L################
#.*.\....##...\.\* .*....... .  .\  .*.\..  ..*..# *..* ..*.*...* . *.***....\\. .  . \ .#.#. # #\ #
#...#..\  .\..#  ..\ ...... .*\.*.*. .\. #.  ....#.  ..#   .##.\..........\#..*#. \...... . . #... #
#  .*#. ..# . . ..  *#...*\ .    . ..*.....* ....#...#.#...........*..#.###.\... . * ...*.*   ##.*.#
#..#\..*. .... .. . .#..\.#... .#....\# ....... *..#\..*#..**...  . \.  #  .*.  # .. ..\ . ...#. ..#
#....... . .\  ..*.*.\....#..#... .. .##..# ... #...# .....\...... .....  ...*..*. ##. ... .# ....*#
#*.. . ..\.....*.....#.....**. **#..*. ...*..#.. ..  *# \..*.*..#* .#.##.#.#.#.......   .....\. ...#
#**. *.  \\ ..  \ . *.. . . .... .. .** .......* #.....#*....... . #.\.#..* .* *..#..*....  .* .. .#
#....*.## ..*  .*.#   .# ..#......\ **... ... .. ......  .#...*.*...#.#.*.##\#**  *..#.. . #\   * .#
#..#.\..# ...  *. .  . .\\.\.\.... .*..... \  ....  . .....#*..  .##. ..*..... .#.\.... . .\  . ..##
#........ .#.. ..\ .*#.... ......   # ##\ . ...#...#..  ...\. #  .#.. .\ * .......#*  .*.R . .#  ..#
#.*. .#...#*.\. . ... *...# .#.. *.#. . ... *...\.... #.... .*..##..*##. .#.......##....... ..*.*..#
#..# ........#...#*......#.*.#... \.\...*  .#. . ......*.  #.#.*...*.*# ...*...#...#  .#.*.**.. ..##
#.*\. .#.. .#*#. .# **** ... .  .*...*.. #* \\. .... . .  *#.. * #\*.. .... ..*\....\. #...*. * #..#
#..*#.#..*. ..*# . . ...... .#.# . \.* . .....* .#*..#...\.# .**#...#*....*.. #.....*  ..#....*....#
#..  ......... ...\.#.....*.\... .*.. ..... ...*.. \.*\# .#..*.*##... . ... .....#\ ...#. ..*.... .#
#.#. .##..\#.. ....... . ......\... #*.. #.\....**........  ... ..# ..* .......*... #* #.. ... .\..#
#....  ... .  .. .. .#...\*. ###  .. .. .....\.\.* .*..##.... ..*\...# #..*#.*##*#..#.\.#.* ...##..#
#.... .\.. .* ... .... #*.. #........**\..\ *   #...#..   .# .#.. *#...\ ..##...*. .. .##. .\ ..\..#
#*. #...... * .. ..  #. ....\.*. **.* .#.#*... # \.. . #.....#... ##.. .. .... *..#.*.. . . ...  .##
#...* # ###....#.  #*.. #... \* *#...#....#*..\\... **......# *...#.#*..*.  ..# ...#.#... ...* ....#
# #... ..* .#. .#.\ .*. . .     *..*  #*..*.#..\.\..... .. ...#...#..*..#*... .*......*\ ......... #
##...#...*\. . # .  ..... ........ .*.  ...... #.\.  #....*..........**#. .. .... .....*#\  .. *..\#
#.# .##...*.#  .#... *..... *..#...#**.  . ..\      ..... #..* *...# ..#* . .\ #... .... .....*....#
#  #**.. *.## . .  . ..#.# \.... ...##........*. .#*.. * \...*..*.. * ..#*##.*# ....#......... .  .#
#.#.# . .#....\.#.. .\..\* .#*..##... ... \.#.. ..# .#*\ ..  ...#..  \.........*.#. ....*.###.... .#
#........*. ... #.. ..*.... .* #.. *.#..*......#..\   .... .* #..*....*. #... ...#...# *#. *.... .##
#.. .   # . *........ ........ .. . .##. .. * ....#.*.*  ....... .. .*..*. .\..  .. # . *.....*....#
# .......# .....*. .. . ......\ \.* * ....#*.  ..\ .*.*...\... *...##..\.\..*\..*#... #* .*. ......#
#...*\# ...*..*\.\.. .\.... ###...\ . .. ...#....\....* .... # . ..*.#.. ..**..*.. ... #  #.*..\...#
#*   . *.\..#.#.\#..*.. *.## .\\ . .*..\. ....... .* ## ..#...*#..#.\. . \ ....  #...*#\\...* .#. \#
#.*..#\..#. \ .* ..\   #  ..   #. ...#* .#. .*.#...... ..* .*...\ .. ..**.  #.#. .#...... ...*..#..#
# #.#..**...... .  *.. . ..*...\ .. .. ..*#. .....*   . .....*.\.......... ..##...#*.*#. . \......##
#* .  #. ..  . #. .. *... *# .*. . ...\* *..... .. ..\..\.  #.\\. # *.*. .*... ... .. ..# \..... #.#
# ....\. ..*..#*.........#*.. \... *.# #..#*#\...... .. ..#..\.*.\.. .*.....*... . #..#.# . ...\.#*#
##.#...\\*..# #.*...\\\. .#.. .*. ....*.  .. #.. *.*...... ..# .*.*  ...#....#. \\.***#......*... ##
#.. .# ....*. .. ...\... . ... .  .......... .*    #*#. ...*  .*.\ #. ... *.\... ..* #. *.... .* .*#
#*..... .* .* #*.\.....*.\.*\.##. . .  ..#.... .....#.# .## ... .\.*. ....\..#...........###.. ..  #
# .. ##.... # *#.... .*  .#...  .*#  #*. #. *.##.#.  .....    \*..#\.*. ..** ..... .... . ... .#...#
#... .. .#...#   ..##....#. * . . .*...\ ..# ..* ..#*...##  .* #.\..#.*.\# ..#*#* *....**... \.\..\#
#.......... *..   ...  .*.  #. #. \ ..##\.##. . .*.....\.#*  ## \.# .. *.#....\.....*.# ...  \...\.#
#........ ..#.* . . . ..\ ... .#. .# ..# ...* . ...  ..##...*... . #..  *. . ... ..*.\.. * ..#.. ..#
#.\.......... .#..#...*...#.. . ....#..#..*...*..*.*#. ..*. ...#....\ . . ... .. ..# .....*#....#..#
###.\#.. .#\..........#..*. . .....*..  .*...#....*. ..  .*...# #.. ...\.. .......\  .#..## .. ....#
#..*# .*.. . ...*. #  .. \ ..***...... .. ........ .....#.# #.#\*.. ... ..*. . . .\.......*.*.#.* *#
#  **#..*... ....   ....#.... .....* .**..\..\..#.  \*#*.  . . ..*....###\#.#.*..# #.*..*..#*......#
#. .*.. .#. ....... . #.\ . ...#..\.#.#\. .*. *..** ....\  ......# .#.  .\ ..\.. ..#*#. ...   . . .#
##..  ....   *.*.*.  .**... .  ...#....*.. .*. ......  ..* \#. #.*. ...#..#.. ..*   ##....#.. ..\*.#
#.#........# #\...#. * *...\...#.. ..\ .#.. ...#..*.*...... ..\ * #*... #.* *\\.  .. *# *.#....*..\#
# . ... .*. ..#. .  # . .#\.#*#.\  ##. # . .....\. # . . ... ... ..*\...... .\.*.......#*  .*. ..#.#
#..... \... #*..\...  #........... . #. .\...   \*.. ......  .....*. ....###..#.. #.....#. .#.\....#
#..... #.  ..*#.... .... .  *. .. .. . .** ..#\.**#.  #.  ..*\#\ *.\ .*.. ..  .   # . ....*\#......#
#...*..*.#. #. .. ..*  *    .\. ....#..**... ..*.#.#.....* .#   #....#. \.*.#. ...*...*.**..#...*..#
#.. \.*.....   ........ *.\** .... *.... . .... \... ...# *......# .  # .......... ......#.*.#*.  .#
#*.. ..#......*...\.... *. .....#.  # . *... .#   . ...*\  *\. ....*\.. ....#*. ... ..*...... . ...#
#. . *.\   . ........   .*# .\*...  .*\. ..# #\\..#  ...*\ .  .. *.. #\.. .\....*.. .. #.   .\. \# #
#..*...  ....  *. .. .    ..* \  ... # .*. #...##...  #...*#..\.\..* .#... ......\*.# #\..#...#  . #
#*.\. #*#... ..# .... # .#. .  *.......*.....*... ...... .*  ........\*.**...*#....*.......... *...#
#*#* .. .... \.*..*...\  ...  .. ....\. ..\ #.. ........*. ...# * ....*..\...\# .. .#.\.. \. ..#.  #
#. .. *.*  .. ..* * # ...#. . .\* ..## . .*.........*. *...... *..##...  ... #...#....#... #.**.*..#
#.......#*.....# ...#. *#.#.#... ................. .. .*# #.* ..#. . ..*...*#...## . .*..........  #
## ..#.   .* ..*..*#*.......*.*...*..#\#..\.....\...#\*... \.. .. .# .\...# ..*....\. .. #.. *    .#
#..  *.#. ..  ### .\.   ..\...#. .\*.. #*#.*.... .... . ...  * .  ... .  ...# . #*.#.. ..# *... ...#
#.\ *.\. .#.#\#..*......*.\....\#..\ .. .... *#..\.# .#.. ...#*. .. ....*..* **..*..*.*..... .#\...#
##.# ....  *#... ...*\..  .# .### .. #... .#. .**  .. . ...* . ... .\*##... .#.##.   .\.* . ..\..*##
#\... #...\##.#...#.. *\   ..#.**.. . \..#...#..*#*\ ..\\...#*.#.. . ....*\*.....  ...*\* .##*\#.# #
#. .# .*........*...*.........*...... .. ...*. ...#.* ..... ..##....#..#. . .### ....  \... *......#
#....#.*...*.  .#.....\ \*. .....**..#. . ...*. .  ...*#..* #.##... .. . .. . ....*.##*\... #....  #
#\.\##...* ..*\.# ....  # ..# ... ..# #* .#..\  ... .. .... #   ... .\ ..\. ..#...#..*  .#.#.*. .. #
# .#..#*.**....#..\.*...... . ..*##...#. #. .*.#.#* # . . .*.*.....*...*.#....*. ..*... .*##. #. #.#
# . ..\*......#\.  *   # . ...*. ..\.*...#.*... *.#.. .. .*.. .. \ \ ....  ....#..\. #. .\. . *\ #.#
# .... #.... *......\ #. .# ...*# .  .*. ..**#.... .#\ \..*. ..... ..# ...\.....*.*#\* *..... .. ###
#. ..#.*. .... # .#..#.#.....\.#.. . ...*#.*......  \... *..\.....\.........\#*.\. .*..* ....## \.##
#...*****.... ....#. ...\*#..*....*.*.. .#*...# ..\.\.#...   . .......\...*. .....*...#..... .##*..#
#*#..# .#*.#\#. . . ....#.\#.. \ . ..*.#.. ...\.. .... . .. ....#  * .........#\*. ...\#.. \..**.  #
#  ....\.  .#\#.....   *..  ##\#.#.. ...#***. .  \ *.# .#\. . **.. . ....#*..*...*.*.. ............#
#..# .#   # ....# #...\ .*. #..* .. .**..##. ........  .\.........*... ... ..#..  #.. #*...  *.... #
#*..\..\...#\**. .. ... ..\  . .#.*..#. \....#..#.* .# .. #\#... ..*..*# *...  \...#..  *... ...\#.#
## #*  *...*\.#*.. .....*.  #\.#... ...#....*.......  #....*.  ...#.#.....#.\ ....*#...\... .  * *.#
#.#.*##.*......  ...*... *# .  ..... * ....#. .  ... ..\. ...#. .*\. * ... #.  \# .....*..# .... ..#
#..*#.   # #.* ##.*.* ....*.*.##.* .# \.#*.#.\.. .*... *...  ## ..#.##.   .*. #.*..# .# ..##.*#* # #
#*.**#* ...*#**....# .*. .. ....*....*  *.. . ...#...##.#.. \...* ..#. ...#.....*. .. .#.....* .* .#
#.#. ..*.* \#. .#\#.. ....*..#. . .#. .#......* \.. *.#...\ .# # . .#. ... ...*.  *\ .  . ..*..  ..#
#.  .... #  .*#..#.......\#...#............. .# .....#.. .. .#\.. .. . ..*..*\. \ ...... ...... .  #
###.#.##..... ..#.*...\.*.* ...\... . .. ... .... . * #\# #* . . *.  .... ..#..#..# .***....\..#* .#
#.  ***. ..#. . ... ...#. .   ....\.#.** *#.#.##*#. ..# .*..........\*#   *. .. ...#.. *  \.  ..*. #
#.   .. ....#. .   \....#. ..#.*.  ....  . ..* . ##. ..*...*...\..#. . ##.#..\..# .*.  ..##. #.....#
#* .*. #.\.........* .*.. \.. ##\ .. .\.  ...#.. .*#.*.#...*   \#..#.. .#... .. *.* # .*.\# .#..# ##
#* .. *.\ .*. ....    # *..# . ..\#.#.#...\#.\\# ....*.....*..*.. *.. . ..\...\\ .# .#. .. ...... .#
##...  #.\..\*\#**\ ..#*. ..... . \  .  .....*#.*# ........*.. ..*.   \ ..\..*..# *. *#.. . .*.#.*.#
#*...#.#..*..... .* *..\*## #.....** #. *.. *#.............. \ #..## \ .. ...#.. *. . . *  .. #\*. #
#  # .. ... ...\#.... .# .  ......* .....#.... *#. . *..*.* #.**\.*..#.#..  *..#.#..  *... .. \ . .#
##*. ....#.... # *.#..\ .#.*...... *  ...\ *  #* .*...... #... ...# ...*.\#  .. .*.#. \.#*. *.  #.*#
#. .##.*..*.... .. \.. \.* . . .  #   . . #..*#.\*.#.... ..#.  . ... ..\.* .*\. \.#..#.#.\##.*\#.*.#
#.\....  ..*. ..*   ...\## **..#  * ......  .. \#........ ...\...*..** .#...\#\#.....*.*..#.#..**..#
#  ..#..\ ...\  ..# .... .*.#.*. . #.#... .*.*  ...  *#....#. #. ... .#*#.  . #.*.    . ...# #. ...#
##. ..... *.. .#\**. . .... .#.*#........* .##... .\* ....*** . ....##.. .. . #.#.*\... . *\....*..#
#*.#*.\#* .\....###..*.*.. ..\. ....#*. \. ....... .#. #.*\*.\..#.*...\ .#*.\.#...   .... *.#..*...#
#. .... ..*..*# .#........*\*.  . ..#.......* ##\\#\. # .. ...*. .......##..\. ..\..  .*..* #... ###
####################################################################################################