####################################################################################################
#..\..*... ..\.\.. .#. * . *.*.#. #\.*.\... . ..\.*.*..#   .....* *.. .\..#....*.\.. .*\.# #..#*.*.#
#.. .... .* ....**. .....##...##... ** .# #.. .... \# .*  .#. . .  ..#..#.. . .... * .\...\*#.. .\*#
#.#..\# .*\..#.#.\. \...*... ... . .     .  ......... # #.*#...  \..*.\. #. . .......*##   .*.. ..##
#. ..  .#  .*.   ........... .# ....#.#**.  ... *\.. ....#... \.*. ...... .#..\...*. ... .. .\.*#* #
#.#. .\\#. .. \*.....\.. ........ .\....##........\#......... ..##...#..# ..#. ....##. #.\ .... \..#
#.*.#.\..  .*.. .*.....# #..\# #.*    .. .\. *.. .#..  ...\....... . . \\  .....\...*.. ... \  .. .#
#.# .... .*....*. #.#.##. .  . . .* * ..  .. \.\*..... .   #..#*.#.*\..#.*.#.# . *..  * ...*.## ...#
#  ..*.#*.....\....#. #.#.... .\. . ..*# . ..#.\.....#... *. .. ......#.#...#.. .. ..*...#. .\..\ .#
# . .  ... \   . ..... *.. #...  \*...#..#... #**.....\.#. .. ...*..\**.. ..  ..\ .#.. ....... ..*.#
##............**.... *........*...\..\.... *. ..\#..# ... ##.*....#.. .*## ...\*#.#\.*.. .\.*......#
# . ..  *  ....\....*.# . .# .....# ...........#*...#..... .\.. .#...   . .*\ ..\## * #.\ .. ..*.*.#
#*..*.*#....  .......#..*.. *..  . #. ..   .#.\# **.#.#  ..\  #\.*.. *........... ..#.. ......... .#
#....# ... . ..\  ......*.....\. .\.# * .....  \ ..\.... .#\..... ..#*\*  * ..#..*.#.#..  ...*.*.. #
##..  #.# . #. ... . .# #. \..* ..##... ....#... #\ ....* .*. ...#. ..... . ....*\....#.\.*. ..* ..#
#\#..... #.*#..#*.. #\ .* \.#..  #. .#...***\ .   . ..*. . **\ \..*.....  ..... .#*\*...*..*.....\.#
#*.*  ...*\*.....* . ...*.....\ ..*.*..\..#*\...*.#...*.\ .#*.* *..*# .... .*.....  .  ##.*. #\....#
#.. .. .#**#\.# . .. .*....#*... .#..... .....*...*.#...*. .*. . #.*. .#  .*.*  \*.*.\.# . #\*\*..\#
#*...# . \.#. .# ....#   .  . ..#.. ....\.*.*  *    .#*  *.##. ..*.# .... .. ..*  .. .* .##...#.#\##
# . ..#* . .. .#....# ..*...# .##.#\....... *. ....*..#. .#.\.. *...*.. .## ...\.\.#..... ... #....#
#.. *\.*....#. *.#.. #.#...# ..*.\#..  .... .. *..... .. .\ #.... .. \**.#.*... .. ..\. #.*.. .\.*.#
#\.##.. # \ * ..*#........  \....*.\#.# #* .*...\..*. #\#...# \ #.*\  ....**. \. .*.. ..\ .. .##...#
#..* ....\..... ..*. .....#\  *  *. .#.#... .##\.#... * . . ....#..\ .. .*... .#...# ....**..  ..\.#
##...... #   ..\ .#.* *.....# #... #.#..  ......... .*\....\ ...* .. .#.*. .......* .*. .   . .**..#
#...#....#...*  .. .  .\ .***.....#*....\## .. *. ......**.   .** ...*\\ #  ..# # . .  .* ##  *.#\.#
#.. *  ...... ##\ *..#*.*.\.  ##..#.*. .#. . *..*.#*..\#.#..... . .. .. . ..#.*.*.... ....\.. ..\..#
#.**.   *.## ...#.  ... ... . ...  ....\#... ..*.#\.. ..#..#. ...    .. ......*. .##. ......#*... .#
#.......* .... .. \. ..#.## ....#.. . \.. .. *.*.. ...*.....**..#* ...  #. *#.....\. #..*. . #\... #
#.*.# \... *.... .... .\*.#..  .  .##.... .##.... ..#.*. ....\.\ *.. ........*.* .\ .#. #.... . ..*#
#..#..*.#.. .....* ....\.* .##.\..*\.#.....  .. . ..*. \# ........   . #.. ... ... ......\.#.*#.*  #
#*.   .. * .. *... .#.#.. \ ...... .**##...*.. ... **. ... .... \#.** .#.  ..##... .#..... *\. . ..#
#......\. .  . .*..\ *.\*\* ...... \. . .  .....** .....#.. #\ ..\..... *#. #*#.* ...##\...... .*\.#
#..*\.*.*. .  #.....*.#..\.  .\\ ..... .  \# ...*.#*# ..*.....*... #. #...*.....#....#....  .# \  *#
# .#. ...... \*..... *.*  . ...#.\...  ##..... #.. ....  ...*#\ ... ...# .....  . ..  #*..#..  ...##
#...\#*...\ .\*  .  #  .#*\........... ..##. \##.# . ......... *\. #*. ...* . .#.*...*... .. .#. ..#
#..... .*.*.... ..\.#\#.##. .. ..*.. #....#....*. .\\. #.*.......#.\#..... .. .....#.  # .*. #.#*..#
#*...*......#.  .*   .  . .. .... .......*....**...#.#...... #........ .*..*.# ...#.*.*...  . *.\.\#
###...*. * *. *..#\...*.  \* #**..**\ ..#*.....\* \.* .#...#. *#.  ## *........\.... *.*..\    .** #
#\..*#...   .. # .  ..# ..# *#. \. .\# #..#.#.. .. ... *. #.* ...#*... \  #. ..... ...#\#... *.  ..#
#.** *...\ #*..  .. . ......#....*... .*#....#  .*..*.... . ......... .. *.  .. .*.* .*.#\   *  .  #
##   #..... . .....*. ...*.#.\*#*..# .#..  .    .\ #.\* .  . .#... *.*.\..\...\#. *.##*..........\*#
#.* .*. .#. . *.....*#. ..#. ...  .  .#... .  .# .. .***..**.*. ..# . ...... \... ..* #.   ...   #.#
#. \.  *#.\....#.....* ..#..... . .  .. ...*. ... \ *.. \  ..*...........#.... .##.##.\.*   ....#. #
#..*#. .*.#\\..\.... .\ .#\*..**.# . *......\*...... \ *.*... *# ..\.. ....* *..\......# . .. *...*#
#......#..\....#..*#. ..\.....*..  . .#  #.  ...  ...*. #*#..*...#*......*..#.......\...# ##......##
#*.# .# #\..... ** ....*...   .#.#.#.*  \..#...#.***. #. ..  #..#...*.... . .  \...##.#...... ..#..#
#*. ...#*. .*...  .\..  ... .\ *.\ #.*... .. ..*... ..*.* \...... ..*.*#... . .# *...# ... #.\. .*##
## ***#.....\*.\\  .... ..#...#\.# .. ... \. ... .*.* .. ..* ...#. .\.. .. .. ..#. .* \. ..  *.#. .#
#....*.\ ..  *. .# ..\# .#... .\#*. .#.*..\ .#....#..#.* ...#..  .......#.. ... **....#..#. .  ..*.#
#.... # # .*. ... ..##..\\.\...... .. . .. . . #..#.*. . . * #..... . .  \..... *...# ..#..#.. ..#*#
#...\.*#.#.*  #....#.*.*... #*.. .*\......*#......  .*..*#. #..*.*#.#  #.# .#..  .#... #.... \##.. #
# ..\  ..\* ... *.*.  .*.# #.\  .#.. *......*. \...#*..      . .. .#..#  #..  #.* .###... * .*.....#
#\#\ . ......#  *#. # ..\.#... .. \##. .*.....*.*. * .... #.. ...##..  ....#\..  . \..*.. \\.# ..*##
#. #.#........ *. *.*.#\.\#.# ##.#..  .**.\.. \..\...*.\.....\.. #. ...**....#.. #..#....\.... . . #
#...   *..#...... . . ***#  *\..... .... . ..#*.. . . ..... #*.... *...*# *.. #..  . .. . . *# . **#
##..*....#...\...\.. .* #. .#** ** \. *..* #..#..* .#. . \# *.. # .#\.   ..  ....*... .. *. .*#. ..#
##. . .#.... #.*. . #*.#.  ..## ..#.# # .. ##.*###. # ...*.. \.... .* .##..*.\.  .#..*. . \  *.*. .#
#  #. .. ...# * .* .. ..\* ..#...#..\... ... ....  *\.###. .*.\#.#*. ........# .#..#.# . \.. . ....#
#.\..\#..# *.  .*... \ \ .\..*.* ..#*.*. *#*.* .#. .... .#..\..  #.. . .* .#. . *  \\.....*#.#... *#
#\*..**.... #*   ..* ..... *. * . ....... ... ..  ...\..*. . . . ..... .#..*. .....# ..   .. ...##.#
#..#  *........ ...*.......\\.#.### # . ....* ..\* ..*#..  . . ...#..   . ..\.. . ....## #.......\.#
#.......#*#\..  .  .\*.. .## .#.#...*... .    #.\ .....**\**.# *\.** .. *...#.#. \... .....  \....\#
##.. \  #  ...*. . #..#*...*## .....#.*. .#.#*...#.** *.#  .#.... .*.#  .... .. .. .....*# \. .\.#.#
###.. \........ ..\.# ...#.#*. ...*..*.. . *# *. .#. ...#. #.. . #....  .. ....#***. \#. ..#.... \.#
# .\... #..#\*.  .\*. ..#..*..... .......#..*....  . ....#.**  .*....#..... ...\. ...*.*.**. .. ...#
#**..#  ..*.#...*. ..*#.*  .. ..#.  #*... *. ...#...*..#. #\.\..#. ... *.\. #*..* ... . ..  . .....#
#.... \. #.\..*....#.....#... *.***. * ...*. ..#...   . ..* . #..#. *......#. ...*   .\.\*.# . . **#
##.#.\  ..#..##..   ..*.*..#...# ..##...\..*.. . #... *#.*#.\\  . .. ...*.*..\.    .*. ... ###.**..#
#. *. ...  ...    ##.#...........\ ........*** ....*............. . **#.  ..... . #. .** #.. .*...##
##.##... ...*.#.#...*... ..... *..*\\. \ ..#*...*..#  #.....# .  ... ## \*\#.#.*\.*. *...#..**....\#
# ... #..\........ .\*.......*.**....#..*..# ..*..  #.#.....#*..\.#..\..\ ....*..\ .#. .#....#. .* #
#.*.*.*.*.*.  .#. # **#..*.# .#.##..# .\.... #. .#...\. . ....\.*.....#.......  \*...#\....\.#.... #
# .##. ..*\.  .R.\*......*#..  ..*  .*.#...  ..# .*\\.. ..#.*. . .  .. #. ..*\ ...#...*  ..\#. .\..#
#.#.*.#. ...*... ..**.# *. *  ....#.. .*#* .. \ ...#...  ..##. ..\  .    ... .. *... #*.#*. .\  #. #
#...\ *. . \\.*##... .  *..# .\\.\...#\*.. ..*\.\*##...  .#* #*..#... #.#..#.......\#.*....# ...\..#
#..  ...* .  . \. *....*.  #... .* ..* *....\ #..*..*\.\.. #...  . .. ....... .. \ \ **..  ...... *#
#.......\#. .*#.. .. ... .\. ..*.#.... .# #*.. ....*... ..*....*.. .... ..*.... *.**.* \. .*\..#  .#
# .#* .#..*#. # ..... * .......  #..\..#\*.*. .. #. .... *....  . .... . \.*.#..* . \.\..  .. .*. .#
#..#. .... .. ..* *.  ..#... . #. . .#*.\.  .#*.#.#.\. .  ... .  #. ***..**\\....\  .  *..\.* * . .#
#*.# .......*\#*  .. .*..* . .#.\....*...*#.*#\... .# #.* #. ..##  \.# ..\ .\...##  .....#..**#...*#
##.....  . .. .*. .#....* ...#. .# .*....*...#.  ...*. ......*...#.  ...\.* ##..*\** .. #..##\*..**#
# .  .....*.*...**..\ ..#. .#*...#*..* ...#. ....\..... .*. ...  ..*....... ..... . .  ..*\\....  .#
#.  ...#....*. #.\..  .\\..#\#.\.#*... \. *\..*\..*.*.*   ..*... .\.*... ...... .\\# \...  *.* . ..#
#.* ..........*.......##...*\  ..#......#...* #...# . ..*##.  ... . ..#..# ..*...#. . .#....  \**..#
#.*.\..##..\ ..\.*.*......... .\ *.##.#* ..# .... .   .  .*.\#.  .....\*.#...*..*... \.. ...\.... ##
#.....#.. .\..*.....*..#.* #.\#. .*##    #....#... .#.#. *\#..*.  * .##. #....\.. #.*#. *# .*......#
#.... #\..#*...#....  ..*....#.*.*#.... *  *#.\. ...\.**. # .#.   ..**...*...#...# ...*.*.. *.\ .\ #
#..\...  .*#\*..... *\. ...# ..#*...##.. ....##...*. .# ...\ #* \.*....#... . .....*...\...\#..# . #
### .\# .**.*.....#. #.....# . .*..*#. *...#\*.....*###**.* .. ..... .  * #\ #.  .. ... .....*.\* .#
#.....\... ....\....\. * .. .#  * ....\#...*#..  ....* *..*. \. .#....\**.**..#.  . ..*.\.   . .*  #
# .#. ... ..\.....  *..#.... #.\ .............#....#.** .# .#*..  \..*..\** #...  . *#.. . ..*...\ #
L **. **# *. .##...*.# *#. ...# .\. .* .*....*  **#.*# ..\**.\\ .......\*.   ..#.#.. .\...# . .. ..#
#.\# #*..#.*.#..... .#..\....*#....#...  .....  . **..  #..... .....  *... # #. #.  #.. .#.....  ..#
# . \... .#.......... .\.*. ...*##.#...... .*. .*..#.......#......  .\... ... #*.. ....\.* **.* .\.#
#.....*   ......*#* \. ....## . ##.\ ....... .#..*.. .#.............. ....#* .. ..\....\*#..#....*.#
#.... #. ..#*..#.. \. . .#. *..*   #*\*.*# ..\.  .. *#..* .. ... .*.  .#.......*..#*..* ... \.   .##
#.... ....#.*.   .\#..# .... *#* #  .\\\...\*... .\. .*.  #\.#....#. .#\... .#.\... .##..#  .... ..#
#\ #. ... .#.. * ..\.   .... ..#..#* .#.* . . ...*. .  . *......#.* **...  ** ..* #. *\#.#.#.*#*...#
#. *\... .# \.....* #.. *....*#..#.# .. .... ....*.*.... ...#..#\ ...\.. .     #* .. #*..#.  ..#.#.#
####################################################################################################