####################################################################################################
#.   ..\..* #. . .*.. .\... \.... . ........ .....#.##  *..# ..*\. ..#\..*.   ..*.##.. *\.. #.* . .#
#*...*.. .# \. .\.#..*\#. \..##.\.#.... .# **. #...#*.. ...\.#.\.#..##... #.**.. \#.* .#...... #*..#
#.. *..#.#..  . ..# ..#  . . #.#. .\ #.*...\...#.\.......... .\.\*. # ..* ....*...#... .... #\... ##
#...  #...#*...#\. #*.. #.. ..#.\#..# .#.* ... .. .# ....##..*. ..#.\*..\*  ..   ..... ### \*. #.**#
#.#...#.*..#..\# .. .*.... # ......*...#*..\.\..#. .. .#.... *.. .*# ...*.....#.... .   . .# .*.. ##
#. ........  #. ...* .  .. ....*\\ . ...#\.*\..#*. .....   . . *..\........*.. .*.#. \\ #.*.#..*#..#
#.  * .**.#\ ...... .*..# . .\**..# . *...#..#.#.*#. . .#.. .......#.# ...#.  .\. .*\. .*.... # . .#
#* #\ .. #  .. .**## .**.##..\ \.*..** .. ...#*..*\ * .*.#  ...#.. # .**.\...* .....#... ....*#... #
#\*  .. ....  .#*.  \.. ......... ... *# .. *# *. .* ...#\.#* \ ...*\.#...*....#*. ...#..* ..*...\.#
#.# *..#\  .#......\..  *# ..*... .\..##.## \*.#.  ........*#... ..* \ . #....  .*...*.*..*.\.* *..#
# .  . ...# ......\..\ . ..*.#.# #   ..*. *.\# ..# ............*...*.*...  ...#. *... .* #...#. . ##
#.......... ..\...*#.\*..\...#\ .....#..... .  .#.#.... ...#.....#.* ..#.. . .# ..#.....#  # \..\\.#
#..\  *.#....\.. #  \...# ##...... *...\..#  * .#.* .\#  . .....  * \*...... .*\.**#.. \..\.\..#...#
#.*....... .\.#   . . .. ...** ** ...... .......*...\  .\..#  .\#..#.##* #**.... ..* .. .#.*.. #...#
# .##\. .  *.#..... . .#... .**..#\....*#..#*. *..\#.*.. .. ...#.....#*  .#.. .#. #*.. \....#\.*\.\#
#....*.*............. ... ...#*.#*.#..... . . #..**....*.... ....**..\.. .*..  ..\.*#\ .\# *#.....##
#..***..... \. \ . \*..**.. #.* .#  ...#.*.\* . .* .##..*...#.# #** # .. . ..\ . ...#....# .. .  .\#
##\ .#.\ .. . .  ..**....*  ... ...... ..** ..*#. .*............# . ..#... . #. .#. ...*.......\.*.#
#. *. *...\. ..... ....# *   .\..#* ...#.*...   .. ..*\*  ... \.  ... ..#.\..\# .#.. .#*. . .  . .\#
# ......#.\  . #   . ... #.. .. *. ......*.............#...\. *  .* #....... *...# .\.*  . .*... ###
# ..#*..... . ..*...#...\.*.#.** ........ . .   .#... #  \.....  *#.#.. #..... .. .. #  ....\ * ...#
#....#*..* .#*#  ... . .##......\.. .*.... *...**\.#.....**.... .*  .  . ..#..... \*  *. *.#. .....#
#...#...*.*.....#\..*..\*#..  .. .*... . ...*..# \ #\#..... .. ....  .*... ....*..\ *.\   ...* .#..#
# *#  ... ...*  . \.*.#.* #.#..*..#.. .##*.  ...*.** .\ . . ##.....  .*...#.  ...#.* ..\ ... .. #*##
## .#.....*...*.\......*...#.# .  \## *.*.#. *...  ..   . ..* #. \*.  *.   #... ..*.#.\#....#.....##
# .#.  ... .\#.##. .\\.............*...#.. ..# #  ..#.* .... ... ... # ...# *.*  \ *..#.. .\#*.*...#
#*..#*\... .....#..\..\.  .\..\#\#..#. .#..  ..... *.# .*..#.... *... #...\.# . ..*... .*.....# *. #
#.**.# .# .\. .*....  .* ... . . .. . ...\...#*.....#. .# .**.*.. ... ...#..#* ....*. ..*.*.....  .#
#..* ...#. ..*..**..*. .\  \..\. .*.......*...*.. *#\..  . *.*.*##*..**..  ......*.. ....  #.\*##.##
# .......\.\  *   ...# ......*\. .\*. ...* ... #.#.#.#.#... .# .... ..#  #. ...#... .*..*.\ #......#
#*.. . . .*..*. .. .#.........#.*.#. .*  *#.*. ..# .* ... #...# ... *.\#.*.\. .  *.#*....   .......#
#.#*............... . .. ..**. .* .#.#..#...#.....*. ...**..* . ...\....*.#...# .# *.. . . ........#
#..*. ...... *..** ... *\.#. ....#.. ...*..  .. .\.#.... .*...* #.... .#....\. .\......*\  .* .....#
#*......#*.#.*...  ....\#....# .\..#.. .\# .\.\. .. .*#.#.. .. ....\..* ..#... .  .*.**  ...*.#\...#
#.\.# #. .\ ##....\. \.. *... .#...*... #. ....#.  .. *. .\.##.*## ... ...#.. \.....\.*...\.*..   ##
#...* ......*  .. .* *..... #..*... ..\#.\*.**....*.. \.   .\.. * * ....\...... .#...*   ..\ ..... #
#..#*.  ..*. .....*#...**.#. .. *..**. * .... ...\.##  .#.  .#..... ..\...*....\#.#.\..*..* ...##..#
#... * .*....\#...*. ..... #. ..\.......# ...#.... . ##*#.#.#\..* .. .  .#*#........... *#. *. ...*#
#*\.. .\  . #.... .. . ..#.. .. .*\*..**# ..*. . .....###.....#... \.# \  .. #....  ... . ....*. . #
#...\.**\. #..*...... ...* .....##.. # *..#. . ...... *  .\...*#...  ..\.. * #... ##... . .. ..# #.#
#.# . .#.*#\..*.*   ......*#.\.#  *   ......#. .... * \.#.\*..\....#..#.*...  ..***......*.*.. \.. #
#. ..** ....**#.. \ *....# .*.  *.*#.#  .#. ..#*....\ .#... #  .#.....*.#. ..#..*#. ..#*.   #..\.. #
#. ....  #.** ..**..#. .*.# .. .......  .\*## ... .*......  .    .... # . \\*..\.*... ...*.**..\ *##
#.  \**.    . ..\ \\...\. .. ....*. *.*\# ..*##.....\.#\ *. .#. .# *.. . .#.. .##.*.   *......... .#
# .*\  .#\ ..**##  .....  .......#.*...\ *...... .. \.#.... ....   *..  ...   #..*..#.. \ .#** .  .#
#..  ...*..#...*. ...... *.*.#...* * \.. * #.#. . ##. ...\*.#...#*...*\.#.  *. .#.#.  .. ## # #.*. #
#. ..*.......* .*........*.....**.#*. .#....**..... #*... .*. ... #....... . ..* *...#. \...... \. #
# #\.... ....... #..*.  ...#  ..*... .#  *\.....##.* ##*. ....... #.. . * .##..#... **.*\..**.\*# ##
#  #. . .#..  *..*... ........*.**.. * # .#.#.#.... ..  . ..*......*.\. **....... ..\. *\#. ..* .#.#
## *.   ...#   . \ ........* ...# * ..##..#\. ...#\   #..*. #* ..\ \* ..#........  *. .....#... ..##
#* . * .*.. ..*.#.* *.**... \*.....* ..*..# ...\...*#... ........\# *. * ...#.. *#**#.*. .........\#
#.#....  .. .\ ....*... . #...* ...  \..#..* ...   * #.. ..#.#.#\... .........* .*....\. #. ..#   .#
#  . \...  .*..\.. \\ **\ .*....# . #\. ...... . .###.. ..\...\..# ...*.. #*#...#*#.#*#.\... ... ..#
# . .*  .*. * #.\..*..*.#.\. .*. ...*#. . ...**..**.\. ..* .....# ..#. .... .#.* .. .#\ ##.#*\ .* \#
#.  #.* ... #.\#...\.* . .*...#*# .....   #.\......# .\ .\ .* .*...* * .#....*###.....*.. .#.......#
#. ... . \.#..# .......  .* ...#...\.* .# ... .\.. *.#.  .  ..#.#... .. #.............\... .#.#....#
#...*  ..* . . .**#... .*#..** \#. . . . ##...\..* ... ...#. #.. . .#  . .  .... ....*..\..#.*.** .#
##*....#... ...*...*.* ...*.....\#.\ .#...#..# ...# #.\..#\.* .. .......*#*#.. . ..\.#\ ....* .\ ..#
#.*.. .... # ..*. #....\.#..*.#..   \..... ..#.*. .* . \.*.. ...***.\.#...  .# ...#  .\*. . *..  ..#
#*#...*  .*...\*. .* #*.  #. . .\*.#  .  ...*. ..#..#*. ***    ....#.. *\\.\....\.*. . *   ......*.#
#**.. #.....*...\.# .....  ...* ..#..##*.. ... ..  .\.. ..  .. *.* * .....\.#.. . ..........\.\.##.#
# ....... ...\.....#.*......*.. .#. \*. \ ..# # .*...# *. ....# .#  ..##..\.*# ..#\..#....  .......#
#....*...  ...#. .*.. .#.* #.. . ..*....... . . *#*\. ... ..* ....##.\ ... ...*..*\#\...#.... ... .#
#....   #.. *\.#.  #...#.\.... .* *..# \..#. #.. .*.......#... .*....\.#. ..###...... ..*... .*.. ##
# . ... . ..#....... .. . ...#.#..   .. ........# #... ..*.*.* ##.#  ..\..... *.. ... .. . ..*.  .##
# ..** \*# .*..\.*...*  ..#.... ....*..#** .. \. #*\ .  .. . ..*.*#. ..#.#.*   ..##..**#..#*..# .. #
#...*. .\  . . ..# .\ ..#.**  . #. ... .. #\.*..... .. ..# \#. .....  .#.. ....*.. \  .* . .*#.*..\#
#..\....* * ...#*.. #.*....* *.\.*. . ... * . *..*...*#*.*... .    ... .....*.. ...\..\.#...#.....*#
##....... . ....\ ##..   ..... *  ...#.... * ..#.. ..#... *#.*.  . ....*...#...*\*....*.\..\ . ... #
#.  ...*. \#. .* ##.##   .#..... ..  .\.* . . .\...#.*\ .. .\#*...*.#* ...*. .....\# .. #.*.\.... .#
#\\ ..#.  #  \..  * .#... \\..#.\. *. #. *.. ....#...*.....#.##.*....*..    ..* .   .. .. *. *.. ..#
# #. ........ # ..*.# .#*..*##..#.  ... ....... .\ *..#*... ....\..\.\.\.#...... #.*. . ...\#.* ...#
#.#.   # ..\#  .*.....** . #.....*#..\.#......#.*....**...*...#  \..   .#..#. ....#.\ ... ## ..*.#.#
# \*. .....*.. ....... ..#*. . ... #. .... . ..#.. .\#......#.\....#..\..\# #..#...*.......*  ..  *#
# \..*#*\.\..*...* ..\ ##.. #...*\..\ ... . *.  .  ... .. .**#.#. ..  ..*. \*#.*.#..#    ....**. ..#
# ...*.. . .....*.....   *. .\ .\. .....\. # ....# ..##.*. ...*# #..\.. ..\.#.....#.#\...... \ .##.#
#*..#....#.. .#* ..# .#.# ..\.. .... ..*.*.\  ... ...\#. .* *...  #... ..\ . #...*... ............\#
#*#.... *.#.*. *...\*#.*.*.# . ...#.  .......\#*\... .......  #.*...\ .... .*.. .*\ \.# .....\  . ##
#.  .. ...... .*. .#.  ..  . *.. \\##..# .#.*....\#.\#\  .* *.*\\..*... .... .\*........#.*...# .*##
#... .....* ...... ...*#..##..#..# .  .  ....... .#  .. ..# #.. *.. .....**.. #....... ...*... *##.#
#.....*.. .\\*.#.. .* \*. . #.##  * ... ..\ . . . . .#. . . .#...*#.......#*...R  #\.\...##.*\ . . #
# .... *.*..\*...##. .#.\*..*.  .* .. .....\..#.. .....#*.... .#* . ** ... .. . ..\.\. ..#.\\ \..#.#
#.....  ..... .#*. ..... #.... .... ..\*..#*.##\*#\......##  ... .* .*#* ..*.\.. ....\..*\.....*.  #
##. *. .. ......#  # .*#......\*.*..*..*.**...\*..\.. .*.. .*.... \  .*  .......... ..\.*....\. ...#
#  ....# ...... ... .## .*. .. \.\ . .\* ...... . .....  .. ....#* ...\.......*..\.# \... . #..*\\.#
#. ......#*.*...     ..  .*......#... ...  .  .# .#. .#.* ..# ....#..\.... ..*\....\.. ... .*..*...#
#.. #  ....*. .#.\.... ..\.\..\ ... \#...\....*..#.. *  ##..  .#...*\   ...*..  *.\ #.. .\....#....#
#...*..* ..\#..*..  *.*\.\*..# #.*... *.  .. .* ..#. . ... #.#..#\..#.. ....* .. ...   # ....*...  #
#.#..*.....*..\*. #***...#.... ..\..#..*# .\*.\.*. ... ..... ..\. ..... ...*. *....... .**... .....#
# .....#*. . . #...#. \.\# ..##.**\*. ...# *#..# .....#.#  ... # . ..*....... . .#.###.. .. .. . . #
# .... .*.. .*  #  ..*.#**... .. .*...#\#.*...#. \..**#.\ \.. *.. .\.\ ..\*.#.*.\..#.   .#. .. .*. #
#... *..* .. #.....*.\ \.\.......*.# ..  . ........ *\*..#. .. .*.. ... ...* ..# .. ...#.\..... *#.#
#. \. *\. **.. *\....* ..*..* # \ ... .. *  *. ... ....\ . \..... *...**# #.\ ..*.*\.#.....#..# .*.#
#* ..\#..\##.#....##.#..*... ...#.........*. #.. *. *. ...*#.*..\##*    . .. ..*  . ..*.... .\..#*.#
#..#..  ... .. # ..#.. .#.#  *.#  ...#. ..##.... *.# ..\.#.\*..# ..##...\ .#..#  ..... \.\#.     . #
#.*... . ..  ...*..#\#.... .*.......*.*.. .**.... *..# ... ...#*..\......#...#.  #. #.#.. *.#\*\..##
#  #.. *. .* ..* . ..##..#. .*#\\ \* .*.... ... .#..##.. . *. .... .. ...#.  ..#.. #.*. * . .. #...#
#..#..# ...# . .* . ... .. .\..\.#*..# .. #...\  .......#. #......... ## ...*.....#...  ....*... . #
###############################################################################L####################