####################################################################################################
#..  .....  #\.\.... \\**..  ...** *.... . ..#. ..#*....... .. ...  .#........ .. ..\#. . **.*#..*.#
##..  ... ..  .# ..#... ...\....**\*.... ..#*..# # *#....  ...#*...#\* .... . .* * .. . .*.# .#**.##
#* ....  .# ..* #.*... .#.  ##..... .. ...  \# .\.....#.\.* ..*\ ..*..... . ..\.*..# ..\....   \...#
#.#..#. .. **\.. .... ..*.*.. \... \.* ...#. . ... .. . . \# *..**#*.... .\\.. .#. ....* .......#..#
#\.  *.. .. ...  ......#..*....# #...*.. .\**.  ...**  ..#....**. ..#....  .. *#.  \ .....*..#...*.#
#*.*...* \\*.# ...  *......*. #......\..#.* # #. *.. *. ...*.#..#..... #\*..  . #* #.*.#.* ....  ..#
# *. ..*\ ##.*.#\  \\ ... ..\...*...#.\*..* #. #.*#............*.*. #  \.... ...\... ....*.... ....#
#.#.*..... # .... .. .\.* .   ... ..#..#.**# * ..... . #.  #  .#.*   . ..\......   .*.. #.... .*...#
#\..  *  .. .*.*..\..\ . .\ ....* *..*#.. \. .. ....*#..*.* .....  .*....*....*.. #.\\#...#.. ..#..#
#.##.***   .*. .*...#...#...#.... ...# . .* * ....#*.... .*..  .. ..*.#. .*#*...  ...... .#\... ..\#
#. ... .\.... .#..#....    . #.*\#\  . ..\*##.#*..#...#.. ....#......#....\...*..# ..* .......\.## #
##.. #. # *. . .* .*.#.. #.*.#... \.## . .**. ... ......\#....  ..*#  .# #.. ....*....**.#\* ...  *#
#  *.. .\....  .. ....  *...... .*..**.\.*.*.#.\..*#.#*.\\....  .#.#...\.*  ..    *.. .....* *. \*.#
#.....#. #..\...**.\.\#. #*....   # \...*. ....#. ....#.......*.*.....\..#..  .....* ... . *.\.... #
#.#..*....** **.***.\ * #...  .*..*...*.*#....#.# .. \ .\*..... ...**....*. . .#..*...#.#*.. ##.#.##
#...##**. . \.*..\..... ..*.#. #.  ...*......# ## .   . . .. .#..#*  ... .  #.  ... ....#. .......*#
##.... .. ..*..\.. #\*\.*..# .#.*.. .*. .\..*#......#...\** .  .#.#. ...\\..#..#   .  \..  #.#* .* #
#\..#.... .*\*..#.#.# .#.....   ........*.* ....*....*#. ...*........ ...   * .#...  .....*. ...* *#
#. #........ #**. ...*..... ..... .*.*.*.... ....  * ..\. ...##..  ....... . .. #..# *. . * *.**...#
# .... \*# . #.... \#.\..**. ......#.. .#...... .... ...#.....\.\.#....#*.  *.*.  .......*# ....*..#
# .........#........\\*.*.#. .*####.... .#\.   ..* .  . *..   . .# .#  #.. ... ..*# ..*...*. ......#
#....#.  #.*.  *#..#..**... .# .... # .\.*.*..#. .*  ..  ..*... ..* .\....\..*. *\\ ....* .# \*.# *#
# .#...\.*  .. ...#..  #.*..\.\. .... ...*.. .. *... . .........# ..*..* .*#...# \*. ..*... .....\ #
#. ...*.\....*#. ..* #.#\   *..... *\.*.\... ...   . *. \.\ .#..\. .. #..#. *......\ .... .*.. # ..#
#.\..*\*..  .*.#. ....*.. *\ #.#.#*...#....*.#.*.\..**. ..#* . . ..#* #. *#\.#*#...##*.#  ..\*.##\*#
#. ##.....\. . .\. \... ..#..#*.#......# ..#..  ..\...* .*.#.  ...#**.#..*. **. ....\..**...\..*. .#
L...#*  ... ... ..  .....*.\ .. .#..#* .....\ *.#... ...\ .. .......\...*. ..#. .#...\ ..... ... *.#
#..*.......#.. .** #*\#.# ..*. ....# .#. ..## . . . .*. *. #.... .# .*...\#*#.... *... # . .  ..\..#
#\...#..\..# . * ....*#..... \.... . *.**.\##.* ...\...* ..  .\.....   *..#. #*...#...  .  #..\*# *#
# **.#.. # .***.. ..\...\.*....#..*# *..\\.....* ..##\...#\#.*  * #   .\....*.....  ####..*... .. *#
# ...#..# #\#.. ... .*. .*..#.\\  *...*\...#...**. ... ... . .......*... .#.#....\..*... *..#.. ...#
# *...*... ... .\...#**. # #* ..*.*.\. . *\.........#... . . #  ...##..*#...*.. ......\...*.**..#*.#
#**...\...*.....#\.. .... \..##. ..** \*. ...*. .#...#  .\....**.. * ....#.# . ...\........*.....# #
#. ..  \\ ......#* \.  ......*.#....... . .. #*..\.*.\#. .\..\. ..\#..  . .#...#. * .. ......*.. . #
#... \ ..**....\. \. #... \. *...... . ................\#.\*.......... . . ..... ..  ...#..*#..  *##
#*#.# . **\#. # . *.....#..#* . ..*.. #..#.  #.*......#. .**. ##....##.#*.*.#...#\...  .. ... .... #
# #.* ......#...#.#  * .#.... ...*.#.#..  #.  ..\....... .....*....# .. \* ..#\.... .*.* .. ..# # .#
#.. *. .*....*.*#...#. .*.## . *.*...* .#.#.# ..*.. .*#.  ...*\.*.*\... ......*\.  . ........#  ...#
#... *. ...*#*..# #  .*  . . .* .##*.  ...# .* . . ..\.....# .*# .# ..##. ... .#..*..#....*....... #
#*\...* .#.# .. * . . ..#.*..\..*.#.  ..*.. .. . *\#. .   .#...  .#..*.\ .# .\.*.  ...\##.  \**#.*.#
#\..*..........*.\.....*.**.#.. . *..... ..\*.... .\#.....*#.#.*... .\*.. .*.#.\.##. . .  #...*#..\#
# #\...#.\.... ........ ..*   . . ...*  \#.. #*. .   ..#\.*\ . ...\ .\. ..... .#.#.....\\...*..#...#
#.... .  ..#..    #. ... \...*.....\\**...\*.##..*.*#..*##. ...#\........*# #..*.. .#*#   ...##....#
#.\. .. ..*.....#. *.... . ..\...... .#..* .  . .*.*...*#..*   ..... . . #. #*##.*.*  .**. *.*.#..*#
#. ....*##...  *.. ......* .\ ..#...#.*##*.#.*.\.. #.* ..\...#..*\..#..*. #.... .\......*\...*.#...#
#... ...# ..  .. .\.# *.*.. . ..\*... ..#......\. . .  .........\ ..#......  .*..#  ##* . ..*\ # #.#
# \#.*.*..*..\#. .. .\.. **#  #\. .##.. ....  ...... #*. .....# . ...#.....\# *.#.#  .#*...* .#.# .#
#.... *#....#*\..  #*.*.*....*..... .  ...  #....... #.. .*.. \\* .. #...\... .**.# *....#.  *.\...#
# .#  . . ...**# .\.\....  \ . * ...*.*.#.*\.#.#.  *..   *..*\......*#*#.... . .. *.#* \. \* .\.. .#
#.. .#..* ...#. . ....##\..*. * ..*...# ...#.\.. .  ..\*.#*.\ .#...... .... .. *.#...#..... . . .*.#
##....*.#.*  .\....\..#. # ...... .* *.\\\#.\  #...*...*.#*.* . \. .. ....*.*...#. ..\ ...*.*.. ...#
# . .##*...*.. *...#..#.. .#......\. #....\......*.#..#...#..**  ...  #*....#.*.*#... .....**.\.# .#
#... ...\............. .. *..\# ..*. ..##..  ....#*. # .. . .#*... *. ..#..*.\ # ....... ..#  ... ##
#...*.. .....\\. *. . #.... ... #.## . \ .....####........ ...\. . . R \..**.**.....\.#. .   *....##
#*... .* .... ......#.* .#* .  \.*#. .  . *..... .\.  #.*. * .*...#.. . . #.*.*.. #..#....#..\...*.#
#*.....\* .... .*...\ ....*  . .... ..\* ... ..* ....#\.*. . .** .. ...*#..#.. . ......   ....#....#
# ..#.** .... #..#. .. *....#....* .# . \#. #*.. # \#..  ..... .  .....#* . #...#..*#  .#...** **###
#....  .. ...###.... *.#.. .. *\...\  *. .....##.#.\.##......*.*\.*#.. #. *.. #*  #..\#.#. ..\.....#
#* #....\.*.* ..* \#  ...#.#..#..\# .#.*##  .*.\..*..#*\#.*.*.\#.#...*# . . \.. .... \\.*...   ....#
# .......... .......#*.# .*   ...**#\. ...  ......*. ....\ #*\..# .. ......# . * *#. * \\ ...\....*#
#.\ ..* .\..#..##. ..#\.*.***  .###. #*\  . ....*..#...*#..*.#   # .. ... *# *...*.  .    * ..#*.*.#
#. . . .\.\ . .#\..*... ..... .  .# . .\ .#..* ##.#  .. #... \....*..#\. .**.# \...* ..*  .. *. .# #
#.   . .#....# *..*..#. .. # ...***....\.... ..  .. . .#..* ...#.\.\.\#** #\.....##. \*.*...   #.*##
#..*.... ... \.#.\. #.* .*\...*..\  .... # . .#  . .....*.*... #. . .  *..# .......\..##.. .* .....#
#.\.... .#. .*.... ....  .   ... ...\..#. # *..*.# .# .. .\.*# *  .*.*...*.#..* ... #.. *#..\.. ** #
#....\#  ....\ .#\.* \..# ##.   . *# .#  .....     *.#..  .. \  ....   *.# .... ...# .* . .#*.. #..#
#  *. \.*.*.\ ##.\ *.. .*.. ..\.. \\..*..  ...#  #.......*#..... ...  #*#...... .\# ... .*.# .... *#
#..  #*.. .\.**  . . *. ...*.#..**...*. ... .*..#..# ... ...#. #.#*. .\.. ..#*. .......#......* . .#
#.....   ..... . ..*..*#.. . ...\ .. ..* # #..\.. * .. #...#. .\##.. .#.... .# .#\##..   *###.. .\\#
#...# .*.\ .... .\.......*.*.  .. \..*.. . . . *...\. ...\  .. *.  .*. **.#**.##...#\ .....**...  .#
# .#.. *.. .  ...#...## #\.#. ... ....  *\. ..## .. ...# *..  *...  .....# ...#.....\..  .* *. .\..#
#..#... ......... * ..#........ \.#*. #. *.#..#.  ......... .. #\ *#\#..*.**#.. \\\.# .**. *..... .#
#.... ##.\ . ..... *.......*#...# #. .......\. #..*\. *#  ..\...#.#... .*\..*.#*.\.#*... . #.... #.#
#. .... .. .....*.   ..*.......  ..#...*# .* .\.###... ..# .##\...*  . ....#.........\  ..#..# * * #
#.... ...#. ...... ..##  ...#*...##..\.\..  .#.*.\\..\...* .#...\\ .*.#...#.......\.  #*. ..#.*#...#
# .*#..*  ##..\   . .#.#  .....*.##.*\*.. . *...* * .\.  *...# .#......# ..... . . .. # *.....# *..#
#... .....  ......*..*. \ *...#......... #* #.*#.*  .#*. .... .#. ...... .. \*.. ..#*# *....\ #...##
##..\.##.#*\#... ... .  #...... .\\  .*  \ ...*. #* # . ...\..  .* .. ..#..*.. * *  .\.#..*...*..\ #
#....\ .*  .. ...##.. # ..**.  .\\..  *......#*... . #.*..# \ . # ..#.  .....\ ..*.#... .*.#*\.*.#.#
#....## * #. .\.# ...*.... ...  .  *.#\ ...*...# ........ .. ..*#.* .\..#. ........*...#.. . ..# . #
#.....#.. ..#\.. ..\#\ .\.   #..#...... .\\ . \*..*.....*..*. . ...#...... #.  .#..\... ..##..#. ###
#...*... ..#.\# \.  . \ .  ...**.#..# #.*.. .\. ..**\..*.....#...*.\... \..... ..*. *..#. .\ *..* .#
#. .. . . .# *#. ....*. *.....* .  *.. *.\. ....#....\... .#. ... ##...\.......\.**\. .#... #..... #
#\#..* ##...#..#. .. .....  .#.\ .   .... .*.*.* .*\.#   \.. ..# .\# ....##...# . .. ... .... ..#\.#
#. ##*#..#. .. . .....*#..*.**...*.....*.#.*......*.* ...... . .#.*...\\.\ #*#\#...... ...  ... ..##
#. .    ....#... *. ...# .. \... * ....  .  .\* . .  ..\##........#.*...*.... .\... ... ... *.. ...#
#...*. .# ......\#...... .*..* . \*. .. ..# *.\*.**#...... ... .*..#...## ....  ....*.   ..  *.. ..#
#\..   .\....##. #.. \. \. * ...*....  . \ ....#...*.\*\#. #....#.#.\..\...*.#. ..**#.\.* ..* #*.*.#
#  #**  .  *.  .  ........ ..*......  ..*.#...  #.*#.. ##.. ....## .#. . *... ....  \..#\. . ..*.\##
#.. .*.#. ...#*.*#.... .*..  . **.##...\.  ##.. .... *.#*. *. ..# #.*.\...*. ... .. # .. .....\....#
#. ...#.......*..#. ...#\..*... * .*.....*. ..*#.. #.. ...*. ...\..\. .*.*.* **#..\..#  . #........#
#* *#\#\*.#.  ..* ....\... # .\..\   #\*.#. ..*.*.  *#\ ...##.*.  ..#....\.**.... *#..\#.. ........#
#.. .......#.#. .*. *  \.*.*... * .# ... .\.....#........*.*.#.# .#..#.....*. . #.#..*.*.# ..*.##  #
##...\ #.*.   .. ....#.# #.. . #... ..* #. ..#\ **.*. #.\. #.#..\.* ..#.#\.. ##.* ## #..#.. ....##.#
#* *# *.***........ #* **.#*. .# .  ....  . ..*#\.*..\.. \.....*\..#..*..\..#\.. # *#......*. .\..\#
#...\..#. . .. ....#... ...... . *...#.#...... .   . ......\..\**.   .# . .. .\ \*.. # #.*.# .* #..#
#\.. ... ..  ....\.* .... \.......   ....* * . \\. .#....#. .#.#. **  .*..*..#. .. .  . .. .*......#
# ***... ...  ...... .. ..... .*...##.\ ...# ....  .#... \..#*\.. .*..* *..*.*.....*.# . ...... .*.#
####################################################################################################