#############################################L######################################################
#.#..* ## .\..  \##.*.*......   .  .*. #.*. . \*  ..\. .#.*....#.*.**# ... ... ..* #.*...* * .\... #
#.. \......\#.##..#*..## .. ..   ...*...  #.*.  .. .. ..#* \....**.# ...#... #..#.\\ # #.# .. ##...#
# .*. ...\.#.. ..\..#... ..#* .**......  .  ..  . .  ... .# \.. .# .\\.. .  *.... ..\#.# .. .....\*#
#.*   \. .*...\## *.*......\#..*.... ..#.\....   *...... . .* .. ..#. \* . . .\. .* . .. .#. ......#
#....... ## ...#** *.##.#..# * ....*... \.*.... * .*. .. .. .#*  #*. \ ....#......*.#.....\  #  #..#
#... ......#........ ..\.#*#.#.........*#..... \.\* *....*......#. . ....# .# .#.*.  .... # .  .. *#
# *...\..#.#\. .#*..#......  .. #..   ....# * . ....*#...*#  ..# ......#..#   ..... .* .. .#.. . *.#
#....#... .\.#... *...*#*.\. .. ..\  ##...#*....*\.. ....* # \ #..\ ... .*. ...*#.\. *\.......#.#.*#
#* ..*#  .#  \.\#. .#.  ..#. .. *\ *..\. .. #.......#...\.\ .*..# ..#..... .***...*.*...\.  ...   .#
#...... .... .  . ... .... ..*. #*\  #....*..  * .*. . #...# ...#.... .#.#. ..   .... .... #. .*.\.#
#..\. *.*....##*. . ..\..#*. .. \.....  ..#.. #*. . ....#... *\. #*  .  .. ... #..#. . \ .....\.. .#
#..# ##.\.*#..**.#... ......*..... # \.. *..##.. .### \.** ... ... .***..\  *.. * ... .. ....\..\..#
# ..*.  # * .*. . ..#...# #\#..#. ...#.#*....#\  ... . .  ...#*.*..* *. *..#.\.* ......  .* .#*... #
#.....*... #.#...#.. ....\*. . .....# .#.. *. .#.#.. *##..#*.#\\ ..... *.......\.###..#   ...\.#.  #
#. #. .. .. .**.   ..#\... # .  ..  ..   .\ ...#..... .. .*  ..* #.#.#  ....*....#.* .. .#.#. .....#
#. ..........  ...#  . * \ . .. #. .\  .\.. . ...#..*..#...... ... . \ *..#*.\\\ ...... ..\ \.\ .\.#
#.  .... \*... . # ...\.#. .##.# .*...  ..\###.. . .... .  .\ ... * .....\.\#...#.....\*#.  #..*. .#
#.....*...***# * ***. ...## .   ...*..** . ..#* .. ..# *.#**\.#\##\\# *... ..  \\....... #..#.\.*.##
# .##*.## ..*....#.*.**.... #.# *...*.\*. *\.....#.#..\. .. ..*\..\ ##.#..... \...*.... .*. ...* # #
#...\. .. .. .\.*.* ..*.#.#...... ..## *#*.\..  *#  *.*.\ ***#.......... \.... . ..\...#.#*.*.  *#\#
##.. .*\..*. .#....... #.  . .#.#.##.....# #.* ........*...#.....*. .#...#...\..# .# ..#\... ..*...#
# .\#\....# ..#..... . ...... ..... #. ..#* .*.  ......#..##.\.# ...\. . .  ... ##.#...*.. .. #..#.#
# ..    ...#.... ....  #.#.. #.\..*. .... #.. ** ... *...#.#. ..*. #**  *#. .#....  #... *. .\#.#\.#
#*#. *.. . . ..\. *.#*#.. .##...*#* .#..... .*.*. ..*..*...#.\...**...  . . . .. . ... ....... .#. #
#... * \  .* . \..*.#..\.. #..... .*..#.. ...#*.# ... .. #....# . .*... # *... ...*.. ...*...  . ..#
#  . *.. * ..... . . .*.#...*...#.. ... #.. . ... .#.#....*..*..# .*.*..*#* . #.....   .  *. .\....#
#...* .. .* . # ..#.. ..\ ..  ##. .#*.... .*. # * ......*.. ..\ .*.*.. \.. ..#\. # . . ..... .. ...#
# .. .\. #...#.... ## ...##....  ..#\.  .*.\*....  ....# .. ..#...# ..* .. ..#......\.\\ *. **..*\.#
#.#*...*...*........ ......##.#..*.#......*.*. ..  * .. . .#.. #. *.. ..  . . ..... ..*....... ....#
# .#..  *#...#*.....#.\.#   ....###.#. .\.. ....##.*..#...\... ....#  *... ..*\.* ..* #*#*..... .###
#..**#. ...  #.  \*.*#. \**. ....\.... \... ..\#.*..#... ..... .....\#..*..  .  ..#.. .....#...*...#
# ..*. ...#. #...**. ... #.\.# .  \*.. .*.\.*..*..*.*#....... ...  ..  .      . * ..#... ...\*# .\.#
#........... .\..# ........\....*. ..  *........ . * . ..*..# . ..*.#. ..*. *.. ..\.#  *##.....**..#
#  .*  .\.## *. ....\.#..  .  .. .....#*.# # ...   .   ..#.#*..\ ...* *......#\\#*.* . *. .\ .*.*..#
#  *.. .\  ....  ...*.....\*.*.  ..#...... \ ...\. .*..\.*...  #. *..**..*.*. ..#..    .. . .#....*#
#. # . \.#*...... ..\ ..*.\  .\...#...** . . ....#*# . ..\.*....  .*.\..*....# ..#*......#.. # *#\.#
#*.#*.# ... # ..... . .... . ..## *.  ...\...*\  ...#.... *......*. . .*.. .\.# ....#**  #*. .#.\ .#
#.# .\* . \......#.*.. ...*  .....*\...# . ....#..*# ...*. #.#* .##........*..# .  . .. .....  \\ .#
# .#*. *........\ #..#..  .. #.  * ** . . ...#. .*... #.... .. .. \ ....*\ ...........  . .*.#*.*.\#
#.\..\#....#..*. ..\#.**\ ..*#.#. ....\.. ..*.* .. .  .#... .\ * *..\..  ..*...\.##.  *.##.......*.#
#.*.#..\.. . .  \#...\#.. . ...*.*.... .. #.* ......\..  ..# . .. ..*.#.*.... .   ...**  .  ##.#. .#
#.*....  ..\. . \.\..* ..\# #...# .##.#...#..***.. \. ........# ... . ...*.# .. .. . ...... #..... #
#.... \\....#.  .. .......   . \# .*. ... . ......*.*..#..#.......\..#  ...#\.##... . .   .*\ ..  .#
#.\...\\ * ....#.#.#.#.# . ..\. .....  .#.....#. ..  ..... ..*.. #\*..  #*...*.. .*\.  #.......*. .#
#.. . #..#... ...*..  *. ... .. .#.... ..\.. \\.*. ... ... ...#.\\.*..* *... ..  ..  .** ..........#
#.#.*# ...*..##.... .....* ..#\.#... .# ......*....\....*..*. \*.#.#..*..*..**..\\ . ....\#..\* .\.#
#.  ... .. #. * .*..#. .....#  . .#...#     .\..#. .#\.....\.....*. *. \  .#.*..\..#... .\* ...\ . #
#..........#... .... . ..#. #.*.. .   *\ .#...  *.... #\.*.. .\.... #\. *..##*#. \ #. .. ....#...###
## .*  ...  \.*..##...# ... # .\ .* *. ..... .  . *\ .*...*....... ..*.*. . .. *.... .... #    * ..#
#.  #\..\.*.  * ...## #.*. ......*\.*.* ....* ....*#   #.*..... ..\.\..... ..\*#* ......#. ..*..#..#
#.. *. # *... \....#.  .   #..*...  ...\..* .  \.\... ..\...#..   . #... ...#.R.. #  .*\...*.#....*#
#. \#.#   *.......*\ * .##..# ..#..*.... \..#\ *...#.\...*.*# .  ... .*............ .*. ..* . .. * #
#.** .#.. #. .....  #. #.#*. #\........ .#.... ..* ..#. .....#. ..\*##.  .....  *.#  ..... ... .#..#
###  #... ..**...#. ...*\.*\. #* #... ..#. \#.\ .\. *.....#*  ..*.#..  ..........\***.. .\ #\..... #
# . ..* ....\....... ..\*.. *#.**..*.. .#..\. ...#   \...* \* .#... ..  .......  .. #. ..*.   \....#
#.. . ..   #...  .#... \*.\.. #*...* \...##.#\\...*\ ... .\#. # . ......  .. ..# *.. ... ....#*. * #
#  ..\* ...*....\...#.# .*. ..\#*..*....\  . .... #...\ *#.*.. . .*.....#  # .. #\..\......  .#. *##
# ..#*\.. . *..# ..  .# ........#......\...#.\*... *..  .... .. .  . . *..*.  #.....#. #.#....\.#..#
# \... .  .. .*.#...#.  ..*..#..*.*.. *..  . .*....*....*..*#.*..*.#. .*.*.#  ....  ..\..**.*.*\ .*#
#....\ \*.. . . ##\.. ... .\ .\. .*..\ ....#..........#......#.\..**. .... .#.*...##. ...#.*.*  *..#
#..\. #.. ... #.. .\* ......# .##...\..\ .....#.....*..*..#.. .. .  ..\   ...#. ...... \\  #...#.\ #
#......#*\.. .....#.**. *  .. \*..#.#. ..*\ ...*...  *...*..*..# .#.....##\*... #\\......  .#\.  ..#
#*. .* ..#... #.#......... #..#*.*.......*. #\...#. . .....# #.#.*..  . * ..##*....\....## \. *.*\.#
#*  *#.*** ... . ......#.#\.#*...#. .. #...#*\#. ..  *..  ....... ..\....  . .#.... .#.\.\. \.*.#.##
#**. .*..##.*..#.  \. .  .    ..*.**... ..\....*.# #.\..  ..*......* ... .*#. *.#*.  . *.....\## ..#
#\...#.** \ ..#. #. .  *....... *....... . ....# . *..... \........*# .#.#... *..*#.#.##...  . . \.#
#....... .#* \ .\.  . .*.*.#\.##\# * .#*..\#...*\. ..#.. #\ ......#.*..* . *.  .*.   .. # ... .*...#
#*.....#\.# .....# ...\.*.#..... ##.. #.#.. ..# ..... .  . #.... .*...*...#...  . . * . .##...*. ..#
#.... ..\\.  .  ......\. ..#.....**....  .#.  .*.* .#.....\#\.. .* \#..   . ...*##...  .#  .#.. . *#
#...*........*. .......   .. **.. ..##.. ...*.  .*#.. ..  . . \..*  ...#. .#....*. #...# .* #.*..  #
#...... *...#*.*.# ..\....#..* . .# ....*... .#\. ..*\. .*......... ..... ...... ... ..  ......#...#
#..\.\* .#\.*. ..\..#.* ... . .* . .**.. ....*.. .*..........#\# .\...   *...\...#....# ..\.*..*...#
#\.# . ...*.... * . \*\.. ..\ #..#.*\*. .*.** .. . ...............*.*......#.  ...\ . *. .*. *.....#
#..  #....#*.#.# .#*. *. .##..\\*..# ...\ #.\. #. ...*.....#.\.\. .... .#..... ...* *...#*  . .*. .#
#. ...##.. . .# . *..... ... ....   .#*..*.  ##*.\.*.* .*.   ....*#*.. ....   . * ......# .##..\\..#
#.#*.* .#. ..*.......# *. *# ... ..   .*#.#..##...*. . *  ..\  .\.*.... .**# ..#..\.. *..#* #..  #.#
#\.#.. . ..\. \. *** .. .*#.... ..**... #.#...*# .**. .. .\.*..*....*#*.. ........ .#\ .... . #....#
#\*.. ... ##  ...*...\ . . .# .#.#.#..*....... .# * .#...#..   .............#..*.. . ....*.. .\ .  #
##.#.#....#.*. \...... ....*.  .  #..#..# ..#.#.... .. *#.. . ......\\ ... . .\.. .. *... ..\..#..\#
#. #..\.. *. ...#....*.#  ...*.#.#. .\.##**.#...*..*..\ .. .*. *   . ..#\.#.#. *\.*.   ...  \##...\#
#*........  .. .... .. .   .*.... \.#\....##....  .#. #*. ... . ..## *# ..#*  ....*.*.. . . ..\..#*#
##**. .....**..\.... .... ........## .. .* .*#..# .  ....#.#...*.. *....* . .\ #. .  # .. #...\. . #
#.. ##.**.. #......\..#..... . ... .\.*.... .. #.....*. #.. .. # .... \....* ....*#*... #... # .**.#
# # . ..*.. *...*..#.# \  #* #.#*. ..*.\ . ... \*#...*...*...##.. .....*..\ ....* .  \..#*..#.  ##.#
#..  # \..\.#......  ...... . *   . .#...\. ....\..\. ..#... \.... .. ...*. ..... .#.##\ . .. *.*. #
#. .....\*.. ..#.#.#..\...*.. *  *.\ *#*. ..\*......  .*. ...#. * .* ..*. .#..#.*\#*...*..\\ #..*#.#
#.## \#... ....#.*.*. ....*.. #.##. . #...*#. .\ .. \  #........##. . ..*...\.....#*.## .. . . .**##
# .. .#. ..  *.. . .. .*..#   ..  #* #\ ..*** . .. .##.*##...#.\ *...# .*... *\*.\..* ..#  ..\ *   #
# ..  # *####. ..*...*#..........#.#..#.*....  *# .\**..#*..#*..... .  ..\...#. ...\*#.....  ....  #
#*..*..**. #. .*..  # \...**  .........# .... .*.*.#.\**.\ \*  #  . ..... ......   ... . * # .** . #
##.\\#  . .....#.. #.*.. ..#...*.  *. .. .. #....... ... .  #...\....*...*...\. .\#.*.\..#. *.. .#.#
#*....#.\...*. #.* . ...#..# * . ..... .# . .... . ....#....#\. .* *..#\.** .# \.** .#  *..... ....#
#.. . *..*....\.*.*#.*. . .**........\.....# .......... .. .\*... \*# ..#**...#*......... .....  # #
#.#.* \# ... .*. .\.. ... . .. ..\. . ....\ ....#  .#.*..... ...*.* ....  ..\. .*..#.# . .#..#\.\..#
###... . .* .## *.*. *. # ...*.*.# #.\###.... . .  .*.*###....... ......#. ... *....#..... *...*.#.#
#. #.. ..# #.##*#. .. **.* .*.\ ...#... ..\.  #...    .. .  . \.*   \...##.... ...# ..... .  ...#..#
#...#. . . \.*  .#. #.#. .**.. . #\\.\..*..... .*. ..\.\.....* ... * ... .# \* *... ##...\\. #.  ..#
#*#..*...  .... .\. *  .#...\.*..*...#*....#.**. *..\.. . *\.#*.#.* #*\\...   .. .. .#\*... .#\ ...#
####################################################################################################