###############################################################################L####################
#.....#*.* \*#\.  .... .##*#....*.... \..\.* . . *#.\# ... ....* .. ..#...*...* .......# #.#.....\.#
#.. . *... . .#.....#*...*#.\ .......*... .#...#..\...\.* *.*.#. *...#...##.......... * ....#    ..#
#.#* #..* #.. . ..*.. * .*.* .#...* \. .... . ...#... .. .. .*\....*... .....* \ ..\ .. ..*..#.\..\#
#.....*\ .*.. ..\....*.. #.#..#. ..* .#. # ..* #..#**.. ...\..  .*.... .  .\#.. ...*..#.*. .*. #..*#
#.... .. *.##.*....   #. .. ...#.\.#...#.#.*..#.\.** #\.. ...\...... *.... #....  .#.#*.  ...... .##
# * ...\. *... *....*. *.\.#*.    .........#.#* \  ..\ ...*........ *..# .. #*.#..#....*#...*..#*.##
##.. ...\..  *...# .... .... .*....\.*.. .*.... *.\..#.*\ ..#*.....#..\#.** #...*.  .#.# #...#.... #
##..\..\*# ...#.....*#.\*.. \. ..*\.#.*..  *\. \\.   .\.. .*.*#....... ....**...\ .#.  .*....#...#*#
#\.#.. . . # *  .\.. ... #*.*. **..   . ..#** ..* .. \.* #*.*.#..\ . . #..*  ....  .*...#* .\#.#...#
#..#....##..\.... ..*.* ..*.  ... \ .#..\..*..#\......#*.#..#....#\. .  . . *#.....R*#\ ..*..#.. .##
##  #***#. ..\#.... ....*..#..\.*.. ..* .....*.. * **. ....... *.\.. \....# ...... ..* .. ..... # ##
#* ...#.\.#.#.\.#.#*.. .#. .. * .*.. .. *...#.#* .. ..... ..\*#.*.....#. #.\* *. .. ....*.#..*..*. #
#*.  \.... .#*#.#.. . #  ..#.*\\.  #.#.  \#*...  .... . #*.....*#. # . .  .*. ..  . *\..#...#....*.#
#.\..#...#. .. #**#. . ....\..#.*. .... * .\ \.*. * ..*.# .. . # *#...*...\ ..* . ... .#.... .* ...#
#.#*...#\..\..#*..... ..*. #.. ..#* *#\..  *..*..*.. .. . *.... .# *.. . . .. . ..  . . .  #... ...#
#. .#.... .#....* ......*.....*.\**\ . .. ..*. . . ..# . #. . #.#. ..\ ...#\ . .#*.#.#..#*...*..  ##
#..*. ..... *.#.  . # ..*.... .** ..* #.\.# .. .. ##..*. ..#.. ...*#.  *.#.. . #.**..\*#*.. . .#.*##
#..#..* #.. .... *. ..##.. .. *..# *#. ...#**..\  # ..* ..* .**...*  . * .* . . .**\#.\ .## * .... #
##* .**. . .*... ... . ..* .\.....**...* ...\ ......* ..*..#.... .*. ...  .*.\ ..\  ..**.. \. ..*..#
# \#  #.*\ . ....#...\.\....##*...  .. **.  ..**#.  .*  #.... . ... *....**... . .*\\\.   ... .*...#
#  . .....  **.\.......  .   \\.. .*...*.... .*..\... ##.....#.. ..\*..#.. .....#. .#.. .. .... ..*#
#...**. .... . ....\ . ....\ .#..*..#*...##.. .....*  ##  *.. \. ..... * .*..* \ . . ##\.  .....*\.#
##..*. .. .  \.....*..........*.. ...*.. #*..#.**.... . *.*.. * ..#...  ... *\.* .* *...# ...... ..#
#...*.*.. .... .#..# ..\ ..*.. #.....*.*..*.. #\....  . ..* ...\  **.**...... *....\..* .#*....  .##
#...*..*..  #...*. . *. . .....\ *....  ..... . ....  #..**...## \#..\##........... ..* .. #.... ..#
#. ...#.  ...#...#. \.....#\* .\\.. . ..*. ..#.# \. *\ .......* #.  #. ..#.. ....#**.. . *... *.#  #
#  # ....#*.....\ # \.. ..  .. *... ....* .\.....\#.*.  .....*#.#..\ ..#.  ... . * *#*..\ #.....\ .#
#.. ..\. .. .*...# ..# ..#.\ .. *....#. ...\.. #.*. . ..#\. ..\.*.*..# . ..\\.. .## .... ..... *..##
#  ... #.  # \.....    ..#.*.. ...\.\ ..  .... ...\... *.***#. .*. *..... ..#...#...#..* #.\*#..*# #
#..    ..  .. .* .. .\...  .\ *. #.  . ... .*.*.#..**.....  ..#.  .. ...*# \.*.\.#**#.. .# .#... *.#
#.#*..#...   #.**.# **....\........#. .#.. *........   .\. \  ... .. .#**.\...\  *#.#. \...  .\.\..#
#.... .*#..#... ... * .*..#... .*...  #. .  *. ...... #.**..#** ...* ... .#.. . . . ..*.* ...  *\.\#
# .. . #**#..  . ..*...*..#\. .. .*\.. ..# .*.# . .. ...*#. # .  ..\.  #..... .*\  ..#..\..*.#.*.#.#
#. ......  ..... . #.#. *  ... ........ ....# ......... .# ....# ** ..  *.* .. . ...#. .\# .. *.#..#
#..# .. ........ *. . ...* .# *#  #  .....##..  #.#..\#\ #. \...  .*.......#.###   *...... ..*..#.*#
#..# \#...* #...  .  ..  ...*.... ...........* .  .*.#..*. ....*.... .*##.*#. .# * ... .\.# #. .\. #
#..*. ......#**....\  *   .\..... # .#. *..# .... \ # ..  .. .......\.#.....*\.#.* #....\..\ .....*#
#.......   \\ ##..*#. #..... ...#..*.*#....\ ..*.*.#.... #.. .*..*..*#...\ .....#.\.*.....\# #. ...#
#. ..*..#*..#\.... ...*.. .**. #.* ..\ *......\  . .\ . .   .*. *....#...... . .  .*... . ..\.. \. #
# ..\.#..*.*#......\.....#.#.#...#.  \ .... ..... #.... ...\... . .*.\. .***. ... .\.......... .* *#
#.*...** ... .#. ... ...#....#.  ... .*... ........#* \  \.... .\#..#.\#**. . *.*. ..\.#.*..**.\ ..#
#.** ...\#*\.   .....  .*.#. ...** ....#  .*..\.* ..*.#..*..*\ .*.#.#.. *. ..*.. ....#.....*#*..*.##
#.\*.*** ..... * *# ** \.#. ...#\ *\  . #.#.*.... #.....*\# ...#**##.... *.. **.. .*......\.   *...#
#*.... ..... .*#.*.... #.*.**...#. #...#*...... ...\.#* ...#. ........*..*. ..# ..\.#... ....*\ ...#
#. \..# .*..... *... * . ..... #. . \** . *.#.. .#..... ##.. . . ..\... *  .#...  ....\......#...#.#
# .#\#.#....*.\ #..* #\ #...*.# \.... . \\#.#..##.....#\\. \#.#..... .#........#.#.#\... * # .#....#
#.. .#.*...\... *...*..#... .\ #.#....  . ..  ... ......*.......*...#.#..#.*. ..#..  .*\. *.....\.*#
#.... *.. #*......* ..#..*#*..  *. .*. #. ##*  ........*#...  #. # *... *\.... .#\#..*\..\. # .... #
#...  ....   .... . .\.  ...#    #  ....# ..\.\ #*#. ..*....\#.*...  ..* . *..*.. #.. ...*\ .......#
#  .  .*.#.*. ...\*#.*#.*...*.*...  .*. .. .. . .\......#.#*   .* .\\  ....*.. .. .. . .##\ .\ .. .#
##.* *\.*...\*.#.  .*.....*.##. .*. ....# .....#. .\.......#....#  #........ *... \...... \#*. .  .#
#.*...\...*. *.*..# ##. *\.. ....* ...... .# ...*.\...\..*.*... ...*.*... .. ...   .*...\.\.. #.#. #
# .. ....\..\.. .*....  .  *...*...#.. .*\.  .##.#....*..##... .. ..*...*....##.   *. .......... ..#
#.*#.* #. \*....\ .#......*. ##.#*.. #.. * ....\... ....#...\##.#..\. . .#.*. \.#..#. .... ...*.#. #
#.#.   . .... # .....#....   ........*  .#. .*..   ...#\ .. #..* .... ..#*...  ... *.  *. . .. .. \#
## ..*... .* ..*....#..  .#* . .*.. \#. \##.*. . .. ..*.... ....   ..## #*...... *.......\*. ..#*\\#
#..... .#* ..*#\..... \. .#....... ....\#   ....* #.\**##...*.*.#.*..  .*. . * ....\  . .. ...#....#
#...   . ......  . *.## .\.#..#...#..\ ... \.  ..#*. .*\ ..........*.. .... ...#.#.....#.  .. #.#* #
# .. * ..#*.. .\***#.\... .** \*..  .# * ...*.. .. ..* .*. .#..* *.. #.. .#.\.\  .. ..\.  #..*\....#
#** . ...... ..##*..***     .. ..\*.   . #.. .  *. .#..#..#.* *...... \  \. .\#* .* .......#.#... *#
#..# ...#.\   .. .  ....\...\*.##.# .. *....*#..*.\. ... ..* ..#*..#.#\..*.#.  . *..#*..##.*..   ..#
#.\..*. \.#....*# ..*\... .. *  . . \ .... .#.#*.* \*...... *\. .  *....*  * .*#.* . .*..#.* . .**.#
#.  .*.. **..##\... ....#. . ..*..#\#.........##.... ...\.#\ ....#.*.#.   .*.... ..... . ..#* .**.*#
#*. #\. .*  *...\.  .#.* . ..*. **..  ..#. #. \.. ......\#\  # ## .....  ..\.*\ .* ...##....*...  .#
#.* .\.#  #..\  ..... .# . ...    *.. *.. ..... .......#..*. #.*.#.*.#.*.*... . ..* ...... ..*.# *.#
# #. # .. ..# **. * . #..   .....#.#................\.*..#.....\#..\.....#.   .. .## .. .... ..##\.#
##  .*....##\. #. ....###.\#...* ... .# \..#.. .*..# *.  .#. \ ..\. ..\.. .. * .#.#. *..#.*. . .*..#
#  ..* #...\.**# \*....#.....  ... . * *..# . ##\ #...*.......#... . .*..  *.#..\ *.. .... \#*#.. .#
#.....#....#. ..###.. .* .. ...#*..# ..\. ..\ *.  .##....# ..  #.. .** ..*.. .*..\.. .#..#.. ... *.#
#..\  #......# .. *.........##. .* *.. .\*... ...*\#\..\#.......### \ . #....... ..##*.. . ...  .**#
#...\. . ..\  *.....*#   \..#. . #.*\ .# .  ...# ..*..#.*#.. ...#.#.......\\..\. .*\ ...*.....##\. #
#.. ..*.* .* ** .....#  .... .\#...#\*... ..#. ..*  \. .\ ...*..\......#..  ... *.#....#...... . \.#
#.  ##.\* .  .. ...... ...#.  #\. *.\..# **  ....... *#...*... \*....##*.#\......#...\.*** \ ...*.*#
#.. *. * ....\.#\   ....#\..*..*....#\#  ..*...\**#\#.*#.. .....* * .#......\#..*...*. ...  ....*.*#
#. .\*.. .. .**.. ...**.   .*......* .#... ..# .... ...... .. .... *..# \#......* .. .....*......* #
#*........ ...#.  . ..## ..#.#*...   ...\.#... .. ....  .    *.  \.  *...*# *.\*. ..* \...*...  # ##
# ..**.#.........*...\. .. .*#. # .*...*.#.**..#. ....\#....\.\..... . ... *..# .#.#...*..........##
##  . **......*  ...\\...... .  ...  .\.\.\.   *.  . .. \#..#. ....... . ...#.#. # ...# ..... \.\..#
#\*..*.#.   ..# ................#.*... #. \.. .. .... ....*#**....#.  * #*#. \ ..\\#..... .\.*.. \ #
#. . .*. .\........ .#.. *.**....* ... ....  ... . .....#...  . .\.....#.. .. *. ## .  . .... ..# .#
## \....*....* ... ........##.*#..*..# \.. ..*..# . ...   ... .... ..... .  ..........* .*. ..#*#..#
#..\.##..... .*  .....###\ *  *..\.. ..  ##. .  ....#..#\#*\..... *........*...*..#..#.#...#.*#....#
##. #.. ....#. .*.*.  *.... #\...*...\..  .**.. .#*...#*##..  . . *\\... ...#...##..* #.. # ..**...#
#. .. ...*\#.  ..  \. . #.....*#.#.. .*.*...#..........  .*....#.* .#.#. \*#*.*. #. . ##*..#.*.# ..#
#..# .....#.#.  ..\. .#\.\....**#....... .# **.# .. .*..#.#*..*.. *.# ... .\#.*#\..*  *  \ \ .*. . #
#... ...*.. ..#.\ ..#.#..... .#\*#....#***#. #.. .#. #......#.#. .....* *...\***.\.# \#.....# . \#.#
#..   * ..##... #.\....# #. ....#..  *. ...\#..*..##  **  ..  #. .#.*.  *    . .....*. .. *.. .* * #
#  .* .. .. .. ....*... . ..\.\*#... ..... . *......#\#....** ..\ .#. .. *...\.   #*..*\...##...#*.#
#..#. * ...  . . . * . ..# .. .*...#.* .. .   .. *#..#. .. .# .\..*..   . .. .*....* *. .....# **.\#
#.\..*.  . ..*.....#.*#........**\  .*.#. .*.#. # * . #.#... *. ..  *.#.*\#\ .#*#... *... *\ ..  *##
#.# .\... ....#..............  . #. *\..* \....*.\#..# * ....#.*.#.....*\.*..# ....... .. ..#*. \..#
#....#.*\... *.  ..* #..... ....*.. #. ......#  .. #.#..\#.* ....... . .*#  ...  ... *.. *.* *.... #
#. ....*#..\#....\*.*#* ...#.......*. *.  ..#*#.   .*..#*.# # ..  ...... .\*# .......\.  *  *......#
#.#.\***#.  .  . . ........ .\*...*#**#.* #..\..#.*\*. .#\#. .. ..#.*.......#...* ..  .... \..# ...#
#*..# .*.*..*. ... .. .\.. .  . .*.**#... ....\#.  ......... .....*# .*.*...#.. .#*\...**.\.. ...###
#.#  . ...*.. .  ...* .........##...*. . ....   ..#.. # ... #. . . .\#....*.....*.#.*#\.  #......  #
# ...** . *.. .\.#..*.#... .# . ... *.# .. ...#... .*\.....# ..#\\  \. ..*. #..*.\. .. *# #..# . *##
# .*.. * .**.#..*. *#.\..... .   ..*.... . **## #.. .......#\#..\\ .\  .. .\... . ..*#. *...#.   ..#
####################################################################################################