##############################L#####################################################################
#.  ..#....... .\ # #..*# #\**. .\\.......#....\ .........*.....\ *..#....... * . . #...*.* .#*....#
# .# .   .*. #.....\*.#.#.\#*.  ...  ..\ ... ........**. \.#.#...#.*...#..# .* .. *#.# ..  ...#....#
#....*...* ........#..*. ....#.*...**.*#.# .#**......* .. .. ... \.........  .. *.*..... . .. .*.#.#
#.*.\.* ..\.*.* .....\  ..#.#.. . .* .\......**..... .... ...*\#. *.....  ..*##..*....#*#  . ...#..#
##  .#.. .......*.... .\...  ....#.. .##. ..\ # .  .....#.*.   ..#......  .\.\#... ......  .*. ..#.#
##.*.\#...#...#..... .#.*.  \#...#..#.*\.......\.*. ... . *.#.##...*.....\#.......*#.#.\*   .#..#.##
#..*. ..*. .#*.# #*.*.#\* .*.#.....*. *.....#.  ..  .. #. ..* . .#.. #...#. .#...   .#...#....  *..#
#*......#..#*. * ... ... ...  ..#* # *.#\ ..\*.... .*..##*........ #.....**.*..\. ..\*.... .. .. ###
#.  #*....   .##..\. .* .*..*. . ..... .#...**. #.#.## . . .*.  #...\.*..\\..#*. .....**... .. #* ##
##.*.#...  ..*  . . *.\..\..*..*..*. .* ... ... ....*.#......*..\...* \.*...  ..#..\.#.*#... * ..\.#
#. \.. \ .#...#. ..**...* . ....\.#...\ .###.*  ..*...*.# *....*#.\ ....#*.#*. ......   *...#.... .#
#........*... . \.#....#...   . ....#..*#.. ** .. . #*.\..##......\.* .*..... .#.....**....#  ..#..#
#*... ..*.*..#.\  .*..  . .##  ... .*......*.#\.# .. ...#\#...... ..#. ..#.*...  *..*. ..* .#. .#..#
#\* ..*#   #.#..\.# ...   ..  *#.\.\*  #..##.. . ........*. .\. .. ....* . ..  ..  .\. .*..*. *...*#
#. \.....*. *.. \.. *#.*. * ..**.*.. ..*.*. .\ .#....\*. .* . ..* ..* *#\..#\.. .... *..*#..#..# ..#
# ..##.*   ...*..# *#.* \ ....* \. .... ..\#.*.. ####.\... ...*..\# ... . ....*##*.. \.# .....#* #.#
# * .. ... . *. . ...\*......*.. *#....#. ..#.\.....# . .#... ......  ... .*.***...  ...*#\#..   ..#
#. ..##. ..\*....... ..#..\#. *..*#...#...*.#.*#..*.*#.#.....\..#. *..#.. ..  . ...#\. .*..*#..\. .#
## ... #. .*\. *.*. .\. . *.#.*.  .\. ..##...*..#.. ..# .*.\... .    # ....# .#.*.\. *.#\.. ##\# \.#
# ...#...  . #... ....#  ..#.... ...#......#...\ ..*......... ..*  .#..  ...*...\#.... ...#\ .. . .#
#....#..* .. .\ *...#*.*....#....#.\*\...\.......#\#* ..*....*# #.*...#..##.# *.#.#.\#... #..*.   .#
#.\. * ...* .......#. ......#\#*..  .. ##.  * #.. *. .. ...... ... *.*\.. #....*.. ...#. .*.*  ....#
#... **.. .*. . .. .# .  .. * ..#\ .*.. ......*...*..#. *..\ * ..... . ........*...*\..***.....*.. #
#.....  ......#.. .*#*.  ...#*  ....... \....\#*###*..*..#*....\.....#. .......#.*.\##.# # .*  #.. #
#.  .....** #* *....# #. ...\ .**.....   \. .....*.*..\....  ..##*...*....# ....* *# .*#.....* .#..#
#. .. .  *.. .# .\.... .. .. . .....  .. *.*##....... . ....# .*.#....*. .\ ... ..  *#..#. #.*.. .##
#.......#....#....*...... ..**...\#.#.... ...*...\..#\...#\\.... ..... .. . ......##.*.#.. #\..  .##
#.. *.\* ** ............*...#.**.... ...  ..... * ..#*\ #.... #.##. ...  ... . ...... ...#.... ....#
#.#  *  .#.......*.....*.. ... # #... #*#\ ....##.........#.#..... . .  #....  ..  .. ...*#   .... #
#  * . .*.. #..... *.....# .........#..#.#.. .\ . .. .. #....#\#  .#*#.*#.. .\*.# ... .   # ...\...#
#.....  \.......*..  .\*#\... .#..\* ##.. \.#  ..*........#\*\.. .....* .. * ..*. ..# ..  .  .*.#..#
#.. *.*\.#...    . .....*#..*.\. \.*..*. \..\**.#...\..# ... .....#.. . .#.... #...#.\.. .#..\. ..*#
#..\#.... .#*..#...# ..  .......#. \. .   .#. .#. .\* ..#\#.. ... ....\ .\## ..#..#.....#. ...*.\\ #
#*. . *....*.#.\.\..  .#..#*..........#.#...##..*...*.....  .. * .....#....#.. .#.*.*... .\*.  *..##
#.#...**#...*...  ....#......* #..**......*.*\..\...#**  .. #.....#. . ..*.\.....#....*. . # .\..  #
##*.* \..#..*.. #...\.. *...#*........... .. ....  #.#. *#. .# *. .* ...#..*#.# ..   *  . .* \. * \#
## *...#.*#. ... .**.  \.\*....*....... ..  . #....... *..    ..#... .#... #.... . \ .#....\ .\....#
# .#... .* **\. .. ...*.*...#\ * .....\.*.*. .#.  ...\...* ..  ..#. #..\.. .. ....#....#.. .. . . .#
# ...\.#.###..#  .....\.  . .#.\.. .*..*..*....... ...**. .#.* ..#...# *.. ..#..\.\#.. ...*.....\..#
# #.#....*. .#.\. . .....\# .* \.. #......*..#\..* .  #.\##*. . #.*....  ... *. ...*.#...*..#...*. #
#. .\###...\# .#. ...#. ##.* ***\#### .#.*... ... #....  #*. . ...# .#..#.. * #...*..#..#....*  #. #
# ........ ....\.  . ..  *#. ....\.. .*.. .**#. # ....*...*# ...#.. .\.. .##.\.. ...... *.\....# \.#
#\\##..#\....... ..#..#  .\#*.\\.#...*#...... ..#.\...#.# .....#..\..# .. #...#* ..*.#....# .....**#
#.....#   ........\...*..\\*#....#..#.#.. . .\*.#...#......\.*.  .. ....#..\.**...##. #. .#..#..*.*#
#....* ... # ... .. . \ \. .\#. ... *. .#*....#....... .** \*.  . #....*..#...\#.. ..  ..#\*. .. *.#
#.   .\...* ...* .....*.* .  .*###..#...#*.*\.#*.....# . ...*#*#. .#....#. .#..#.  \* * \#* *.* ..*#
#..*.#**..*.  .**.... .  #*.#. .#.#.* .. *...*# .#.. ..#...\.. .. . .###.#.**\#  #*..#....##.#. . .#
#........#** .. \#\#...**.... \*   # .** ##*......\* #. ..#..\*.. ..#...........\.. ...*...  ......#
#..*. .# * . . ..*....  ...  #..#\  #..*....*.#........  .. .  ...\ .... ....#.*. .........#...*.* #
#  *......*.*.#.#...... #.##.... ........\. .\...** .#*.#.#.\...\*.  ...\*..  \..... ..# .......*..#
#.... .. ....*.#. *.*..#.\#. ..* \ \ ..... #. .#*.. #...**........#\.. * \.#\. ..**. #...\....#\\..#
#\.  #.  ....*.* #.*#..# *...... #** \..*.. *...#.. \ # .*\.... ..  #..\. .*....**#.*....*.#....#\.#
#..*.* ..........#..#*..........*... .... .  . . \\..\.#....  .\. *\*.#.. *...\##..* ...#...\.. *..#
#.##.\ #..   #.#. ..#...*.\.  *. \. .. . ....*......\#.* \. ... ..# .*.#......\.  ... *.*\.* * ....#
#.*.  .. ..#...* .. .*.#.........#...#.    .#...*\. # ....  .*.....\# .**....  \\... ..*.... .  . *#
##.*.*..#.. .. . \* .**#..*\. ......#..\*.#..*... ..# *#...#\# .  ...# .   ... .\. \.*.... .##..*..#
#..\ ..#..*  .#. # ...  .......#*.\....*...*... . ......  *.. .. .#.*.\*.. *\ # ..\* . ...\.#......#
#... . ...... . *#.  ... .. \. \.# .   .*#. #......... .... *.....*. .*#..***...... *#....*..#.*...#
#. .....*..##.*\...\#  .*...\...# . #.. *.. .........* . ..#.  #.......\.. .**.....  #.. .\\..*... #
#.#.   ...#* ...#*# # #.*. ....*.\.#.* .. \.......#.. .. *.*.. .*...*.. .\. **...#*.#...  *...*. ..#
#.#*\..#* . .. ...# ...  #....\.....  \ *... * .  ...\...# .... *.. *..# ...*......#..*...###...*..#
#.. #...\......*#....... . .... ....\. .. ...  #\. . #*..#...#. **. ....*.  .. ...\. .#..\........*#
#........#...\........*#*#. #..*.  . #...* # .........#.*. #..*. .#.  .... .#....#.*.. . .... ..#..#
#. ...* ..# ..#. **.*..#..\. . .*.....\*#\.*..#...*\.*.... \*...*.. *. .  . ... .*   #.*\..##... . #
#..#.#. *. ..**.# #\... .. #.....*...*..**. .#....#.#.. .\..\#... .. ..*..#...# ..* #. *#**.#*.....#
#.\.\.. . ..**.. .##\# \.... ..\* **\ #. #*. . *...#..  \.\.*.. .\\ .#  .*.. \. ...\#.#.. ..*... *.#
#.\.*..  \..#. *.. *. . .*..*.#...#.*.*.# *#*..# \*. ....\#... ........# ..*. .. .*  .\.#....  *...#
#*..# \ .*.#.....## .*  . .   .#* ...*..........# ....#..*. \.**.\ ....# ... ..#........ .\.  .. . #
#....... ..*#* ..# .\*.#.....#.*  .....*.\* *.. .*. ...#. ...#\......\#. ........ .#*... . ..... *##
#. .*###**   ...#*... #..# . . .. .. *#*.*##..#*.#..##..*.  ..    ..\..#..  ..*. ..* #. .\. .#. .#.#
#* *.\......*. * .... *....  .\.....* ......*.*#..  \\.  .. ... .  . ..# ..*..  . *.... .* .#..##.##
#..  ..#\.\. . \.*..##..*. . . #*#...*..*.  ..*..**.....*...*.#..#*..#***#.#  .##*. ......**.... #.#
# ... ..#  . #.. ..#... *.. ..* . . .*...   . .\.... . . . #..*. .\*\..#..#.***. .*..# . #...*.\. *#
#...# *\#.........\**.   .. .*.....*.. .... .. # \.#\.*.* .*. *....*..*......*\ .\.\* \. .. # .   .#
#*...*#..* .. ...*.\* ...##..#. *#.\..# ..*# ##... .\.. ....#.. .*... . .  .... #\....\.*#* ..\* *.#
#.. .*..  \\.## .... ..# .....\.#*...*.#** *... .##...*. .# .#\*.*\   . .*..#  . ....#...\# ..###..#
##..**.#..#\.....#.#* ... ....  ....*...#  ...# #*........ #... . #\.. ..    ..*....\. ....#\. .*#*#
#*.*.... .....#\*..\# ..#...... .. .  ...*.   . .*. ..* ..#  .. ....  .\.#.... . ..#...#.#..# ..\*.#
#.*...#..*\.. ........#.*... .*. #.#* ......\......\ #.*  .. . ..... # .#........  ....#..... ..# .#
#.....\# .#*.. *... ...#... .* .....*..# .   . *.... . .....#..*.#... ... * .#*..#. ..... .\*.....*#
#......#. ....... ..\.. ..#\#\\.. .* *.... .  .. ...#...**.#\.... # * ..*.. .#.  ..... *.R..... *.*#
##\. ....**... . *.\..\ #.. \.*.*......\ . \* ..    \\...#\.*. #\.#\ ..#...*.. ..#.** ..  ..#....**#
#...*.. .#... #.#..#...\.... ..# ... .#.\..#.* .#.. ....*...  #.\*....*.#.* .*  .#..  . \.  .*..#..#
#.  ..#.#.. ..*... .*. . . #..  *.#...#.\.\*..*. ....\. * . .... # #.*... ...*. .. ..\.  ..*. .  ..#
#......*..    *..*# ##. . \.**........#.. .. .*.##..... \...  ....\.#...#...  .*.**.# *... .*..*#\.#
# #.. .. *#. . .  . ..*.#. ..#*. .#...  ..*.. .. . . .. .\..  .....*. *.. #. \*...**.#...  #.....  #
# .*.... ..#* .* ..#....#  ..\#... \..# .* ........ # .....**..  \.. ....*\. .#..**.. .. ....#.....#
#. ... .*#*##.........*\.# .*. ...\\.#.. .#. .. . *..#*  .. ... ..  . # ...  . ....... ... . #.....#
#.. .*..\.  .\  .#...#.   ..* .\.. .#...*#...#.*##.#\..#.\ ... #. .. \. .. ...\.*#.#* ... .*.. ...*#
# ..   ..**........\...#.*...*.* #...... ##  .   \.... .. ##....  .. *. *. \.*.. ...\.*...  #  ...##
#* .\...#.#\\..\ #.....#. ..#  *.....*#....  ..# #.#\.* .  .....* .     ..\..*....\ ..*#*..\..#.. .#
# *.# ...*.. . #...\...........\.. ..  ....... #.. \..\. . *#... ... ..\# . ... . .  *..* ......  \#
#...*..#... ...... .. *... .. ... *..... .# ....* . \\..#..\.... ...* ....\. .. .#. .  ..*.## .. \.#
#..... ...... #.# ..   #*\.#. #\..#\*#..  \*.#.#.* ** .... #\   ....  ..*#.* *.. .......*.* \ # ...#
#.#*..*## .  ..  ....... .#.*.. ...#.#. .. ##...*.#... *. ....#. #.*...#. ...#*   ... *. ...# .....#
#   ...#..  .*.* .  *...* .  *#  . .  # #..*    .....#.*. ..* # .. . .* \#..\ ..  .#*\\ . . .   ..##
# ..#*..\ . *..... ...*.. ..  .*\#.#*# #....#.#..#.  ## #. .*.... ..... * ...#..#.#... .......... .#
#*....\#.*.#.. \..*.\#*.*....... ##. **..** *. ....#....##.**..*.  *.....**...#*. *...##.# ..*... .#
####################################################################################################