####################################################################################################
#**.\.*# ..#\#*.  #*#......*#*. ...\....\\ *#..*.#**.*.... .*...#...# \.#*........#..*# #.*..#*#*..#
#..\#*. ...\..  ##*  #..\.*.......* ... # *..#.# ## ...##...#\\..#..**#**..# .*.#. ..... ... **... #
#..#..*..** *..#.**.\ #.....*\ \#* ....\ .... .*. .\.*#.*#.... L...**\\ ..#..*\L*.\..###\*.  #.#.#.#
#.. ###*\# \...*..*...... #..#.*#. .\ ...... ..#. .*#.#..#** .###. #. .*.. #L\\.*.*#..*.*. ..\L..*.#
#...*#.    #*L\.\.#..#*. ..\ ... .*.\....\# .#. .*...###.#.... .**##..* #...#\#...*.\ ...*.... #...#
#* #..#*...*#.#*.\.\*....#....# *....*  ..*. . ##\.\. ...*\..#....\.*...*\**. L..#. ..#...*.*.. .*.#
#*.*. ...\.. .*...#*##.. .. .. *..#. ...\\ .. .* .#.\..\.....#L...\...##  ...*\.. #....*\* *.#..#..#
#*\..*.#. .*....# * # .. ....\..... *#.#*. *#   .. \\..*. L.#*. *..#.## *##. #.\ ...*. ..... ***..*#
#*  #\\.*.. #.*#.#*.\#*\# #.*..#.*#.\ .* L......#.*  *. .## *\*#**## #.*....*\#.#..\.\ ..L.# .*....#
#.#*.** .*#..*.*.\....... ... #\#.*.*  .#\**# ## ..\..*..*... .#. .. .*.* ....\..* .*\*...*. .***..#
#..* .*.. \..*.\..# .#*..#...*#*.. . *.##.\\ *#...L.. *.. #...*..#.....*  .\..#*...#.. ....#*.*. ..#
#*\.*.#..#.*.*\. .#.#*#.*#*.\* * *#....\*.#  # .\ .*...*. #...L..*....##.. ... \ ...# .\  #.###..\*#
#....* .*.....# *..\... . . ..\...# *#..*# . . *.\** #...#..##...#.#.\..#  .*.\.#.#.#...##.#. .# # #
# . #.....\. . ..*. **....* # .\.*. .# *.\. .. .\. ..#.*... *..#...#.\.....###*\.#.....*.#\.\#...\.#
##*..#.. \..... *...*L.#.\ .. ..#*#.. \*.L.\.*....#*#....\* #........#..#.###..#. ...........#.....#
#*..... L...L.\#*.. ....*.#\L*.*.. #*#.* ##.L#..##. \..#. *.. .. .*....* .....### .\ .# .* ...#.#*##
##.#*.....#\ *.. ..#.\ ..*.*.. .. ..*. .  .. .  ..... #*\##.L. #.#. ...#*.. \\.. .#..**. .##L....#.#
## **.##*.#. ##.L#.#*#.. .. .*.. ##..*##  .. . #*..\# . ..\. ...#*..*\ *#.#\\. *....# # *#... .\ # #
#..\#.*..**...........#. .\*..*.#*.#.  ...\\ **.*.*.....\.#...# ** .#.... .#..\#*..*.L .* ..#.. L..#
#..*. *#L*...# .*#.\*#..#.#...\..  #...#............ *.*.*...#L.*..\..#..*.*.. *.*.\...*. .*...*. .#
#* ...*. .\*....#*....*... *.#**# *..# L* . *.#...#.#*.**. ..*.. ..##.....#...*.*.*.....*.*\## \.  #
#* \..#*#.##*.. # ..* #*.\.#...#...#. *#..*.*# .*... .#..*.*... *  *...*..*....#... \....\... *..*##
#*..#.....#\*#*# .*#.L.#.. .. ..\#. \    **.*\* .*# .#.#.*..#.#.#.L..#..#. #.*.# . .##   #. .......#
#.. ...\\ **.*#.** .. ..*..#... \*.* .# *\.#..*...*#..##.# *#\##.\.\.. .#.... .#*.#. .*..\L#.. . ..#
#*#*...L..R#L..L# ...L. .# .* .*....#.  .. * .*#.#...* ..# *....#*#*.#.#.#*.\.*#.#..\.*.LL # ..\ ###
#..\.#.. #*\*...#.#*. #...##...**.*..*. ..\.# .#.* \....\.*.#.*...##*.#.*#.\...  ..#.#.........\#. #
#. ..###...# . ....\...*#*##*\ .  \.\.... *###. *.#.# #.*.##...... .#L#...*..\..# ..#..*.. *.  ....#
#.*.. ..\*. ....#*#.\. #.... #.L .#\#.# *#.......###....#..#.#.  #.#\#..#.. ..#...\...*##..\ ## *..#
##.......  .*.*.#.....\ # .#..\#..#*** #*#   ...#.# ..# .#.#..*.\#######.. #.\...*##   .....* .... #
#..\....*. #* . \....  .#*#*#. #**# *##. #*..... ..*.#.#.. .. *\**.*\...#.....##.#...L...L...* ## .#
#.*\..L....# #.*#...#*......*.*.........# ..*# #...#.#.#..\#.#..* .......#*. \.* L.#\ . .#..\..  .\#
##...\*.*## ...#.. .*.## \\.... .....*.*\ ..#*\\ \.....*....*..\**.. .....\..#.........  ...*...\#.#
##.. * ##*#.\.  ...*. * #.#*.\ . .##*\ *..*.#.*\. ##..*  #.\.....#.#.\*..#* * .*#\ .* .#.# ...*.*\.#
#...## *...#.. ..# .\#.. ..*. *... .#*.\#. .**#. ...*.. ...#...\\#..\.\.*..*.L*. *..*# .*\##\.. *.\#
#...\# *#.\. **.*.#..#..\#L...... *....\ ##..#. ...#.\ .#..\\\..#*.#.*....*L*.# *...... *.#...\#*..#
# \##..\  \**#..*.. #..*\ #\. .............*... ..*..#.. ..#*.*..#** .........*....#....*#. ##** .\#
#\.. .#*.*... *.. ....\   .\#* .#..#..L.## ...*.*.........\.\.\\ *#.\.#.\*......\.# #.L# ##*..#..**#
#. *.*.. #.*\##*#* *.**. .....  .\ .##\.*...#.#\ ...*.\..*#\.#***L.#. #..#.# # \#....#.\.#*#\ .#.. #
#*. *#. ....\.L  *#...*#. . #.# ...**.#.#\..#.**\.*\..\ #.#\..#.##. ...*..\#..*\*.* #..... .\#\L.*.#
#*.*#..\*..*. ....*.# ....*..#  .... *#.##..  .*.......*##.# .. **#. #...#\.\.#*.#*\*. #*...#......#
#  .. .\.*. .*..#.* .**....\#* *......... ..*..#. ... ##*#*.#.#...**.. *..#*#*.#..#*. .#..... ..\*##
#... ....#**. **  . . .. ....*. #.....***#.....*. . .\ ..*#*##......*.. ..#*\#.*.**L.....#....*.# ##
#.#*# \.#*.#. # *.*#\.#.#.#\*. *#*.#. ...*...\ .. ##.#... ..# ......**##. ..# .*#.*.# ..\..L##L . .#
#* . .*\.#. *..  \#.#\. *..#..*..#.#..*.#..*...... #......**. .##.*#..*. *#...** \ .*..# .#\***L.#.#
#..\* . ......*.# ##.*.*  . .**......#..\#\... *.\*....#.. ##..\\. ##.** .*...\#*.*.*.**....\ ..*#.#
#..*. .\. .#..#*. .# .#.*L .**.\* \*\ ... *\...\\..* #. ..#.#..*.\.* ..L*.#...# .*\..#. ...#....#..#
#..#. .##..#..#  ..*\...# ** .*.# # *..#\.....\* .\.#\#...**#*L*.*.. ...#. ...# .\ .*. ...\.....\. #
#....# .. # #  . ...  .* ..# *..*.\..\\..#....# .\... *L ..*.... .#. *...\.  ** ##. \* .*. .\.\**\##
#...#.......#...##.*..#\ .\ #.  #*.\..*.#..#\.* ..*.L..#\\\.\\.#**.....###  .*. ...*.*L*###*#..\. .#
#.\.....###.*.... #..*#\*.....# ***.\#.#.*.\ *#......L#**.*.....#*..#...*.\...#.# L....#..  .#\.\..#
#.L..# L..*. \*. #....* ...*\ #. #..  ..\*##*..#* ..#\...#.**...##\. *.#.\#*...#. ##..##*..#.# \ ..#
#.##.... .*.....##.... ..*.#. .# #.\. #..\ .#\.#\.\*.*...#.* . ... ....##..*.... # ......L## ..L...#
# .**#. ..*.....# #.**..\...\. .*\...*.#. . *.####.L. ## .#.*#*.\ ..*#.. ..*...\. *. #..#. ..**. ..#
#.#**.\  .. ..#.#.#..*. ...*  \...*.#.*#*.L .\.....\.*.# \*### *.#\\....#......*.\**.* .  ... ##...#
#..L..\#\ *..#*#*\.#*  . \#*#...#.*..#.# * \#.\#\. # .L.*L...#*..\#*\**..## .. #* #.\.\..#...\.#*#.#
#. *\*  .* ..*#. ...#.L. #*.#*..*..*.L... ...#*.\**.##.*..\....*..*#\. \**. . \ .#...#..*.\** #*#.*#
#*.*# ....L #  *..\..  #.*. . *#.####.#... .##.#### *#\* ...  *.* ...  .*.\..#. ##.*..#.L.\ .\.....#
# .....\\\. .  ..#.*.#.*##*.*\* .\#..##*...L. ...*  *#..\#. . .#...#......*.#.*#.\..*... #\  .*. .\#
#*.*\*# .......\\.#.*... ...#*.#..\ .. \*##. #*.  .*#***.L.*#*.. *.. \ ..*..\#..#.\ ..L*.\.....* \.#
#....# L. #*#.. .#.* .*....* ..**\  .*\..#.*. **. .#.  *............#. ..##..... ##.##**  .#*#*....#
#***#\\.\.*.. \.\#\. .. **#. . .**.##.... ..#*.#...#..*#*# ...#. *.#. ..# ...... ... .#..... ##*L. #
#*..   . .##.*#.#....*.** .# #.\..**..*.#.. #.** ..*. .. #*.... \\*.. ...  L .#.*.....   . .## \*#.#
L#...*# .**......*  ..#\\..*.. ..**.#..*#.#.. ....\ \ ..\.# *...\*#*..#..*\*.**.* *..\. .* # #..**##
# ... ..#.*....*....... *.*..\L#.  ...... .*.. ##\#.#\....**. . \\.......*.#..#. .**..##.. *... *\*#
#.. . ## \*\#....*.  .*#.. ... ##\.L\*#.#.# .#*. \...#.*.. ...L**.# ..##.#\.*.\.... .\.#........#..#
#. # .#. *.#....* .#.... .#.\\#. .*#*. ...*.*.. .*# ##\ *.# .#\..*###.**.#.#. #*\\# L\.*.*..# ..\#.#
#.\..\.*.#.*.*#..###*. .*.. ..**.#. **..\....\.. .*.#* .L\..#*..\##**#\\...  \ \ .*.  ...\.. ..#...#
##*.......*#.* \.\\..*.....  #....#.* .##.*.....*\.#* .....L.*  .# ...\.\**.. ##...L# .. .*.##\.#..#
#. . **#......*\.. .#...* ##....*. #* ..*.*. *.. #.L...*\  # .*...#.... #.. #.\..* .#. .\.\ .. ...*#
#\........*..#\..*.#... ...###....\# ...\\.##..\.\. *... *.*#.##*.\ ..*  \#...*\. ...#\##..#.#..#..#
#* .*...#.\\# #.**...#.\#. .. L*  *##.#\#.*...L*\**# \......##*.#..*  #*....*...# ..**...*#.\.\#..*#
# .*...#\*\#.. \ *..#..#* #..\*. ..    ###**\.. *.. *.\#.*\. .*..*.. \#.. . .*.#.*# ...\#...*# . . #
#. .#**#.*..##....#*.#* .##*..\....\..\. ...*#.. ..\\...##...  # *...##... .*#..*#.*. \  *.#\*.L#.##
#. #*   *.*. .#* .#.\.# * # #..#.#. #..*.#.#....**#....*.\ \#.. .*#*#.\..\##...  ..##.  \# #.#L#.# #
#.... .#\\.# #.  ........# .#*.\ L\ .*#.#. .#\.*#*...*....*\.#...*...*.*\...#.\**  ... ##.*.... *..#
#.#.\   *#. ....#*.#..... .\. \\ . .\*..L.# .. .*.*\.....\*.#L..#*...*...#  #..**..*#..*##L*.. L#*.#
#......*. \.*.. .....#  .. ..#...#*.\*..#...#* ... *....#\.#\.* ...L*.*.##..#.. .#*.##*#.....\.#.#.#
#*\.#*.\ .*....#\# #\..##.#*...\..# . .. ##......*.... .*.*.*......#.*#.....*.\ .#*....# *... #.\..#
#.#.L*.*\#. \. *#... \#\#....\*..*....\#..#..#. .*..*. .\#.*....*..# #.***  ##. ...  *. ..#.. .  #.#
#*.#.. ..#. #*# .#\#*..##..#.....*...*. ...L# .  \# .....\..## ..\.*.#*.. ...*.*L .*....#  . ...*..#
#....#.. #*.#.*#.\ .#...#.*#. **.... .* #.\* *...*.##\*...\. .***.\.*\.......    ..  #  *\* #...*.*#
#.#.......###.. *#..#*..**.**\L....*.##.*#.\#*..... * .*....*. .*.....#..#.#**..\.**.....#..\..**..#
#.. * ..#..#.\.*..*.*....#*..  ...#..\#.#. *#.**\....*. .*.*.##.\. #......# .#.*###..  *..\#..\#*..#
#. . *..\ ..*. # ......#\.\.......  #.* *... . .#....\...#.*.*#.....#.*\#  #..* ..\*#...*# . #.. \.#
#*#. \ ..#\ # #..#\#......... . **.#.**##. . *.#*..### # *#.. ..##\.# . #*..***...# \.* #\*..#.* #*#
#. .\#...\**# .# #.#.***  ..**..#**..# ....\. *.##\\ .\.\# \L... .* .#\ .. ....... *... .##\.. * ..#
#.#..*.#**.#.. .#.. \.... #...\.*.... ...... .* \  ...#.**. ..## #....*.#*..*..\#.*#.  **...*.*.\.*#
#*# ..###.\\... L\\#*.*...\#*##.\..#...#.*.#\..#.*...\\*..#....... *...* ..... #.\*.*\...\. ..#.*\.#
# ......#**. .***. \..  ##.  .#.*# *. #...#.#..\.\.....\*. \*..# .*.\\L #.\ ..\...*\   #.*...*#*. ##
#.*.\ #.* \*.#....... ...\.....# **\. .#.....#.#... **#..... ..*###\*.#..#.*\. .....** #\.#.*.* . .#
# *.*. \*.*\.#.*L#*\..\.. #...#.***..\*..*..\*.**#.*#....*.*. #..L...\..\#.*\.*.. ...#.#.... #.*.. #
#*#...... *... . .. .... ..#... ..###\.* ......\.*.** \ .#. .#...#.##\# ..L ..#...*.**.# #..*.#.\.*#
###\... #...### **..\. **# .L..\.# ..#\..#..#. .. .#.*.*...#..* .**....*##..#.\..# #..##*.*.# ...**#
##......#\\. .*.###* ##...*#* \..\.  . .....*..#*..*..#...**...##\. ...*. .......\..#.#.  \. ..  .##
#*#.*\..# ....# ...* .....*#. ..\.# .*#......* ...#.#.#.#....**.#L.*.*.##**.# .#..#.\.*.. .#.# ....#
#**# ...*# ##..*. ..#*..*...\..# # *..... .#.#..* ...#.L. .. #.\ ..*.*##. ##. .\...* #..*.*\\. .  .#
# L.**.*\.\...#.* #\.#*..*\....#..**.##.#\ ..\#*...*.. .*...#*\*..*....\.... .#.....\##....##.# ..*#
#.  ***....\#...#.\..##. . *..*###.......*.*. .......*.*..\*..#. . .  . #. *\*.* .. .........##....#
####################################################################################################