####################################################################################################
#. ..##.*.#..*\.  .# ......... ...*.##   . \...... .\...#...........*..*. .*.#*...#...  .. * ...  *#
# ..* ... . ..* .*  ..\..  ..# ....#* ..# .\.. ... ...#*... ##.. .\\..  .......*..\. .#. .. *..# ..#
# #.. **. *\.. \. ....... ..  *. \ ..*#....#.. *.**. *#.*\...* ..#.....* ... .*..... ..*. .....* ..#
#. .\....#......#.....  ....*  .*#..*...#\.#.. ..... .. .  . \#...\*#.*. .#..*.... *...... \#*...#.#
#..*.#\ .*#.. ..#.#.##**.. ..*.... . ..\.#...*.#. . #*\ *... ....#.. .#\.  ***........ ..* . ....*.#
## .*.#.... ..*.. # .. * ...\   *.**\....#..# \*.....  ... . ...*...\.#...*#...#\...#... . ... *..\#
#. . ......\..#.*..#.... . .* . \..*.# #.#.# ..*.#.. .#..#...#..     .#.#.\..#..##. .*.......#.##.##
#. .. .*#.. .* . . ..*.... # .*\...#.......\ .... .  .. #..*.*\..*. . *.\##. . . ...#.  *\.#...#.\.#
#..*...... .*. * ..   . .**.*#..# ..#**#*... ...#*........... .#.. \*.*.. .* ..*. *#..*.#.*.*.. . *#
#.* \.# .  #.* .  .. .*..*..*........# #.. .. *** *... ..*..#...# .... .\ . \#.\#.*.. #.* *#.... ..#
#.......# ....# ..\*.. *. .. . ..#*...*# \...# .*..... #  .#* .. ...#* .....\\..*...  .## .\. .   ##
#. .*..#* .....*. *\  ...# ...#..*.** *..#... .   *... .. .# .....*#.# *  ...........  *#..\ .. .*.#
#.#....*..*. ##..*..#.. .*.#.... .#...\.# ..... ...**.#... ....\.**..*...#. #.. ... . . .\.... .*..#
# ..*.#. # #....*.. .\..# #..... ......#......... #..... #.*. ..#*. . .  ...#.#. . #** .. .. .#... #
#... ..#*# . \. . .*. . .* ..... #\. .  \#\...** ..#*.#*.. \..*....*...*\... .\.*......*. .\#.. *.\#
#\...*.  .. \ \\.....*.........* .. # . ... .  *\.#. ..   *.#.#. # ...# . ....*... #..  ... ..#  ..#
# .....#.. .. ..# .* ... .\..*....\ ....   .....#*. ## .\##.*...* ..##*.*..*.#... *..* ..#.#.. ....#
##.....*.\..#.#. ...... ...*.. . ....* ... .\...\..*....* ..##..*## # ....\......... #....... ..  *#
# \#...... *.*  *.. ..#.*.....* .#...*.. ..#. ..#...*..  . \  ...\#* ....#*\.#\. .\#.  #..\.\... ..#
##*... *  **...*#. ..#.###..... .  .\..... ........*###... ##...*.\..\..#.** *#..\..*#........ .*.\#
#...\ .........#.\.\.*  * ........ .. ...#... . .....*.**..  .....# **  #.. .  ......#...#...  ...##
#.#* .##.*\.. ..**..#....# ....\...#. *\...#*\*.. ......* . #..*.. . .#*.. ....#..\. .*.*....* ..**#
#*.. \.\. ..#  * .#  *.  ....*.*. #. \...   . . *  ##..## ... .## \  #...  .#...#  \. ..\ ##..#....#
### ..** ..*.. .\... ..   ..*..#* ..*.* .#  .\* *.#. .*... **  *........** . .#*..#. .##. ....* *.*#
# ..... .*\ .    .. ......  ..#\#....\. \#*.\. #...\*........#.#...* .#....#. ....... . # * ..\.  .#
##\.#. ........*..\*.........  ...#..*..#.#\\ .*..##..\.*... . .\ .... . ..#.....#.. \   .... .#...#
#\#..  *...  #. ..#.#.. ..........*....  *.#*. .. #.....\. .... .#.. .. .  ..... \ .#.........#. ..#
#**.# \. **. # ....#.##*#\ *#...*...#.#..  *#\ #. . .. ...\\...# . * .   ...... .#\ .*..**.#...*  .#
#*.#..## ...   ..* ...\ * .*... ...**.\#**...#.. #.... . ........... #....*#....*\...*#\. * .  .* .#
L. ...... ... ***.**..#. . .* ..\.. .. . *.\..* \.....*... ..\.. ..#.. \ *..\ .* \*. .*# .. ..#.#..#
#  * .....*. .#* .....*. *..*#.#...#.**\\*.\. #.*..*.....#\.*. *..\.#*..# . .  ....# ....\**\.\  *.#
#.......# .\....\ .  ..#.*... .. #.... ..\....## #   * ..*.#....*.*.* ..*..*#.. ..* *. ... ..... \ #
#\.. ##.*.....\*.** .#.\...\.#..\........#\##.#. \.\#.\#..# \.. .* .   .# .#*..#. ........#.. ...###
#\...... .*#. .. ##...  ...#...\. .*...  #.....#  . *....\ .... ..*#.......... .....#.# \ .. *#. .##
#. **..*#.....\....\.\ ........**\.*....##... ..# .\*. .... #.....*...... *\...#.*.....\\.....\#.#.#
#. *  #. . .#** ....#*.*.. # .# .......*.# .#*#* #.   ..#. #. \ ..\*.. *.....* ** . .....#....*. * #
#...... *..... .... .\.... .. .#. ....... .*... ....\..#.. .* .#.* .*.* **..*.  .*......#..* .## #*#
#..*\#**. *\.. ...#... .. ...#.#*.#...\...*## ..*..... ... . \ .\.#*..#... #.......### #...# ...# *#
#.\#.#\.#.  *.#* #....#   ...*#.. ... .*.#......**..... \*. . ..*....**.... #...#.\...  .......  #.#
#. .....\#..#......#..#.\  . #..  #...*......##  ...*.  *.**.*..#* #....*...*#.. . \\... * ..  .#..#
#..#. .. ..#...*. .#.\...\*  \# \ .. ....* . ***#.\.. . ..#. . *\*# .\*.. ..* *...... .*.##... ...*#
##. .......#..#.\.*... ...... .\...*. ***.......#.. ... #...\.. ..**.*#.  .*  ..   .\.* #.#..#\ ..*#
#......... # *# #...#. .. *......#... ....*. .*.*. #  ...*  ...#* .#. #.   #*. . .\#*.....  . *#*. #
#. #.\.#\*..*....##...*...#... #\.#* . ...*...\..*..* .#..#.. . .. *.*.*... .. \  *.. .. .  ...# #*#
#..** ..**.**#.\*..*.. .\.#*... * #\. ..# # \..*..\ ..*.*....* ..#....... .#.. ..  *.. ..#....#. ..#
#..**#. ...  \  .\*...#*#.....\ *....##.\...*###.#... .......  .#. ...#**. #.#.. .. **.... . ... # #
#\... \ .   ......#.\...*... # ..#........ ...* ...#..... ....#...*#. *#.\#.   .*....... * ##.#. ..#
# .......#...# # ..# ...#...*#..#.*\.. ...###......*# .*..... \.... #..... ..#...  # # ..#  .*.*...#
#.... *.....  ..#....# .#*.\ . *. .. . .*  ....#..*..\.\  ... .....\ *#.*.\.#**... ..#.. #\#. *..#.#
#.... .  #.*....#.*..\**#........... ..  #.\....\.*..\......#. .*#.*... *.. #..... ... .*... . #...#
#.....  .... ...#.. *#..**.......\..#...........*.   .. ........\.#.. . ..#... \..  ... .#.#\ *.. ##
#... ...*#*.# ..##*..* ....##. .\**#.... ...#..  ..#\.\##..... ..#. ..#\. \\...  #\... #.\.\.\*.. .#
#.**.....#..*..\. #.. .#.. \*.... .*#.\. .....#.#.#. \#  ..* \#.*.....#\.......#..\.\.. #....\ .##.#
#.* ... . #*...*\..#....*\..\......*. .*#.*#.  ...*.#...*.  ..*#.. .#.... *.*.*. .......*. *\.. .#.#
#..... ##...\.... # ..  .. . . .#..  *.*. .....#  .. #*.#........  ..#. ... .. *....   . #. ...** .#
#. ..#..# .#.#. .....*.*....#.#. #. *...\ .#.* .. #*.. .. .  ..*..\...* * *. .. .*.**\.. ... #...###
#.\  .  *.. .\*..#.*....#..#.....\..#.* ##. .*.....**.\.. ..*##..\.\* .... .... .*#. .\..\  ...  .##
#*...**.. .*##.* .......*..\.#.#.# ..  .#**.. ..#.#.\.. .*... .  .\#.. .. ..# #...\...... #  . .. .#
#.#.........#.  ...\...\. .\...\..    .#*.#.\\.\. ....  #. #*..#\... .  .#*. # ..#.. ..* .#.*\#...*#
#.. . #*.*............. . #..#.* ..#. ...  ..**...\.. ..\.*.....*\*.\...*..#..  #\* .  *....#.\.***#
#.#.* . ..*...\ . \. *.*.. . .#\. ..#  * ...*.#.\ ... .*# . ..#..#...#.... .#...... .  ....... . ..#
#...\ #.. ......*....#  ....#.\... . .  . ... * * ...... ..  ..*... *\ .#**.\.. .. #..... .... ##..#
#...#.# . .*.. .... . ..\#*...#...*.*... ..#  #..... \ ....#.  ... .*.  ... *  .*.#....  #.... . .*#
#\. .....#\#...*..#.*#...#. #.  .. ..#..#.#. .....\.....  ..*** *..... .. ........\\ .. .. *  . ...#
# #\ #.#..... . \..  ....*#.#. .. .. .##.....    .*.. .. .....*.. \.\.  #..** ..# .*#..\.   ...#.  #
#*..*... ..\\. .#.   * ...... ..#..#....*#.\.#...\.# *#..#*....#..\. .. *\..\#...##. \.. ....... . #
#.*...*.#.. .... .* ..*..... .#.....*. ..  . .# .  \ \ \.....  . . ......**. \... \.#.*. .. ...*..*#
#...... .\*.*#.*. . #.. ..... *....   #.........#. .#*.#.* .**. * ....\ .\.. .  .* ..#. .    * . ..#
##.....#.. . .. . .#..*.#*....#. ......#.#\#...#......* #...... ..#..\..#..  . #  ..*. . \* .  ....#
#........*\.. .*..# .#\ ..* . .*.\# .#. ... ...#... .#.. \*..... . ..#..*.*.. . ...*..*.#.. ....*..#
#.#.........*.*# ... ... ...  *   ....\* ....*.#...*\.#*.*#\ #...* ##.##*#.  .\...#.....    \..#  .#
#...  ....*#.. \.... ..... . ##.....#... # .#.#.. \ ...* .... *. ..   . *......#.*.#.#....*.#.*.\*.#
#...  \#*\.*.#..   ..# .... ....#\.*....... ...#..*\  .. ...\... .*.....#.. * #. ... . *.... .# # *#
#.#...#.*\.... ......##..#\.... .#...   ..##.# ......*..  * ..  .#.... ..#. . ..*..*..#\.  \.\....*#
#.  .\. ...#.*.#.*.#.....   .. *.##\*#... #.\..*...#*....**. . . ..*.. *#.... ..  * .... .\. .*....#
#.. *...*. *...\..  *#...... .. . ..#... *....#*.. \.....\****.#.. . ... *..# .......    ....  .\..#
# *.#\.#.# . . ..* .. ....... \....... #* \.*..\.# .... . .**.....\ .... **. ...##.** \...**..*# #.#
#* .##...*. .. .**.#.*......  *. . .#....#.#*\.#..\ .\\  #.... ..#....* .*\. . .*.  ..*# \.....*..##
# . ....\...# . #* ...**#. ....*##.. ... ..*.## .*...#.\. ......   .#.. #.  .*... .  *......  . ..*#
#..*..... #.. ..#..*\#...*....#...#.. .\..  ... \...*# \\.......... .. .# .# . .. .......* ...   #.#
#  .*..  ....* .*...#...* ...   ...#.......... #. .**. .....#..#*.... . *.\\... #.##.*.*.#.. #.  . #
#.**. * ...... ....\.# ..* #. ...#*.  #\.*..#  *...*#... \..*.\. *.*...*.*..... .... ***...\.....#*#
# #...# ..\...... #....*\# #....#... \.#*..*#.\. ....*..\*  .#.*  \ .#*. .\...#. .*...*..#.   ..#..#
##......\....*\   \ .\.\# *....#..*.  ........*...  * . . * #. . ## .* ...*..\....* .#...*\. ...*..#
#.#...##*.# *..*\..*.#..#.#*    \...*...##.#   #...#.. .*.##....#.....#..# .#.....  \ # . ..* . \..#
#. .#....*. *  ... . .#..*.........* #. ....# *.......*.. ...*# . #\..... \\. ... ...*.. .**. .*\ ##
#...*.\..** ....#..#...*##.#.. ..... .#... ... .*.#....*........**....  ......##.*.  ......#.... .##
#*. #.*...#*..** **\.. * .#...   #  .....#*. .\... ..#*....  .. \#.#  ...  *...... \ .. ...**.* ...#
#. .   #.....*.#.#... .*#...#*  .... ...*....##....\*.\..... .\..* ...\*.#.#\.#. R ... .. .. *.. .##
#*     . .... ...\..##*. .  .##.# \ .. *..\##\*#........ \*\*#...*..\ . *..*#...... .  . . ...*... #
# .... .. ..#.*..#* \.....##.   ..*#*\..... .* # #..#.*....\.#..#..... .*.   #..\.. *.#..* \.# . ..#
#... *.... # #.#..## .*.*..\. . ...   ..#.....*. ....\  ##...#..##*. ..#..#..\#.*.#..*.. .#..#\#...#
##. ..#. .*. . ....#.* . **.. ..\. .\. ..*..# .#......*.#.#.... .*.  .#..* ...  ...* ..##. ..    .*#
#*#.. . .  .. *.# .\.. .  .. ..*.* \.\... ....*....#..  ...**...... .......\# ...........  #..#. ..#
#..*... .#.....#* \#  .*#.. ..\. .*. . .. #...  .*.\. . ..*........*.. #.\ *#.... .. *........ . ..#
#...#.#* *..##.   . . ...#  ...#.\..*..\*# .* ....*\#*..*... *.# . .  .# .  #*\#.*.# #......  .....#
#..#.#..# \ ....#. \  ...........\.  . ...\*.*. .*..\.. ..........*..*#.#  *.#* ..*..\ ....  \...  #
#.....#.##....*........  .##. ..* # \...  .**.*.. .....*... ..*. ... #.#.*...*..***... ..*#.\...#..#
####################################################################################################