####################################################################################################
#*# \#\..\. ..#\.*.  #*.*#.. .  #. .*#... # .*# .#. .\. \...###.#. .............*#... .......*. .. #
#*....\#\* .. ..   ..... .* #.#.*.*.   ..#*  ..... #  #....... ..  .#..  ..\.\*..\ ..... ...*.  #..#
#.... .. ..  ...#.\......*... * .....#  .\...... .... *  \ .\ .. ...\. . .  *##. . *.\. ....*\..  .#
# *.*.. ....* ....  .*...\#*.# .. #..........#...# .#.#...*....  .. * \.#.....*.. #. \.*. ##.*... .#
## ...*. \.. * .. ..# .\. .......*\ .*#....... .. #.#..\.. .\...\..* # ..#..    *  ..\. ...#..#.##\#
#.#.  .#..\.....##..... ....#\...   .#. .*\...... #\\ .. \.* ...#. #... .#\. .. *.#*.... ... ...#..#
#.*.#. * #.#.....\* ...*.\ *.*...* \..#\.* . #.. ...*\#.*#.....\#.#..##..... ......*..... # .# . ..#
#  ... . . *...*...#..**. .. \*.*..\..*.#.  .\*.#.  ... . .... *.*\*.\. #.\. ....\*# ..\...#\\.#. ##
#\..*. *.*.##*#... ...\ .......\....  .. ........... ..  *.#.. .*  .* ..#.# \.#.#.......  ...#. *..#
# ....  ...\... .#\..#*......#.#.*... #......\#***.*#....   ##.. . . .....*#  \ . #.*... .*. #.....#
#. .#..*. .. .#\.#. #.*... .  ..* #.  ...#.. *\ ... *  ..\ .  #.. ....#. . .*..#.  .**.# \##...\. *#
#.\... #*..  .. ..**...#. ..#*   ........# ...#..  ***##*...#. ......\  #.*..*..#* ...   \ .. .. *##
#... *.  .....**.#.*. ..........#.\#.*#* .*. . *..  ....... ...*.... .. ....*.\\ *#\...  **..   .*.#
#....  .. \ ..# .##  ......  . ....*..* .##..    .** .....*... #\ #....\\#   \. ..*.#\.#  .#  .\*.\#
#  .#*  #.##..#. ... ** ....##. ...... *R. .. ......**#....  ..\#............#  ........#.  ..#.. *#
#. .... \* .#.. ..*. ..\   ...#.... \*.. ..##.   .\..\... ........** .*.. ..\...#*\ .... ...*.\ *..#
#. #**.  .##.*.#. # \#....#.. *....#. ..\## ..#.\.* *... *.*...# ..*....#. #..  ...\*..... *.. ..  #
###.. ...... .. ..\#. ...#\#  *..  .\ .*.\..*.. .*..#*\..#.\..*....#.* .# .#  .*..\. *........**..##
## . .....  .....*#.#. *..*.*...* ..  ...#....#.  *.* . .....*. . ......##\.  # # \\\..*\. ..  .. .#
#... *.. .* ..* .. . **... ..... * #.#\#.* . \...**. ..**.#.#.* ..... ..*#.*...#........\ . *#..*.\#
# ..*.  \....\.. #.* .. *..... # *.#  ...*.#..# ..*..#*...... *#. \.... ... *...*  . ..#....\.*... #
# .......*..*###............. .\....  *...*. #..# \  * ....  ..**  #.# .. *...*.\.. ... .***...# . #
#..\...#...  #*.. *#... #..*.....#*.\...#...  ..\ .. ...#...* ..#. **.# ..*. ..## ... \*#.. .#*.#.##
#. ....* .\#.. \#  *. .*. \ *. \  .......\*#  #..*..*.. .. .  . ..\. .* *#. . .*.....#... * # . *. #
# ......... .*..*...*##.#  ...*...\#.\... #.* ##.....#.. .   *.  .*.  .. #..\\#... .\  .\*.# . *...#
##.. \.\ #  \*.*..#*. .. .*#  .  .  \..... ....*.*.\ ..* #...*... ##.*  .. .**   .. .#...# ..  #...#
#. ... ...*....#. .. * ... . # .#...# ...*#\.. .....# .. ... .*. . ..... \. #*# .\*. . ...# .#*.  *#
# .#.*  .\*.. .#.### \....*..*#.  #\.....*.....   . .#.  . #  . .. ...*. \. \ .\...* .... \  . ...*#
#\.*...# ...#.#.... .*.....*  . ....* .. ..\.*... ...... ......  *..*.#.*#..#.....*... . .#....#*..#
#. .* *.#......  .#...\...*  .. . #.......# .....##.. .* .\... *#...#..#. *..*.*# .#\\....#*.\ ....#
#.\##..*.#... .\\..#.. ..   .#....*.*#*... ...*...*   *..\ *... ...#. .* ....*.. .*..*#...*  \ #.\*#
#..  \... \ .....*... . #....\.*.*. .*.*   ...#..# .. ..# *.#....... .* .. *..#  ......\ .. \.*.#..#
#. \ *....   .... #. *.*#....#..   .**.*.*\.....# ... ....*. .*#.##.*..#....#.* ....#.#.\.... . . .#
#.#..#..*.\..   ..* \#\..... ....\.... . .*..* ......# .  ##.*.*..\..  ###* #  \. *.....# ...\*..#*#
##. ..*\ *..... .*  .... #.**.. ..#.# .#....*#....*.... . ..*...*. .. .....  #\.. ...#. * .  .#..#\#
#. #\ .#..*..* . #*..# *  ..  .\*  .  . ..#.\..#...*..... .# ..* \ . **##\... ...#. . .# . ...# **.#
#.... .\...#  . .. ...*##*.  ..  #. .*.*. .#\ # . \*.....*.\....  .. .... #.  #...* ....\. ........#
#.# . \#.. .#.*...#..  .....# \*... .. ..#...  ..... *...... *#.#. ..#. .\.... . .. \ ..*...*.. .* #
#......###*#*.* ...  . ......#...#.......... .*.\\....  .....*....##* ..\# *.*......   ..*.   ...*.#
#....#.#*. ...   *.. #.. ..#\.  ..*... .* ..#.*. .. #.. .  \ \#.\.#\ #.. *..  \ #*... . ..  .*\....#
#. \*. **.....\.*.# ...#\.  .... ...#.#.*..*....#.\**.* *.*..#*#** .*#.\. ......#\**...\*..  ...  .#
#..**...... # \....*. ....*.. ..  ...... ..   # ..#.*..#. * ...##.....#\ ....#*.# .#..##....  ##. .L
#...\#...* ...* .   .#.*  #.....*.... .. .  \.#...*.. . ..*.* *.#.*\*. *.*...\...  ...##.\*.......*#
#  .. *. ... .  . ...... . \ ... .*..*.*.\#.\..........  .   .#*  #** #.. .....#....#.\... .... *..#
#. *. . . ..#. *\.. .. *..  *#...\#... .\\......*.\  . ..* ..#.#.. .## .#.. *. *.... .... . ... \  #
#.. \ #.. .. ..# #... ... \..# *. \#. ** .. # ....*.... ...* .... . .... ## \....*\.......#.... ...#
##... ....... . ..* .  #.. ... *.... \.... .*..# #.. .\ .   .... ..  **#\#.**...*.  . ..\\.... #...#
# **\ . * #*.# ..#.  .\#.. .... #.\...# . .  ..*.#.. ..#.*.#. .#. ..*..* #  #.... ........*..#. ..*#
#  * ....\...*#.*. #..*... #. ..*.#.*#....*## ... *\.\**#.#  #...#..##...\ .* .##..*#. #.*.#\  ..  #
#....# . ...#..#....\... \\.. *..*.** * . ..*. .#...  ... .......  . # .#..\* *\ ..* ..***#. *.#***#
#..*.. .....*\..*. . .*#.#...***.... ..#  . #. *.... #.  # .  ..##\#...  ....\#.. ...**.**.\ \.....#
# ..\\....*#..*....*....\# .*.**.. *..\.. ..*#....#...#**  ....\ .\##..\. . *.#. ..\ ..*  *. .\#\. #
#. ... .....#. .....\\.  ..##*.#  ..    .*. ..* ..#.#.#... .#.*   .\....#.#\\... ...#...*#.*.......#
#..* .\.#..#. . ... .#.. ..*.  .....  ...#.   .\..## * ....... . ..*\.....#...* .#.#......#.**. ...#
## *\*.. ..#.*#.. ... ... ..#..*.*#....#*.. ....\........*...\.. ..*  .... .\ ....* .*. *....  .*#.#
#   #.. ... \...#\....#*. .*...* ........... .. . .. . . .# .# ... *.....* .#.....\. ..#...   .  . #
#..\ . * *  .#. ..... #...   #..#..#...... *.# #*. ......#  .....#....#.#.#....* * #....*... .#\.**#
#.....#\... ... ......#... .......*## .#\ #.##*. ......\..\*.....*#*.#.***.#...\. ..*..\. ##* #.\..#
#. #.....  *... # #  .. .. #  *..#. ..#*.# *... ........  ...# .\ .....#......#...#....*... .*...# #
##.*... #..#..\##\... #..#....#\ ......\ #**...#...*........#..   . . * . .*.# .......* *.*.. \.. *#
#....#.....# . \... .*....#. ......***.**.# \. .*..*..*\*.... .#.......*.#  .... ...*.\.**..... .*##
#.... ...... \.. \#.#. .. .....\.* . . ..#*.#   .\..#....#............*.  .\*.*\..\....   ... ..\..#
#.#.. ..#.. .#\  #  .#.##.\.#*. \.# #*..\. # ... ..\*....#. . . ##.   ..... ##*...**....*..*..#    #
#.. *. .\*......... #.*..\#... .....#...\*.. . \ #. *... # ..#.#*..  ...*... .............. ....\.##
#.   **.  . ...#. ..*..*.. ....# ** ..*... . . .\..#.\ .......*.\# ..*..\\. . \.#....... .# . .....#
#....\...*##.. ... \* ..* ...*.#.... ... ... .*....#..... #..  .....*\.*..*##. ....#..  ...... # #.#
#... ... **. . .**....* . .  ..#..**. ....  ... .*..*# ..   .**... .* . #*.##......... ...\ .\. .  #
#..#.*.. ....\. .#.. ..... .. \#. .........*# \#.. *\. ......*\. *# ...* ..  * . \#.....*.. . .. .*#
#*.  .#..\.........##...* #  **.#. \.\ \..#.. ..*.#.. #\\.  . .#*......  .**. . ........   ..... . #
# **..#.. .*..*  ..#.\ # ..\ ....#.*.\*. ..# . .#...# .\.*....*.  ...**....* #.. *#..#... ... *..*.#
#....#. ..... ..... .....*.. ..*.*..\. * ... . .\. *.....##*. . # .* *\.* \\##..\* . \.##..*...*#*.#
#. .#.#...*.#. \  .... **.\... .*.#\ .* .#. *.....   #....*.....\#. .... . ..#. # ...... . .  \*#..#
#.. .. *.*.....#.**.........\*#.*.. ....*.. .#....*.*.*..\ .# .#   . .. .  .....#*.  ..\#.. *..##. #
# . *\ .*...*\.* #*#.\.. ......#... . \ .  \.# .. *.#\.. *...*. . ...*...* .\* *.\.. #*..*.... *#..#
#\.*#... ....    .#.. \# . ... ..*. .. .. #...*.*.#.* . ...#..#. #...#.......   ...... .\.* .......#
#. ......*. \\*. *... .\   * #\...*..##.. .  # ... ...  ..  .#..... .*..\# #*.#*#*..  *.#.......\ .#
#.. #*. ... ... .  *\...*..\.#....... ...*.#... ...*.... *.##........\#..... #.#....*. # .#. ..* #.#
#..#..*#*\ \...*. ..........#.. * # .. .\......  #*** ....*\  \. .* .** .\. . .*....*..#.....##...*#
#...\..\ . .....#..... ... . ..*.*. #*....# #....**...# ... ... *.. *. ..*..*.*. . #*.  . .#... ..*#
#. *.* #.##. ..*\\\ . .*....*.#*...#... ....*..... . . ........\. .* #. #. * ..\  .#...#\** . ..#. #
#..  . .*...** ... .... **.#.*  . * .. ..\*... *\\...\#*..... ..*..\....**...*..##.\.##  ..#.#....##
##..... * .##...#  ..*... .. ....#...# # ....*......# .  . .   #*.#\..# *... .#.*. *....\ .#..*.*.##
# .\..... .* .........*\.. . ......#.#.... .....#.. #.*....*.......\..#.. .\.#*\..#.\.##. *.....#\.#
##* \* *.# ........... \* .....#. \..  ... .. ........#.*.... ... #\. ....*..* #*. .#. * ....#.\..\#
#...*.#\*.. ..**...#.....\*.#. ...*.*#.* .....  ... *.#*#.##.... ..** .*\..... .. .  * ...\**... ..#
# ... ..#...*\...#*.... .. \.#.\ ... *...*..*.  .#... . .\*.....\ .* **..... .. * *......** #..\. *#
#* ......#\\.*.  .\\.#.*.. ..*...#  .....  * # \..# * \.#.. #...*... .......# . ...# #. .. ...... .#
#...  *.. .....\.  ..   .....\* ....\.  \..\.....*#.*.. *..\.. \..* . ..#... ...*.#. ** .## #..#.* #
#.#. *.\.*\#\..... .# ....#.. ..*..*. .# *# #  \.# .\# #. .. .\.# *.#  .  .#..#......#.   #.*\ ..#.#
#.**.#.# *\*..\..* # # *\\.#.  .**. . \.... .\. .*  . ..#...**. ..\\...##.*...* . .  ...#* . .#.  .#
#*#..#..*#\*.\. ...... .#\. * ..**...**. * .  .#.#.* ...*..#.  .* #......#..\.* .........    #.... #
#...# ..*.. .. ...** \ .*#.*. ..... ##\  .\##..*  . #\.... *# . .* .##.. *  .\ . ..#..   \#*. .  * #
#.....#\ ...*.#  .*.. #.  . ...**  *... # .....* ...... ...... ...*..# ..... #.*#.*\\#.\. *......#.#
# *.   . ..*\...#....#. ......\#...# .# .#. .#. ....*... #.\... ... #* ...  .\..*... *#*.#. \ . ...#
#. ##....**.*.*.# #...#\\*#**... .... .. #...#.#. . ..  ..# ..\  .. . . #..*.........#*. # #.*.... #
# ...#. .# ....*..#... .. .... .#..*..*. . . **........  . ...\.. **#.. . .... * .**...\ * ...*...##
#..*....#. ..#* .*#...\#.\.........#.... *...*..   ...*.  \.. .. .....*...  ....  .*....\ ...\ .#*\#
#....#.. ..  ..#..... .#..**.\#.*. ... ....*...\. ......#..*# ...#......#.##.#...#\. . \. ..# .*. *#
####################################################################################################