####################################################################################################
#....*#\....   ..* * ..** .#......   #. ..  .#..##.*.\.....*.#\....#...*.. ....#.*..\## ... . .**.*#
#.. \..  .*. **..*## .* ..#.\#.*...  ...*..... *. .*....*.#.....#.\#..#. ..\......#.. ...#* ..\. ..#
#  ..... . .**.# .*.....**.#.  *....# . .... .\ .# .#*.. ....*\ .*.*. ....*.\. ..#  .....    *.\.  #
#..........*.# * ....\ . *.#..**.#\#.  ...## ... .. ...  *... . .*. #.*\*. ...\.*...#. ## .#...*. .#
#.##.** .. . #..*.*. #..*. ...*..  ..# #*.#..#*..**..*. ....*.....\. .#\#..*.**.. ...**.##*\#.....\#
# .*.. ..#. .* .#...#*.*  .*..  * ... #.*.#.    .....*... .*.....#....#...#*...... ..\ . ...    #..#
## .......#.*#....*\.. .... .  .. ..*.#  #..... #..* .  *#....*.*   ..* .*  # \.... \...  ##..*#...#
#..*. .. .#.#. ..#.#.#.*#*.. ..#..#. *. . # #  #*#. .....\.. .*.\#* ..##. \....\\#..#. ...  .\  *.##
#.\...\. #.... .# . .   #\*........* ....\ ..  . #\**.... .. .. ..... .*.#........... .#.*.#... #..#
#.. .*.*.. ..*..#..  #.. #......  ..*.* ## ..*..... #..  *\.# #.\*.... .  .*... ..\...# * .. ......#
##.*...#*.*# .*.##.# #. \*#.#..\.\ .  ...*** ..    #    .*.#.. . ..  .*. ...*... .#*...#.\ ...  *#.#
#..*## *. .*........#...*..  ...#.##......\ .....*. . \. .*\...#\. #.**.  \ . .. ..\..*..#..\.  *#.#
#*#......\ .. . *...#..# .#..*...#  .....#.....*..#.*..\.#. *\..... ..* ....#.#.*.  ... ...\.#....\#
#.  ....*.....*...#.\ ....\..#  .. ...\.\.*...*# ***  ... \......*..  .*. .#...   * ..#. .*. .. # .#
#... * *. \.# . ..\ ....#... ....#* ..\.\....***. .. . .. .... ....\..# ..#. .*.\...*#..##*...#.  .#
#..... .... \   ...#... .. ..... . .. ..\..  .... .*#.... #.#.. . . . ..*\.. ..*..#. ..  #....\.** #
#*..  ...\..*\ .#..#. *... ..#.. .. .* #... . *...... \  #..... * *.. \....*.  .*.##\. ..# *... . \#
#*.#.# # ....*.*.. \......*.. ............\.# *.... ..#...*..# ..#.. .....\..*.....  \ ..*.. ...* .#
#  ..* .*....#...... .....*.**\.\. ...   . ..*#*#. ..#..#. \\. \  .\ \.  .*\.......\... ... ..  ...#
#\..... ........#..*\.# .  ...*.#.#. .. \.* .. ..*.*... ....\* *.\.........#. \ .. .*. .  #. \....*#
#.... ....#...*..*#..#.....#**............. .. .. #.  .. ..\...# * .*.#.... .... #..  ..#.*... .\..#
#.#. . ..#..#.. ...*#..\.. ..*.\..... .....   ...#..#.\ .*.#. #..\. # . .. #\. .. ....**. . ..#.   #
##...* . . .#*.*#..*#.. \# .....*.. #.#.*.*...# ...#.*#.\#. \#*##.*.....\......\..  .#  .*.........#
#.. .*.. \.#.....    # ....*....*....* .\*#. #... .*.....#*.#\. *#*.##..........**..# *. *.\..* . .#
#***#..* .#.#. .#...\... ..........*..#.*.  . ..###... *## .# #.*..  .#  *.\\*#...## . .\.# ...\.*.#
#...*.*.* #.. ..#.# .............\...###..* .*..*#\.... .. .....\..# . ..#....\ .\* .#.  .\...*  . #
#..* ....*.  #  *.. . #......**.. ..* *. . .....#.....*#. .*#..*.*...## .    . ..##.\ . .*. \## .\*#
#.....#.. .. .#.#\* ..* *....# * . #...... #**.# . ..*  .... ........  .. ... ....... ....* ... ...#
#.... * *.#. #...*...#...\.......# . **...\.... #.* ... *...... ..*..  .\ ...**. *.#. ..#......##*.#
## # *. #.. .*.  ...* . . .. .#.\ ...*.*....... ..*. ##.*# \.\.. \* * * *..#..*  .......* #...# . *#
#...#*...  .. ..#.* . #**. .   #. .. .... .. *..\.*\...**** *.*........##..#........# .... .. .....#
#. ... .#. .\\..# #\ \.  . #.#.#.*...  .....* *.\  ...***.   #* ..  *..*  .  . .... .. \*... *#....#
# . . ....\\ ....  .  . \.....*. .....\#\* *#**... ..\#.**.\ .  ..#*** *    . ... .*.\ ** .  . ....#
#....#. . .....\#. . \...\.. .  \..\ ...\ ...\...#. ....   ...\ \ .\...*.  ... ... .## .#...  . . .#
#.*.... #..\. ..\##*.**.#\\.. ##.*# . ...** #..#..*.\.\ #*.  ...*. #... .*. *#...\*#...#.... ...\###
#.*.. *.. ..*..  ..\..#. # ..\\.* *#... .*..... .#*\..\.. ..  .... . *...... ..*#*#.#....\#..##.. \#
#*#..........\#.... * . .....*#*.. .*.\ .. #.  . ...*.... ##. . ........   ... ...#.*.*.\ . #\.....#
#...\. # .. ...* \.##.. .*...*..# .*.......* .#*.#... .*. .  \##...\\ .... .##..#..... .. #..... #\#
#*.***\#\..*. .... *\....... .*#..  .. .#...# ..#\\\#.*... .#... \. .\.\.   ........*.* .. ... .# ##
# #.\...*....... ..#..*  ..\ . .\... .*....\. **....* ..  . \#.. ..\ ... .......\ .#.***... ..* * .#
#........ ..##..#..* .\# ...#..\  .. .  ...* #.  ... .*\..*\. . ..*R.\... . .#*## ....   *....*.#.##
# ..  #*#.#.#.\.  #*#.  \ .\..... ..*.\..  .. # .  \.\.. .\...... ...\.   . .. #*..## .#*#...#... .#
#..*...#...* ..#...*#. .. ...#*.......#*.##.#*#* \ ...  ... ...*#.#  .. *  ##.. \# #.......  .\#...#
# **.#.. ..*.*.#.....#.*. *...#* .*...... ...#.###.  .#   ......# ...##\....* ..*. #...* ..\..#. ..#
#\\#.. .... .\..*.. #...#. .... .... ..#.*  ..#....  ..#...*\...*... .... .*.*.###....#..  ..\.**.\#
# *# #. ###.. \.\...  .....#* .#  ......\..\...... ....#.. .    ..\.\. .....  .#..#......*.*.*#.. .#
#\. #.#* .... # # . .#.  ..*........#\.# .. ..\...*###...#...#..*..#.#**  # .. *   ....* ..*...* ..#
#..*# . ... ..*#\........\.#..\.\.# *.  *..\.##..** . #....# \ ..\.#.  ....* ...#. ...\.\.*.\..*####
# .  . ......*.#. ..\*  .*.* ..\.#\* ... \......***.   .# .. ...\#.*..  ...#. ....*.... ...#.#*....#
#...*...#*...   .* .. *.  .#..\#... ..#    .... . .... *\ ... *.# *..*...####*. .# ..#* .#.\.. *## #
#...#\..*..**.*. ....\**#. #. .  .. .*...\.*.*.**#...*.. *..*.... *.*#......*....*.#...*\..... .*  #
#...#....\*.*.#..... #.\.   .*...\.... ...\... ...  ....*......# .  *...*.. . *.**...... .... ..  .#
#....#. ..*. .. .*. .*##.\ ......*.# .. .\\.*  #.*...  .*.\..*.* ...\..*.. ##.* *\ . .*......\#....#
# #. \*..*\. .. .. ..... \# .##... .## .. *....*... #.\.*.  . .* ......##...*......\.....*..  .....#
#.#... .. * ... ...   ** .\. ...  .*   *#. .. .   ...*#\ ... .#.. \ #.. . ...# ..... \........ .\*.#
#...  *#*#....#.....*..*#*.. ..#.\.......**.... ...*#...... ....\\. ... ....\.......*\ #. #.\##. ..#
# . .*   \..#.....#. ...*.. .. .* #.**... .*.\.. .*....**\. . .... *. .\ .... .. ... ..\.  # ......#
# . ..\....#....#.#.. .*..* .. ..\..*......#........ .\....\..\# ...#  *.*. .. * . ...*.\.#...\* \*#
#.#.. ***..\. . .. .. .....\\.... ....# .#.*... . #. *. *.... ... ..  #.. *.\* *.. #. .#.. .#...#*.#
#..#... .. ....\..**  #  ... ...*    . ..... .. . . ....\ \ ....*.#   ** ..*..... .#...#.*..  .....#
# ..##\..  .#  ..\#....#. *#. #..##.. ....#  ....#.  *.   ...#*    ......*.#.. \..*.##   ..\.. #...#
#  . ** .**.....#...#...*\ .#*...  .... .# *# \#.#.#.....*# * . ...\.#.\ \.. ..#*..#.. .....*.*. .##
#  .  # .. *.#...#.  ....*.\...##.##..* . ...... . #...#..... #. ..#..* *  # .\. .   #. .\.*.. .*#*#
#  ** ........ * . ........ * #.#.# \.  ... ..#...#....\.*#...\# ..*.....*..\.#\*..*#..*....# .....#
# ..  .*.\ #\ .** * ..........*#....* #... ..#*...##.*  ...........*#\..*..  *.... ..  .#....*\ \ .#
#*# .#*...  ..#*#.**..  ...*..*#....* . ..##.# .##.... .. *..#.  \.. .\.*  #*.. ##.  #. ...## ..#. #
##.#.   ...........  .... .*# ..*.* *....\...... *.... ..**.#* \#..#.. ..# . .    ...  *\*. #\##...#
#. #...... ..#.\ .#....*.. \..*.#.......*.  ..#\.*. ..   . .  . .. .#..*...#\... . .\ .#...........#
## ..  *.......  ... . .\.. \ .#. ....... # .*.*.\. ...# .*.#   ...##  ... .#  # * .   *..*. . .  .#
# . .. .*..... ***... ...... ..... \ . ....*..*..\*#. ...#..#.* .  #* ..\.... .\ .  #.\\  *....#*  #
# ..\...\\..*#... .....* .#\...\...#.\ .. #... ..... ... ... ... .  ...*#. \\ ..\....# ......**.##.#
#*....#. ......\..\## **......#* .. .  \...#.....#*.. ...*..##.  .#.#...... ....*.# ... .##. . ... #
#\..\. * *.\...... ...  ..#.  .....  **... .#. ....... #. *# .....#..  .... .#.. .. .....*. . \.#.\#
#..*#... .....  . ..\.....#...#...... \.#\.....#....... * ....*# ..* .**#....**.....# ........  .. #
# *.  *..#. .*.#.* *.*...\#...#........*.#..#.. *#..\.*\* ..*....\..# .\ . .   .#  ...* ....\.....\#
#....\..#\.  # #**.. ..\\ ...   . . ..\.  \. * ..... .....   .#...*.#.#*... ....#\#.....*...*... ..#
#.... .\..# .... .#.. ...... .#  .. ..* . .*..*.....#.#*. . . ..  *.#.**\. ... * #... \....*..... .#
#***... * .*...\\. .*..\.  .\... *##\.*#. .. .*   .... #..  .*....#....*.  .# .... *.. ...**.... ..#
#.#  #. ..\... . # # .  .#\. . ..  .*.  .#. ..\#.... ...#*..#  . .\.. .\.. .#. .  \.##.# ....*.... #
#.#.....#.#.* .*...#  ... *... .... ....*#*.#.. .#*.   ... *.* .....#.  ....*\......... ... \. ..* #
#...  ..*..... #..# . . #**. ..\.  .. . . .... .*#*...#.*...  ..##......##.# ....... \ ....#.. .\ .#
#*.*......\#.*...\... # ..# . ...#.#.* . ......*. .. ......#..# ..#..\ .*.\.**..... *.  . ## #.\.\*#
#...... . ..... ....#.. *...... ..    .*.#.\# .#. * . ..##........#..#... ......#*...\*... # *.. .##
#. .. *..\..*..# ..  . \...  . .. ..#*... .*.. #. *... *.. ..*..\...... .. . \#... ....*...#* #. ..#
#..\.. #**..\.*  .  .#.... . *# . ....*\.  #*##...#*...*...\*.\ ....*.  *...#*..  .. .#.# #  ..#.\.#
# *#. \..  .**.  *... .....  *. ....\ #.# .*.. .\..# #   ...# **...  .  \* \.   .* .# ..... ......##
#*...*..*.\ #....  *..###*...* .**.. # .* .*\#\...* .#.....#.....\.. .. *#...#. .\*...\# #\..* *#..#
#.... #\.  ......#.#... #*..*.*.*..\..#.... .. ..\ .*.#.*. ....# .. ..#..#  *. . ..#.... ...* .....#
#.#.#*. ** . . ..*. \.*.\.#*... #. ...#.#..#......  ......#*.....  #..*.#..*# \. .  .. .  #  ..\.# #
# * .\.# ..#. ....#.. **.. . ..##.. .*...  . . #.   ..#. .  .... ..*. .....  ..\.. . .. ..... .*...#
#\. . ...*#.. ..*.*.*#..\ \ ...#. \ *....*..*#....#.*. ... .#.... #.... \. .....  .. #.\.##*..*#.  #
#*.*.#.*. . . .  #..\#..*#.*.* ...** . .. ...*...*.... .. ...... *.. * .*#**# .* .#...... ....**\*##
#..... .*... . .. ...\ ...*.... ##*..... ..  ..#\..*##. #  .# .\..\.........#.*....#.   .\....*. *.#
#...***#....\  ...*..#. .. #..... . *. .  ......#**..#...* ##*#*.#\.  ... #  ...#...  .....##*....##
#\.......# .. .... ..\...#. ##.. ..#*..#...*...#... .   .. ....*..... .*#.#...... ...*...........\\#
#..... . ... .#\. ...#..  #.#. #.. ....#...*.  .. ...\* .* .#. .#. ...  ##.. .  .*. ..*.  .. . . #.#
#\.#.....#..#......##.. .  . ..#.. \  ...#*.....#....  .###.... ...#.\\. *... . ..\#. ..*. ..# \...#
#.\..* .. *.... ....  .*#..  ........*..*.\..  \**.#**. ... .... # \.*#..#\.....*. .* ..* .. .. ...#
###########################################################L########################################