##########L#########################################################################################
#.....#. ..# #. ... .*\...   ...... ..  ..\..... . .\.\ #.\. \* #  *.\......  ... \... .\...... #..#
#.# #....... .. .#..*...#*#.  .#....#.\ .... .#..... *.\ . ..  *.  *...*#* .*..# *##. .. ..*.. .#. #
# ..  ..*\.. ...# .. #.. ........  \. *..\ . .. . . ..  \ . .....\.*.*  .*.. .. . *\. *..... .# ..##
#..... .....* #.#.#.. .#.. .....*. . ...\\...*..... .# .*.... \.*...*...**..*.*# . \.  .......#\.\##
#.... . .. ..  . #..*.#. ..*. *..... .. .......# ...... \..... *  #.\..   #.. ...* . ..* #..\#..#..#
#\. * ..#* ..#. ....#..*.\#*.... . .. \.# .*#.. . .#\ .\  *.*.#  ..*.**\. *. #\ .  .  ......#...#.*#
#\..*...  #\. . . *. .. .\#.. #*.#.#...*.\.. ...*# .... .. ..*#.*.# ...##.....#.......... .....**..#
#.....*..\.#.  .......**  ..* .*. *.. *.. . \.#..#.\.  * ..  ....\.# # .* .......  ..# *...  .*.\..#
#...#.\ ..*... .....*.... *.\. ......\ .\. ..*.. .... **..  *.##\. \ #.*......\ . *..**\...........#
# #.. .  .#.*..# ## .... . ..   .. #.. *\..**..* #.*.*. .. ... #.#*.#\....*\........ *#\#. * . .*..#
#*...*.........*#.... .....*..  ..... .#.....  # ...  *.. . ..* #. ..##......# .. . ..  ..\.#\\.*. #
#*#..#\... ....#.#** ..............\   .\.. ..#. *..\...**\.\ .*...#*\..  .. ..*...# ..\.#... *....#
#.\*#.\..#.\.# ..#..#.....*\  *..*## . \.#.#..*. #..#.\..... #..# .. ....#.\*...##.#\. #... \.  .. #
# *#...*.. ..#.* ..* .... *.........*.......... .*.#.... ....\. *..  *.. *# * .\..   .#..#... ..  .#
#*. .\.*  *.#.. .. ....  .#. ..#.\..#.*.*. \. *.*...*...##.\.. *......\\ .......\# ..* *#. ..*#..\\#
#*. *. .**  #.  #*.#. *......*. \ \... .#. .#... .#.* . .*\**...*..*    .. ......#. ..\..  ..#.#.\.#
#\..\ *.*# . ..*  .. . ......#.. .#.. . . .\    .#\.  . \ .\ #. ..........\\ \  . .# ..* ..*\#\#**.#
#.###.*...  .#..\..... .*##*\.  .*..#..  #... .**....*..*\.. .\#....#.#...#.##..#....*..###.... .\.#
#...# .#..*\....\.#..  .. ...*\# ..**#.#... *.....*..*\# . #....*..   . *...# .*\#..... #.\...   ..#
#....#...#.*..*........ #...... .. ...\\ *... #.\*.. ..#.. *......#. * ........*.\.. ....#..##...#\#
# * ..*. *.\.  ..*..*..... #.\..#.*.. # # ...........  ..*# ...#*\ . *..\*\.*#...*.#*.. .\. .#.#..##
## ..##..*..#..   *.###..#.* .... ..*\#.   ..  *###  ..  .  ...*.   .... ... ........*.... . *...*.#
#*##.#.\.......   ..# *  #..  # .....  .\. ...#......*.\... ......... *# \..   .*.... *... ........#
#.... . #*. * #.\.. ... ...  ...\.. ..#..... ..#.## * . *.. .. .#\ \* ....#... \*\   .....\.... . .#
#..\##.. . *\..###..  *..*.#.#.# .\ *.*.#.....**##...**.. .. #**..**. *. ..***. .\....*..#. ..#*# .#
#\.....#\.\..... .*..# \. .  .  ... #*.. #.\.  . \. . . ...  ....#. .#*.#...**.......* # ..#.*.....#
#  *#...   #...#.*.#....#...*#... #.**. . .* \....##.#.. .*#**#.. .# *\.\  .*.#...# *\.*#\ ........#
#.......#.. . * ##.*..\.# #* .\ .#. ..#.. *.... # ..... .## .#.....\..#  .  ....*. . \.\..... .*** #
#....#....* .#.#........* .*.\ *.## ...#..\*#\*#..# . #*. #**....  ..#*. # . \.. *\... \ . . . ... #
##..... .  ... .....#*..... #.\*...\..*#...\#. ##.. .. * .*....##.. .#  .......*#* #.... ..#. ...#.#
#\.\.*.... \ .*... ........ #.# .#. .. .#  #.....# *.. ..#. ...** .#\#\..* ..* *..# \*.*... .......#
#  . .. \..... .    \ . *#...  . ..........**  ...*..\ \*.\\.....#.#.#....*.**.\ ..* .. * ...*\. ..#
# .#....  . ..... .... .\.. ...#.. .... #* *...#.  *...... ...# \.##\.....*.................*.. #..#
#.. *# ..  . ...... .* ..* .# . .*  # *. . .. ... ..*...   ....*#*.#.#..... ...#... \.# ..##\.\.*..#
#  .......#*...     * .#*...\...\.. . .\.#...#.\..#**. * .*..*. ..#...*..#..#\..........#  .....*.*#
#.. #  \*...  .#.*.. #\..#.*.....\.....\ *.. . ..\... .#..#.... ..# .. *#.. .*.  ..\ *** . ..  .  .#
#. ..*. . .....##*.  . .... * ##* ........*..# ...*...#..\*..*...*..#.  ..... ...   ..\.... ..#... #
# ...\ \*...#.......#***. #  ....\. ... .##.  ..  ... ..* .*.\ ....*#.*.... .##..#..#*#\. .*......##
# *..**  ..* \.  .... ...\*#.....   .* *...##\ .*. .\...#.\.. ..\  ..... .\*#..*\.#..*.**#.\..*.\\##
#. ..\.#.*....# *  .***..#...\*.... . #.*.#  .#* .#* .. ..\* .\..*#. ... ... .* ....... . .*.. *.. #
#...... .. ....##. #. . ... .*..#. ..#...  . .**   .. ...\*.#.. *.......*.##*# #.  #.\...##. .\... #
#\ . #..*....       .. ....\..**#. ...  .*.....R......# ....* ..# \...*.... \...... . .* ..\.. *..*#
#\... * ..*.. .... ..... ...*#.. ..\ *.. .. *.#.... .. \ \*#.#*..*   \\... ... #.. \.#.... .. .*. .#
#. *.. ......   .....*..... ...#...*.*#\ ..* ..... . .*..\*\#...* #.. #..***.\. ..#......\.....#...#
##.  ..... . ...\ ...\.. ..#....\ *. * .#..#..... ... . #*...\#...#.. ##.. **.....#. #.# * *....*.\#
#..*#. # ..\....... ..*#.\ . #.#..  .. .#.. \.....#... .\.*  ..*.. . .*..*.*.......#.. ....   ... .#
###\  .*.#.\.*.  *..\... *...\#.##... . ... .. \...**\..#. ..##.. * #*.\.   ... ..##   . * ..* . ..#
#..#.  .#..*  #  ..#..#. .*#..\ ..*...\.\. .* ... ** ......\... # *##\....* ... .. .\#....**...*.###
#...*..#..* #..*. .**...# #.# *.. ......**. ..* .*....\. . ..*...\.*  ....  . .*... #* *#...  .\.###
#. ..*...*#......\.....#.. \.  ..#\**..#\.*...#.......... ..\..... . . \*.# . .# ..*# .... * .#....#
#.. \...#** ....... *... ...  ...... . #. ..*\ #\#. .... .#  \. ...*. .. .  *.  ..#.# ..###... \.*.#
#..\. .\#.\. ... *.. . . ...#. .*...\# .. \..##.. ..........*.#... ..#  .  .#.........\.  .\*.   *.#
#.#. .* .. ....* .# ..#... ..\.  ...\ . ##....... *.... .#.* ..\#...\. . \.*...#.*.\ .  ....\. *.. #
#...\ .\..* ##.\...# ..\. ...#.#.. .* . ......  . \\#  ...  .#. .   .*.#..**..\ . \...\*.*........##
##.*. ......* .*     . *... ..\#.# **\...\\#* .# .*..\. . ...\.. .*. \...#. . .#.... # \#... #.#...#
#.\.#.*......*..*...#... .# ....  #.... ...* \*. ..  *  ..\.#..*...#.* ..#*...##*.#... ...**..\ .  #
#.\*#* . *...##... ..#. ..  ....##\..\. ##..... .#...#*#.\*.... * * .. .*. *.  *....#*#...\\.... * #
#...*\.. .... ..#....... . .\*. .#   .....#. . #*.##....\. .. . .\   ..#.#..***.#.  ...*.*... .##**#
#..*.*. .. ...#.#  ..*#.#.. #\..#...#*.....#*.*.*.#..* . .#  .. . **  .  .#..##..*........*. ..# #.#
#..##** ...*.#......#..*....*\.. ........#....#..*.. ..*..*. . \.   #. *...#*#\#. ..#..*... . .** ##
#.#.\...* # ..#.   ...   .*.  \\.  .*# .. ..* .#......#*...*\..\..# ......#\.*. ..\......\ \.. ... #
# *## .. .\# #.  .. #...\ . .. #.... ......#. #.   ..... #. #*. *...* *.\.#.....  ......**.*.......#
#.\...\ ...##...#. \ *... *....* **   ......*  .##.......#. #\ #...*..#*  ..  .. .. . *.. *..  . ..#
#..\.#..*..  .* *......**.#. ..... .. \... .  ...*...  ..*...\ \....     *\ ...\....\ . #*. #.###..#
#.\.*... ......#. . .......#....\ ...  #  ... . .. . . ....#.\..\ #.*##*#...#* #. ..#.......#.. . .#
## .*.#\.#.....  ...*..*.....\.....*.#..* ..*. . . \. .. ## ##.........*\\*.\.\ . # ..*.*\\ ..*..  #
#.#. .... .  .*.#. *.  .........\ .#.\.# *........### .#.# . #  *..*#....#. .#* *. .* .\\......#...#
####.......   #..*..#.\ \.......*.. ..\. ...  .  ... ...\..*.\  ..\...........##.....** *......##*.#
#..*.. ...#...\..*. ..*....*\#.*... ..*. .#*#*#.*.  *. .*\ ...*.* . #.\#. .*....... *..*..# . #\ ..#
## ..  .. * .. * .*#.#... . #..#.# ....*...\.. ..  ..##... #.*.. ..#..#.. *. . #\.*#*  . . *.*#....#
#..*.......   *#.. . .\# ##..#\...\....#* .  .\  .\...*..... *..#...  ... .*...*..*.**.\.\ *..#\..*#
# .... .. .**  #. \* ##. ...\....  . #\#.*..*..  \..#.. ###  . .........#.#.... ... ..**.....  .#.\#
##...**..**.**..\.*. ..#\ *#....* ....  .. . ...# .#.... .##*....  #**#.... ....*...... .* .*..*. \#
# ...\...#.. . . ....... #..  ..... ..............*.#..#  .*. .\#...* *. ...#. .# * ..\.....#. ..# #
#....... . .. *..* .*. .... ....\.*....... ..\.   .* .#... #  #.. .. .*   ....#.*...*#... ..\#.*..*#
#......    ..* ..#\...... .#.  . **...#.# \#..##. ..... .*..*..\ .**  .....#. ..*.. ...#..*.....  .#
#*#....**.. .\.*..\*..*.. *....  \.....*. .#.....#*#..#\..#...\#*#*. .*##...*  \*..* # ...*...# ..\#
#..**.*.* .# \ ..  ...#... .*..#.# *. ......  .... ..* . .**. * #...  .#..\.*....**.*.....\ ... ...#
#. .  ...*.. \.. *...# .\ \*#.....#..# . ..\...#.... ... .\....#.*.\..* ..\.\  \*..  ....#.. .**...#
#*. .*.*...*.#  .*...*..##.... .. ...........#**#.#..*  ...  .##  . . * ...\...* . .#\** #.\*\ \#..#
#.*.*.  .. .. .... ...... .. ..* . . #.... #... . ..*.# #..*\#.. .......*..\.......*... .  #.......#
#.* #*.*.#.....#..# .* ...#.. ** .  .  ...  \. .*.\ . .  *  *  ...*..#...###...*.. .*#...#.#....#. #
#..#\ . \...*...... .\.   .  ##\....**...*  *... . *\*.*...* .  . . .*. ...  *\*..#\##.# .#* .#.*. #
#.*...#.\.. ..  .#. #. ....#. ......\  ...#.....  ...\\##.......#***...*.. *.*..... . .... ....\..##
# . ....\. ... ..\..... ..#..#...  .**...*... ..*. ... #.#..........# . ......#..  ....#.#..\.. *..#
#  .# \.#.  ....#*.\ .... . .. .*.....* .#... .\......... #*..#..#....*#.. .......*...*..... ... \ #
##. .*.....*.   .. #.*.# # #..#...#*....*#....**...\# \....#..#.\.#. *.#..*.. .* ..*. . ...*.#.. .##
#. \#.#..... #.#.... *... .. ..\*.  #*. ..# #.. .*...# .... . *.*...#.**...#... \......*.\..# ... .#
#....* .....# # *. . ... ##.. *#\.. #....... .....*..*#...... \#...##.\ \  ...#*.\ ...*....... ..* #
##.\. ..# .........*....\......   ..*....#.. .....*. #..#......\*..... .  .. *.  \..#.#*#*.*.* ...*#
#...# #. **  .#\#.. .#..*....\..* #.. \.#.....*# #..... .#.#.##.##\.. . ..##. ..#.#\*.\# ... . .. .#
# \. .*.  \. ... ....\.##.. . *##*#...  .#.\.. .#...#..\ .........*  #\**\ ....  ..# \\\.#\.....#*.#
#.*.***#..*. *. ...... *... .* ..#   #.#..\...*.... ...#..\*.#  . .. #. .##  .**.*.. ......*.. ... #
#.  ## ..#.  \*\  ...... #...* .*.. ...... *. #.  \..... *......* \. . . ..*## ..#..*. .....#*..#.*#
##.   . ....*. ..*.**. ....\......* *... . *.*.  .**.# .  . . .. .*** #\...  ..\..\. \. . #...#. #.#
#. * ... . ..* ..#.#.\.. . # ..\ .#...\ *...\... ..  .... .* . ...*.*. ....*..**..... ..#.. ...\. .#
##.\# ..... . ..##....* . *..*...... .*#  ##... *. #......#..\# ..*.....#...#.#......*........#.*. #
#   .*# ... ....  *#.*.#*.#. .....\.. ..  .....# ...\.*.   .#. ..#*.. #..  .......  *\\. .*.*# ... #
####################################################################################################