##########################################################L#########################################
#. .... *.#.* ..*..##. ..#.. .  .**#... ...**..#\.* \*\\..  #. # .. .. . .*....  \.  .   ..\..#.\..#
#\#.\......*#.......\..#...\.#..\......\.#..\#.#*.*.*..\ ..**. ...####.* ... ...*.....##. . ... #*.#
#.#*.\...##.*.*..#.. ...# . *#... #*. *...#..*......# .... ...*#.#.... .*#.....#*...*...*  #.#* .  #
#.. .\..*#\.  .#.. .#.. ***..#* ...   .* ....*  .   ... . .#....\*..  ##*....#. .. . #\..#  . *.\..#
# #. \.......\* *#.....#  . .# *....*. .##\......*......#.# .#.... ... ...#   ..\. ... *### .*. .. #
# . ..#.....#.*..*. .  .  #.*. ....#. ......  .*.**.#*.*..\..#**#* .. ..*.#..# #..*........#.....**#
#..\*.\  \.. .........*#\....# ..##..*..... .** ..* **... ..\*..... \. . *..... #.# *.*. #.\ ....*.#
#.*...#. .##*#\... ....#. # . . #.. .. ..**.#..... **... .*# .*.* ..#....\#.....#..\#... .#.. *.\..#
#.\. .*.....*.#.  ...\#* .. .# ..*.# # .. .# . .......#.* .. ....* \..... #*...\. #.. ..  *#.\.....#
#... ## .*.*.... .. ....*...*.#*...\   . #.#.. ... ........... \....  ......*#...  ..\ ..\.*#.  ..\#
#*\ .. .#..\\.#..\ .* ..*.#. * ....*...*.... .*\...#\#..#.  ..#...*  *....  ....  #.#... .....#.. .#
#..*..*...*.. ..  .\##.  .....*.. .#*.* ..* .. . .\. .#.\* #. .. ..#.. .  #..\. . .*...    #*... #.#
#....#...#... ..#...\.  ..\..... # . .. *.# ....\ .......#... . .\....#. ..   .. *#..\.#. .... #..*#
#*... .....#\*  ........  ....  . \ .... ...  ..#..*##... ..# #  .#.. ..*. . ..... .. .... .*.. ..*#
#....\.\.. *. . .*.*....  #.*\.# ... .....* ........**  ... ...\   #.... \*..*..\.. ..#...\*.#.*.. #
##.#  ..*  \##..#.. .\. .\..\.\.. #. ... *..\...   ..#..\\... \... . .   ...\ ..*.#* ...\.\....*.\ #
#.\.. #....*..\. *....#* .#. . #\#* ... .# .*.*..*...#\.. .\...... ..*#..*.....\.**.. ... .. .\*#..#
#.  .. . *..#.. . ... .*..  *......**\.. .#. .. ....#\*.  .*.  . *.*....*.* .  ..  ....... ... *.  #
#. .***#.#... ....*\.    #...## ..\ ..  #.#.. .. ...... . . *\...*... ....#.#.*#\....**...  ..\ .. #
#..*. .\  * ... *. #. .#*.#\.* .#. .. *.. ..# .\..*.. ..# .  . ..\#.. .  .*... ... *.#...#\..#..#..#
## #...\...... ..... .\.*\........*..#...# ... .#.\. ..#...* ..# .#..#.#..#. . .*.....#  #..   *...#
#..*.... ....#. **  ....  . ...#. ...##\. .\.*... .**.#..#*..# . .... . ..*.*..... .. ...* .#. ..#.#
##**.... *...#.*..\   ..#. . . ....#. #..# .*#   . . ..... ..#.. .# ... .*.  ***. \* . .\.......*..#
#*.....#*\*...* .*.   ..*# *..# . .#.\\... . .*.* . .**..# \....\# * ..*\ ...#.. ......  #.#\#...*##
#.... .#.* ..*.#.# #.#.#.* .#....... .....  ...##... .. \..#....\....**#.. . .  *....*  .*  #..#. \#
#..... ...* ..\.* .# ....#. *...#*.* ..*. \... \#\* # ....#........\.. . . .....* .\. .. . .. ..  .#
#.....#.. ...#..*.\...#  .  ......*....  .....*....#..#   . . *. #..   ..\......  *. ....\#..  .. .#
# ..*.... .....*...*..  .  *.# \ #\........#.. ...###..*....\ .#\....*.. .*.  .#..\.  *....*... ...#
#.*.# .\.... ....*.*.#.*........*..\#   ...\.#. .. #  \#*.* **...   ... .*..\..*.#  #.#....#*.. ..*#
#.. ... .......*...##. \\.....\ .....**.. ... ..   #.\*..#... ....#. ... .... ..\.  \#...#.*.* #...#
#*. *. * .#.\. ..... .. ..\....*.#*.. . ##..#  .*##..\#.\#........... . .........#. .\# ..*.. #.   #
#.##\.\...#.. . .....*.. #*# ...#..\.......*..*# *.#..\#..#.... *...*..#. #.#...# ..#.  .. ..  ..  #
#...#..*.*# \ ... ... .. \. .##......*.. ..*... .*.#.#.. .**.#.*.# ..#  #.. .*..... .#...##* ..... #
#  ...*.*.... ...#* .#..\.. ..\.##........#... .. . #. * *. .....  ...*.#. .... ..  .  #... ..#\...#
#.*.*....\.#... *.. #*..*..# .#.. ...*#.... .#... *\.. ..#.**..#.. **..##. ..#\\.#.#..*### ...*..*.#
#.#...**   . \.*#.\.\. . .#  ..* . . ..# *#...##....#**. . . ..#. .#.*. .. . . **.# \.. ..... ....*#
#.*.....*  #.* .  .* ......  \.##.#..*\..... ... *..* *..   . ..#.... . *. ..*..   # .........*    #
##..#. ....#\.#. ...*. ..\.  ...*...\**.. .. * ..*# .\ .#.  ..   #.\. #.... ...... *..*.  .#.\*#\..#
# ... .. ..#.....# .. . .# #*.*...#* .\. #...... .. . ........... .....*\.*. .......\.* *......*...#
#*.\##\.##....\*   ..\... .. .. .. .. .#... ...*... .  #......  . ....\. .......#.\  .\. \.  .*....#
#. ..... .#\.**..  ... ....#.# .\.....* ...\. #.## ....# ...#* ... .... ...* ..# .. ...... . .* . .#
#*#*..... . .  #*. .#. ..###....  .*..... .*.\. *#.. . .....*#.#... ....*# ..#....     *  ..  .*..*#
#. # .  ... ......... .....*##...... #..#..\ ## .* * #...**. .*.......##.\. .#. ...\ .#.. \ .. .#* #
#........\ ..* #...... ... *  .#.*#*. ... \ ...\#.. ......#\..*.. ##.*.  *# .#.\  *.\*..##..#.. .. #
#\. .#...... .... .... .*# * ##.\.. .*.. .  .. ..\. ...... ... .  \..\#. .#. . .*. .#   .#.. #.\. *#
#*#..#.#....*....\#..#... .#.. ..*.\.  .##*#* # .  . . .. . ..#..... **.\*#.#..#.*..*... *.#*......#
#.#*..\..... .*.*.....*   #...*.   \*.\#.\#...**.\.. ..\... ...*... .. . ##..*#...\ *.... \ ..#... #
#  .. .#. .. **..# ...*... . .. .*.*.... ........ \.. *.... \ #*#*.#..* .*...... .*\....*.##.......#
#..#. ..# *.... \. ...*#..*.\. \.*.*.....#\... \ *..# .#..#...\#.. * . \. ...#..#*.*.#.. .....*.#.##
## . ##. . ..*..... . ....*. ... # ...*. ..\*..#. ..#.*\...#.... \...#*.#..#.. .*.* ...*.. .\*. .*.#
#...#.....#.\....* * ....\..#.#.....#. .#..... ....#*....*. ..\#..............*...*...*# ......#..*#
#\...\... . *. .. ..\\..  ...   #  .#.* ##*.. .#.*  .#*...*.. .*.#*.*....*..... \ ..*.\.# *\...#\  #
# .... . .*. ..#.#. . .. .*..\ .*..*.#..##.. ..... .*........... #..#... .. ........   * ..*... ...#
#..# .\ .......#.\.*.*#.\ \ *.  \.....\.#.\.#.\.....*..#.. . ***.....# ....\   ..\.. #*...#...\. .*#
#***#.\\..*. .... *. . ..*.. . ..*#****... . ..*. .....** .\..\*\. . ..\.#... ... ..*.#.. ..*#  . .#
##..*....**.....# .*# *..##\. #..*.# .. * #.*.. ... .. . .## \.*.*.*..... .\....#*..  .*.*    \....#
#\... #.\*...\ \.. . .... .. .#\....\. #.......*. #. . ...\..#..#..# .. ......\ . ... ..\. #.......#
#.*..#.. .  .*...**\.#*\#.\.. .\#.\ *.*.*...#.*.......*... ...... \....... ...\\.*\... .#..*.*....*#
#..... . * #...* . ## .. #  \..* ....##.....  *.  ...* #. ...  #. *. .... .... ...\. .*#... ...... #
# .# ......*... ....# \#*.* *#.. .#\ *.\.*......* .# .. ..#.. ..*...\ *\ *......... #.*.* .. ..   .#
#* .. #... . ..#.. .... *# *.*. ...  .*...# ##...*. .*..\*# #.# \..#.  .... .* *# \... ... *#*\.. *#
#..*\.#....  ..\.**.. ..... . #*.. .. ........ ...\  ..*.*. ...#....## .... .#\##.\... **..*..... \#
#...\*....*  ..  *. .  *.... ....# .  ...## ....  .  ## #*....*. . . . .* *..#.* .*....# .#.... .  #
#...*.... .....*  \  .\.\..\.#. #..# .... .. #.*. .. \ .  . .*\.#.......*\*#*. .....\ .. ..#.##..*.#
#.*   .. .#. ..* .*...... . *.\......* ..#*...## ... \.. . .\.\..*...#.....#..#.*.*#..*.. * .... *.#
#... . .\.* .....#..*##..**.\.\...*  ##.. # .#. . .. . .##. ..**.\...#..#... #\ ....*.\.\*#.. . *..#
#.. *.*#..# ..**..\...\   ...  ........*.#\. # .\.....## .. .*.. *..*#...  ..##*# . *  ..  ...   ..#
#.   ** # .. .* R **  ....**# ..*. .* ..*..*. ...#. .#\..*.#. # \.*.#*.*\\..#*\.\..   ..*. *  # \. #
##.\ .......... .\.. ..  .....#..*.\...#...#.#..  #. ...#.*.\. *.......# ..#..#..  .#. ... .* ....\#
#....#..... ... .#..*.## .*.** .*. ###.  ....\ .......  . .\.. .\.....*.... ..*. .*....*### ...## *#
#*.  .# .. . .\. \. # ..#..\..*#....* ......\ .*. ....\..#.....\..##..*. ... ...#....*\**.*.... .. #
#... ..*. .. .....\.# ..*. .. . *.#.#.#... #.#.  *. ....... ... ..\.*..* ..** .. .#...#..# \..*\ ..#
# ..\*.....#.. *.. ..#*.   . *... ... *\#. *.......\# . ..#....... .  ... ....#**#.... ....*.... *.#
#**.#.\ .*.. ....*..# ##  ..\ \  .....#...**.... #.*...  ..** ....# ..... *.. .  *...*.*.#*..\.*...#
#.#... ..#  .. ...*. #..*.\ .*.#\\\* *. .......#. .*.. ...\* * #. *  ..**#. .. .#*...\.*...#*...#\.#
#....*.\... . .. ## ...\ # ......*\ \...  .. ..#*... #*. .  .. #  .\. * . ..#*. .*..... \*.....#.. #
#..#..... **.. .* ....\  ... ##.. .....*... .*.......*#..*..\ \#...#..#\. ...*. .. .....  \..#.... #
#...    .#.  ....#...     ....#....#...# ..# .# *\\.#\...*#.\...#.*.  . .. ....#. #.*# .*... *\ # .#
# ... . .....\ .#  . \... .\....\ .#...    .....##.#  .#... \..* . \ #.*..#\. .*. .**. ...*.. *. ..#
#.*..*..#...##.. .\*.... .....**. #.#...*.... .. .\.  \  ...#..... ....\...*#...*...#* .....#.. * .#
#.. .. ... . ..#. #.. ..*.. *.\.  *.. ... .*.*.#. ..#\.#  #..\ .. .*\ ..*.   .# ...... ...* . *.\#.#
#.. *.#...*.  ....... .\..  ... .# .\.#.... **....#...* #...#**.*..*..#.  ..#\..*..*.*.#\.*#.. ....#
#.....# .\.#.  #...#\#.... ## . ...... ..........*..*.. ....#*\.* ..*.......  .\   .. ...*.*. ....*#
#.#..#\.. .\#. ....*...\...* \.. ....*..\\.. \.#...*#.##. ......\. .#. #...*. ...  .  ....  *. .\.##
#*..***. ..##..#. ......##*. \*..... ..  . .. #.... ...\#\*..# .  .##.*.\*.#... .. ..*  #. ...**.# #
#...*..#*#...*. #  ... ..#. *.#.........\...... \...*....##....  ...#.##..\.\..***#.#.*  ....#.*#. #
#.#.. .. #. ...#.....* . \.....#.* .#*........ .# .... .#... ..#..  ....\#*. .. *# .# . ....  *. *.#
##.. . .....* ....\#.#  ..#. .*# *\...... .*.......# ....... ... ...\....  .... \. .#.......##... .#
#..*....*.\.*. ....*. . .#..\.#*..# ..###  .** *# ........ ... .. .....##. # ##.# *.......\\ .\ *.\#
#.#. *\.....*.\. #*##**...* . ...#.\ .. #.......  ..**.\.*## .* .\ \ *. ... . *...  . .. ..## * . .#
#...... .\ . *........# ......#.##.....\. ...**. ....*#..\. ..  # #....\.....*. .\. ..\ .*#...# ..*#
#*..*.\...##.. .*.*. *.. .*. . .*  .\..... . ...  #.*.#... . ..##*. ...  .# .#  . #...#... #.....**#
# ...  . ...\.#..*. *... *.\..  *\*.... \ .*....###\**....#*.#. .\ *  .... ..\..... \..  .*.. #  ..#
#..#..  #. .. \. #.*... .. # ##\....... .\*....*# .#.. .....*...*#  .\*..#*.....*# .# .#. .......**#
#*  #... # .*#.....#\#..  \..* ** *\..# **. #  ##... ..\*. #.  \# ....\ . ..#... .#.\ .. *\ *.*... #
#***. .... . #..#.... ..\.\.... #.. *\. . \* *...\ \.\\.   .. *\ ......#  # .*..#.#.. ......\...  .#
#*....\....*...#\...... ...*..*...*.......* ..   . .#...\.\   .. #...# ...##. . #..** .... .*  .*\ #
#.#\...# . .. \...*# .. ..\... \\.*.*#.\..  #\.*.#.#*.\...*#. ..#\..  #..*.*#.\\.# *. ###.\. .\.. .#
####################################################################################################