####################################################################################################
#.... .\.\.  ..*. ..... #. *  # ... \*. .** ..#........#\ #..#........... ..    ..#..  .*... *   ..#
#**..\..*.. ##.##..***#..*....# ....*..# ......*.#.   ... .....*..**... .... .#.*.... *.*# . .#.\.*#
#...... #..## .#.........#......*. #...\*.. .\ \.... .... . *........ . ##. .*#.. . .*... \.*.....*#
#\.. .  \ *...#*.   .*........ .\.*. .... . .\.. .*... ....  ##. .*.\ .\ ..*. .#.. ..*#\.#.... # ..#
#.. **.#......* \  ..# . .# .#.##..*.. . ...*#**.. ..#.#. *.. .. *... . .. ...*\ # .. ..#.. .. ..*\#
# ..  \#.#. ...  ..*..#*\*\* #.* .#  ..*.\.# .#. . ... *.  . #. .*.....\ \#...\*.  ...#..\..\... ..#
#.#\*\ . ....\..#.....*...  ..#.  ...\...*..*#...*..... ..** . .\..#. *...#*#.*..   *.#.....  #..* #
# .\. . . #.... .. *\\...  .. \*...#.*...\\ . .....* \..#\\ .  * #......*.#.#. .*  .. .. ........ \#
#. \.. .\#. ........*. *#..# . ... ..#.#... .... .. \...*.  #* ..... #*...\ *\. .*. . # #.*# ....  #
# #..****.#\.... .** #..*. *.# . ..#..#..  ..#.\.. . # #..\.\..  ....*..... *.\ .. . ....#*.*\..#..#
#  ..#.#.. .. . .... . ....\.... .... ...*..  .* .. *...* . . #  .#.. .  #..#  * .... .* ..  ......#
#... #. .. \ . .*#.     ..#.. ..\.. **. .  ....\.*..\.\....#. * #... . ..# *.\..    * #.# .*..*.. \#
##..#..*. ..\*# *...#........ ..... .*....  .... .* #* . ##*.....\ .# .#.*. ....... . #... .  * ...#
#.**.* . . . ... ..*.*. \..  ...# ....#.... .#.. ..\ \...*. ..  ....#.#. ....... .# *\  .. *. .#...#
## .... \.. ....#*........ . \. \.#*..# #\*#  ..*.#.... *... .   . . #  \..*.\ .*#..\.. .#. ...# . #
# *...## .. \* .* #. *...\* ..#. #...*... # . \.* ...#...  . . .#.*.  *.#  ....  .*#. ........#.##.#
#... . ....*...#...#\#. .\..\ #.**.* ... #*.*.. . .. #.... ...*.... ........ #..\ *....* *  ...  ..#
#...  .....\*....#. .*.  ...#....# .*.. ..# *... ....#...*......*.... ...#*#**\... #.*...#\.. .#...#
#.*#.. . . .  ..*...# .  .##..* #.. ...*.#.\.. #..\. . ... . # .\#.. .*.**.....*  \.\.  ... ..  . ##
# .**.*.\.. *\ .. #\.. ...   .....\..* .#. ##.  ...*.* ..\....*##..#.#.. ... .. ....# . ..\.  .\.. #
#.# ...... ...# .*.## *...\#.. #..**. \.. ..#*.#\..#. ....# ....\ .....*. . * . .... ....  ..\ ....#
# #....  . .# .  \*..##.\\..# ...*...#... ..#......##.*.#..*.#..#.*. \#*  \....   #*.. #.. .\. ... #
#.*##..#\. . *.. \.  ....\ .#..*...* *\.#. ......* #..\*... ..#.. ....*.* *.*... .*...*...*.  ...\*#
#\...**... ........ ...   .  ..*.#*.............  .\.. ...     #.......#\.#..... *........#....\# *#
#.. .#. *.#\.*\..#### ..####...  .*.\.#.*  *..* .#...#...*...*#  #. *.#..##..#.#*..# *## .#..... \.#
#. ...**......  .. .* . *.\....#.#\ .*.R .. #  . ...#..#.\... .*.#* . . *#.......#**....# . \..*#\.#
#. ** #.##. . ........\\ . .* ... .#.......##.. ..# . .... ....#.........*..\.. *  ..#.....   . ...#
# *. ..  .......... .*..*..#*.\.*.. ....*.#.#...#** *#.# #  ..... #... ...  *......*.*.\.......*#\.#
#   .*.. .\.\.#..#\...# . . .* *  *\.#*.... *#...........*\* ...#.#..... ... .  .. ##.  ##..* . #**#
##...#..*. .#. ..... . ...#.#*. #*....  . .. * #..  . ..... ...\*\.....\\ #. #\........ .... .... .#
#*.**...... . .....\ # .\.......#...#...... .\ ..  ..#..* \.. .. *# \.* .  *#  ..* ...  . \*.. . ..#
# .**. .....\.*.*#...... .. ..* *.\.# ... \.#.#  #... * ... .....*... *  ..  #...   *  #.# .##..\ ##
# ..\. ....# ..*..... \..*. #..#.. ...*.#.*... ..#*.....#....\ .....*.**.#*.... *.\..   ... \ .. . #
# #.# . .*  *... #..*.# ... .*#.*.\. .. ..*.#..* ..... .. . .# ##..*..*...*.. . ..#.. .#. .#. #.#. #
#*..*.#.# ..  . *. ...#* ..* *\*. .*..* .*..#..#...#  ......*#..*.\. * .\ ......    .....\ .....** #
#.*..  . .. ... #*. .# .*. .......#.#...\*..# ...#*...*\.. . .. .. .... *.#...\  *. .. * * ....... #
#.. ...\#.#. .#.... .#.....# . .. ... . .... ...* \....#. .#.*.#\*.....#. .. #......#.#..*#.....*..#
#* *.  .... .. . ......# ...  ...  ..#* \ ...* #*...  ...**  .  ... .  ..## ......*#.. ..**..* #...#
# *. *\. ...... .\.#*..\ ....  ...*.#. .... .*... ...#...\..##*.*    **......\..*..*........ .....*#
# .. #.* *.#*. #..... . ....*##.*.. .*...\#..\..*....* ...... . .#.#. .. *..#  ............... ...*#
#*......... ..# .... .#.. #. .. ..  .*\.#..*  *.*.#..#...#........*\.......# .. .....  *....* ....\#
#...*.\. \.##. .... ...#.. ..**. *#*..*.# ##.   #\ .*. *#..  *.. . ....# .....* .... *..*...*.*....#
#.\*... *. .\... ....#.#... .. ...* . .*..  . .... ... ... ... #.. **. .  .#\... ...*.##. ..#.* .#.#
#* #*\*\.\#..#\ . .... #....\...\#.\.\#.*.\#. .. #..#*..*...\....*....*...*... ... #.\...* .*# ....#
#..  .... #..\. #....* .#....   . .  .. ..*...... ....*..# #. .*.  .*...  *.**  *. .... ..... #..###
#.  *.#.....*..*..# ......#\..*.....*.. ..\..... *. ....* ..#.... ..\.. .. .\*..\.*#*#. .*  .  \*..#
# #..*.*.  \.#. .     .   .*..*.\. . * ...*.....*.. .*\ #.. .*. #. \.......  *.. ...#*... .\.  \...#
#.*... ..\.. .. #... ....*.*....*... ... ..\ .  .* .. .. #... .\.....* **. .*. .#*.. .##..#  *   . #
#......*.. .. .....#.  * ...*.. ... ..*. .... *##.#.#....*....\#\ *..#..#..\#*.......#*.**#... .. .#
#.\*.# \.. .#.*. . ....*...*. .*.*..\....*. .* .. .**... ... ..   .. . .#.  #.#. ... . *.# .....\ .#
#. .\.\ ...#.*..\  ..#..*.##.*...*....... ..#....  ...  ..... ...* .* \*.#\....#.  ..#.*..  *......#
# .#.*.#...*...* .. *\.#.. .. .. \. \.\* *. . #   .. *...#..* \ *..# ..*...\ .#.#* .\#.\. #.. .. .*#
#.. .#*...... ...\...  .#*#...... #.. ...\.....*.#*.*....*#* ... \\.# ...  ...\.. ..#  **.. #.\. .*#
#. *. . . . .. .*.#\*\\.**.....  ..#*...*...#. **.* ...   .*. **. *..#* #.. *..#.#...#..# ...\ ..*##
#.\..#\#..  #..**  ..  ....\\#..\**. ### ...*#..#. ....*.*\*. ..*....*......*..#.  *. # . ...# \.  #
#.*#\.#*#.. . .*. . * #..#*...#  ...**.. #*...  .. ......... *..# .\...#.    .# .....    .*.*.#...\#
#...**.#..\.*... .\... .....#....*....##. ...\..\.*  \.\..\..#.... .....***. .. .#.......##\.. .. .#
#.#. #   * *. .....* ... \.#*.... ..\..... *\..........\.#. .\....#.... #...*.. ......#.. *#.#....##
#...\... *.*\...... .\ #..*..     *..* ... ..*..*..* .#.\ .\...  ...#.**\*#  #....   .\..# #.*   #.#
# ...#..*# *.\..##. *.. ##\*.... . *.... \.* ... ..... .*...\\. ........ ..#. .** . .   ...\.. . .*#
#. .*.*.#*..#. \#.. *#.#. ..** ......* ........#\ . ..\...#..#....  *.. * *.. . .. .#.#... **.*. .\#
# ..#.   ....\.#...\....# .#.  ... #... .....#* . ..#.* ........ .  ..#...#.\#. ...\....# \..*..#  #
#. ..#. ...*...#.........*. ...*.#........ #...\... .#*...#\ **.. . .*.#\..#.*\. ... ...\*...#.\..##
#. .# *. *.#.\.\ .#...... *... .\..# ..*.* ...** #  ..*  .*#*..* *.#* .*#...# .#\#. #. # * *... *. #
#..\..# . ....... ...*.#\...#*\. .#.*# ...   ......*.#*.##. . ..#..#. . .#... .. ..*.\..# ...# ....#
#.....*..#..\.# . # #*..*. ..*...*.*.....\... .\\....  . ..*..\*.\ . ##.*... **.... .. *.. .\. ... #
#..##.. .*#.... .#  ..*.\...*.. . .#**. \\#..\ . . ..* .*..  # ### ...*.#....# *#   .... .\. .. ...#
#\...*..\ .\.\.. .. . .*....#..   ....*\...*. #.#.#.# .....\  #.*. .\ .*.. ..... **.\.** . ...*.#.##
#\.\.....  .  .# #. .......\.#. ...\.\.... .. *  ..*. #.. **..  ..... .. ...#... \#. .#. ..#..*.#..#
#*.*.*# #.*.#....* **..*. .. #. ...\....\.#. .#.#....* \..#.*.#. *.*.  . . \.#. .. *#..*..\... ....#
#..  #.*#.**\\.\.\...# \.* .#... ...##. ..*. # .#\.   *....\. .. . .# .. ...# .. ..#.....\  ..... .#
#....*#\**#... # #..\.   **# .#**..... *#...#..#*...\. ..*..#.*.*. .\..* ....*.\..  ..#. .#.* . ...#
#.#.... . .# .. \.....#..\*.#.  ...* .....**.... \... ###..\ .##.... #*.#.. ...*.#......*...   ..\.#
#.\#......\......  .  ....  #.#.#... .. .... . ** #..#......*... #....#\...  #   ..... .. *.# . .*##
#..*..\\\..#. . ....*#...*. ..... .#. .........\#.... .....#.. #..........\##..# ....##.........\.##
# ...\..# ....#** .#*  . .. . ..*.*..\...* ....*#. . *..** #.#\ .. \..*.#**.*.##.... .... ......#..#
#...#*.  .##.* .* * . #... .#\ .    . ..#. ****...*.\.\.*.. #\.#*#*.#..\. #*.....* ..... ...#......#
# . . . \... .* . .*...**.*...... .  ...#\ ... .. ..##.. ... .*.*.......** *. .. #*...**... .*.... #
#. ...\.#..#. .. #.... .**. ..#. ...... .* ..#. . .\##..#\....# ....  . #*.....\ .  #.. ..#\ .#..  #
## ... ..*#.  ....##\.#..#**.. .#*. * ....... ...#. **....  .. .#* .. \#.. *  ..#..*.... \ .# .... #
#.#. ..* *....#. \......  . #*.. .... ...... ... . ..\ \ .*.\.*. ..**  .*.# .*... *..*........* .#.#
#.#..\*#*....***#\* *...... .. . *.. .. .... . ##*..#...*.# . . .  . ...#..\..** # \...*....# ... .#
##\*#*.#...#...*. ... \... *.\ .. .... ..... .... ..#..\....#... ...*.#.#......*.....#..  ##...\...#
#\  .**#.# #... . . * . .. ... \#.. .#..******.*\*.#.#*.*....... . .** ...\.......*  .*..###. ... \#
#..*..........*... *.... ..\.... # .# #...#...*. . ...# ..... \.  .#... .*.#.  *.\... #..# #.*.##.*#
#...* *. \.#.*     #   .  ##... ..*#..  .*. ....\*. ** .*.*#*....##..*\\..*#.* ...\....# ....\#...##
#..\\. .. ..#.*  ..##.#..##**...## .  .* .*  #.\.#............**.....*.  \. .. .. ....**\#.... . .*#
#... ** .   ..*.......#....*.    ....\ ...*...#.*....#.... ..\. ... . .*..#....*.......*...........#
#....#. .\*...\ . .. *.*\....*.. \#.\#..#..*..\.... .\. .*  ...\ *. \..*# *.. ..* ... #. .. ...... #
#  * .*..#*#.. .. .. .*. .#....\*..#*.\** ....**  *...#  #.. ... .\\ .... .*. \# ...\....... .#*...#
#.. ..#. ..\... \..*..*# \.. .... ..\. #. ......#..**#......#. ..# ..\ .* ..  ##..........#..\. ...#
# ..  .....*. *#..*.#... .* \  ....... ..#... .... ....# .*.. ...#.. \\ ... .. #.... #..#*...  .#* #
# . .\. .*#.... .#.\.... #... *.##..* #*\ ***.*# ......#* ..# ....#..#..*..\..  ..# .. .#.\.*.#\.#\#
#  .. .  .. \..*..*. ... .......*..*..*. .#... ....*.. #*.#...#   .........##.#.. .\#. .#... \*....#
# # . ...... ..  . *.   # \.#..#.*.   . .........*.. #* .*.  .. .\\..#.*...  .*.. ..*.#....# \...\*#
#.   ..*#..........\..##.\*....#\...##*.....\.#\....#.** ##..#.*......* .... ... .#.... .. .**.\..*#
#.\...#.* .*.. #..  ... ..\ .*.  *#.#.. ... ..#...#*..##**. #..**\ \..*..#.  .*..#\*.......\#*.*.. #
#.. *##. ....#  ......#.*# ..#. # .... .. ..  .. .  ...\.#.#* ..* ..... ..\... #.#... .. ##..#...**#
###########################################################################################L########