####################################################################################################
#..# .#. *.....* *  \....#  .#.\##*. *#....... . .*. ....\ .... ..#*.  .....#.**#.##*\...\#**#...*.#
#.....\...\.#. .#.*###  ..#...#....#.# ...##..... .........# **. ......*....#  #.....#.. ..* ##....#
#. .. .* #. \*.... .\#   *. ......*.. #. . .\  .   ... #. .......*..  .... .\.*..## **.\ .\#.\*... #
#.....*........ #\..... \*.\...#.. \ *.#... .#. ..*.. #.#....\...  .\.\*. # . .*.. ....#. .. ......#
#..*. \ .#.. .\..#... # ..\.\.... .\... #.. .*....* #\.# ....#**..# .*. ..##\# ....##.  ....... .*.#
# .#\..........  \ #.# ........*.. ..\*.... .* .... ...#.*.. #. #.. #.\*.#...  .\*# . .\...*...\.#.#
#.#.. ....****... #.#* .# \..... # .\ .#...##.* . \. .*.#\.#.#.* \  . .  .#..\ *.*. .#...\...\.*. .#
#.. .  ** ###.. ..\*..#..#..  .\#*.#.*#.#.#.#.#... ...  ... .#...#*...* ..*#.# *.  .. #.. *........#
#*# .*\..#...\. #.. . .# . ...# .*....# ..*.   *. ...... ...\*...  #..\ .. .  . #...#.\.. \....*...#
#..* . . .*...\.*. .. #...# .....\. .. .  .*.\. #.. *. #\.*.#.....# . *#. #\# .#.....\....*#...#.  #
#...* ...*.... *.*.*....#  . ..\ *.*.#..\....**.\ .......*..#*........ . .*.  ...*  #  . .#...... \#
#..# .* ... .\...*. .\ .. ..#.... # \\ ..* ...#.....*#.#. ..#.. .# .*.\.. *  ..*.*.\...*.... * ..###
#.......** . . ....#*\# ......\*.#\ \*....#*..  .*.  ..** .*   ....*\ ...#.. .....  .   .** ...## *#
##\.\\.*...#...\.*. .. *. . .#**. #.. . . ...\. *....... *.. ....*.#.#.......*  . ..* .#. .#..#\ ..#
## *. ... *..\.*....# .#. . \* .*.*#  ..##... ..  *.#.*\..* .  . ....**.   .##\. *.....\#....\... .#
#.    ** .#.*\.* .. .. .... ..*..#* # #...#* .... ...*.  ...#.... *    .. ...#..*. #...* **\.*#....#
#. . .#. .#..#. \.*.. ..*#.*...*..#. ..*...  .......... .# ......#*.*.#. .. .# . ##..*.. *... \**..#
#..   ....# #*.*  ... ...#.#. .  ..\*...  ..*#.\*...*##.....## . ...*..*#..*...*.. ..*....\. \\#*#.#
#..  * .*..\. .  ......  .#.#.*#.# ##*..##.    ..   **#.#.   .. .#... .#* .R..*\.*#.* .  . ......**#
##\...#.. . . ... .#\.\...# ....... #...*..*#\.....#.**. .#.*. .... .*..#... ......  .. * \. .\.#..#
#. .... ..... .\.. *..\  ...\ .. .\*..  \.....#*.. ...#. *...* \... ..#.#..  ##...\ ..#...\\*#...*.#
#. ..  * ..*..*. ..#.. ** *. *..*  *.. .... \..**.\... .\ ... .. *  \... .*. ....*#*.. .......# . .#
#.#..*....**.##. ..  ......    .#. .... ..... ....###.*.. ..  .#\....*.*.* . ... #.\. .\.\ .. .... #
#*#\...* .*... . # ..  ... #. ..#... ..\....* .... *.... .  .#.#..#.* ...  ..\.. . .. #.*#.#.\.*.. #
#. .#  **\..#.**\. .*... ....# .. ... *.#\ ..*.  .  .##.  .  \....* * \*.#.. .. \.. .**#.\ ##..  ..#
# ..... . .#.......#.  *..\..\*.*.. *\*  * #\ . #.#..... #*..*....#..... *..*.*..\  .  .. *.*#..*. #
# . . .. ....  *.# . ... #**....**.  .. .#*  .....#\*.# ... *.. *....\..#...\.# ....#..*..##. \* ..#
#....*..#.\..#. ..*.\.*..... . \.. ...*....*.* ....*...... .. # \...#.#*.#.  .....**... ... \.*\ ..#
#. ....\#......... .#... . ....#*#  * ... ..*.# #....* .. .#  . ......*#\ .*..\# #..** #....  ....##
#. .. * ...   #... * * ..\. *..... . .*#.**\...... #.*....**\  .\#..* ..#. ... . .... ##  #. . ....#
#.\* ..*. # .....  ..*.. *  .   ....*\.*  .#. .*. .. *\\\ . ..*......#.# .\.#.# . .#..# .*\ .. #**.#
#*... ..##..#... .#. ..... # .*..** ... .* .. . ..\#.. .... .  ...#.\..  .\.##..#  ....#*... #...*##
#..# ...*#.....#. ...*... .##..#  \ ....#.....#. ..  ...#.... ..... *#....*. . . ..* ...*  . . ....#
#..\.....#. . * ..... \*. **.*##.*..* .*.*...........#*......#.. ....#*.\.*... ..\..#.\\.\ ....   .#
# \.*.. *.. # #.\.*  ..**.*....#...  .*.\..  ..      \. ..... .... . ........ ..#  \..  *..# .#..# #
#. * . ....*.*\.# .......**........#*.. *\ #........ ...  .\\........##.\...\.*.\. ... .. ....*\.#.#
#.....#  .\...*. *#.. . .... ..#...#..*.*.    #.* ....#... #..#*.. ..# ..#*#.  #.#\. .. #.......#. #
#.. # #..\. #.#..*#\. .#*.\#.\**... .. #  . ......*.*#\... ..  . \ .....*.. . #...\ .#. .*#* . ..#*#
#.. #.... ........\.........  .. ..\# ..*#.*...\ *#..*.#.... ... .. .** .... .. .* .*#..*..#*. ..  #
# *  *  #.. . ...#..... . ......*##***\#..*.... . \....# ...#. *\....# .\ ....\* *#\..\ ..*# .. ## #
#   ..*  #..\ ..#. ...#....#.**. # .#.......\*  ....\. .....\... \......## *.**.*#  .. ..*..**.**. #
#.. ..#.*... *......# \## .*#. ... .*.....*..#  ..#......  .*.# ** . \ #.#*#.. . .. . . *.#.*.. #  #
#... .  ..*.\. ....#..\ *....  .\.... ...*..* . #.* ...#. .. .. ....*...... **.......*.* .... \... #
# #.#.# #....*...*... *..#.#. ...##.\.. ..   ..#.##...# ..#...#.. ...*...* ...#\..#....\#. .*.  ...#
#. #.  #\# .....\#.... ....*.*..*. *\ * #. .#.\#.   #...#.  #*\ .*#*.. #. ....#*.#..\ ..##..#..  ..#
#. # ...\\.#. *.  \.... ..  # .  .\ ..# ..  ...*.#. *.*.... *.. \.#. ....  . . #  ****## #.*......*#
#...*......\#. ..# #\ ..*\..... .*  ..**....#.....##.. *... *..*......# ....#........*............*#
#*..#..... .* \ ....*.* *..#...*  ..# . .#...*.#...* ..*.. ...#  .*# .*.\*.. #...# #..*.. . ..\ .\ #
#...# ....#* #..  .... .#\..**\#. \.*...**.#.#.#.#*. .. ..\.*. #.*.*.....*..\#.\ *...#....  .#   *.#
#.##..* . *... #.*.  .*. ..#\...#\.  #. ..#.*.\...........#..#.*...*..*. # ##.. #\..#..* ** *.*....#
#.\\..\ ..#\ ..* .**.....  \#...*..#....*#... #..**.........#* ..*.#** . .... . #.. .  ... ....*#..#
#*.. .*. .... #.  ... # ..*.#.......*.....* \.. .*#.. ... .......... ..... .\ # ...\... #. #...#. .#
#... ...... .. ... ...#... ... .. ...... \##\ .\..\.\..\. ##..#. .\.. *. ..... .\ ..\#.. .\.\. ...##
#\ .*...\\.......#.... ...\\.\*#\*# ......\.#*.#.\... .*..**. .... .. .#. ... ..* .. ...**...#. \. #
#....*#.*.**.#\ \..**.#..# ..  \ # *..##.. . #...\*...... ...**#. ....# .* ... ... ..*.#.....#.. ..#
#.*....  **.. ..\...#.....* \\. .... .. .....*..#\....*#\ * ...*.. .... #..*# # #....#*\.... #..#. #
##.*...#..\... .. *\ .   ...# .*....\. . .*..*  .. .*.#.  \ ....#.......** **. # ......*  ...\*##..#
# .. **.#.....#.# .. .. *... ....\*# .#. .#\ .\  ..#.#*. \  #  \.. . .. .... ..*........#..*#......#
#*.. ....#.......#. .*..#** *.#\*..#.\..* .*.. .#*...\.#... ..#. .... **#...#..\...* .  \..*.....  #
#... \#...*....**.#.\**.....*.##...*.. # .#*... ...   ...#.# .\ ...... .*.#..**..   *.#\..#...***..#
#\. ....*.  .*##*. .....\*..# ..#* ... .\.\#.....\.  \......  ...   *.#. .... *. .  .*.. \..... *.##
# *...#...*... .*.... ...... ........ .. ..... . .. *..*.\......#.... *#....**#. .. . . ...#..*..#.#
#. ...*. * .... .*.\...** *#*...... .\ . .*#  ..#*. ....*#..  *#..\ #.*.....#*   #.........#..\..###
#. .... ..\ .#... ........ .**.*.#... ...#  #*  ..#.#. ..#*.*... ........ ..***# #**  .\ . ..#*#.# #
#*... .*..#\#..# ..**# ....... *....## *\.*#  \......*.. *\#. *....*. ....# .\....# ..  ...*....#.*#
#. .  ... \#\##*\.. .  .#.##.*....\..#....#. *# *.*.** *.*.\ .. . .... .#..#.  . .   \... \*... ...#
#...#. * ....# ..*\*.  .\..*\.......... .#  \ # .....#.*. ...*. *....#.#.*\. .\..... ..#...#.# ....#
#*...  .\*.*..*.\..  . ..*#.#  .\.. # *..... *.*. \ ....#*.* \. ......... .. . ... .*....*#.*. \. ##
### ..... *....\ .. *..*...# \..\........\..\\. .... ........*..* ...\.#.** \. ..**#.#. ..*.. .  ###
#...\..**.....*#....\.. .\ .....*.* ..*.#.#.. #.*##.* ..*\#  . *.... ..\ *#.....*... \. *.## .#**..#
##... ...\..* .. *.#. #. * #.*.  ..  .#...#..#.  ..## .* .... . ... ....#.#...*.. *. .....\.\ . .#.#
#...##..\*\.\ #..*#.*  #. ..... ... .. .*.*..\ ...... \..*#. ..*##.**. *#...* .#..*.*  \ #.*.*. .. #
# \ \ #.. # . .*.. ###\...*.... .#.....* .  . ... #*.  .#. ...\..... *#..*.. .... ..* \ # .. *. ...#
# ..*\.* #.#*  .#.. #.*. *#....*.#*.*.*....  .*..  # #.*..#*#..*.#.\#  .... \..*...#..** ...#....#.#
#..##.#.\.......... . ...*.........  . *  .\.*\... .    .*.. ...  # . ... .##**  ...*...*.#....\ .##
# . .....#..  ....  \.#  .. \..#. .....* *#..\\... *...... ..**..   ..*#.. ..... ..  ***..*#*.*.*\.#
#.#  #..*..#. ..*.. .#. *.#...#.......##.. #..\*.....*..*...\# .    *\.#.......##....*..* .  #*... #
##\ ..\.##..*.. ... . ... ##......\\...*..#  .*..*#*.*...*.. * .... .*.. ..  * #.. .#.... .\ *.*.. #
#. ....*.#  ..*...   \.**.*.*...# . #......... ..*.\ .... ....... ...*..\ ...# . #*#. ...#..*.*..#*#
#..#*.# *.\...    *. .#.*....*..* #\.  \ \...#\....# **......\ .#.*.... ...#.....\ ... #..\..  ....#
##.\..*.#  . . ..#.. .# ...#  .#. *....   ..#..** ## ..**... * ..   .#... . .#*#...*...#. ...  #. .#
##...*#.... #.# ....## . . .. . .*.#... .. . .  .*... ..##*\..\.. .. #   .#.#.#....*..\......*# ...#
#.*..\..#. .*#\# ...   .* .*...... ....*.. ....#.. *.. ..#\*.\ .*. ..#.....#.. .#.###..*... . ..*#.#
#..**   .#.#  ..*... .*..  . . * #....*.#... ....**#.\*. #..*\**#.  . .\ .\.... #..**....... .\..#\#
##... .* **....* .. . .* *#.#.*...\.... . .\ ...# .#\.\ .... .\....*#.. ... *.\*. ..\*...*........*#
# *. ....**.#.  .#  ..*.. .****# . .. * .....#.*.*..*.........\..#.. ...*\ #..\ .# * ... .\\.... ..#
##..*.... ...##* ..*. *..  ...\ .#. \.... . #...*.* .#. .# .#. ..#   .... .. .. . #..\#...... ... \#
#\*.. .*..#..#.#. .*... . *..*# . . ..  \#\#.#. .. **.#...  \.\.... ...# *#.**..  ....#.\...   ....#
#.##..*.* ...  .#. .\ ..\.......# ...#.......*.\.#.  .*. *  .....#.*  #.*\ .#.. ..* .*.#..#\ \....##
#. . #.\.  **#.#...*.#.  ##....  .\.. . ..#...\......\.... ...  # *  . *...*.**..#*.. .. #.*. .#*  #
#   . .**.# . ....#..# * .*#.#.  . \ ... . .........*.#.*...*. .....\#.\....#.# ... *.#.#. ...# .\ #
#..# ..*...*. .#.*..#......**. ...*.....* .. \##.....**.*.. **.#....#*. .\...* ..#.\**....* #\#.*..#
## .....  .##. ....\ #.\..... .. ..##  .... ...*..  . .* #...*\.#\... .\.. .....  \ ........ .\*#. #
#. #..... *.. . ..*.. .... .  * *... . ..*....#  ... * ....   .\..#. ...\.. . .....#. . ..*# ..#.*.#
#.#  .....#.. ..*#.* .#....#.# #\.# *. *. .. . . . *.*.. ...... ...#.....  .... ..#.. ....#    ...\#
# ... *. ..  . .* .***#.. ...* *.... **.. #....... .. .  *#*. #\*.* #. .. ...\.  . .# . .### .\ ...#
# ..#.#...*.... ..*.#  .. . ... .....\...\.  * .  \ ..\.\...#.*....... *..*..*#.*.*.# *. . *.. . #*#
#   *.*........\#.#.....\*.  .# ..*\* #*#..*....... *\..  .........#.\*#.*.... ....#.. \... ... #..#
#############################################L######################################################