########L###########################################################################################
# #.# \ .*\   ...#... #..*  #.# .# .. .*..\. .. .  #\. .*  ...* ..#..##..\# ..  .*....*.... ......##
#  .*....* .. #... .. . .. . . .. \. . . .# \... *..*  .* ..*# .**. ...\... .\... .#* . .. ...*.*..#
#.*. #. ..*. ...* .* .... *...*\.#.\ .# ... .  #....#. ...\ ...... *.#..\. ..... .   ..\..#. . ....#
#...... ..#\*....  #\..*...#..\..*## .  #...*...*#. . .. *...#...*\#\# .. ..#..##.#. .. ...*..\ .*.#
# .#.***  .* .... ..#.\..#.#...**..*.. ....#.......  .*#.#\ ..##*. ..... ..#.\  ... ....*. .#.##...#
#..#   .*... ...  ..... .. \ \ ....#.. ...*\..*....*...#..##..... . .#. ..#\  *...  ..*  ......#...#
# \ .#* .* . .# ..  *\.  . .. ..#*  ..**..#..\...*. ......  .\**..*..*\. . .*..#\. ....#..#..*...*.#
# ..#.  ..#.\.#.. ...* .#*...\..*.\...\.....*......*.......*....*.. ...* .. ........*. .. ... . .. #
#..#*.. \. *..*.#.*.... .*.*.*#..* \\..#*.#.... *.. .....#...*..* .*.. \#..# ....# ....*...   #....#
#*.... ..#.*.. * ....* . .##. .**#. ..... *.....*..#.. .###. . ... .... ... *..*...#. # . . .#..  .#
##.  .* * . .  ...#.....\#.. . ..*.#   .....#. ... .#.R**.*.....# ..*#*...#... ..*... #..* ... . \ #
#*..#.#..*#. ......#.... ........**#. . .\...... *.#...* . ..\..#. .\ . ...##\...*. .....#....#*...#
#.......#.*......#...## .#.*..#.#....*#.*...  ..#..#...  **. .. #.... ..##....... .......#\ .*. . \#
#..##. ..#.\.\.*\#. .  .... #\  ..#\\. ..#..#...... \ ..#\..*. ....#..*..*# . .. ..* ..* #...  # .*#
#. .......\....  .. .*  . . . ... *..\ .  #*..\.. #. ... .# #. .. \.#\...  . #. . #...*.  ..    *\.#
#\..*.. .###.*.. ......*.# .*.. ....\......*....\*.*..*..*#..##.\...   \ . # .*\ *... .. ...*.*# .##
#....* *......*.*..##..\ *..  *\##. .. #*.. .#  .....#   ...## ...#*....**\...#. . . .\ #...\\ ..#.#
#.#*..*... .. .#...  *...*..\......\  ......##*\\..*.#..#.. ...#. *. .#.#....... . . \. # .\\..  . #
#..* *#..#... ..*. .......... ... ..\ * . \ .. *.\....* **.* . ......  ......\.#*.. * .....*....\. #
## \**..*   #. # ..  .. ..*...\ *. .. .....#*....  * ##..* ..#..**  \.* *.#..#....* .. .#..   ..##\#
#*.**....#*   . .# ..# #. .#.*..\*. #.*.#.#.\.\#*# ...  .. ....#**.#.***#... .. ........* ..*. . ..#
# * .... ....\. #\\.  . .\.. .  . \. #.*...## #. .*\.. ...*....*. ..\..*.#....*.. *....#.*...## .#*#
#...#..*..\ .............*. . ..***....\#*.*. .#. #...  *# \..#..  # .*.  .....*\\.. .  *#..# .#.* #
#.*... #\ ......# .. .#### .....#. .......# .#.*...*  ...# ...#.#..##*. * ..\ #\.\..*.... ..*...*. #
#..#.*. *...* # *#.. #. #\.*. ..#. .*... *  \.# ..*\..... #..##...\ ...*.. ...#..*\..........*.#\..#
#*.*......# .\ ..# **# .  ..  .\..#\#...  *..*. ..\\*...\..*#.....**... .... ..#....... ....*.*.*. #
#. *#. .\* ....*..... . ..* *...*. *.. . *.... *.*....... .    .. .. . .*  ..  ..* ..\ . \.*#.\.#*##
#..** .... ....*.*.#. *.#.#...#... #...#\.... ..#........*..#...\# .*..*#. .*#.*..*. .... .*.......#
#. \ ... .. \#.. .*.*\  ..#.. * ...*.. .. .  . ..\ .....* * *.\.......** .*#...#. #...... #.. .. . #
#.  ##..#. .....#...\.*.. #.. ... ... *...**.. .* *\..\.......#.. . .. #...*...... # #.... ..**  .##
#.*.#\... . ... \   .**. ... ....... *. ... . .*..#..#.\.......#.... *.  . #. .. ......# . *\..#.  #
#..* ..*\.* . .*#  *..\*..*....\..#.  ...... . .#..\ . ....*... ...## *...##.... ..\..\.*...#. *.**#
#......#\#.. . ..#.*.. *....... .*  ...   . ...*..*.. ...  ##..\...\ #   ..  ..#*#......  #..# *. .#
##.#.  * .*  #. .*...*.*##. ..  *.*#... ... #.# .#.*.\.  .* # *#... #.***# * .  .#.......#*#..#. * #
# .* ... \*. ..\.  . ..  .\..#..* ..  # ..  #...... #. ...*.. .. ..\....... .*  ..*#....#*...  .*. #
#.# .\#*. #\.*. ........ ..*#.*...#*\*.#... . #.##.. ... *. \  .#*## ...  # ..\ \....* ...* * . \ .#
#.*...# . .\...\# *..#..*.*#.. # *. *.....*.  #. ..#...#.*.* #.....*.....\.*. . \*.*.#..* .*.\.#  .#
#...*\  .. .*.... * *......# .#*. .*.*.\.\.. .  .....  * . * ...#\.\*.....*...\*\.#  #*.. *..*.... #
#.*\. ..\..*.. . # .*  ...#. .#\.\.#.   ..* ..**..   .#... .#.**# ...#. .*##..\..... .  *# *\.*.. .#
#*  \...## ...#  .#.. ...*# ....*\ #.#. ..#.\.*.* .#  . #.* \. ......*.**# .\*#.....*.**..#.#.#\ . #
# ..#.#....*....*** .\... ..* *..... #  .. . .\\. .\ ..   .*. ....#.. .. \..  .#.... ..#..#.. .#...#
# . ...... ..* ... ## #.\. .#.# \#*#*..\.....\  ..* . ...*. * . * #.. ... .*........ .*. .\..*\ ...#
# \... ........*  . .....#..* .*.. ...*.# *.. . ...\*....#.#.....*#.*. ....#.#...# #.#.\.*...*....*#
#..#* .*\... #.. .#..* ..... ..*. \.\*.\\..#\#.#..  \ .... ..*...*. .... .*..#.\..  ....*\#.#*#.#..#
#....#.# . .#.. .#...#\*. ## .# .* . ..*..* . *.....\*.#**#..... *  ..*.  \. * ..* \...#...#......*#
#.#. ... * ..#. .  .# # .*.\. *..... *......*.*  *.....# .....#. \... ..*\# .  #...*...*. #.....  .#
# #. *... .*.. ... .#..... .. \.\ ....\.#... .\\.#..  *#\.#. . ***..... \###..#.##.#\ ***..  .. .#.#
# . ...*.... .#\#...\.*\. . \\.\..  #...#.*#.*.**  ....*   .##.. ...\........ .#.......\ ....... ..#
## \***..**\   #.##*. .#. .....**..  ....#.. .... .. .#.*.......... .. ...# . ... *...*..* .#..\.\.#
#. *\...  .* .#   *... ....\#*........#.....#**..#\....\.#*#**#\..\.\ #*..*..*. .##. . # ##*..*....#
#... *. ...# .. . .... .# ...*#.. ....**.... .. ...... *....... . ..*.\     . ..#.... * . *#.. ....#
#*...\ .. ....#. .\.* .. . #.\#.   . # ..#\..* . ..*.....\. .  .... \......\ .  *.... ..*.##. .# ..#
#.. #   . . #.\...\....#..#..*.. **. .*  .. .. ..#.\.....#  # .... .. #*.. ....#.*..*.....*.. # ...#
# .. # . ..#....   .....#*..\ ..\ \... .. . #..*. * *....###.\....  *..#.....*..#.. .* ...\.#....###
##  .... #.. .. ...#  *. * .. ..\ . .# .*.... ...\**..*........*...\.... #. .  .\*.\ *.#..   .. ..##
#.*. \#.*..  ......*#   .... ....#.* .#. #. . *.*....## ... \\...\..\.. .. .   ..# #... .. ..##.*.##
#**\*..\\.*... .. ...*.*...  .....*\..#..#...# ..#. .. ..*..\..... . .. #. \.. ...* .. * . . .. \..#
#.\. .#..*...... ... *...*.... . ..  ... .. .#.. ..# #. ... .\   ..#.......#.**...\ .*.. #.. ..#.*.#
#.#.*.. .. .**....#**.#...#..#*. ..   *.. #.* ..#...  ..*  .#..\. . \......\. .. .\. *. ..#..\*#*#.#
#  #..   . #. ..#..... * .....# .....*.*. .*.\. .#..*#.. .. .# #...*..*. .\..\#....... .#. .#\. ...#
#.*...*.#. . *#..\\#... #..* .\....# ..\ ..*#...**...\.....#. \ .. .#. .*. #.*# .....  *...*.. .. .#
# ....\#. ...#. .\...\ .. ..\   #......# ..*..*..\.#..... . .*...*.. #* .*....\..*..*. .. ....*...\#
#....#... * .#..#... ..#* .* #... .*..#. #.....   . ...\....#.\#*\... ....  #. #..  *.......#..* .*#
#....# . .*....* *\ \ .. \..  .#  \ #.. .* . .* .. .. .....*. ..\  ...\...   *. *.*#...*#. \##.. .\#
#.....\.#...#.....#... . ....#...#..........#..*. ..#*....  \*... *. ......... . .*#. ..\..*... .#.#
##. .*..\...  . ...##*.......*.*.*..* ... ...# .* .# #.*\\. ....#..\. ... ..##........ #\... ..#...#
# ... ...* . #.    .. * * .*\. .. # ... .  . \ . #. ..........**.*. #... #.#..... *.. .#* *...\ .*.#
#.#.....\.... ..*\..... .**\.*..... ....... ... .. .. ... .*# *....#.#....# ...\.* *#*#...#.#....###
#.#  ...*..\........\..\. ...**.# #... ..*.. .*. . . #...  .#. #.#.#.*\. *.. *. .. #.#. *.. ..  ..\#
#.##.# .*  *.*.\##..*.. ..\..... ..#.## . ..\ *......\#.\.. ....\...#.\. ...... * ......  . .\. ...#
#.... *#..\.....#*.* . ..\*. .#. * ... . ..\.....**\  #..\..#.\..  ...  *. .\......*.*.#.  ..#*. ..#
#\.*. *.*..*  ##... .. #..... .#.. #...\ *\ *....# ...*... .. .#.*.#.#. #......# .###.\. ... ......#
#.  ......** . .*.. .*.   . #.*. *..\#*# ....*#..\ .#*. .\\ .#*.  . .**...* ##.. ..\.#.. ....*.* . #
# .  . \..# ...#.. .#. ..   # ..#\ ..*#\\#* ...# ..*.....*\.\.. . .*.... *.\.. .#  .\..  . .#..*.  #
# #..\.**#....\.*.........**#....#.#  **.*...*..#. ..\.. ..##..*#.... .#. . .#.. .. .*\..... ..  ..#
#..\  #..#. ..... .*.. . #.#\#.*. .. ..#\.. .*...#...\...# .*.##. .*. #...\. ..#.. \#..*.*..#. .. ##
#*. ....... ...#.*\..#\ .* ..  ##\ . .#  **..\#. .#..#..\.#. . \. .. \... .#*#.#\.#.....*..\#.... .#
##.*.*.*..  * ## ......##.*. ..#\\.....*.*.*.... ..**.\.#**.....*. ....# *\...... ..#  ...  .#..#. #
##*...*.*#*.. .. *.  **#....  ....... . . *#* *....*\ ##....  * ......#.  \...*.\....#....\..# .*..#
##**.\# ..  *..... \  .\*  . .#..*#..##.. ..#.. #.... ....*..#* ..\  *.. .... ## \#*..\. . \...  \.#
#.  *.....\. .*.... ..#.. ...  *.....#....  ........#\*....#.*..\.#.*..... *..**.# .#  .##.\. * #..#
#*.*.# \... .  ..#..*. #.  . ... #\#.. . .#\ .........*.*..  .#.  .. .* ...##..#.\\ # ##*. \.#... *#
# ...#* \  ... * *#.*. .* ..\..  .#..\\\.**  .\..**.  ...*..*\*\..... . . ......\ .... #  .... ... #
#  ....*. ..  **. *...*.#\\ .*..\ # *..* .# .#. ..# .#\\\..\.# .....\.*..*....... *.*.. .. .. .... #
# ..#........ *..#.**#..## .....*. ... ... *..\..*#.. ...\.##..#.*. \.\...* .. .*.........# .......#
#*.. .#...*#  #..#. #...* .. . ....  ...##.#. .#  #....*#... ..#..#. #.#.....*.**.\#. \#...... ....#
#........*...## *..* .. .*...*#*\.*..  \.... . .. .   ....# *..* .*.*#..\#* .\.. #.#..#......... #.#
#\#.\*.# .*.# .  .*.*  *#. ..  ...* .. ..... ..#. .... #\...\.*.* .. ** *...  \\#   .#.* **  ..*.# #
#.  . .#....\..# ..##.*. .# .* # . ##.\..... .    ...\.#. #..##.. *. .... ..*. ..#..#  .. #.... **.#
#*.#.*# .*. *..... .... **..  ..*....#.*. ...... #........\.. #. ..... .*.*..  .\....#....   ...#  #
#... #*#.\.. .......# .. \.* ...*.... .. #.....*\ ...\.\ .# *..#...*. . .   .*.#* ..* .* .#.  . #..#
# \.**#... ....... **.. ..#...*....*..*\...\..... .. \ * . .*  .... .......# \ ...#..\ ...  ..*#..*#
#....*#. #* * ..* . .. *. .#.# .  ... #... *...#.##*.. . . #..  *\........ .....*....# .. #.#.\..*\#
#..#..  #.*.. #.... .*. #..  .*  ....# .  . . .....*..... \.*.*****. ..\... .* ....*..  . .  **..*.#
#..... .*...* * * .....  #....#.#  .#.*.# .....*....\* .\ .. ..*. ..*...#.#* #. *...** *. *.. .... #
#.## \##. .*  .. .#. ...*.....##.*.# #..... \.*.*.... . * .....#.\... *....#... ... .*.*\#... . . .#
#*.\.*. *....\.. ##* . ...**#.. .  *.. ..*.\\. ........ \.  \.....*.. .*... #*#..  ..\...#...\.. ..#
#.....*..*..... ## ..*.#  .....*....*..# ..*.. .#. .# .\.  #.\# . ....#*.* # . .##  .#. ...#   . . #
####################################################################################################