####################################################################################################
# *# ....*  ... *. ......... \....   .. #.......*.#*.... ... . .\ ..# ..  #..**.....\\...#..*.. *. #
#.. \.#.*..#.. ..*##  .##\.......*\\ *  *\.*#.....# ......\. #\.* #...\  .........#. ... ..** #. . #
#  ....*. .\...*\... *..  ....   .. #...*# .  *\ * ..\. .* . .*...\#.# . .#..* . ...*..#.. .*...#.\#
#..\ *. .\.*#*....#..* .  .#..*#..  .\. . .#..*.. ...*... .... ..... .   # ..*.. ..... .  .#..*....#
#   *.\#........#*..  ..*# . .. .*.\..*.#\ .*..#..#\#**..  ....*..     ....*.\*.* **.#.#...#.#*..# #
###*#*\.* ... ..*##..  .. .*  . \*# *\.## .....#... * . .# .... .#..  ..# ..* .. .....\#*.  *. ..  #
#...   ...#. **\. ....#.... .#.. ..*. # *.*#* .. # #.# . .  \#..**..\..... ....#.  . *...\..*.\.\..#
# #\..... .... ..\* .#*.  ...*.* ...#...  . #.\.. . *** .... .#.*#*..  ...**.... ###.\ .*#....## ..#
#.  .*... ...*....  . #..*... \ .#.   . \.  \ .####.......#..... . ....*..... . .. #...*. ..# . *.##
#... .##....#.*. . ..... . #...*..#.\.#...#..*...*. .. *\#... *.. . .. *....*\ ** #. . ....... ..# #
#  . \...*....*\.  .*..*.#*.......#  \...\.. ......*...\ . .#.#.......**....#...\............. .##.#
# .. .. .......#*..#. *... #\..#**... *. ...#....* #. .  .... .*..*..   **..  #....  .. .#....*\  .#
#.#.#. ....#...#  #....# . \.**.  ...\... .. *...   ....#.. *..*...#...#..#*.#......\...#.... .. . #
L *. \  . .. ...* *...*\\..... #. ..\ ...\. .... * #.*....# ...*.#.........  .# .. *.##*..... *.. *#
# . #..*. **..#.*....\. ..#\ .*...*# ....\..# ..#.#......\*.... ..   ....\.... .*\.#. *.#. #.. ....#
#\.\.#. ...... .*..\ # ...\ .... \*. .. ... #*....* *.  ....... ..\.. #*.*....#.*....#**.... .. ...#
#. \..#...\*..... #.#.   ..##.*.*.... ..*.\. ....#.\.........*. *.* ....\#...*. .......#\...* ... .#
#....*....  . ..\*.*# ...  ..#. ..#....#.... ..\.....#..  .#.***..........*.... #....\...* *.......#
##. . #.  ..#\.*... ..  #..#.*\...*#.*.*....*.#.. *... ... *. **#\.\....\. .* .#.#\#. . . ..#\..* .#
# ......*.* #*.*....#..*#...## . #.. . ..#..#..*... #.. ..#.*  ......##** ....#..\\. ....#..*..*\ .#
# ......   .* ....*\  .......*...*  ......  *\..#...   *.*..**. . ......\. #.. . .. # \.. #. ..*.*.#
#. .##*.... \ ...*.*...#\.*\.. .*. . ..  .#\ #..*.\.#. *..#......... ..... ..##**#.. . ..*\.* ....##
#*  *.\ .. \.\*. #.##* .. *.#..... ...* ........*#**\... .. ..  #.....*... ..\#.... ...  #. ..... .#
# \.....*........ ..... .\. ......# \..#*. \. *.\.*.. ....*.*..*. ....#. .**.*.*.. ... .# . #.. .. #
#..    . .... .*..  ##*\. .#.. ... .\...#.*  *....... ..#.. .#.*.\. .. .*\..\.  . \. ..\.\#*.. .*..#
#*.. ..#  ...  \.. #.. ...... #.. #. .\. #..* *.*..*  # .#... ..*..... ...*..#..*#..##*...  ... *#.#
# .* ... *..    ...\#*.. \..... ..*..#.  #..*.*... ..\. \ *.   . ... . #\.....*.. .. ..*.\**.  # ..#
#. ..... \ *..#.\#* ...\.. ...*.*#.... . .#.\.###\...#.....*.. #...* .#.. \.......#....** \* ...*..#
# .... #...\..... .*#...... #.. *...\ ...\*...**. ..* .*\...* .*.*\ . ..\.\##  ...*\.......#.. ... #
#  ...*.## . .#. . ...#.   **.\.*... .. #*#. #...\  #.\..*.....*. .\. #. .#.** *  #.\*  ...... *  .#
#...\. * *............  .*..*.*## ..#. .....*.  .. \.  . . #........*\ .. .#.#. .. ... .....#..**.##
#.... .. *\...##. .*...# . .#  #...**\.#..#... . .# . ... .....\#....**. ....* ... ....*. *. ..#...#
###........ \.*.. . .# \\*...#*..\ #..... \..#. \........#.#.. .**.#.  #...*.##..*.. # ...\.* .... #
#*##*..  ......*. #\...*...*. ..#. ....*... \ #.  ......#*##......#..#.\ . .. ... ..##.*. .*#. \...#
## ..# .......*.  ..... .... . . ..\. .....\...#  #  . .#..*.*.. ** ....... .. \. *.....  .*#  .\..#
#\.. .** ...\ . ..#.*# .......#....**#..#. .  \ \..#.... \.*#...*\# *#.\... ....*...\.#. ...# #.  \#
#...#*#..  #  . ...   ...... ... #.*.  .\# .. * ..*....# .#*. #.#.... #*# .  . . .....*.   #....\.*#
##. #. .#.*..\.*....... .... .#. #.# ...#.... #. ..*. ...\  ...\...*\... .#* #* . *\.  * .\#.\.....#
# .*.\.###..*.*\ .#.#..  *  . *.#.#.*# .............*..  ..#\ .... .*#...#.. .....*#. . ....*.#. ..#
#.  #...... #.\#\\ .#.*..\   * .....#..\..#.## #*.... .. #  ...\  ** ##. .....#*  #. .#...\.  ..*  #
#*\*.. ***. ...  .......*.\.*.*#..\# \.. ..\.#..... #.\ .#.#..#..*#*\*..\ .*.*.   ... ...#....**.  #
#. *#. \ ..#.....\.*# .*   .  ......... \..... . \ . ..\.....#..\\.. .. .***## \... ..\ \*..\ ..#**#
#*.#. ...\ . . .. ..\.*#......... #  *...# *.*.  . **.#.#.*.#\\.##.*.\...#*.*. .....\..# \ ...\....#
##.. ...#..* .....#.......# .... . *.\#..\.... .*..#.#... .*.#.. ...*.. #. #*..*..#.\ .\\. . ......#
#... *#*# .R.. ...*...\\.  # \***...#  *.  .... .. \   # .*.. .#....  ..*.  .\......  ..*# .*..... #
#  #..#  ...  \...#*\    \ *.# .. \ ..##. .\  .#... . ....#*. .  *.*..* ..#\...#.. .\....#.. * ....#
#*.# \..#\..\ *. ...... . .*.. ....**.*.. ........# ... .##.  . *  ..\ *...#.\. ....#*....  *#.\*.*#
#*..*#. .* #*.* # ....  .#.\#.  ..   .\#.\......\ \.  .....#... ..#.... #.......## *... *\#. . * \ #
#* ....#\# ##*. . ... *. .  #  ...... ....#* #..   \**\.* ... #*...#... .\ . ... #....#*.*..#  ..*.#
#\* .*.*.##.......*#.*.#.*\...  ....# .  .\#..#...\ .* . #......  \.. .#.# *. **......#...*    ..*.#
# ...\..    *.. ....*.*#..#....\. . \*.* ..  ..\. * . .#.... .*... .. \.#.\ ...\ .* . *\##..#.. .. #
# .. .  *#*.#. ..* ..\# .*..  ..##.\ . . ..#**.*... *.......* ....*.... ..\..*. .. .*..\ ....  .#.##
#  #* * .. ..\.  *. * .*.... ....\ .#\..*.*\\...... . # . .   .........*.....** # ......# \  #.*..##
#  *...  ..###  ..*.*.. \\... ...* .\#.*\ .\ .#. .*#.... \...... #... ... .#.  . * . * ...*. .*.  ##
# \# #.#...#.......#..... .\.  ..* .   .    .# . ...  ..\ ..*.. *.*#.#  *.#. ..#.....\#*#*...##*#\.#
#*.. .#.. ....*.\.. ....  .\  .......#....##..... . *....#..\#.*#\.....##.... .# ..#.\... ..\...#..#
# #...*.#.\  .....  ...# . .*.... ..*.#*.*.*...#.*\..*... *.*..*..... . .*\..\....\.. ..  . . #.. .#
#..   *##  ........  ..*....*.. ..#.#*. ....*.. *....#.*........* .....#\...*..*\..*.\.  ##. ...#.##
#....*......*\#.#..\#...**.*.* . \ . \. ... **....# ...#. # ...#.  .#.. *...#... #..#\ .* *   .. #\#
#...\*.....\. .. *  *#.#.....**.#....\ .\.*......#*.   ..*#.*.# . ...... *.*....*. #. .*\. \...*.. #
#..*. *.#.* ..##.*... .**\#* .  #.*.\#.#*....  ..#..#.# #* ..#..* .\..\...\#..... .*.....#.\   ....#
#.#..#...* .... *#...*....*#*#\.......# ....*.* . .. . ...* ... **..#\#. .#* .*....... ... .... ...#
# .*.##..*#... .... .*. .#.*.##..   .#.\..*..... .. #\ .....*.**..* ...*.*# .*.#..#**# *... ..  \ .#
#.**.. *  *\.*.......* ....# ......#. \.#*#...#. ....... * ##..... ..#  #.\. #.... .\...**. * .  .*#
#.*....\...\.* .#. #\...\#....#.*. ... #*# ...*.* #.*  \**. .# *...*....... *..\.\. ..* \..\..#.*.*#
#.#.. ..#..## .. .* .\...\.#...  #.*.  . .#..#.#**..  . ... .. * *.\ ..*.#*..#.. #*. ...\.#*...#\. #
#...  .## ..#...* .#...\.\ *.#  .. .*. \.\.....# . ..#...# . .\..........  ...*## .* *    *#*.*\. \#
#......#...  . . .........#..... .#.*# *#.** .# #..\..#. ..\#...*.*\..#* ..... .# .. \. *... .... .#
#*.#..*... ..... .*. ** *  . \ #. . ..\.\ ...\.# .. .....\.. .....#.  .. *. *. **.....*#*..#..#*...#
#...........#*..\..\  . *#...# .............**.*. * .#.# .  . .##*.... #...  #............. *.#....#
#..#.*.  .*\.. * #.#\  #.  ..#.*...*........* ..  #.  . *.. # ...#\ .#.#.*....#.*. ..***.\.... #*..#
#*....#...... ......\..\\ ...#. ...#.# . ..#..  .....#..#\..#\#  .*#. \.....**.....*... .... ..*...#
#. .........*### . .  .. ....# ........ \..\ ..\.*. #*.....\##.#.. # ..\ **\..\.  .*.  ..#....*.. .#
#....\. .. .#.. \ .... ...*\\..*  .*\.# ...*.. #*.....*.\.*. . .... ..  #*.. \#* **#.....*.. ... ..#
# .\... .. .. *..#.....#.#.##*...#.#.. ........#. .##...# ...  .\*. . *.. #*...... .. *. . ...\#.. #
#  . ..\........ .  .#.. .....#\.*.# ........#.....*. . ...* ... . #... .\...\*........*\*#\\. * ..#
#..  #. ..#\.. .# .*.... *.  .. * \....##* .  ..#*....*.*....... .*..#......#.. #.......  \ .....  #
#  ..\*...#.. *.. .. . ....\.. ...  ... . .... . .*.  **.* ..##...*..... *...#*\ #.\...#.* ...#... #
#..**.# .. ..#.*..\.....*. #.#\. ....*.. .... .## *. *..# .... . ..*.. *## . *... ...#. .* ***...* #
#.. *.....**.....\. # ....\ .... ....\*.##... ... ......#\.. .* .  .*.. .......* #.    **.. *..  .\#
#.  .\...#.\  ..#  *##...#.* ...*...* ........**. ... .. .*..  #\. \.....**...*..#..*. ..*  *.#*. .#
##\....#. ....#. * .#..\ ...*.. *..  #...*.\...*  .. ...#.. #. #.*........ .  *.. #..#.*.##\.*..*. #
#..*.*..*..* .#..#\ .#.\* .... ..* .. ...#...**.. #. .\... ....* .... .* .* . .#*\..#.*.#. ... ..\.#
#*.**.. .# .... . ........ ...............#.\...*.#.*......\. .*.. ..\ .* ..# .....*.#. ..#.....#. #
#.  # ...*.* ....*.*\* #..#.\......*..*.*#.# .  ...*.*.* .**#.*.#*#.#...... \*#* .  .. ...  .....\.#
##  #.\.. * .*. .    ..# ** \   ....*..* . *.#... . * ......#..#\ \..... ....  .. .# #. *  .......##
#. .#. #...#*.* ..... . ..*... .. .# .....\... .....*..*....#*.. ..... ..  \. . . .#.......*... .*.#
##....* ..#*  .*\........ . .......  .. #....**....\*...#.....*#  ..# ... ... #...# ... .... #..*..#
#. ...*.** *.... ....... ..* * *... *. . \\*.* ....#........#... ..*# .*...*. .. ....# ... .*#...#\#
#...\ ......# .\.. .\....#.. ..*. #*.** .......*\.. .  .... . .. \. .. **.#..#  ..#.\*\*..\... .#..#
#..   ....##..........\..*  . .* ...\.*...\**...  . ...* \.   *..  .. ..  ..*... ...*.**... *..*...#
##* \.#. ...#........  .*.\*..*.#. *..# .. *. .#.  .....#... *. ..... *.#. .......*... . .. .*.....#
##..*.....  ..#\.. .*#.# .. .*.. .\..\* ....  * .*.. \....*.......\.#.*\*.*...\..\. .  ..\.....* *.#
#*..#........\..#.#...#.#\ .# ......#\ .#  * .##. \... *.#.*.  \ #.*.#* # .\..*#....... \.......\###
#. .#*.\.. . . . .... ...#.  ...........#.#*#   .... .....\#.#...*. *.#.##.......... .. #.\..... ..#
#. .#....#... *.......*...##....*..* #.. \ .... .. .# *...* #.......\ **. #......##.\.  *... . .*. #
#... .. .#\\\..\ ..*.**.#\.. . ....##.*.. .....\* . .**..#...*... . .*.*\.  .#.#..#. ... . ...... .#
#  ..... ...**..#.. ... #..# *.#*..... .. #. ..#...  ...#... . ..*..... .*. *...\...*. . .\..... ..#
####################################################################################################