####################################################################################################
#.. .\...*..  .. ....#..  ..*. ..*. .. *.*.. .* ..\#... .*..\.  .\.*.# ###.# ...  .*.. . #. *......#
#...* ..*\.*. #.... .## .. ...\.*.............# ..#*.... .*#..\..*....*.#..\  ** ....\... *.\....#.#
#.......*** ........#....#..###*.. \ ...... . .\..... ......#  ...**.*#. ..\.. *. ..#..*.*...\* ..##
# ..*..* ..#. #..*..* *....\\\  *. ..\.#.##    ..  ..**......\..*.# \#.# # **.\.....#* *.*. \....  #
#.. *......#..*..*.*#.......#...* .##. ...**.*..  .. .. .#* ... #.#  *....\.. .*. ##   ....\#....*.#
#....* \......  .. ..#.\.*\\*. *##  ..#    \.. *.*....* . ..*. .... ...#* ..*.#.... .....#..*..*...#
##*.. #.##.  ... ..  *. .\ .#..#...#...*  . ....... .  *.\ \  .   .*....\.## # * . #.... .. \...* .#
#*. *..\....  . . #... . .*.#.....#.  ...... # ..#. .* . *.* ..  .#. ...*.#.. *..#.#..*. .   .*....#
#.. *. \ . .. *#..* .* *......#.....**  .....*\.  **  #.... . ......#.##..\...  # \.*\ .# #..**. .##
#*.......## .....#*...#*.*..  ..*. .....##.*........... .##  \.   .....\.\. \#.*#....\  #..# .#* ..#
##. .#...... .#............ ..*.... .#\.. .#... *.#. #  .\.. . ... ..* .....\.  ... ..\...\ . ...\ #
#..*.....##..##... #.   . .*#* .....*..#* * . \.. .\..# ...# ..*.*.  .**. ... .. .**##*.# ...#*.#..#
# .  * .# ...\...#... . ## ....\. .*..  . .*  .* ..**##..\. ..  ... \.... #* .*  \*#*.* . .#.....  #
#..#..*.*.. .... .**..  .....*...* * ...  .#.....#\** .*..  \...  .#.\. .....*. .. #.*.........\.*.#
#*..*....#*.** . . \ . ......\   ............ ..##. # \* ...#  ..*.#....*. #...\.* *..#..#. ##...#.#
#*..... ...# ..... .#\*.. .**...*. .... .*.*..* \..*..... . ....\.. . ..... #.. ..\#..  . *...*\. ##
# .#...#.\*...* .. .... ...# .  ....... ... .........#....  . ....*. #....#..**#......#.#..........#
# ..\**..\.....  . #.....* #..*...#... .*..##......*.  .*...*##. .*.#.. .........\........ .....#..#
# .\.*...#..\.. ...\#.\.. . \ ...#*..... . . * # .*..*....\#....*. * ...\# **.. ... . *.##. * . . ##
# ..... \... #.*... ...#.#. ..#.. ...# .#.\ ...\..#...#*# .\#.*.  . .#\.*.*.. .#.#.  ........*. .. #
# \*.  ..###.#.... .....\ .  ..#..*#.#   #. .   . . ... . #........    ....*..#......*. \. . *....\#
#.*.. .......#.#.*\. ..  .  . \ *..# ..*\. .\ #.*.* ..#****. . \.......**# ...  ..*.#.*.*\ .......##
#....#.\#.......##  #.. #.*...** .* #...#\.. #.. .#*# \ ..*.\ #\  .*..#....#*  ...... . . . ....**##
#.. ...\....... **## #... . .*.*#*..  ..**..\...\\.. .   . \*#.#..*#.....   .*.##...*.*.** ##... \ #
#*.......#. *.#...*  # *.....#\....... ....**....\... *.\..* * .     * ... ....#.#..\**....#.. ..**#
#.  *  ....\ # . .* #..... ...  .. ***.\#. . .\ .....* ...\.....#.....* #.......*.\ .#.\..... ..#..#
#..\*...*#* *...\.* ..... .. .. * ## .... #*..##*....#. #........\ .* *...* ......*.*. .**.*.# . ..#
#*  #\.\..*.*..*. .#. ..**\. \ ..*...*....\ #.   ..#*#      .*..... .\..  \#..##.**..*. #.# #*.....#
# *# .. *..*... ..*.* ......*.. ...... .*.\   ....\ .......*. * #.. .... . .**. . ..\. *.**..*.#...#
#..........#...\#.#.  * *.. .*\#..*... ..\ #.\.... *.. .\\....  *..  .#\#. .#*.  .# .. ..*...  ... #
#. # . ..#..#  * ..#.  #..#... ....#. ..*.*. .....  \ \..#....... .# .*.\.#.##.* ..#*. ...*......#.#
#.\* .*\...# ..#....\.. . #..* ..... . ......#**..\... . ........* . \.*..#...\..  ...*##.* ..*\.*.#
#. .\#...*. ..* . #.\#.. ...\\*.... .#...  ..\. ...#...* ...#   #*\... . ..#..  . .*.# * ##.*..*.  #
# ... ....*.## ......## *..*.*.*.** .*##.. ......#*.\  \..#.\... \. *..  *..... *#.......*.*..  #*.#
#..#..\ ....\.#..#.\\. \.* .#..*  *. ..... ..\..\#\ .. . .*#..#.#.... *.......#... # .  ...*   ..#.#
## .....*.*\*#.\..#\.*..... # . ...#\.#..*.#. ...#*..\*.....\....\  *..#.#*.........\.*.#....\  \..#
#..*. #.\   ..  ... . * .#.*.. . ...*....*...*.# #. .....*  ..#\...\##.*..\ .........  . ..\ .*....#
#*.  #*...*. ..#*.# \.. #.\  **.#.\*# ..#*..........# ......\* . .#...#*.*\.. ...  *..#...## .**.  #
# #..\..#. #. *##....\.**.... *\......*..*... #\..**\\.... ...#. .. .*...*.....#* .#..  .....*.  \##
#...\... * .#.**.. ...*..# #....#*.\  .. ...*.*... . ..* .#* .*.\. ...\..\.. .*..*##... . ... *.. .#
##..##....   .#... . ...   .#.. . . . .* ......# .. .#. ...**#. .* **. .*#..\.... .#.. ......*.....#
#... .##. ..# .. .##  ..#.#..#..  . ... ... *....   . *.*...\..   \.#.. .. .# . .*.. .\*.*......\ *#
#.... ... .. #*\... .   . .\.*# ..\......*\.  .. .*#    #\#*##** \....#...#. *.#*.. #...##..*.*. #*#
#..#....# .*#..#...*.\*#.#.\..*. ... * .. \.*. . . ... ..*. #.\*# #. ....*  . ..*..#*\#..#.....**#.#
#*....\.........  *....*\.. ..\*.* \\..#.#...  .# .*.  #...\.\.... . #\###...*... *.*...... .. ..\ #
# ... ....*...\*.........\*.... ..*....\\..\...  #\. .... ... .  ..#.  .#*##....*\*#...*..*#..*..*.#
#. ... .... . **. *.... . .\.\...... *....\  ......  #...#..#.##** . #....*##.  ... .  ..*#.#  . #.#
### .*.... * ....#. .  .\#.. ##*.#\ #.*..*#..\..#. \*\.*\. ...\...    ..*\...*.  .. ....  .*... ..*#
#..   #....\.#*..#......#*. .. *. ...#.. \. .  .*   .*#.*.*. #.*.....#. *  #... ..\ \ \.  ....   .*#
#. #..\.   * \#.\ . #***##...\ ..........\ .*...... ..*....  .\  ......#...#  ..  .*. .. .. .# ....#
#..........#. #*. . ....*.........#... **. .. #...\.. *...# \ *.. . .#**.......#.. ........* *##..##
#  .# . ..# .. *. \*... .  #.#*.*.#.\ ..*** . . .*.....#.... .  .....    .# .. .. *\.......... .  .#
##*...\*..  .\..*\* .  . *.........** #. .*. .*   .... *##.. ... ..  ......... .#. .##**  #..... ..#
##*.**.... **.#.#.. . ...**  .\  *.... .*  .........\. ..  .*\ #..\#*\#.... . *.\ .# \.** #*.#.. . #
#......#.\.  ....\. . .#..\.#...#... .. ..*..*#. ....#  ..\.......##..  . . .  . . #..*#....\.. .\.#
# .*. *   ....   * . . *. *\ ...   .. . .. .\..  . *#.. *....  *..  *...\....#\.. .\. \..\......#. #
#\\...# .* .........*.. .#. . *.....#*.. .\#....#.. ##..*..\*.... **..*...... ...*  ...*#..*.\##...#
#  ..\...\..... .... ....  .....*.... . ..  *  .*...  .  *. .........*.   . .. .#***##  *...*...*\ #
#.*....  .. .#. # .*.  .. .*  ..# .#*. .*.. ....\ ..*.##**\  .......#.*\...\*. ... ..\# .*.  ....#.#
# ... #. #........ ..  .. .##......*.. ...*. ** ..#..#  . ....\..# .*.....  ..*.#... .. . ....#... #
#.\.#..  .#  ..*...  * .**...*.... #.. #....  ......  ..**\..\. ...# ..#. # .# . ... .# ... .....*##
#.*#......# ..#.*.*.. \.#.#.*. ......* #...#..*.# .... .#....#.. . ...#......\ . .. ...\ .. ..*.\ .#
#....**..\. * #..*.. .# .*.# * .*#.*.... .... ............... ..... * #\. ... .... . .*..* ##....#*#
# ..**#..  \...##*... .  .. .. ...# #.. .\.  ...\...# .. . .. ...#*..#.. ... .**. # ..\ #.........\#
#.#...*#......# ....*. **#.. ..* .     #...*....\ *  .......*.\. . #..#.. ..*\ .... ... .. .#.. \..#
# ..... ...*.#.*. *  ...* .. .#. #*\#**.. * *. .... ......*.*... ...\* .. .* ..... ...*.. . ..* . *#
##*#. ..\..* .. #  .  ...*....#.\#* #*.  .....## *.\*.  . ... ..# ##*. .\.*. ..#. \... ... . .  \\.#
#.*#\.......*. ........ * ... *. ...#*#*#. .. *.*.* . *#*..\...   ...*#.*. .\ ..#......*  .... \ ..#
#.* .\\ .#*... ..*..# *##. *.*.#*.#.# ..#.  .*..\. #. .  ..*. ... .*  .#..**#.........*.....  # . *#
#\.*...... ... * .. ....#*.. #..*.    . #.* ..\*** ...   . #  . ..* ..*.\ . .  #..... .*.....*.# . #
#.\.*\.* ...#.  #..... #.  ...*.*.  . ..*\. ..*#. .### ...... ......\.... \ **\ ....  ...*.\...... #
#.\.\..*. ## .... . .. *..............   .** .#. ...#... * ..\.........##.\.\.. .....*.*#....#..  *#
#**. .\. ..#.   .....\ .*..#*.  .#...*\.#*.... ..... ....# .#..#.  .. ...* *...# ..*. ..# * .*.. .\#
# .......\.\..\. ..... *...# . # *....#*. #.. *   .\#. .... . ..\... ..  #...*.\.....###... . ....*#
#*.... .... .#...*.. **.... *..#.*...... ** * *.## .. .. ....*. **.* * *#.*... ......##\*  .....# *#
##.....##...\...* #.*...*.\....\...# #.*...\....... \*...#*.. .*.#\..*#.#. ..... *  ...#.#\....*.  #
# .\ #...# #  *..\...*.#.. ##.###\*##..\.......#  . ..#*#.. ..*..  ..\.* .#...#..#.*#...\. .  * *..#
#*.. #. .*... #.  *.... ..*... .\\. .#....# ..#...* \. ....  \ ..\*...#. R ..##...\.. ...... ..... #
#* #....... ... .##. .** .\#.*#... \..*.*..\..\.. ....\. \..\.\ *.#... # ..... #\ #.. ....#.. . ...#
#..#. ....# *   .. .\ *.** .. .*...* . .....*.* . \...*. ...#*..#.\.*... . ..#\** .....*#**. #..#..#
#*.#....\  .. ..#....#. *.....   #*..#...**... \......*. .\# ...#... \ .   .\.*##*....*.. * ..  *\.#
#. .#.*#... .*..   ... .* .*... ...*.\. ...*.  .  .*..*\..*.. ..\. . .  ....*......#..#..... ....\ #
# ...#*....*..*\#.\\\ .*.*.#..  #. ..##..  #*... **#.....#.  . # .* # .#.........# \.* . ...*.\....#
# # .. ...#... * ..\.*.. ... .. . . *.#...\*..  .. ...#  \* ..#. ..... ..*#.#.... ..   . ..*. . * .#
#  #*..*#.*#.....#*##. *. .\..#.# .....#..... .# .#    .........**# #*.## #...*#**. # ....* ...*\ .#
# . .......## ..*... ...#. ..  #.......... .....*.\....# .# ....*.  .   .. \ . .#.*..*..**\..*.....#
#.\*. . ..# . .\. *. ... ..# .*. ..*. #.  ... *.*.\#. \ ... .   . ..* . .** .. *..  ..#*.. .#......#
#.. .  *...*  \.. . .. ....#*. *....... ..  *.#   .  .\..*.\.. ....#\..##.\.. ...*. .  ...*  *..# .#
#..# ..  *\ ..#...* .  ....*###.#*........ #.......\... .. \. .####. . ..#.....*\# .#\... #..... ..#
#*  \.    ...\..\*....*.  ..\.#..\. .. # .........  ..#..**# *..... ...... ..   *... .#..*. .*\ . .#
#.. . .......##\..#\##.#.\. ..*.##....*...\..*..*\.. *...# .. ....#. .. .\ ....* #. ... ..# ..*..\.#
###...#.*   .*...** .\  ...\...... ...# #... .. .. #. ##.. . . \ * .#..*...... ......... .\..*.\...#
#.# *.... .... .... #. . ..*....*.* ...#..#.\#....** .... .\..*\#...\\.\\**.**.... .. * .. . ....**#
#.  ....... ..#  ..... .\*\ .*\##.#. ..  ....#... .. #.... \.\#..#.#  .#.  ##.. *....... #...*...#.#
#  .#....**#\ \....** .............\**...  .#* ..  . .....   # ..*. #*# .  ....\...... ..  ... # ..#
#....  .#.#. *.. .# .... . ..   *..  .. #*\........#... .*#.  ......#.\..  # .#. .....# . *#. ##  .#
#...#...*.# .. ....#. ##......... # *... ..*.* .*.# ##.\.*.. ..#.* .... ..# .#..\. . ...#.# . #**..#
#\..\... #.. ..\.##. *  \.. #.. .. . #....* .....\ ## ...*. \..  ....*#*.... . .... ...*....\  . .*#
##########################################L#########################################################