####################################################################################################
#.  *..#\\\.#.....\   *....\...#*. . .. #. ...... \#.#* *\.... \.... #...*..#. *...*.#..*  *..*#..*#
L.\.#....\.  **.   .........  \.*#...##. \#... * . .** ..#**.# .#\.. . ....... .#...#......*\#.#. .#
#..*  .. .\..  . . .*#... ........... .** .  .... . .....\...\*. .......#\*\. .\ .*...#........#...#
#.*..\..\....\.##.... .#... \.#..*# ...* * ...* ... ...#......#..     \\*..#..#.\*..  .*.#.. #...*.#
#.. #.\#. .....*#. .... *....#   ..##.  ..* ....*#*.###.#.....#.**........***#....#....... \*.... .#
##...#....#. ....*. .......#... .#. **#.#.. ...# ...... .*#.*. .* * #..##.......#......*. #.... . .#
#\#. \ #.*.# #.*.\.........**. .# . .*..*   **... ..*.....# ...\**\ ...##. .....**.. . .\. .. * ..*#
#.. #......... ... #.....\ ...#   *..#.  .*..#.*..###*.#.*. ..#..*.#..* ...**..  .# .. ... . ..#..##
# .\. #* \ ...*. .  . .*. .. ..*...\. # . *. .#*** #*\##........\...  ..  .#.........##* ...*. .**.#
###   .....*.\.  ............\.... .. ...*  .\........#..... \#\..#*..##..*.. #... ...*. ..\ .. .. #
#......#. \\..  ..#.##....# .. *... .. .#...#.*............#..*... \..#*  .  .\..\.#  ..**.........#
# .. ..... \ ...*....#.\\.....*....# ... . #  ..#.*  .*..*...  .*.#..#..*.. ...*.\.*. ** \..#.*....#
### .* ...\.  *. ..... *. .... * \..##..*# .. .#.. ... .......\.* .\ . ... .##.. ..* ...\  *.. . ..#
#...#...#. .  # ..#. .#**.*..#\. ....\#.*.*. .#.\\ ..# \. ..# #.\.........**..#\ \ .#.#.. .. ..# .*#
#.. ......*\ ....\..*...\    ...\ ....#...*\....  *  ..... #.... ..#...*#.. *#.* ..*..# ... ... *..#
#\  *\....#..\**#\ .#...\#..#. ...**.......* .#.  ..\ #.#.. ..\*\. ... R..\.. ... . .  . ..\..... .#
#. ##....# .......\.##. # . ...*..**.  *......\#.. #.# ..##..\. .\....#\.. .#....#... . ......\..#.#
#....**. .. ...# *.. #.*##*#*. # *  *... ............. ....*   ...\  .*.\...##.... # \..*#. .#....##
#*  ....     ... . .#. *. . ..*. .....# ##*. .\.# .  .*##.. ..  \\..... .\* *. . *\ ...\  ..#. #.. #
# . #. ....#.   ........ . .. .....*....\.....**..... ..# .#..... . ...*.#...* .* ..  .... .... .\\#
#.*   *..##.  .. ..\. ...*....* *.\. . *\*... ##..  **.. #.*........\ \ .  ....\.\.... ..  \*... \ #
#........ . ..... . ...... **#. .   .#.. \.....#...  .. ....*..... .. ..\...*........  #. . . *. . #
#\ * *. \..  .. #.. .#...  .*.*# .# \*.... .. ..\..**..#.*\.... ..#. ..... *..... . . ..*....*.\..##
#* ....#....*#....\.*.   *..#  .  #..... ..* #..# .. ..\.*. .... ... .#...  ..... #\.# \*..#. .. ..#
##.... ... . .#  ........ *...*... ...\. .....*. . ...#..*#*..*#.\..... .. . #..\.  *\.. #. .#. * ##
#..\ \. ..\ *....* ... **. ..#..*.*......**#.#...........#...* *.*...#.. ..*. . *...  #... \......\#
#.\.*.* * . . ...  ....... ...**.... .*...  .. ... *  *..\..#..## #...\.... .. ..# ... .# . ....#..#
#* \* .  #....\\... .*\.\...#.. *.#.**.\\... .. *  ..*.*#... ..*..***.....  .\###..**. #  .#\#\ ...#
#..\.* .*. .**..\.*.\ .....#*.. .*#... . \.*.. .. *\.....  .*.*#.....\..#. ..# ..... ...... ##...\ #
##.....  #*#*\. ..##.  # #*#  .*.. *.*...\....*.*.........*.. # . .#.. .... #*. ..\..*......*# .*..#
# ..*.*..\  #. *.*. .. *\..\...*\......*.*.*..*.*. ...  #.#.#. # . ..\ * *  ..**.\#.*.*..* . #. .. #
##*.\.#..#. ..\** ...*. ... #.....  .....*..*#. ...\.......*  .. ...\.........* . .......  . #*  ..#
#.  .** *....  ..#...  ..* ... .......##*.*  ..#..#..*#.*  #.*.... . *...\... ..##..*\.... .. #...##
#.#*.*...   .....#*....*#* .. . ..\..*#..*.*..#.. .\.#.\.\.. .. .. ..........  .. . ... .* .# .\..##
#..... ##* ..*\#\.#.#*.... #.#. ..\  . .#....##   ..*#.. . ..... *.\.........\.... . .*..\.#.......#
#* .. ...*#. ........ . #\.  .. .....\#.. #.. ... *.  . .**.  .*#.*#. ... \.#*..*.##*#.... *\.  ..*#
# #*... *#. .......  .. *....##. * \*  #..*\..\......  . . .#.# ... \..... #.*.* .. ..**  ***#....*#
#......##*.....# .* ....*  *.\......\.....\... #   .*\\*..\...# \.......#*. *#*.\. #*#*.......*#.#.#
#. ....#.#..*.....*#.....** ..* .  ..*#.#.**. *  *. ..... *  .*.\..*.. .#..........  .*..#.....   ##
#......* #..... ...#*..*.#  .....**.*......*. .... *. .. *......*..*..... . ..*##.##....... ..*\  *#
## *.\.\  #....  ..#\..# .\..........*.*..*.*.... \.. .\...\\. ..\. ...\* ..#.... .*.. . * .*\ \*..#
#*. # ...  #\ ....*...\* ....#. . \.*  .#...\ ###.. ..*..#* .\ *.. #. ...... ...*... .\.*..##..#.. #
# ..** .#..*.*.# **#...## #..*.... . #.*.. #.# . #..# .# . ..*. \.....  ..#.. .*.\ \.# ..\.* ..  ###
#. . .... .    # #.*.\. ..*#    .###.  .#.#..*.*..  . .. ..........#...* *..#....** ..# .. *..... \#
#* .. .* ###.** ..##. .*....#.*...... *.. ... .# ....*.. #.   .*   .* . .........    **........*..##
#... #.#....*.*.  ....*.. #.\.\.*.....#.#.... .......*. .  .. .#..#...*#. .. . # .. \.#.*\*..# \..*#
##..#*.*.\. ...#....* #.. . .*... .#. ......\\..#. .   ........*..\* ..*.....\..\\.\*.  . ...*#.#.*#
# .  . .#.....#....#*.... ... *.. .#......#.. ....#.##. .*..\.... \... ... ...  ..** .\..* ....*. .#
#.  ........ .\. ..\.#......\. *\...\.#. ..#..  . ..#* ..# #.# ..... .  .    ..#..*# \   . ..#* .*.#
#.\.... #. ....#*. **.#.. ....#  .\..*  .*.#.#..* ..* *.#..*.. # .**. ...#.*  ...  .* #. *. ....** #
#.#.*.*..#  ##\...\  ..#.. ....*.*...*  .  ..*.#... *.# ..*... ....* .. ...... #...   .#**.. . ... #
#\.*.#* #\. .*##..#....#  . #... .*.*. .# ...\... .*.. .*.....\#.\ * .... ..... ..###...#.   ##.. .#
#\... ....  .\. *#.. # ... *.*.......... *.\  ........* #.\ ...*# .   #..*......\........#*.#\.....#
## ... .. .....*.  *.. ..*..* .\..*.  . .....#.. .*. .*..\# .....*...*..*...#.. . ....*. ..#....   #
#.*\...\*\....*.....*.... ....#.. . . ..*   .\.#.#.*..#. .*..\.# ...... .*... #..\ .. . ...*. .#.\\#
#.*  .*... ..*  ..#.....*. *..#.#...#... #  * .##..*... .*.*. .##.. #.. #. ..* .#. .. *..  .*. \#..#
#.#.*.\ *... #\.# . .#\.##... #.*#. #*.   #*.#..#...\.. .*...#.\...... .**.*   #.   *.#..*.*.\..**.#
##.. .. ..*#... .\ ......#.#...*.*  ..\\. . .\.##. .#....  .. ...\ #.#* ..... ... #. .*.. .\*....*.#
#.. ...#. ..*.** #.. *# ........*#..*..# #... ......#.#..   ##.*.#..............*. ..*. .. *.#\.   #
#..  #. #.* *.#.##*  ..#.. ..#.. .\*# .. .\...*\. .#.. .......*# ... .. .\*.#...\.. . *#.#...  ..#.#
#..#....#*.*.#..   . . * ..\*..*###..* #. .##* .#..*. .\*......*....*. .*.*..# ....... .....  .... #
# #  .... . ..*\..... ..*#..*.....\... **.. .\*#. \.*#......##.\... ..* ..\   ....*\...  *#. .\*.#\#
#. .* .. #.#\..... #....*#.. .*.\ ...  \*.... *.#..*#.#\#.#.*. ..\\.*....* * ...*#...#.....**..#*..#
#* .... ...\#... \ .\\. ...##..***.**.##.\.\** ... . *#.*..#.... \ \*## .#\..*.#..\\* * \.##.*.##.*#
#..#. ..* ** ...  #... #.#\*#..  .#..\ ..\*..#.*.*......\.**.. \..\.... *.. ..*#.#....\ .#*#..... .#
# .#.\..* .\*  .\..... ... .###.#. ..... # ..#*.*. #. . #.*...#....*.#.. .\.#..*.. # .#  ..#..#. ..#
#*  .#...#\..... .#... # # \....*.#... ....#. ..*.... .*... #.. ..   ... *...  \...\.. ..*\..* ....#
#...\  .\. \.*#.#...... .  #*.\.. *\. .  #*. . .. *.\..\.....\ .#.\.\.. .* .* .\..#*.  .#....**  \.#
# \# ...... ..#*  .. #..  ..# . ..*...........*..#...*... #.# *.\. ......\..*.. ...\.**.. ....#.. .#
#..#*....*.\\. #.\.....*.\#.*..........#**.. . .*. #... .. ....#....  ...*  ...... \. .. **.. **.\.#
# #  # *.. #....*... .. *.. .. .*.. .\ .#....*...#..##.##.......\*#.....#...#.#.* . . ..*\.*#.*....#
#\* .....\. ... .*. #.#*........*\*..#.  \.#.. \.#.*.# *#\.#  ... ... #.....#*....*.. . ..... #..**#
# ..  ...#.#*#.... *. **\ .\  *......#. *...#.*. \.*..*. .\.*.   .   * . ... . . #....*# ...# * **##
#.  .  * .\... . \\.........  .... .  . . .*.. .. #........#. #..#. #..... *\.#... \.. #*..*  . \#.#
#. .....\ ....* ..*.....#.   .#....#....*.... #. ..*# ....\. *... ..... .\.#.*..  ...  .##. ...*...#
# .. .. .  ..*.....#**... *.*\.** .*.#.#**..#*\... . *.. *...#. .     .........# **.*##.#. ..\ .. .#
#*.\.... **. .... \#..*.*** .* *\*.#.*.\. *..* # ....#. .#*.. ....  ......*. ......\\ *....\....\..#
#\#..*# #\ *.  .#.\..... ...#. ..# ...\.....# .  ...\##  \*. .......*#  #  ...#. .  #...#.. ...\.*.#
#. . .# ..*... \* ...#..    .   . \#.*\...#.#.\ .#...  .*.#*  ..# .#. .#.  ..... .. \. ##.* .*.. ..#
# \.... ......*..*..*...#.  .  #. .. *..#.. ...   . .. ..*. # #.. .....#..#..\ .....  #.. .. ...*..#
#.* *  ... ..#.. ##......\..\.**...##.*...*.. ... #..#  ..* ..# ..\..\..... ......... ...   ... ...#
#. .*  ...#.... ..  .........    .*.*......\*..# . .....*... ... ...*..#..* * # \. ... .#\...  #*..#
#*.*#...#\#..#.*........#* .*  .#. . #. .\..#... ..*....#......\.. ..*#... \ .*.. . ..*...*#.*...#.#
#*#.......*.......* *... \... ..*. . *.... .\  .*.....#.  . *#*##* .*..*......#.#... .*  ..*.#\. ..#
#. .* .#\ ..* ..  .    .*\*.# \*. .. .. ..... ..#.. # .. .#\.. \..\ .  . \. .....## #...*\  . #..# #
#.. ... . *.  . #.*  ...   . #.\. ..#.\  #.*.\\  \.*.......\#..# ...\. ...... .... .* .\...#.#..* .#
# #. ..# .##..  . .#  ... #.......... *#....*.**#  .\. .#. \#  ..**\.*.. *.\ \  *.* ...*... . .. ..#
#.\ . * ....#.*..   ..*..#.#*. ... . . ..*\.*..  ..\  .\.*#...\**..*. .....*##. . . **... ..\  #.#.#
#   .. ...  ..... ##.\..\#..\ . ..****.*..*... \. .....*.#*.. .  .\ #\*..*. ...*.*. ... .#.  ..  .\#
#..#. *.. .....*..* .# .      .... .  ... # *.*#   ..*..... . .....#..... . #  .# #*.*....*....* ..#
#*...*....... . ... * ...#.... . .\.......\..\\   .#\. .. ..*.   ...... . ...*.....#.. * ...\..... #
##....*#....*.*. .#*..#.*....#* ###.....*..\...## #.# . ...... *...#.... .\ ...* . .*\#. ... . *#.\#
#..#.. .. .   #.  ..*\#...**...\ .. \#..* *#.\#..  ... .#.* ..#\..#.. .\* #.. \#\... .*.. *..... ..#
#..\\##*.  . .\.*.... .\  *..*...\...\\.. . ....... .*.. \.. *.....  ... ...**..* ... .*. #. * .##*#
#...#...#* .\*#*.....* . ..# #... .#  ..\... ..# ....\* ..#.# . * .#*..#*. .. . .. .*..*. .*.... . #
#. ..#.....# .#......*  ....**.  . .. \. . .. ......#.*. .#\.....\.  . . ..*..##. .. *. #.*#*.# .#.#
#.......\**.  * .......*  \\. ..  \ .*.* .. #....#\.. .... .#...* *.... .. #\##.. ....\..#  . * . .#
#*   * .#\.#. ##. .\........  ....*  #.*.  \#.....# \*. .    .. #..#. *...#.. .#.*# *..#*#. ..*.\#.#
####################################################################################################