####################################################################################################
#*....*.......... ... . **\*  *..*.\*.# . . . ..#.**.. .**..# .... .. ....* ##\ #..#.. . .#.... #..#
#.. .#*.\ . ..  .\\....  .. .. .\ ..# *.#\..\.. ....#*\## . \ ..#* *#.....*\*... .. #* .\... .* .#.#
# *  ..... #..\*..*#..*.#.  . . \.\..\...*.#.   .. . ..* \.. ..\.#...... #. *....#.....#.  .*......#
#.*##..\. ....* .. . . *.....# \   .......#. ...#.  ...*.... *. . *\..#........  ..\.\...*...*.. ..#
# ## ...*\......\. ...*.......#  *...*.#..#.... #  . * .*..*.**   .*. .. . ........*...*.#**....*..#
#   .*.*.*.*.*. ...# . .. *#.* ...........\..#..*#.. .....* *..\ .... **# ....** ...#..# .*.....\..#
#\.... .... #...* . .  ....... . .#.#... *..\... ...#...*....  . .*....#...#.. .*...#.... . \*#\.\*#
#. #....  . .. *.. ......  .\.... ..#  . .*..*..* .*.# ......#\.**. ... *.## ... ... .#. #.  .\ .. #
#.#* . \#.#* \*...**#. \ .*..... . . ........##.....#*.......#....#**.*#... .  .. .*....\.# .....*.#
#..  #...* ..*.... *...# . .*.. . ..*.. *..\.  ...  *..##*. .....*#..**.*..* \..#.. #.  .. ..#.** ##
#.#.. . .....*.  ..#..\.*.##... ...#. ...*#..* ..   ....#..... #.. #...#*..*.*\.#.#....#.##  ..... #
#*. .. . ...*......*...#\#.*.*.*..  .\    *.#**......*...*.  ... .*#..* .\.. . .... .. .. .....**..#
#..# .*..#. #..  #*.....##....*. *.\*.#.# .\*.*...\. ..#.\ . # * . *   . .**.*..*.# #.**\  *..  .. #
#..... ...\ .*  *...  ..## *  ..........\#. .\#..  . ..\...... ...#....*.#*. .*. ....*.#.\\... *.\.#
#. ...... #...# ......#..... ....... .  .#... #...\...**# .....\ ...*.\.*.\*.#. ......*#..*... ##..#
# ...... ..  . .\#....* ..*.......  . ...* \##.\.*   #.# .###*..#.*.# ... .....  ..#*##* ..## #...*#
#. ... ... . *.. ...#\. ........\ .# ... * . . * .\..**....#. .. .. .#.**\...*.....\  **..\. .#....#
#.......#.#*..* #.*  .#*........ .. .....** . . . ...\ ..* *  ...#  .. *..#....#.\..*.\... #.. . . #
#.\ .*.. *\..#*...#*\.. .. ....#.....  #.#.. \#.. . .*.**...*....*..  ...*.#..........  .##. ....  #
#...\ ..* *.*.#...#*#....\#  #..#..*............#.   ...# ..#....  .*  #..##. .# .# \  . * .*.*.**.#
# .#... . ..  *...*\ ##. ...\ .... *.  *  .\ *  .... ......*....#. \...#....  #...*...*. . * #.\ *.#
#.#...*.. . .......#.#...*..* . ..\. \#... #  ... .*..* * ... ......#**....* .. ..*..*. .#. #. .. .#
# . .#*...... .#.*\........\*.#\  * ....*........ ..#... #\ ........##*.....*...*..#.. .\\.. *.*.  #
#. #.#...... \............*.  *..*....  \ ..  . .##.##. ...... ...#....# .. #.*.*.. #.*.. ..#..*\\##
#.#   *.  .\* ##..  . # *. \\.* *.....# .......#.. .*#. # ...\\*...##  \*.  . .* .#. .#...\##.\ ...#
#..   *.\.#.*. *.. ..R...#*.  ...  . . .. .. ..... \.*#*..#\**.#.*..... ... .#..#.....  .\... .#..##
#.....\....#..#...     ## .#.\.*\.. ..... .\... ..**.##...*......  .\#  .#...*.*\...*......*\*.  ###
#* . #\* ..#  #.# ..#.*.* .#..#.....\.#.\ .. .. *# ...#.. ...**#. .*.\... ...*... ... .*.\#..#.#..##
##.\#..... .. . .  . #.# ....*.#  #.##..*.*. #. *.... \.#. \.#..*. .*#..** .#. \.......* .#.....#* #
#*..* \.....  *. .\...\**. ... *.*.# ....*...\. #.# # #.....*.#. ..\...\ .*... #..# .\..*.....*#*.##
#..## \# . \*.#.#  *....  ..\. .*\..*. *#..*.* ....  .  .#*...#*.*.   ..*. ... . # ...\ ..# .. \...#
#... #... .#.  . .......*.... *.#.#. .#...* ## . .. .#....*. .\ . ..#   .. #*.  *.. ##  ....*   *.*#
#. .... #.#.. #.* .\#* \.. ..*..#. *. . ..* #\.....  . #.\  .#. ..\ .... . *.... **..... ..#..##*..#
#.*.*#.*..#. .*......\ #*. ...   ..#...#.. ..... ...*.. \ *....\.\** ...\. . .. ....* .*. .. ....*\#
# ....# ..#..**  \##*...*\..... #  .. ........ .. ..* .#  .\  ..# #..*#..# . .. * .\. ... .  .#*...#
# #...\\..#. ...#... ..* .#.. . ...... ....*.#. . *.# .**  ...\... ..  ....#\\........ *. .  . ... #
#... #* ...  ..# ...\ *...........\....\... . . *\.\#..\*..*# #.#. .. *... .# .*.#.. . . .... .. \ #
#.. #\.. * . .... .*.\. * .\   . ..  #\.... .\.. .#.. \.#.#..*.... ... *..*# ....# . ....\ . ..\ ..#
#\   .. . ...... . #\ ....#.. ...**..... .*..*  \  .#..##\* .\.\.\#....... *\ .#.*..#\.   .  *..#.\#
# .. \\..#\\  .  .#..  .. ...#*\........  \.....  ....\ *.**.. .#.....* ..*\...\#.  .  #.  *\. ..#.#
#..#  .  * ..#.*.*\....*..  . ...*. ..\.\...\ ..#.* ....#..# . .*#..... .\. **#.\. .. ...#.. .*..*.#
#***.. .#*.*...\#...\..#..#*.... .....* **... #.....# .*\.....*.....#\. .....*  ... ..\.\#.*\ #...*#
#............ . ..   .#. .. .  *... .#*.* **..#...*\....#*. .... .  .\. #.\ .*.#.*.. ...... ..... .#
#.\ ...#.. . #. .\....*......  # ...... # .  .*#...*..#. . *.....\*....  ..  * *....**.   ..*  ... #
#......#.#.\\. #.***\ #.. ..  .* .... . #...   .**#...   *.....*  . \ . . * \#.#. ..\.## .#  *.*...#
# #..#. *... . ........* ...#.  ... .. #. #.#... .*\#. .  #.\ .\. .. ..##* . ...* #.  #.#. * ..* ..#
###.   . .. .. ......\.\.# ##...*. #.. .* ##.\.....*  .. .. \#...\..\..*... #.......#**. . ... ....#
## #..*#. \ #. .#*...   .\..#.# \  ....... *.....  \ .*.#  .*. . .#. * #....*  ..*.* **\..*  ....*##
# #. .* . ..\\# *..\.*.. ....  *..*....#... ....\.  .\. * . *..*\*.\  \.....#*.#*....\..#.*.... .#\#
#\..  ..\.. ....* .  . .# .. *..*. .. .. ..... *.. ..# .. ....####........\\.. .....##. .. #.*  ...#
#.*.....*.. ** .  .... .# . .*\* .\\.#..\*#  . ...*#. #  . ... .\...... *..\ *.. ..\#. .*. ... ....#
#...... ... ..# ..\ ..#.. ..#*..#...... ... ..  ..... ....#.\.#... *... # .... \#.. ..*. ....*..\  #
#. . ......#*.. .  *\#..** #*\.*# ...*.*. ..#.*.#. ...  ...*#......*... #\...# . ..*...\..\ . . .#*#
#.*.*##.*... . .. ......  ....* .... . *. ..*..  . \.. . ... .* \.\#.\ .....#  .*... .  ..*#..*  ..#
#...#.\ ...*....*..*....*.. .....*. ..  .*.\.. ..*.. ..* *.*........ . #. *\ \.. #.... .... ... .. #
# *.......# ...*#*..\ .\ ..*   .. * .#..  #.... .. . \... .....#.....#  *.*...  .# *.#* #*.. \*  ..#
L*.\ .#.\.  . .\ .*..#..*#.*.*  .*.....*. \ * **  .#\..\\.......   .* \\# ... .\ ......*..... *#...#
#..* ....... ... .*.....* *.\.... .\......... .*.\\*..# *...****.. ..\.. ..*\.#....*.    #..  .#..*#
#. #. .#. .. .......*... .# *### ... ...*. ..* **. ..\....  .#......*.*..#.*#\ # *... .*.#..  .....#
#.. . # .#. ..#.. ....\*.*. . .* .# .##.. .  ...*....\#.. *......#.......\...* ...  .. #.. .* .#..*#
#......#* ..#..##.. *....#\ ...#.* ..    .... #. ..*... ....*..#.#. .  ... ...  . .... .\. ..# ... #
##..*....... ...#\#..#.#..*.   *** ..*... * ..  ..#.*..*..  . ...*#. ..*.*. ..##........#.* ...\...#
# * * .........*... ..# ..... #### #....*.#. .*\...# .\ ... .#*\ .. .... *. # ....... .*..* ..#. ..#
#.  \. .. ..*.. .*.*\ ##....  .. \  *.#*#.....*.... ..\..  \.*.#.  .#...#*.. ##......**. ...# #.\. #
# #..#* ........ .*. .*.....  #.** #.. .... ...##..\.* .\....\..**...*..# ..*.*.*#. . ... .#. .  ..#
#. .....#\*...  ..#..\\.**#.....##..#... .. .*.... #..*..  *.... *.....* ..*... #....* ......# ...*#
#..*.#*.#.#. .#.#. ..\#.. ..*** \  .*...#*. # .*....... . .#.# . .......*..# *.....* ....*...#**.*.#
# . .#.....*.#.    *..#\## ...#...*.......... ....**. *. . .\.. **...# .  .** #... . .\.....#*. *..#
#.. .\..*## * #. . .# #..  .*..*##.   ....*..\.*.  #..\*#...** ...*  \. . \.*\.#.* . .. *.#.. . #\ #
#.. .*....#.. ..... *........#* ....*.*. . ....#.\.#\...*#.. *. .*\*.*.\..#*. .. ...\*.*. .....\#..#
##.......\#* .. ......#.* *.. ...  . *.# .. # ..... ......#.. .##.\...*  ..... .\. *...#. .##*#\#.*#
# ... *\ .*##.\.#*..#.#. ##...*.... #..#*. \. .#.. .\. \\..#. * .*... ..... .    ##*...* ....\.\...#
#.. .\....... ..... \* \.... . ......#... .*\*. .....*...#  .\.. ..##..\. ..* ... .... ....* \... .#
#....*..\ .... .* .*........ *. * #.*.*   # .** .#*# \.# . #..#.*.. ...* .. .. # *. ..# .*..\*..#. #
#\. .\ .. .. #. .*** ..*..*..##*.** .#*....... .*##\..\..# .*#...* ..*.*....# \.......#.... ...... #
# #.... #.....*.*. .* #..*.*#.# ..*  ..... *#.. .*.. .*# ...*  .\ . # ....*.  .#.. ..   .**. \... .#
# #..   .*  .. .. .**...*    .*... .#\   .. .. ..*. ...* ..*..*. #.. *.... .....\..*  . .#  ...*.#.#
#* . ..\#. ....* .# ..*.*.\... . .. . *  ...   ..*. ...\  ..\. *.##.    ..##.......\..  ..*.*#. .###
# ..*.#.#...  #.\..\ ..* .....#.  *. . .. * .....#.......  ..\..\.\\. *..#  # ..#..# ....... .#*#..#
#.# *.  \.  ..#\\.......... . ... .... .*...   *  . ...* #...  \\...#..#   # .. \#..\*.#.. . .*.. .#
##.#...*#.*.*.*.\ . #*.#........ *...*. ... ..*\....*.*..#  .#.#..#..#*.***# \ ..    *. .**#. .....#
##.....*.*.  .#.. ..# \ *.. ..*.  .**... ..*\.\   ## . .........#. .... ...*#*........#..#. ..**...#
#.. . ...\...*. # #.. .*. ..# ..#..#.*..#.. .#*..\.... .. ..#*...... #..\ .*#.... ..  ...... ..... #
#\... ..\...\..*\..  ..... . *.. * #..*.  . ...**...**.#\..*## \.. #*\ *... .#.*   .......# . .....#
#. .\# .#.#\... *.. .#*..\ .    ..#.##..... .#. ##*.*\..*.#**. .# *. .... #.......*. ..##.*.. *#.#.#
#..* ..*#\.   ...*  .  .#. ......#.. ...#.....\. \#. ...# .. ..#.#.. ....#...###....*.\#..  ... .  #
# . \...... .#.....*.. \... #..* ...*. ..... *... . ...# # #. .*\#. #..** *.... \.. *... ..  ..... #
#. .# . .. * ##.* .  .#. \##....**.\   . ... *  #*\* ..*.. .#. \.. #.#*. \ ...#....#. ... .. .## *.#
#.##*.. ..\.#.*#.. #.. ....#. *.... .##... ..  #. . .*....   * *.*.....**.....#...*.*..#.# .....*..#
##..*.  . *....... ..*#..\. ..#.... \..#.\* \.... .....   .*.. ...*.#...#.#...#.#\\.#. #.#..#...*\*#
# *#...*.  ...#...\....#.. . ...\.....   .. ..... .....#... #.\*......*.*...#..\.....*#... .#.. **.#
#........  * .*..#... .#...**. .. #... . .  #.* .........#...... ..\.. \...\\.. ..# ......\\.\.*...#
#.. ...#. . ... **...... .\...\...*#*..#..#*..\..\#. .\..#...*#.\..* .... .... ..*...* ... .# .....#
#.. .... ..  ...#.. .##.....\.\. ..**.. .\. .*. .. *. .. .#.\# .. #....\. ..#  .**....*.#... *... \#
#\#.#.*..\ ...*..#...  ... \*..\...*..#......*.#.. ...... #\. ....\  . #**.......\..*. ...**..**.*.#
#....  .  # * # ..###.\......* ##....#.....*.....#  ...#..... *.#..*#.# \ . ..*.\.#..# * .  .. ... #
#...  ##. ..\. #. .. .....*\\.***.#..*\.* \..** . .# .......#.. .. \ .* . ...*\.............*......#
#\.. ..#.*...    .*.** #* *..\..# . ... . \ .## ...#. *...#. *.#. .... *..*...     **. .#*.*#.. ...#
####################################################################################################