####################################################################################################
#..*..\...##* .. .. .. . .....*#*\#\ ..#..... .. . *..#...*.*...*##... .  .  #.#*.#.#*#*.  . .*....#
#*###. \ .*#.  . ** \.. .#....  *..*#..#..*...#..*...*.*\  .# .\... ...#...   ... ....* .*.# . .. *#
##.. ...#........### #... . .. ...\*.#..*. .\#   ..# *..## #. #..*#*.#.*..*...  ...*. #.#.#..*.. ..#
#.  ...\. ... ..#.......# .*..#.\.*... ......# #..   *.#.... .#*............... .*.#..*..\\\...*.#*#
## ..  .**..**\.. .*\* .*.#.#   *.#. #.#*. .\.  **.... ....*.. \ .. ..........#.*  ...#  #...*.**..#
#.#....#..* . * #.....#. .. ... *. . ..*.* ...* ...*. \. .* .\.*..*.#.. \..\*.. . .. #..# .\. .. ..#
# *##.    #\\..*.... *.... *#..* .\....*.. . .....# .. .... \.*.....  ....#\... .#.....*...\..*....#
#...#.#.\.... .\\   ....\ . ..#....   .   .. ....*. * ...  #*. .#.....* *.. *   . .*....\...**.....#
## .##..*#.. ..*.# .### .  .. *# ... ...*.. .\...... .#.#.\ ...  . .. #*. ..#. ..* *#\...#*\# .... #
#.. ..\. .....  ....*# *.#.  .*......  ...... .* .*\ .. #..#...*.....*..*..\..*..  . #.# ..  \..#  #
# ..*##.#...     # ...\**.    ..*..   ...**..*...*\... .......  #.\.#... #.#. * . .    .......#. ..#
#..........*.. .. .. .\ .... *. *. ....*.*..#.##. ...*\ *..#..# #. \** .. .... ...\. ....... .\... #
#. . \.\#*.. .. . ##...\  ..* ***....# .# ..\.... #.. ..\..#..##*..#.*#*# *#....* . .. ....#.*  ..\#
#  *.#.. ............\* #. .# \.......*..##\....#\ . .#.....##.... .  ..*#.\\....#..#.* ..\.*#. .  #
## ..*... .* .*. . ** .... .....#..*..#..#...# ........\ .... .\. .##. .#..#.....#...#..*.* #\.*. *#
#... #.. .  ..*. .\ #.#..*.#. ..# . . *..* .......#. . . ....*. .......... .# \..# . ..#\...#. . ..#
#*. .....* .. ............... .\ #.**. .. .*...#*.. \ ......*  .*... .\... *. .#...*.. .... \\.#..*#
#... \*  ...\...*.#* ..... .... ..#  \.. ............*..*.##.... ..#...*.#.. ......\...*..#.. .....#
#  ..* #........\ .  .##*. * .. *#   ...... .#\..*.. .... ##.*.....   .  .#....# .#. #.   .. . ...*#
# ........... ..\..*..#.. \. .. .. #. *... .......#\. . *.*.. .##...... ..*.**.. .#  .\. .#...*....#
#...*. . .. . ....  # *....\.. . .......*.... .\.* .... ... ...* ...... . * *....* .#....#\  .*.*. #
#. *. ..    #..*.*.*... ..\ . ##. .. .. *..... ..* .. . . .*...**..#  . .* . ..*\.......# .\. . ...#
#.#.  .. ..##.\..*..\........#...\ ...*.... ...*.*\..** ##\. ..... *.\...#.. ...# . #...     **. #.#
#..#  . .# .... . #.  *.. .*##.. . #. ..  #..*.... ..\.   .  .#.\....#..\\. #. ... \.*. *. ###..\..#
#. ....*\..#...#.*. ...\ .. #.*  #*\..*#*.. .*.*.* ..\. .  #\. . #.  .. . \. ..*...  ..\ .. . \...*#
#.#...**... .\#.....*.*.. .\**... *.. ......... ... . .##*... .. .#.. \.  ...##  . * *. .\ . *....##
##  .. ......#\ . . #.\#\..#    . \*\.*##.*....  . \ **.... ....*  .  . ..#.#**..#  .* . ...# . ...#
#..  .**\\.*..\...\...#.. \...## . ..* # .. ...#..#..#.*.* ..** ..... .*... .#.*.#\\..   .*. .*... #
#... ....*..  .*.. *... .  . # .... ..... # .. .\... . .*\ **.*.\#.* ........... ..R*.....\...#..* #
#...# \.. .#.*. ***...#. .\* \.*\*.#\.. #.#.   . #.###... . .##..* .*# ... \* *#..*...#. ....\. ...#
#.....#..... #.#*\..*..*....  #....## ...*.. # .# \\  .*...* ..* .*...... ...\#. ...#.#...#.... .. #
#. .\#.......   .#. #..\...#.. *. ..#. ....*.#.... .* ...... .  ..#.. .#\#.......\  ....* .#..... .#
##..... *...* .* .#.**  *. ....# . ..* \ #.* .\.#\  ..#..\....*..#  . \. ... ..*.. .#*.*...... ... #
# .* ..*. .#.. .\... .***...... ....... .# .\.....##* .. *#.# .# ***..  \..*\.. ...#.. #* ......\.*#
##..*. .....**#.#.*#  *#.\#. # .. .**\.. .#...*#.#..#*..........*  ...\. ....... ...... #**.*...*..#
#.. ...#. . .*.... ..\..\.*.*. .* ..# ......*... \ .......    *...#*.......#..... . \ .. #*#.     .#
#....*\..**.  \.#. **\ #*\# .\**..#\...* *.# .....*..  #..#.*.#... \........#.... *\...\..\.*# .. .#
# .  ........\. ..\ # .. ... *...... ....  #...#**...*.#.* ##.....\..*. .##*...  * # .  . #*\.#.\.\#
#......* .\ .. .. .#. . \....\........ .\.#..* ......*...#... .\... *.. ** .*.... .*.#... .\..  .#\#
#.#..#...*..#..#...*\... ..* .#* #.*  ..# .\.... #.*\#  ..... ....\*\...   . **# .\..  ... .#\#\..*#
##.#**\..#...#.*..#.\##.. \ *..... . ..#.*.....\. .\ . ...*... # .*.#...# #....*..... . #.# #.\\. ##
#. **...*.\#....* ..#.*  #.*..#.  #   #*.  *#  ..#...... ... \..*.. ..# .#..  *...# . .. .#...... .#
#\..... ...# *..#..  *..#.... #*# ..#...#...*\* ** \...*. .... *.... .\... ....   .. ..#. . .. *.\##
#. . ....# ..  .. ..#.#\...*.#.#.   ..#. ...\ **#...\.*#.\.*\.. ....*. *.#. *... ..  # .......*.#*.#
L...* .  . # ..... . **..\. .......... .... .....#*..#*  . ..  \*....\...\.*.*......*\.... ........#
#.......\ #*..... #  . ..# #\.. ..#.#.* .. \.\*.  #.\....... *.\. ...#*.# ....\..#\. ..  *#..  .  .#
#. ...........*.## # .\.. ....##......\# .* .#..\.    #. *#..........#*.# *. *..*. \..# * #.**....##
#...........#.. #.... .*...  .. . .#...  ... ....\.\*.....\..#*..#...#.. ...*... . .  ..##.*..*.. .#
# ..  .. . . ..\... .* #... #...#...# ....*.*. #. ... ..*# ...... .  *   ... .....  .  . ##.....#.*#
#..*. #.#. .#  *.**..#..*#.#.*# \#..# * .\  #..* .. *  ....#.  ..#  .. ...  *\#.  .... .*.*#..\..*##
#*.#..##. ..*.. \. . .. .  . . \. ..## .*.* .#.* .#.#.  ...*##.... \ .\... #.. .*......  # *.. ....#
#\**.*.... # #.... ...* ...*...*.... .......* ......\.  ##*#... .. ...*. ..#......*. ....* . .... .#
# . .*.  . ## *..  .. .*. .........*...#\ #.#.\##..*. .* ..#.#..#..###......#* #.*#  #..#.\...\....#
#.#.  .#.##*.*.... .....*.... .*..#.......*...\.#....*..#.#.*#. # .  *#......#.#...... . # \. .. . #
#....  .    . .#...#\##*..# . .*.. .... . #. ... #\...... ..#\#..  #...*.##..*...*\ . ....\*. *...*#
#..*............\ .\..\ .... ...*. ..#.#.# *  ..#. .....*.....#...#\. ... .#\*.. ..#.........\.. ..#
#........ #*#..*\#...#*...\.... .\*..#. . .#  *.. .**....##....... ..... *....*..\.\##.# .  ....#..#
#\#..\ . \.......*#*.  .  ..#*.#... ... ...#*.\ *\###.*# ...#  *\. *...  . ..\.. . *.*..*#.. .# ...#
#. . .. \. . .*. *... .. ....\....#.. .. . ..  ... .##.\*. \.*..* #......\.*. .#*. .#.*.....*.*....#
# *. * * ...*......#*..... \ # .  .......#...... .* ..#.#...  .\...#....  .** *... .##.*\.* **...*.#
#.#*..\ . \#.*.. . ...# #...  \... \...... ......#.. #.. *..#*.#....\. .#.......... ..##  #. ..\  .#
#.. ....#....... ....\.. . .  .....\#..##*#.. *#....*\ #\.\...*#..\.##....  ..#** #* \ *... \#.#. .#
##. **..... .....\.. ......  ...  ... ..... *.....*. .......#. ...*  ....  #. \....*..#.\\#. *. . ##
#.\... ..*#..#......* ..\.\...   ..*.  \...* .#*# ....\\ ... .\..  ...\ .## .. #. ......*.*#*.*....#
#.. *.....*.. .\.*...... ..... #.. #... .#. ..*.*.. . #. *..... \ ...#....... .#.#*..*....  ..... .#
#    .....    .\.   ...* .#*..\... .... .  . ..    *.#.#. \.#.  ....*.  ..*.*..* #.#. .#*.\....... #
#..  # ###....#.... #... ... .* .   # ...*. .\.* ..  ##.. *.#......  ...*.. .#*.**##.....#...#.#...#
#.##.#...... .** #.##.....\... ..\\.. .. .*.. ..*.. .. . ... ..*... #**... .#.  ... ..* #*.#.....  #
#......\ .......#.... . ...* .*#..*...#. .** ...#..   ...* * #*..\...# .. .*\.. ...  ... **   ..* .#
#..# #* #  ..**..\ .#.\ .  **#. .#.............. .*... .\.... #.\#\#.....* #*..* .. .#*\ *.# ......#
#.....*.\..\ #....***\\# ... *.\.#... ....... .. #....**..  ..... #\ ....**.... *. ...\.. ....*....#
#.##. ... #* *....*.*.#  ...\#. .#.. *#..   ##....* .....#*\.... #  .*#. .#. #.  **.*#  . #. #.  . #
#.... ..#.\.#.... ....** .##.  *.*..... #.*....*#..\*\.#..*..*..#\\#  \***..\  #.. ..*. . ..#...\ .#
#....... . *..  .*##...\# ..\\..*. .*..*.\. . ........\##... .. .  .** #..*.**..*.   ##  .. #.... .#
#.\ .. .. # ...\. .  . .  .....#.#..##\.* #..*...#  ....*.** ..*....\ ##..##.. ...#.. *.\..#*#.. #.#
#.....*.. #* ... # . #.*....  #...... .. ...*. #..\.. . .# * ..* .\.#.* ..#..\.#. ...  ..#. . . #..#
#.#..*...##..\  *....\.. #..#. ..#......#*. .....*....*...\ #...# ##.\ ..\#... *..#.##...*   .\ \ .#
# .....* ...#  .#...#... .*. *. \..#..#. *.#*#. .....#. .* .*.#  \** ....*# #.... . #*#..  ....#...#
#*.. ... .# . ...*.#.* *...* .. .. .....*\*.#..#.....**  *..##..*. .. ..#*.#  .*... **\ ..  .#.... #
#..  .. .  #.*\. . .##..# ..#.#.  *.*.# # ... ## ...*............\..#.\ .... ...*.. ...\.. .... ## #
#*  #..\ ........#.*...*.#. *....*.  .... .#*  ## ...\#. ..\ .   . ##\*.*... #.##*   #**.#*.* ...  #
# .\ . * .\#*#*.. #..   #....#.\\   .*.. ..\. . *.#. .. .#. *\. . * . #*. ... # . \.# .*... *.##. .#
#. ...\ .*.##.. #.* ..#.**#. *.#. .. ##. . .....*..*  ...#...*....*.... ..#  .. *   ***. ... *.#.. #
##*. . ..#.. \ . ....\#* .. .... .. .#...#.....  .##.* ..#*.... *..#.\  #. \ * .*. ...#\#.*#. .*.*.#
#.   \...*..... . ..\ .*.  .# ..... #\.*..#.#. ... ##\.#*..\\ ..*.##\*. #...*.....  .. *.## .\.... #
#......#... .# \   .\.#... ....... *#.** ...... ...**. \.*...#.... . ..\. #...#.*. ...#.........  .#
#.* #.. *..\...#* ..#.\..##.. .**. ........ ......  ...#. . ..#*\  ...   . #. *..... .\.  #..\..# .#
# . .*  .\#. . .. .... ....... \....#. ...**...**.#...\*##....#\.*##...\.  *...\....   ..\ \ .*.* ##
#... ....*\..*.# ...#.#.#*..* .  ....... #* .....  . \  ... *...*.. .#   \.... ....  . *....#...*  #
#. ..*..........##...##... #. .\*\\ *.*.\  **... .. \ .\  .*  ...#.*. . .*.*#. ..#.... \.#.# ...#. #
#.. ..... .*...\ .  # ##*..*\\..... . *   ..... . . ..*. *#..# . ..  *\ . . .  ...#. ...  *..*. ..##
#..  .... ..  ...... ...  ........ #*........  .*.*..\..*#.  .....*...#....  ..*#...  ##..\...* . .#
# .*#*  ...\#.. ....  ..##. #*.#\.*#..  ... .#\.\.*.. .* ..*..\ .* ..\  ....#  * ..#..... .* ...**.#
# #  .  ..# ...*...*##.# .. ..*#.\\\....# #.   .. ..#.*#.\*..#  ..  ..\..#*...##*#*....... ##..### #
#\# .... .  .***.....#\....  . # . .. ... \.\..*#*..*. ..#.#. #.## . .**.. .#..#.\.. #.. \...#..*..#
#.. ....#  ..*.. \.#.#. .\.\..*.... #..#*. *#..... .  .... *.. .. . ...\*.  * .   ... \ *##.. *....#
# #**\..\#.  ...#\... ... *    ... ##...... ..#...#....*..#  .... .* #  *. *# ....  ..... ...  . .##
#.. . . *.....*.... .. *.  ... \..#\. *    ....#... *.....#...\..#**\......  ..\..... .. *.......*##
####################################################################################################