####################################################################################################
# .\  ... ... .*. \.. .*.. ...... ..*  ...*#. * ......  * .. #. ... ...*.# #\#....#...#.*...*...\ .#
# #\.*.  .. ..  .......*.\ .#... \ * ..#.#. .* * \*\. #..#.....*.....  *# ...*.#. .  ... \..*.#. # #
#.##.........#*\\.* ..*# . .##... . .#..*.....#...*.*.....#. ...\..*..... ....* .\. ....## .... *..#
#*  #\**...#... ..* \...*##.* #..........*#..**.\#..*.... ..  . .\..#. ..#*   ......#. .* .  .#...*#
# ........ ..*.*...*..# .## . ##...\#....* \.#.......... .##.....*  *** ......# **. ...##*.  ..... #
#.*.....#......... **. *.#.#*. #... .#.*. . *#\.... ..\. *.## .#.....#.###.#*... #...#...........*##
#\*.*.......#.....*. . .* .*. ........... ... ..  .# . **.*\...*#.. .#..  .... ...\..   ......\. ..#
#. ...\. .*....  ...\.*.* .....*\..* .. ....#..# #....\*\\....#  ... ..***.#.* ...\..... .  * *....#
#. ..#  .......#..  ...*......#..#.. *.\. ........... .............. *.*...#.. *\ .*.. .. .##.#... #
#. .#.\#.... .. . ..**.#  * #\**..#  ..****#.*.#...#   ....\.... .*.... .#..\..*. #..  .. .... .\  #
# ... .* .  . *...   .#..*.. ....#.#.....\  *.  *.\..\.\. *#. . ##\....#..\... #.....\.*...   ... *#
#...*...........*....#. .  .*.#... ...\. **..  . *..*.\.#*\....*## ....*.. .#..#*...#.#*  # .....  #
#...# *......  .\\ #*#... #.*\#..  .#*#... #..    ....\#..\..\...........##* ......##.*#\* ..\..\..#
#.. ..#.\.. .... ##. ..* .. ..*..*..\.. .... .*......*...\.#.###*. .*.\.#* *... ......... ....*#...#
#...**. ...#. .#*..\\... .. .... .*..#*..*#...# \##.* . ...* ..#..*...\.#.***.. ...*...*. * *. . ..#
#..*  .#.  .*.#  ..#..#....*..*.\.....\.\....#..*.\.*.\ *..#.. .  **..*... **. ...*....  ..#\\..*. #
# .....# ....*..# \.. .# ..*.....* * .  ...*.#..\* .  ....\##. ...*.#....\. \#.... .....*.*...#\ \.#
# .  *.........* .*.#\\  ......#.*\.. . .. .  . .. ..*...*..#   .*# .. *.#  ...*. *.**#.*.... . ...#
# .##*.. .# \ ....*.... *.\#..  ...#. #.#..  ..# .... . . .*..# .#**. . ..*.......\ ..#.\  ..*.#.  #
#*.\.... * ..*\..#* ** . ..* ..*.*..... . #.\.*.*..**. ... . ...* ......#. .#\..*... . ....... ...##
##\.*  ....* .\*.\. .*. ....#.   ...* ..*.\.  ..#..**... #  .**#..\ *   ***##.*  ..\*..  * ...## ..#
#*# .*...\.....\*.    ##   . ...\.*...*. .. #.*. *...#* #.#. ..*...*  ...**.\# .*..#*.#.#.. ...#.. #
#..#*..  . ....# .# . .#... ....#*. ....*.. .#\ ...\  . ..#*.  \.....\*.....# ....... ...*  \#.....#
##.*..*\.. . .........  ..\... . *.# .. .*.*\# .\.\* .....#*...... ...##.# ...#..#..*..  *.*..#\***#
# ..*. \..*#\\ . #......#.*.   ..#... ...... \..... .. ..#..*..\ ..# ....... .#  ..#....\.\#......##
#... * .. ..#.. . #.. .\ #\ ..\*#...## \#.......#.# *#..*\#.*#.... . .*\#. ...##....#. . ...** \##\#
# .. \*\.*..**\*. . .... .\ ..#....#.  .# ..\ .\ .. **\\.#.... \.. ..\...# . ... .....#..* *......\#
#.**......#...#.....#.....#.*## #.\..  *#. ** * ....*.# #.   *.. ...#.*.*#*. .**.   .... .....*... #
#. \..#\.......#*. ...#*.\ *.\....#.. #. **#..\.*##.....*#.\ .. ..#\.  *......\.\......#.....\#.  .#
#.**#*....... .**. ....*.*#..\\..*.. ..*...* ......*...# .....#.. ....##....\  .  ... #    .... .#.#
#*.#.... .....*   .. ... . .\..   ....**##.. ###. #. ......\# *..#.... .  ...**.* .   .*.#. ..*.*..#
#.#.##.#.#..*. \ ..\..*..# ....* ...\ .  *.....##\..... .#..\.*.. * .\. ..... . .# ..#......**.**..#
#.*. .#...   . ...#\..*.*# .... ....*#\.. * .... .*.......#*.......  #\...#.\....#..  ..*. *.   *..#
#\ . .*. * ..\#....\\.#.*...#.. ...# \. . ..#*...##..\\ *..#*#.##.....\*  * .. .#....#.*..\.*..#...#
# ...\.. # #...   .*.. .#*. *  .##...**\  ..*..#......... .\ * *.  # .. *. ...\.**.*.# ...*#\*.....#
# #.. .. ..  ...* *  *.*. .... ...... .\.  ...* ..#. .    ..#...\\ ... ...* ... ..   .  ..##.... ..#
# ....#.##\.. . *# ... .#....  ...\..*\\ *..\.*.  #...  .. ...... .#*...#*........*.. . ... .......#
#*.... *#..\..##.*.# ...#.. ...#.. . . ....#.#.....  .\.#..........*#. ...*.#.. .... .#.#  .*\ .. .#
# .\.. .. . ..  ... .#..\#..\..#... ....*...#*.... ....*#..... \ ...* . ...*.# ......   * .  . .\\*#
# * ..........#...*. . ..\.# *   .*. .#*.#..#....  ..*.\*. .# . #.#.*.....***#..* *... \ #.. ##*..*#
#..#\\\.. .....#..#.#..#*#... ..# ..\ ###....*..**#....#..#.*#.*..*..*#\. #.   \ ..#.*..*..\# ..#..#
#...*. . ...\#..#.. ..  .....\#.*. #\*.\.....#. ...\........ \.  \.\..\.. .. .#**\ . ..\ .........##
#. .......#*  ....*   #.#..  .... .*..*...*.#*. ...* ..  . . #..*# .. ..* ..* . \... ...\*... .  *.#
#.#.. *.*..  .. ..\.   ....# . ... . .#\.*..##\  .*.. .*# .. .\\ ...  ..##.\ ...  ....#..*.  ..*\. #
# .#.\. . .*... #\ ## .....  ...\# *.#.*.  .  .*..........*#*..*..*...  .#...**.#.  . #.. .#***.. .#
#. ......#.......* ... # ..#  ...  .#. . \ ..\.* \.  ...\.. . ..*.*# . *\..\*#...\ .#..* ....*.#.*.#
#*. *..* .#*... ...#....  ...#...*\ .....*....#.. . ..# \...\..........#. #*.**.. .   #**. .....#.*#
#.# *.*.......*.  ..  ..\ ..#..\.. .** ..# #..\....##. .. .\....#\.. .. . . . .. ...#  ##.......  .#
#. ..#.#* .. .     ....... #.\ ..#......... #.*.#.*.##.\.*.  ....##.#..... ..* ..   ..*...\.**....*#
#*..*...# ....\#.....*.#.. . .# ..  . .... .....#..  ##.. ..*...#.*.. ..#\ ..*.........\..# .  . . #
#.. . . \..\.*. \ .....#\.\.#  ...\#.#**. ..... ...#.  \ . ..#....#.   .* ..###  #..#..#..#*...# . #
#.....*...........#. .. . ...# . * # .#\..* ..*..# * ###.\  ..* ..*\ ..# .*...#  ...#..# ..*#\..#..#
#. .*\... #.#..#..... #. .. .#.# ...*...*. ..#. . *\.**\.. .#..\.... *... *\..\.###...  ...... .#.*#
##.\.. .....#  ..*.... . ....#. \#.*. .\..... .#*\. .*#. .# .#.##..#. .. *........#... *.... #\.\..#
# .......#.  .\.... ..  .... .*  \.###.*#. *.. ..#.*\.*. . .. ... *.*.#. . ...  .#....#..... ..#* .#
#\.\..\*  ... *..*.#.  .. . ..\ *  #.#....#. ...# * .. ...#.\..\.\... ...... \#.... . .... ..   *\ #
#...*\.\ ..*... ..#...*....... ....\ .*..  .. .\.. .*...\.#...# . \ *#.. ...*.. ....#..#...*#  .. *#
#.#\* .. ...#  . ... ...#.*....... .. ..# *.. ..#..\...\*  ....*.*\.. .  ..\. .#... #.#....... ... #
L* . .... ...*#.....* ..........#*.\....\.. ... * \. \. .....  .#.. *..**..#*.\ ..\ #.  **.........#
#...*.....#.#....# ... .## ....  ....  .... \\\........*............#.*#.\. *\ ...#*\.#... ..  .. .#
#.. .. .#..*. ..... .**... \.# \ .  .. ...# .....\#.\*#. *. ......\. ..#..  ... .*..  \# .**.......#
# ##..* #. .. ##. # .. ..*.\ . *..   .....#...... . #..... ..\. ..* ...... .... ..#...#\#. *\...##*#
#* ....#*.#..\.* \...*.#. ..#.##   .\..  .. .\#.*..# ....#*..  *.\.##*... ..  .  #..# ..... \##....#
#\...  .. .... .  ..\... ..#  *.#*.\ ....*...#.#...#.* #..*# #... ...*...*.* ...##.. .*#.#*..#  ..\#
#....\*.  ....... ..*..#. .*. # .* ..*.*  \.\.*\.  .......*. ..*#..**...... .. .#*...... ...  \..* #
#...... .......  . #*. ..**.#....\...**.#.*.#\  .. . *...#..\. . ...   .\ .\ #..*... ...*........ .#
#...... \. . .*.... *..*..  ...... . ..#... # ...*\*.  .. .\... .**. .. .... .... ..... *..#.* ..#\#
##**...**... ..  #.*.....#  #. ..#. .#* ....*..  .#.. .*. ...*\...#.#.*#. * .*....   ....\ #.. ..**#
#...*\..#.#.......#...... ... .#....\....#*.... .  .#..\ ..#......... ... ......\#... ....#.#..  .\#
#...*..# .\#.#.*\ . . ....*.*.  .......  ....##.\*.. \..*.  ...** # .#...*. .#. #.#.*....... #\....#
#...... *.  \#..# .. ... .\. \. #..*   .* \*\ ...\.##.\.. * *.....*\....*#..\.... .#... .   .*#..#.#
#.#...\\#. *.# ... .#*....*.  ......\..........# *.. .......#*\. ...*...  ....#...*\.*..\## .#  ...#
# . . . \.\ . .#. .... #.\  ... .....**.. #.... . *.#..#.\.#\ ... ..*.....#*. #.* ..*..#.#.\.#**...#
#.\....*# .*..#.. .\#*.. #.*..\#  *... #  *. ....*...........##. ...........#...   \*\.. ...#* ....#
#*  #.# .....*.#.......  \...**.** .#....... ...*# ...# .#. ..##\##*....*.*..#.#.....\.*.... **....#
# * ..\....#\*..#... #.*#......*#.##.. .. .....#  *\..#*. ..# .\. ..*.......*. ..#. ... .# .....  .#
# \*.\\*    .... .#\.*  #... #.. .  ##.\.  #.*..*.##.. ..   .... ..##...*.#. .. *....    ......*.*\#
#.*......\..#.\#..*..#* .\*.  ...**..#...#......*.\.. .....\.. .\*..#\...* *..* #...... .\ ...*   .#
#..* .\..#....*#\*.... . .\. .\...#.... *..*..\.\\*..#.*.... .\....... .#\*# ..*# ...*...#.#..... .#
###\. *....#  .\.*###  *#. *... ...* #*..\*.#. *#.# *. *.. .. ...  #*. *.. ...#....\.* #*..  #\. . #
#..#........*..#.*.#\* .\.* \ .*.. #..  ....\\ ...#..\.* *\.# .*....##*....  #. .. ...... # ..**...#
#...*.*#.....#.  ..#...*. #. .. ..\  ..**.#..... ....#\... . #. ...  *..*. *..*#.... .. .. * ..\  .#
# #.*...#... ###.  ....#..\.*.*..   .....*... #. ... *..........\..#\# .......*   .. . *#. ...*..\.#
# ..R.#...\ #* ...#.# ...\..\...#..# .. ...#.   \#*#...... .......\..# \......  \**..... ....#...\##
#.#.... . .\# .. . .\.. ......*.... .#*. \*\ . ...*.. .\. *...\   .#... * .#.*.......*#...*...\....#
#....  .#.*..#....#.......\ ..\ .*##...#\ .\. ....*#...*. .\ .  . ...#    .  .*.... \    *. ... #..#
# .. .#.*. #..*##...*  ..*#... .... . .....* .. .#.#.  #.*..  #..  .#* *..## .  .\..* \.....\...#.##
# . .\. *. ...  .*.#\  \#...#..  *#...  ....#\#.#*.\.. ......... .. * .  #...  *.\. ..  ... . #*. .#
#..*#...* .......\ \. *..#. *#. . ..  .*..\*.. .# ..*#  #.\ ...*..\*.... #*....\.  \..........\... #
##.....*.  ...# ......#. ......#...###...*\#. # ..#.## .. ...#.. ..#.#.....#*. ..#...#... #. ...*# #
#... ...    ...\...# .#.......##.. *.#.# .#... .. . #. *#.  .  #* *. ....  ..*..#. ..  .. .........#
# # ..\... .*. ....#.*.#.*  *... .# .. .#.......#...# .\* . ....# *...\...#...\ .# ..*.#*#.....**.##
#....#...*.....  . ....*.  \...* . ..** ... .*\...  ....\**...# ....#.. ..*  ...#\. *..#.....*..#..#
#...... .* .#.*. .. .*...... #\# ...#.. .. * #.*...... ..*#.\#. ..\  ...*......\.#.. ... .*.# *. # #
# .. .#*....**..*....\..........  ....*..........*. ..... .. ... .....*\**....#..#\#.*.  ... .#. . #
#*.#. ... .....   ..*.\.....*.  *#. . .  * \.*.#\..*....... \..#..*.... . ...*.*..#. .. #*..\....*.#
#..\.. ..#*\#.....#...#.*.*#.. ...\.\......#. .#\.  .#..* *.............#. .#..#..........  .#.. ..#
#*. .*. .* *.\.....# \##.   ..** ....#.*.*** . #.*  *..*.#. .#. .. ##......  #..*. ..\ .... . .\...#
####################################################################################################