####################################################################################################
#.*\..\ ..###..* *.#...#.*  ....#\ ....* ... ...#*\.  ..*.\..*****.*......# #\. ##. .. . # #.\  #  #
#... .......*.#** .... *\..... .#. *.*...*.* *.. .* ... #\ *  .. ...........  ...\... ....  .#.*...#
#...... .#.\ .....*#..*..#.##.#.#.. ..# ... .*.#.  . ...\..#... . ..  . . . ..#.#. *. ..* **..*....#
#.#.*........  *...\* .*.. ..\##..... .#*..... . \.... ....#..\\.** .....\..... ......#... .....#..#
#.#.  \#.*.    ..*. ...... ...  # *.# ...  # \ .*.*.#.#\ *.... .*.\... ..*....*.... ...#*.##*. ... #
#..#.\.\ .......*.#\*....##... ...*\. *.\ *..*... ..... .*.... .#.\...#*..*.#*. .#.... .*.**\.\ .#*#
#  . .*  ....\.#.*...*. . ..#. .*.....  .... ......# #  . ...... ......  *.*#.*.**#....#.\ ..#....*#
###.....#....## **..*..\..... ..  ...#. #.. # .#..**..*.. ...*.\\  . .\.  .. #... .**... .. ....\..#
#.#. \. .....#*. \*.. ..\\...\ . .... .*..##..# #\\......\###.. .## ...#.. ..\.#*.\#.#....##.\. .. #
#*...\.\#.. ..  \......*.\*.....*.# ......\...**.#..\.#\ #...\#.... ........... .##.# \. \# . # #..#
# .*.\  *... ##.*# #. .#.#.\.\.*.** . # \......   .... \* . .....#.. ... \..  ... .. .#.*# ...#. ..#
#...# ....#... *\..*....# .# \ .* .\......#.\.#. *......#.... ...#..*.  ...  #..*...* ..\..... ...##
#.. .. #..\#...#..  #. .\  .......*.   . .*#....# ....#. ..*. *#. # #...# .#.. .#...* .   .. .. .#.#
#.........\ *..#*. . ...* ...   .. . ....\ . .....*. .*..#.   ...\..#**.* . . .     **...... ...* ##
#. .  .........*...* ... .#. .#.   ...\...  .... . .\ .**.*#\.   #........#....#...  .... ..\.  ...#
# ... . \.*.. \.\\....#\ . . ..# ...#*. ... .#  ...* ....*.*...*#  .#.*............. \ ..#.... \ . #
#**   ..  #..*   .. .\*..\.#. ... . *... \. #*...**.  #* ..*.\ .*..##. ...#... . # .... \.....#.# *#
#.#  #....  . .... #.#....*....... #...*.#.. ..* .\..* #  \#*.#.*.......##. ..*.* \.#..*....##....\#
##.\.*# .. \.\#...#..  ....*.. # ..#.\..*.*.. ..* ..* ... # .# .*..\ .#..# ...\. #*...\. #.# .. ..*#
# .**...\.* \ ..*.. #..... .... . . ..**. # . .\.. .. * *#.\#..#. ..#.. \. .*.. ..  .*.# ... ...*. #
#\. ....*......\.# \ ...  *#.. . ....*\**..  .# .#\..*#....#. # #\.... .. .*.*.*.\ ..........*.*  .#
#\. ... .\.#..\....  ..\.*.# #*.#  .. .#.... ....*##...*...\# * .   ...   ..#. .#. **....  ..  .#..#
#. .*..#\.....*.*. ...#.* ..# ..*.....* \*#   .. .#* .....##.\#  \.\*. *....\......**.. #\.... .\..#
##  .. . #*.  \. ..*..\ . .......... ...#.*\#...*. ... .. #*.*.....*  .. ...#. ...*....##..  ..*\. #
#. ...#...#...  ...###.... .. # .  \...   \#.* .... . ....* ....... .#*\\. ..\.#.\   .* . .*...\. .#
#. .   ...\ *.\..... .*...# **\*...... . * .#...*#. . ..#..... ......*.\ *....\. #..*.\\#.#...*\.#.#
##..\## *..\.*.#. #.\.*.....\ . .*.. . ......  ...*.*.#.#...   . .. *#\ .. ..* * # *...#. ........\#
# ..#\\.#. .. .\. #. .#.. #..# .#. .. . \.... *..... .* ...\.   #. .. ..#.\\. .\...##. . . ..*.#.#*#
#    ...*#... .... ...*.\..  . *.. ..##.. ...*......#.#.# ..... .#...*....*. . .*..*......  ... ..\#
#.*# ..# \...... .........*. ......*... .\ .. *#. ..  ..##*.*..*..#..\...*... ..#..* ..**.. ..  \.*#
#** .....#..##....*  . ....#.. * .. \ \.*\#. .  .#.#.. .. ..# .**.....*....\\..\ ........... #...#\#
#.. . . .. . ...**   * .. #*.. #.*.. #*.....# .* .#. .#.\.#... .*..*.... ...#*..#**..#\* .....  #..#
#.* ...... *...*. .....   .... ...*.. * ....#....  \##.. .#..  ..   ..*. .*... .... \. *#\* .#.... #
#..#*  . #..  . *\#. **..##. * .. .....   #*.#. #.#* ...#*.#.*   . .... ..* \..*.. *.. *.. ..#.....#
###..  ##.  .* .\.. .. \. ..* *.........*....# ..  # . #.# . ...  ##....\\.#...#....#. .* ...*...* #
#..#** #\ *..  #. ...*#*\..    ..#.   .#.. ..#..   ..# *... ....*. . #..#..\.*.# ..\.... ..\#*.. .##
#.*... ...# ....\..#.  .\\.. .\......*.#. .#...*#* .  ..#  .....  .... \#.... ... .\. ..#..#.\  . .#
#.......\.. * #.*..*..   ..*.. .  .*....#. . *...*...#.* #.#.... . . ##. .* .. .....\\....... ....##
# . .\  . ...#*... ..##  .# .   . *. ..... ......\.. ... .....*.....##..#.. .\...\. ...* # #\*.* ..#
#.\...... ..#.. . ....  ..#*.. . ...... ... .. #.\# ... .. #.*.. *. ..#. .......*. ...   . .....# *#
# \.. .#...#*#...... \*\ .#* ...# #*   .. . ...#. .  .*.... .*# .. *...*.*#..#*#. #. *.....*...#..*#
#... .#.  ....#......* #...*#.##*....# .#.\..*..  . .\.#\ ..*.  .. ....*..*..*....... .*\.  ..  ..\#
#*.*..#.#...  .**.....# ... #.... . ....\#......**...... ...#.......#  .#*..\*..* * . #.\#...  ..\.#
#*. .......  .. ..#....... .* **. *  ..#  .*#. .\ ..#. ......* . ..**..#.  .# *.... .# .\.\*. .. ..#
#... ..##*  .....*#*...... .  **\.. ..**...# ...#\.\..# . . .#\..*....*...#. .\...... .... ..  ..#.#
# . .. .. ..#.#   .*...\ \...#*#.#.   ..# ...#*...*\.# .* . ...#*..#.**\ #.*. ... * . ..... . .... #
# *..\.#... ....*.. .. .*.   . # # ..* ..#*..## ..# \\  ...#..\. . . #..# *......*  .\\#.. .. ...\.#
#...* .  ...*.. ...## #.# \#. .. .\*.. #...*... . . *....*.*....*..*. ...  ..#.#.\. # .\ .#... .  .#
#**. .... ......\.. .... . .. .# *. ......* \.. .. .......#...... #..#\ ...... ..* . .# ....#..#*.*#
#. ..# ...  .* #..\ .\... ....* ..#* #.#*#*  .#. ..... ..  . *#....*.... . .#....... .. \ *\.*#*...#
##..\*##.......... .. . ...** # ....#*. .*.....*.  *#.  ... *.. .*..* \..\ .........*.  .\.......#*#
#    . .*.*.  #.#.#.*. ....\.*..*.*#..\. ..*..* .\ .* . ..*..*..# .#....#*# * . *.***. ..# ......###
# *.. *. ..*.* #*   .\#.. *. .**.. \\\ *....\. . #...... .\*# ..#. *. \....*. .... #. #...\... ... #
#*...\.... .. .....#..**    .#..#.* *.. .. ...# .\#.... .*...*  ..#*#\#. .#....*.....\ .\.##...\.#.#
#...\\....*#....\ .. .....#.#. . *# . #*  . . *#. *.#.*.\. .* . *.\#.....**...*.\..#... .#*.*......#
#.*........# ........*.*.*.\.# * .*. ..# ###. ..* .# . .#..#.......# .. .*. * ...  .# ...#. .#.#  *#
#.....*...   ... . .#. .. .  . ...# ***.*.. *...#.#\...*..**. \..#  ....*.#*##...#. ..  .....#\  ..#
#..  .. \........ .#... .# ....... . ....*.\# ..*.*. \. .*. .#....\#... .... *.* .... .*#.. . . . ##
#...*# ..* ...... ... *... ... # ... ..# \#. . .. *...##. ....*.... .\..... .* ..*..... . # .* . \.#
#...#  .. .#.. ... ... \.*.*...#*......#*\.*... #..*.... .*  ..... .............# . ....*..*. .. *.#
#. ...* .... ..# #.\....\. # * ...*.....*.#*....\.# .. #. .#......# .. *.# ... ...... #.* .......\##
#...... ##. ...*....  .# .*.....\.\.#. \.#..... ... .# #.* .\\ ..... .. .. .#.#.*#.##.\. ......* ..#
#.   # ...*.  . .#... . ..\.#... .............#. ..#.*...*.\. . ..  #.#..**#.# **  ..*...** ...\*..#
#...... ..*. . ..#.#. .   ......# ....  ..# *.#. . .* .*\..  ....*..\.*..#.....\. \.**.# .. *..*..*#
# #*.#.*... ..# *...\. ##.....*..... .#. .................. \##..*..#. ..#*....* * .#.....*.. .....#
#.#. *.* ..* #.##  *#*\\   ....*. #. ....\.#*#..*.## .**.*.  ..*#..# ###* ...##.#.#.... .. ...#.* .#
#*.##\.*. .\#*........ .\.........#..  ... ... . * #..#. *.#*\.. .# ..* . ......  ....*..... .\ #. #
#*..#**. #.\..#.. .. *  *\ ** #*.*\  #...#. ..* ...*.... .. . \......... . # .. ..*.*.*.\*##.#.....#
#*. ..* *#*.*..#.. *....\# .* \.... .\..#..*.. . #.  . ........ \  . ... \.. *......#.#.  #.... **##
#.....*. \.##..... *..#...#....# . ..... ..** \.#.*.... .. * .....#. *..* ... .*#...# ...*.....  . #
#... # ..  #*.*...*......*.... #.... *.. .##.... . **.*....#. ..* *. ..##*...#   . ..... ....#.# ..#
# . #...#.. ...*...*.   .#\..##.#*.#.#.* #**.* #.* \*.#....*  # . .. *...*..#.* ...*........*.. ...#
#..*.*..\.#.....#.**\#*#... .   .. *... *.... .\#.\* .*.. .. ....#.. *.  *... *..#  #.. *.#........#
#....#* #. ...*  ..#.*** ..*...##.. ....  . #.#.# ..*...# . .....*...*.. . .. .\.*...#..#***#\. . ##
#..\.....\...#.  ..... ..* ..\...# *. \.#...*.#\.........*.*.#.\..#....** *#...\ \. #...  .#*..*.#\#
#\... * ......\. .. ...\*...*... . ..##...#.....*...#..*#*...  . ...# *  *...#..#.#...#..* .** .#. #
#.#......\..........#\......  ...#.  .* ..*#.   ..# ..#*..#...#....*. *.... \#. .. *. # \**..\  ##.#
#*  #..* ....#....*. ....*.  ..\. ....# .....\..#. . .. #.##..* ........ .*##....   .*....  .....*##
#..* .#..*\....*#..**.. \.*...*\...#..*#.....  .....\. .  .*#... ...* *.#.....#. ..\#...*  . .# ...#
#.. .   .. .... *...\*.\....*#.#.\*.*.. .. *.*#.* .\.... . .\....*..**...\ #.*# ..*..*..#...\......#
# .. ......#...#   .\..#. .*.*\.. ..*...*..*.*\. . *##*.*#....***.*. ....#. .#...  ##......  ......#
#...##.# .... ...# . #. .##\.. \.**.*...... . *..\.. *....#*.#.....#  ..#....#.. ..*....* .* \... .#
#.#..\ #   .... ..#. #...**.\ \..*.......# .*... ..*  ...** .... . #. . ..*...#.#.* *#..\ .\#....*.#
#.  #. .*.... ..#*........ *.#...* ..*\. ...\..*# . ##. ..*\.#... * .... ...*..  .\. . *.#*.*.. ..\#
# . . ..\#...* .##... . \  ..*\. .*\. \.. .*\. \  ... #.#....##. ...##*.#. .\....\.....# ... ...#  #
# ..... ....\...*........#......#.......#. *.. .*.. ..*\ #.#.\#.. # ..#.    . .*...* #.# .**. *.* .#
#.#.. . * .*.#....##.....*...*#.*#... . ##  .#.###.*.*#......#. ..\... *.# .  . #........ \*.......#
#.........  . .#. *..     ..  ... .***.*..**....  ...#* ...... ...*#*. .\...   ...#.#... ...*#... .#
# .#**.    ..* ... ...*....## ....* .*..*   ..... ....\.....#.. . .........#.. ..   #* *#..#....  ##
##..*..   .#*.*.*.......# ..#.#.**.*# ... .#..... #..... .... .. .*\*. ..*. . . .*.... ..*#\...#. *#
#.. *...  ..##\  .#... #\R.*#...*. ..#...**.#.  #. ###*...*...\... .*.*......*.#. **.# \...#..\..\.#
##.*... ....#..# ......*.... . ... ..#*..*..*....#.. .\...*..#\. ..... ..#.*\ *.. .#..   .\#  ....##
#..*........ ....*   . .*  .*.  .. #.. .\*  ##......\.#\.#*.#..\..  .#.  .. # .. .      .* ...#...##
#*#\.. ....\.  \  ... ....*..#...#\...\  ......\........\.. .\ .\ . #.# . ..*. \. . ..  #.. ..# *#.#
#* ...# #. ..*.... ##. *... ..#.. \... ...\ .... ## .**.  .. .*.*...#.  **. .*.# .. ...... # *...\ #
# .....\..... ...  . \......  ..#. ..  .\#.\... * #....# ....\.\*.*\.#  .# ... .# .#*..*. . * ..  .#
#.# . ..\..*# .*.. *#*#\.*.\.\... .....#   .#*.\*.#...... .# ..*.\..\..*.......#**.. .*. \ \#.\ ...#
L..*..## ... ...#.....  .. .. \*   ##. ..* ..#..*.* ..*... *.. ..  ..... *.. .*.. . #.. *..   .* .##
####################################################################################################