############################L#######################################################################
#.. ....  \.#...... ** ....**.*\ ...* #.# . ..*#. ...#.... *..# #. #.*.*.*.#.. #  #.   *..#*..#..\ #
#..*..#    . #.*.*. *.#... ..* ##..###.*.#* ***....*.... .\..*\.  . ..\.#.#..#..#*   .  .. #.. #. *#
#.*#... #.#..*\ .#.. . ...#. ....#*... .... \.*..*   # # *..  ##. .. ...... \*\# #. ..#*.*.# . . .*#
#.\..\#  \ *.# *..\ \..#.#   ... #. #..\ ......... ...*..... ... *.\.. #......*#.*#..*.. .....*.*#.#
#.* ....* \*. .*... .. ...\ ......  *..... ....* *#.......##.#. ...  . .. .\.. \.....# ... ***.# ..#
# .....\*#\ * .#\* ... ....#.. ..\* *.. .#.#.#...#*...*# #.*## .#...**.# #.... *.. .\* .* ..\.  #.*#
#*.**. **.*.. . .  *##..#....# .# .   ...*............. .*..... .*..#.#.    .#..... .#  .....**..#.#
#   \\. ...\ ...*   ...**. ....**#\.. #*..... # . ..\\.... \..\.. .\*. .....\#\ .#. *.. .*.. ...*..#
#...*.. ... . *#............ *\....**..\ .. # #. ...*..*....# .............#..*. ..\*..  ....#.*.#.#
### ..#** . .*#.*. .... ..\*...\ .. . #.##. ##*##..\*#*.##.. *.\ .#......#.***#.  ...#.....#..*.#*.#
#... .. . .  *.* .  \ #...**. ... ... \ ....   ...  \.*.....\ ..*.#*#.*....  . . #...#. .. .*\ \\ .#
#\.*..   . *....\ .....*. .....\..*..*.#. ..\. .\\   .... ....\.#* .....*.* ..#. . .......  ....##.#
#.. .  * .. ..#.. .  *...# .  ...#......##..... .*.*\.....#.#.....#.#  ...\....#. . .  ...\#*.* .*\#
##...*..*.. .#*. .  *.. #..* *...#.*# ..*..  .#.*. ... #.#.. .\ ..*.. #..##.*#*.# .#.*.* .###....*.#
#..*.*..*. ....#* ........ . ###...#.. . \ . .....**..... ... .......\\..  #. .#*..*.  . .... .. ..#
#  .*#  .#\\#.#...\... .\.....# ..\ # ... *....* .\..#. .  ..*.#.*# #.. ......*#**...**... .. .. .##
# . .\*#.  #.\*... #..#  .....\.\ ..*.\.*.\*  . ... .#.. ..# ... .. ..*\#....* ....   .**..#... ...#
#  *. #...... *..  * .*.. *# .  #\.  . ..#....#. . ..* *. .. ...#..  ...#...*.....##.  .* #\ # # ..#
#.\*...  *...**........ ..\.....** **#..*... .....* ....\ ..#.*.*** .#*.*.  .. *#..  .. .\#\..\....#
# ##.. *...* ..* ... *#* .....\...*\.#....#*........#. ....  .... .. *.#*#\#.#.........*#  . \...  #
#.*.*#...\ *\# ... . .##  *...*.#.*.*......*.. ... . .\\... ... .... . \.\#.. .*#.*........ .# #\ *#
#.... ..... ...   .  *.. .......**.. .*.*.. .#. . ... ...#.*\..*   \\........* .....#..#** ..# ..\.#
#. #. ...*...     ... . ..*.....*.*\.\..\*....      ...#  .. #..  ..*.  . .... . .*#..#.......\* *.#
#.**.*.. .*..#...#.  .. *. *..*..#** ..## .. ............* ......\#...#. * .\ .*.. ...#. . \.#.# .##
#........#...\. #  *..* #.... .#..#*. ..# . ...##\.* .. ..##......** ## ..... ...#\*  .*...\.\#.*. #
#..*......** * ..*.* ..#.. .  .#... .*... \\..#\. .... .#...##.. \\  ** *....  \..**#... . #  # . ##
#....*. *.....#.... .. .*..* *.#.  .*....\....*## .\........#*.  \#*..*.........* ..#.#. ...*.*##..#
#... . *.#. .....#. . ....#.#..  . .....# ...#...\#.*# .\ #.\.... ..***...* ..  #*...#...... .\\\ \#
#...*#\\..#.....\.*...  .... ..* . \ ..#*#.##... \.#..*.#*.#.\ . # ..#..*\..... .#.. ...\\\# ......#
#* .*..#....\.#*.*. ... * ....\ ...# .*#..*..* .##..\. ..**.........\#*.* ..##..#** .*.*...... ..*.#
#  .....#.. \.\ ..#..#\  . #*.. .* #.*...\..*....*.  \..***. *..*..#......\........ #\ \#... ..*.. #
#......#..... .. ..*.*  ........ ..   #. .#\\ .#..\#\\..**.....\... . .. \.\.. #. ...#.# .  .. .. .#
#. .#*.. .... ..  #*.... . ..\   #....\. ....... **##  .....\    .. ...\#**.*** .# \......#*. #. #.#
#* ..#*...\... *  .  .  #. .*.\.....#.\. .....#...*. ..#.\\. *... ...*....... ...*..*.. .*  ...* .*#
#.. . .. ...* \ #...* ......*\..*#.#.\..*.*  . ........ #\ **# ........#.*.\ ...   .#..* ...#.#*.#.#
#\....*...\ *.. # ...#.. ..*...\... #.##..  .#*. ....  # . .. ..  .......*......*\ \ .# ...  .#.. .#
#*.. .*....\... *  .#*#*....\#..* **..#...... . **.. #.*.#.*.*\...#.  *..*.# ..\#... *.* . ..*....*#
#.....#... \ **. \\....  ..#....#.#. .*.... ......* #**.*....#.#.* ..#*...#...\.#.  \**#.#.  #\..#.#
#*. ..#  ...*. .#**.   ..* *.#\. *#\#..*. .*# \\#\.  .. .#..\....#. .\\ .*....#  .. \#. . #..# #...#
#...#*.. .*\..# .\\.. .\.\\...## #..*.. \\. \. * .***.. **. ....  ..  .. ...\ ......  . * # .....  #
#..  .#...#......*#. *\* ..   .. .. ... *#.*. . .\.*.\...... #....  ....*#*..*.. ... . ...#..#*#...#
# .. #.. .........*# ...#...#.. ...  #... ..*...\##  .#...#. .....#...*  .#\...  ..\***. \.\ .. \*.#
#.\..#..#. \... #... .....*.#...\.....*\\#. .............\..*.* .. .* .*. *#.#..\ ...  . .. ..*....#
#.\\. .#. .. .#*#..  \. .*  ....*.#. . .. #. *..   . . .......\  . ..*#*.*...\*..*.* .*..#.\   . ..#
#......# .*.*.*#...# .* \..  ..  *... . ... .....#...#.. . ....  ... **..  .....\.... ..   #..# .  #
#. ..#..#\# ...\* ..#.... ....#  ......*.. .##*... . *.....*..\.*... .. \.##..*...\. ....# .##.....#
# .. ......*.. .* ...  \.* # ....\ \.##...# .. #   ... .....*.*#   ......*#...* .*#..   ..#. ...*#*#
#..*. ..*.**...# .#..... .. ..*.*...*...*.#\....*#\# # ... .*..... .*.\...*. ....*.......*  ..#.#..#
#... . . ....\ . ....\..#. ## #.*. . .#* .. ..# .... . \.  ... . \# ...*.......#*#. ...\ ..  ... . #
#\. *.#. .. ....#. .#..#. .\#... *  .##.##..*. .*.*... ......*..*.*..*#* ....#...  .....   ....*#\*#
#.... .. ..#..#.\.\.#.. . \ **.* ........#\#...*.*... .\\\...    ....#. . . ......#..  . ...\..#.\##
## ## # .## \...*. .#\. ........... ..... *#..**. .. .  ...\....*\.#... *..\# * .\* ...  ... ......#
# .#*.#....*. .....* ........  .#.##.*. ..  .# ..* . ..##.. .  ......*.* \*. *#.*.....#.. . *. . ..#
#....   *. #.   \#...\#.  \ .*....#.... ##.*#.#..*..#.*..#.. * ....  .#.#. ...\** ....\ ... *\.  ..#
# .\.*..*.*... #...\.##*\ .. ..*..... #*\*\ *...#*..#.*#...#..*. * .#......#...  . ..* *.. ....* .*#
#......... ... .\  \ ..  ..#  *# .#....* #....   .\ . .*. ... .........*..*...\...*  .... *  .#.\#.#
#\ .\ * .*.# ..**...* #... .# . *.#...\... ...... ##.*.  #*  .#*#...##...... *... *.#. #..# .*.\ #.#
#. ..... ... #. . .#.\*..#  **....... \ . ....#... #.  *..... . .... . #. ...* ...**..... ..  #.*.##
#. ....\...\. . \. #.#.*. \.. ..*..  .*..*#.*.#..\ \...*. ... .* *##.. ...#.. #.*# . .#*# ...... *.#
#..#\.#  .. .\ ..# \....# ##.. \ *#..*.......##.*..#..***... ... ....\...#*.#  #...  .....*....\...#
#.* .*.......#.    #. # #. . ... \#.**....\.  . *..## .... *.. .... ...  .*.......#......#.. *...#.#
#. #..**...... ..  \...#.  .*. *.*..#.....*...*.* *....  **..  .#** #.# ...\#.*....  # ....##..#...#
#\. . .\.*..\.. ..\#.*.#*.....*  *. ...\\ ..........\ .\\.*.##  #..* **......... .*...*...#....... #
#.##*. ....\..   #....*. ..##.#\......#..##.. ...#.. .. #*  .. ........#.*\.. #....... ...#..*  #..#
#.#  ......* *.. \# *.*.\.......*...*...\.. ***\ ####. ... .#  **\...\*.  .*...*#.  *.*\. \*... # .#
##...#...\...*\*...*.\.... *.*..**..... ..*.... .*...#*..... ..*. . ... .... #  ....**..*..# .  .\.#
##  ..*.. ..***.* ... ...*. .* . . \#* #... #. \.  ..#\.# .....\.  ..* \..*.* .\ .. #*.#   #\... . #
#.##**...*.  ..#...\*.. *.# .* #....... ....#. .  ..#. .# ....*.* \.. .*    .....*. .. ..\\.. .....#
#...\ .\#.*.\. . .*.. . *.*.*##.. . .... ......    #..#..#\ ..  .#*. ....\ .....\...*....# ..#.\...#
##*... ... ...*.........#...#.....**..##....*.#.*##......#. #.# ...#..##*.*.. ......*.\ *#.#.. ..\*#
# .#.. ## .*. ..\..\... . ....* .##. .....\*.#.* ...... \....\.....#. #*....\..*. * ...  ...*....\##
#\  .#.* .#.*..*...# .* . ..#\\. *..\..#\.#.#..    .. ...#..*\.. .....#...#*  *##.#..##. *. ..# *  #
#*. #...*...#..  *... . #\.#.. \*...... .# . .* . \.... .\\..##. ..#....*.... ..#... *#\\..\  . .#.#
#.#*.*. *.......#*..*. *.. \*. ..# ...........*..*#*....## .\..\* .\ ....* \  .. .. ...  \.*... . .#
# .. ...*\.... .........#. .**#..\.#.. #...   .*. .#.\...#   ...*.... ...*...*#.... ... ...*...* ###
#.....*\.*..\....**. ...*..# *.*\\... . ..*#.. .\  .....*.\  ...**.  ......**...#.*.##  ....*#...# #
# .. ...... .*.   .*\.* ..#... . ...  .  .*. .. ...#.. #\ \##..\*. .   R ..#. #**.*##. *  .#..*.. .#
#.#*.#...*. .* .*.... .... \ #.. .#*..**.  ... \.\...... .......**  ...*...#.....# #.. .\#.... ....#
#.. *.. ..*..  ....* .... *#... . .#. .*#.\..  *\...\ *##...* . .*\..\.#\. .*##. \ *#...**.  *\. ..#
## #...# .....  .*... .#. # .#*.. .\##....##....# ... *.\ .* . .. ... ...\... ...  .... .....##.. ##
#..##......#..*..  #..*...........# . .#..  \ .# \.* *   ..\... ..*.# .... \  .# .#..#...  *...#.*.#
##..*.# \... ......##......#.  ...#*#..# . ....*. ..*.#..#...*.#. .## ..*...  ...\\#... .*#.#*.  ..#
#\.........  ..*. .. *.#.*.#.\  .*#\..*..#.*...... ...##...#. . . .#. . ....*.....#.*....#......  *#
#...  #.... ........\ ..  .*  .. .##.... ....#  .......* *..*#...#*#*....*.#...\.*\... ...... .#  ##
#.....\*##.##\. *.....\* . .# . . #. \. ..#\ * .##.*##.#   ... #.. ....\ * .  ....#.# .... *# .. * #
# .# ...  *..  .. .#. #...\. ..#....*. .......\ \.....#...#..* .#**..*....#* ..#...\. \ #.* . .*.  #
#\....#..... .....  .... *   ..* \ .. .*......**..#*... ..   .... ...#.. *. .\ ......\##. .*. # \ .#
# #.  #.*...*. .#\.#. ..# . ##.. *\..#.*.......** . \.#.. ..*** ..*.. ..#*..**\. .*..*......*.. #..#
#.#..........*.*. *.....#.**\*#* .\.... .... .......*\... ..*#... ... . . ....#..*.#.....  .*......#
##.*...#..*...* .. .#*. ..\.. ..* .*..  *.*.\. #... *##.#. ..\***#. . .# .#..* **.**.... ..\......\#
#*\***..  *.*.*. *## ..#.. .   \ .#. #..#... *\.... ..*#* . .... .#..#..#.....#.\#*.*## #..\ .#\* ##
#.#..#\.*.. *....... ...\*.......*\.**\.**##..#.....#... .#.*..*.....*...\ \ #...#* *..*..\ .... . #
##.  .#.#...#.# * ... \. . .*.... ...*#. .###. #... .. ... . .. ...  . ....\ ...... . ..#.. .. . .##
##*..*.....*..   ..\ ..   * .. .  . #  #\..* ..## ...\*.\....... ....* .*.#..... *\. .**  .#.  ..*.#
# #... \ ...#\... ..\..#..#...#..\...# #......#.\.#.. ...... *.*..\#..*....#**\.##..\.*#..*. ... ..#
#.#* .. . . .*##. *.* .....**  .. ....#  ##.*.....\*.* .###...  ..#. #*.  *..*##.....#...*#.  *...\#
#*.\* . #. .  *.*..#...* ..  .\.\. ....*.#................\....#   *...\ ... #\##.\..... ..  ...## #
#..*.. \ \#.  ..#\#.... ..  ..  . ..*  ........#..*...  .\ .. .# ***#.  .  .....*\.....# # .. #..#.#
####################################################################################################