####################################################################################################
#....*..#.#.*..**.. .  .*###....#\..#. #.\*.....* \.#...... .....*.... .*..  .*. ..#.... * . #.. ..#
#. ...\..*. .. .* ... .*.. ...*..*#. ## \.  \.##. .   ........#. .........#.. . ...  ... ..... .**.#
#*.##**.. .*.#*\.... .. ... \.##... *.. .*..    *# .  .#.... *     .*..\#. *... .*..  ... \...#....#
#\  .......\ .**#.*.# ..  .#. #\ .....*..    *....* ..#..#...**#*.*. .*.#..#* #..*\# #*.  .\ \...# #
#..... . *#........#.\. \ * \.*.*  .**...*. . #..*.*....\.* ........\...*#....  ......*.\. .... ...#
#*.*\.. .... *.... #.... ..#.# . *...#.\.*. #\.......*.#...\.\......#. ..*.* .#*.*..   ..\  *.... ##
#....#... .#..#.*...*\#..\*. *.#..... \ ..*.......... ...  ......##. ... *....  ...#\..*......#**  #
#*\.#..\. ..*....  .**.. \\*.**..*. .....#. .*#... .... .# .. ....\ *.*..#....\..  ......  ..*. . .#
# #.# .#..#\#....  #...#..*..\.\.\......\   #.#....#..#.... .....#.#.... ...\. . .# \\..# .  *##...#
#...  . .....*#. ...***.*.......# *  *.\.#\..##. \.#.##.\....*..#*. ...*...#... .*.... ......... *.#
#*.#.*.*....\.... ....... #.# \......\...#  ..#.#..*#..*......#.\\#.. \........ #.. ...* \...#.#\..#
#. .#..#* . *...*.#... .\.#. ...* #  \....##*. .....*. ......# ...*.. #.\#.    ...#..*... . ...*.. #
#. .*.    .\.  .......... ...\##..*.  #. *..#...#... ... #..  ...*\.# * ... .... .. ..\*#..\..#..**#
#. #*... ...#*.. ... #.\\. .##..# .*#.*.. ....\#.\.. ..#*.. #.#... ** .*.#... .  *#...*.*\..*......#
# .*##..#   ..*..*.# ....*...###. ....# *.*  ....*..*#*.. . *..#   ...  ..#  ....\ .   . ... .\#...#
#. .....#.#.*.... #.\.... ...#. ..\. .. *.. .  . #....... *\..#..*.*#....  .. . ##..* #*. ....#** .#
#   ...\.*.  ..#.   .\.  .* ....##\#* . # .* \... ..\##.... **.\* .....* .#..*\ ##\.. \ *....  .. *#
##.*\   ..... .# #..*.. ..#....#... . . ..#..#\.#.\ *.. ... \...... . . ....*..  ..  ... ...#.\ ...#
#.*..#... ...#  ##.. ..#..   .  .\ \.*# *....... *..*.  .....*.. # .. .#    .  ....#...*.  ....*.. #
#..##..#.*\  ..***... \..   . .\..#....# #...\.. .....#...# ..#.#.  ....#\. .* . ...**#..... ...  .#
L *#...\ .**\.*\..\... ..*.... *....\...*. .*....*.# ..*.##.#. ..#.##.#.. **....# . ..## *#....#  *#
##... #*.# #.**....# ...#  . .. ... .\.....*... .......\...* .. .....**.*..\*.  .... ...#*.#.. .**.#
#*.#.. .... .......* . . ..... *..#*.....#.\  . *#\.\.*. ....*. #.#.\.. .  .#.. ... **...#\  . ....#
#..\#..**.... .*. \. #.. ... ...... ...\#..**###.*.*.# .*..* .. ...... *#...#..## ....*.# ..\.....*#
#*#.*. .....*... \#* #.#*\ ..\...#..*#..* *...... ...#.**........#.....  .. \....  .....#....* . . #
#. ....\#...*.. ..#.#*.#.... #....* ..*... . .....  #....*.... ..#.   * .*#. \#.. .**.*...# ...  \*#
# .   ..*.#. . . .....#*# #....* #.#. ... .. .* .. .\.... ..\\.\#.......** ....\ \....... *..... ..#
#.\.* ......*\#* .*.... .*   .\..... #. . .\*#.#*.# ..* .. ***. ...##\...... .... \. ...... \.. . .#
#...*... ...\. # .##\..#  .... .#  # #..#.*.  ...... ....*#..... .*#. .. ...#*.. ..\*..##.. .  #  .#
#.*. .. **. .*.*..#.... \*...*....  .#.#  ..... ....* #... . #. ......#..   ...*.#*  .#...#... ..\ #
##.\.*. .   ...\...**## . .. .. .#\*  ..*\.\.\... ..*.. .#...  ..#**. . .*.  ..#.#...  ......  *.#*#
# *.*. .. \....#*\   ..#..**#*..#.#...... ..#.#*.... \ .. ......  *.*##... \...#.. .*#\\.   *#....##
#.\ .\.#.... .**.*# *.*.*.*\. ......#...\......#.. .. .*\#\#..  \.   ..\ .*.#.....#.#..*..* ..... \#
#*.* . **...*.*.#. ..#..#..... #...#..##\#.  .  *.....#  ##. .#..\# .  . #...........\#.#.#.#. ..*.#
#.#*. *. .... ....*\.#  \*.. ..... .\.#... ..... .#... . ....     . .*...*#... ......*#**.\*.#.... #
#....  ....# .. . .. #..... #...*. .#  #.. . *#. #...*#...\..* \*....#*  .* .* # ....*#....*... .  #
#...  .##..#.*.. .  #\.\..#.  ...** .*.*.\#... .   ......#... ........#* ...##. .  .. ....#..... .*#
##.*.... ... .*... . .. ...*.\#...*..#...........*..\ ..... ..*#...#. ...*. ...##* ..#.    ...# \..#
# .\. *#.... .#....\.....#....#*.. . * ..#.\\.* #.*.*\.  #..#......... ... *.#..* #*.##. .. ..\. ..#
#.   .. *..  .. .\.*.... ..#......*.... ...   . .....# .. #... .  *..*.#.. .. ....#.*\. *. ..*. ...#
##... . * ....# ....* .**..  . .. ... .#\#..*.# #..# . .\ . *. *....*.#. .*.\....*.\. .\\. . ##...##
# .. .#*..*.## # *.\ . .* *  . . ..\*\. ##.. *.\ *#. . \...  #. *\. \ .* \###. ......####.. ..#.#.*#
#.# *.... .....*# #*# .##...***#..#...\. *.*.# .\ .*. \.*....*.\*.\ ..# ........\ .\\....*#. . . #.#
##.. *.*  .*..* ..*...*.....\..#..# .#...  .. ......*# .***..#... . ....*........ ..*...  ..#...#..#
#\\.  *.*#.... ... .... .. . . ..    . .*##*....... \\.*..    * *..\#..\\..\.#........*.####.... .\#
#..*....* ...\.. .#.\.. .#.#.. *.. ....#*.*..# # ..*..*..#.......*..* . ..#.*#..  \.**....*#.... .##
#..#.##..\..**\............. \...#**. ...  #\ .*\#.##*\*....  #\ . .  ..*...*.....\ .*#\**....... .#
# ..*.*#..\... .. .  .\.# .* *. .. ..##  . ....#... #*..*.* *.\ *. .*.#. . ...\*.#.*.... .. .# * ..#
#  . * ..* *\.*...***..... .*.#...  ##.*. * . .*  .\. *. .. # #\#..# .  .. .*....#.......##. ..*...#
# ..#\......... \*... ...#..##...#. .*.# . .  *...#..# .\  ....**........ # ##. ..#... ..#.  ... ..#
#....#*....\... .. .#..\*.\ \.*#..\....\..#... \ .\  #.*...\*. ... ... . \....... * * ...  .... .. #
#.. .....*# ..... ....*....##....\ . #..#....#........... .. .. .#...*..........*#*... .. .... ...*#
#**.*. #...#...  .#*... *.  .#..#....\ *.*.* #  ..\\ .#.. .. . .* ..........#.#.... . . ...... .. .#
#.... ... *.*.* .\...\ ..##\..# .....  *  .. #....*.\....*....# #.   **..  ...#.. ..*..*...# ...*.*#
#\.**.*.*.. ..*....... .###. ....***# * *. ....\ ......#. ..\.. ...... ....\#.* ...#..*. .\......#.#
#..\# .**.   . ..*  .#.\..*...#.#.. #..  .. ..#. ..... .\.*... ... ..\#...#  ... ...*.* .....#. .. #
#.. .....*##..#.#*..*##. **.... *. *..*..#.# .. .. *..... ..... . ..* ..*##  # \\.*#   ..\.#.... ..#
#*. * ... *\ ..... ....... * .#. #........#......# *.......... *.. *...*\.......  .. R.*#.*... .. .#
#*.......#.*#..*.. .. ..\#..*.*.#...#..*.*. #*#...* ...............\\.#..*.#....*.**. ...*....** ..#
#.# .*.... ......#  ...*.#..#.*#.... .*.. .#.*. . ...*#*.*. \#. #. ....*.\.\ .. .. *.#....\.##.....#
#   .. *. ..*...*.\.   *.*.  #.#  . .\  ...#...**#.. .*...# ...*. #..#.. ...#.. . . *.. \\..##\.. .#
###*\*..... .. ..*  #* ... ..\*..## .#  \#  \.*.#.\ .*   .\...\  # *..* . .. ...\*#.. .*...\.*.\.\ #
#..#..*...\*..#....#...* .#*  .\#.\. ... .#.*\.**   #.*...##.*...... *.\.*. ...*.\.. ....*.  #**.#.#
# .\...\ ...#. ... ..#* ....  . .... .#...#... \# ..#...\.. ... \#.#.. . .**.. ..........\.. .. ..*#
#........# ...\ .*\ .*....#. .\..* . #...*.*\ ...*. . .## \. *\. **#.#* .*# * .... ....\. ...#. #.\#
#. .....*..# .#* *.*.*......... .##\....\..........*#...... ###. ..*.... \.*...#.\*. .*. *.......  #
#*.. .#.....* ..#.... ...*...\*. #.....#.#*. ##... .....#. * ... . # .\#*...*. .***..#... .*.\.*.*.#
#....  ** ..*..** * ..\## *.*...  \....*  .#.....*..#....* ..*..#.#.*  * .#....# . ..  *..*.*.  .#.#
#.# *. .\\\.....**... . .. ..# *.....#.. *.**..#...  . ...*..#*.# .......  *. .#...* .. .#*.* * \.##
#..*.....# .* ...# ..*..## .. ..\#  * #..\. . .# .*..*..  .*..\#*#*\..... #.........\.  .. .*. .. .#
#. .*#*.#...*.*#.*..#. ...#..*.* ...#.. .  * ..  .# ...... .. .. .*. \.*.. * .....#..#. ...* .#....#
#.... *. #...*#   .# #.. **..*#.*#.# ........*.. .#* *#. ... #...#.. ... ..  .#.....*..#. . * .#  .#
##* ....  #.......\...*.*. #\..# ..  .*## #  .. * **. . . #. *.* *  . \ ....#....*  * .* .  .. ....#
#. **\.# ..\ ..#...  *.... #..\ #. ... #. ... .*  #*........**#...*... ..*..... . . . ..\...** . #.#
#. .#*.#  ....   . #..*. . .. ..\.#.**.\  .\.#..# . .*.   .. ***.\.... . *##.. ....\ . ... ..\.... #
#.\*. . ...*. .......# ...#   ....... ..  . . ..    .\*.**.**.#.  #..#*#..#*..#*.. *.* *.*....\..**#
#*.. \...... .# ..*......... ##  ..........*# .#. . ..**.. *# ... # *  ..** ..\..*.. *.*. .. *. .. #
#.*..#... .   .#.\..... .*   # ..     .... ..#.**..## ...# *.... .. ..#..#...... .#.\\***\ . \..*..#
#..#......* .  ..#.#.###*.\.....  #.....\.*\. ...  .*.\*.. ........ ...*# *. .##.#  . .#. ... .#\. #
#.#\ .*.. .. .*.. #..#.*..* ......  ..  .#.##. \*......  . ..*..*. \..*##.....*.#...... ... ..\.*..#
##.*.......# . .*#  .... ..*.. . .#*..*.. #.**  .  \..##.#..#.\.. .\ #.# #.#. .... ...\\ .  ... .# #
#..*..... \*..# **. # ..\...  * .#.*#.. .\*\*\ *.. ... #..\#.*.#*\ * .. .  #.#..#..\#..* ..#. ....\#
#... ..#..*...#* #..  ...#. #.*\...*#. .#.*....#. . .. ......* ..*. ....* .  .##.*.........*#.*.#\##
#..* ..**#.*#..\\**.. . ..\*##. . .. .*.  ..\#.*..\#.#....#.\   ..* ..#\* *\....  ..**.*.*....* .. #
#*.......# .. ....\..... . .\\......... .. . ..*#*. ...#....*#..\.##  .. \..*# \..* ........ *.*  .#
#.*.#..\.#\..   \ .#...*... . ...  .\... .*#.##.*.\*...# .... #.*#\ .... \. *..*...# ..  .\ \*\...\#
####.#. ..*. ... \ *.. ..\. .. .....* # .. *. ..... #  ... . ....* .. #..#\ #.\......\....#.**.. ..#
#.\.... .#...  . . . .*  .*\*. #.#... .*.*..\. ...*.. . *  .....*# . .  ...#*.\ .. . #..##... \  .*#
##.#*  ..#... ... *..... . ..# #... .#.#.......*   *....... ..*....... . . .#......  .. *...... *\.#
#... . \# #..*.\.\....#*..  \ \.#. ##..* .\.....  *#.# .\#..#........  ..#..#**.. ... ..\..........#
#...#  **...... ..#*   .. #  .\..#. .\..... \.#* *...*  .*#.. ..\.. ..  .# . .....  . .  .# . .....#
## \\. *.... ..#.*..*.#. .#..\*.# #..*.....#....#\. \ . .......#.....  .. . . *.* *..* .*.# ** ....#
#..\*. .*. ........ .#...\.. *....\ . .*..  . . ..* .... . .   . #..... ** ##...... ......\...*. ..#
## #.....#..\ ...*#..  \.. \.#.\..    *.*....*..# # *......... ... .##*.#. ..\.. *.  # ....#.* ....#
#. ......  ..*...#.*.\....\.. ..  ...#.*.#.*\.....#. *..  ..*.*.#. .....*. ...   #.*...*..#...... .#
##. .. ..# ##. .. .. ... \. \.*.#\..*.. *. ... .........*# ..#\ . . ..*.#... . #. ......**.. ..   .#
#. ......\..# #... * \  ##.. #. ......#.  #.. . ...#.\. *.*. .# .....\.**.\ ...\.........##....#\ .#
#  .... . .....#...\.#. ..*##.# #. . .....*.*....  #.#  \.* ... *\  .#.. * *....\ * #.\\# #........#
####################################################################################################