####################################################################################################
#\.\ ..#....... .....* ..**.*. ... # . \..  * ..#  .#...\... *.*..##.*. . ..\ .**##.. ....*#  .\ #.#
#..*\ #*#*.. #.# #.. *....  .. .#..\.*.#.*.. .. #*..*#*.... . .  .#.....#...*........ . .#. ...*.\##
#..*...*. * ... *   ... #*. .#......\#. ... . *  .#...** . .. ... *\. .\ . .* ... . ...\....# . ..##
#  .. .......**#.##*. ... # .*. ..*  ...#*.. .........\#. #\.*.#. * ..... .#....   ...#.#. ..*#.*..#
#\.#. .....##..#\..*...\ \.**..# . .. # . .##..*** #... ....\..#...*... *\ ..\....* ......... ... .#
#.\..... ...\. .  #.*\..#\#...#\  ...##.. ..#* #....*.. ...* .... ##  \*.. .*..***... . . # ###.# .#
#*.  #.....*  *....*# # ...   #.*.. .\..  .# ....*.#...*.. ...#.\...*..\#.#....*..\.*..#\...*.....\#
#..*...*. ...*.#.*... \*..#....  . ...*.* .. .*# .#  #.  ..#....#\.# \ .* #.*. *  #\.......*.... ..#
#.....**..#*.  ...* . ..*  .#*..# \ *.. *. .. .  .. * *... ...*.#. * .#  .... ... ........  .#. *  #
##.#*.##..#..\. .\. .# \....#...*\.#*. *.*.#*.*.#....\..  # *... *#*..*..* .. .#.#\.#. ..\........##
#.. \ ...#..\* #. \# ...\.\ .**.    ..   ...* .#*.\...#...\#*.\ *....\... * ... . *.#\   *... #... #
#*..*#...#*.. .. . .* # # . ***.#. \...#...   ...*.   ....... .\....\\..*.\.......#*.. .\# # ..# \.#
#.... *. ....\#. ...*. ...*.... **.     ..*... #... .# . .*..\**.*.#    .*..**. ...........   # ..##
# *.... #.. *......  *... .\# #...\.. ..*\. .#. ....#. ....\*..#.#...**  .*....*.....#..\ .#..##.###
#. *. . #*.*.*..#.......#.\*.#*. .*#*.... .. ... \.  *. #. \. . #**# .. ..#. .....#.. . ###... ...*#
#..#* *... #.\.*. .\.#\*\..#.\ *. \..\ .. .#..\....*. .* ..  ..* # ..  ...**. *.*..##. ##.* ...\.\##
#.* ...#\..# .   ......  ...#....\.#..... ...#... ..#*.*..*#\*..... .\....*\*..    .*   . #..\..####
#*#*.  *.*.#...*..**..  ##...* .*. ##*#* \#. **  ........#.  # .#.*##.*. ..# .#..#.\ . \..*.....\..#
# ..  ..* . .. ..#.\ .   ... . .... . ... ....*..  ..*.. ...... ...  . *....*\ .  ..\..#..*...#.*..#
#..*... .... . .*.    .#*......**.#*...\...# .#.. ..# .. #.*.. ........\ ...## .*..#..*..**. ..#...#
#.#...*...* * ... . .. ..#.#*#.... .*...\*#\....*.. ...**\  .*.\....#...\.. .* . . \.*....*.....#. #
#... ..*. **\*  . *#..#.. .*# \..\....****..........* . ... *\ .\... ..#.  ..  ... ##.#. *.*. #.# .#
#...\*........#..#..# *..  ...*..**\..\...... .*.*...#..#...*.... .\....#\..#. **.#.... .. . .#.*..#
#*...*. ....*..#.# .......#.#.  \..#.#.#..\. . .#..........   *..#..#.\.#... .#..... ...  #.. ..\..#
#...*\..* *.\#\..*#... .   ***........\.#.# ... .. . \ ..***... *..  .*... .#.. .. .#   .  .\*....*#
#.**...# ... ..... . .  ... . *. # .*.  .*...*....   .\..*. .. .#....*\......#.....* .*.*... .\.\..#
#....* #.*.\ *.. #...*..###\# ## .#.#. #.\#.#...#...........# ..*.*..## .  #..... .... .#*.*..#*...#
#. ...\ .#........## .. .  . \.. ...*# . ......* . ...... #..**\#..**.. *....... #.#. **.## .  .*  #
#*.*. . #.*.... ...... *.#.....\.*. . ..... . \*......... . #*.*....#.*.. .....*\..* ..#\.. .*.##..#
#*. ....... ..*. .....#....... .. \.....#.. .... \....##.#...\ .  *..\ \.#\\  .*..... .##.#.*..... #
#.*.... .#.......#........#   ..#.....\ * ... .. . ......*\............ #....*\. #\..  ** ...#. \**#
# ... ..   ..*...*.#.....\.*.....\.\. #.\ ...*....*...# #*...#. ......  ........ #...*  .#. ...#..\#
#\. ...*.#. .\. * .....\# .. ....#.. .*.*#... *\#.  ##*#.#.. \....#*.. ...*........ .#.#.. ...**...#
#.#\.. ............#..#. #.#. \. .....#. . R...#.*...*...##* #\ .\... ...*\\..#*...  ..\   . \..\###
# *. .\.# # ..*.. .*\...* **.  . \.\.*...  .# # \...\...#  .*. #\.* .#.. ..\*  *....... .*  *##.. ##
#.. .#. .\.\..*.  ..##.  .... .*..  #.** .   .#..*.#..#.  ... .... .\.# . \ *# # \...#. #*..#*. ...#
#. .... ...... \.*... #*.....\ \ .....*\#. ..\.. ....*## .. .. *...#\.*..#.*\.....# .##.. *.##* .. #
#...*...#.*... .*. .. .*....* \.#.......*..... .....* # .*#..#*.  *#  #.#  #  ....** .\ \*.#*..*##.#
#.. ......*#..#.  ....#\.... ...#* .. .\.*..**#.   .#.. \... \#  \...*.*.. ...* .#.. . ...#....*#.\#
#.\.*...* ..#** *. . .. #*....\... ..... ..#.....#..#.* *..*.\ ...\.***.**..#. #. . ..  ...\\.#  ..#
# ....*... ...... *\...#.#  .#. .#.. *...*   ..\. *#*.* .#. .*..#..#....  .... .*# ...*.....#.#\...#
# .\  . .. * ..#\.. .. .\ .#......#\.*.... .##.......# ........# \. *. .*\** .. . .#. .\*. \*.#....#
# .*. ..*..*\ *..*. .*\...  ##.. . ... .   .# .#. ..#**#. ..# ..\ . .... . .. . ..... ......\.# .#.#
#. ..  .*#.# . .#..#\. .*.*. ... . .  .. .. .\.. #.... ..# ..#   ...... ...  .#.*...*#......#.#..#.#
##..#.  .... ... .....\ ..\  ..*..  .. ......* ..  ..##.\..*#.  .. *.... \.. .    .*  *. ## #..* . #
# .  . .*.....#...* ... ......#.\#. *.##....  .#.....*#\... *\.\...##.........#... \**. .\. . .*.  #
#*.\... ..\ * ... ....   *.  ..  *..*.. #.##.. .#.#\#..*. . . . .**#.#.....##.. *#.. .*.#. ..#.#  .#
#. .. .*. **..#    \... *..*.\ . . . .. . *..#. ....* ...... .... .*.\..\.. . ..*.*\.....\# .. ....#
#.... .\ . . ... .........  .  #..#. ..\\##. .#.......\\.\....*. .#..#*.... * .* ....\. \..\.#*  .##
# *.... .\....*....*.#.... . .  . \. .*.#.#...*#. # . .#. *.. *. \.  \* . ..... ....##  . *.\...*  #
# .\.. \.  .*..#. ... .  ...# .#.. . .... \.\.. .\  ... .#.# ..\*..\ . *\*....  ....## ..\ #.....# #
# .... .... *#...#.*.*#... .*.# ... ..# .. .... .. \. .*.\#..#.#... .. ..#*.##  .....*.*\. .. . ...#
#*\ \... ....#\..#  .#  ## ..* ..*..##*#*... . .* ...#*.... .#.\..... *.. \ *..#*\.. ..* ..* .*..* #
#. *..      ##. ..## \*...* ... \.\ *....\ \....* ....#..............##...#..#*... ..#*...# . .*..*#
#....**.......#.\** #...... .##..*  ...# * .#.......**. ...*.*. \  .  ...# * ...*.*.*.. #..  ...*#.#
#. .#.###.. .....#..*.*#.*....#....*.. .*.  ..#.. .\.\.......*##   \.#.   # \*.#  . .* . #.#\. ..###
#... #* ......*...\. #.... ....... . #. ...#...  ..\.*  #*...  ...#.. \. \. *  .  ###...#*.... ** *#
### ..\\* # *#.....***.. .. \*.  . ... *.. .. . \..\. *  .##......#.....#.. ... .*  . #\ ..... \..\#
#...  .. .  . .. * ..#..*#.. ..* .. ...* ..\....... ... .. .. ... ... #... ....  . ....** *\...*..##
#. .#\.#.#.*#.*#..\#. #.. ..*..... #\#.#.\*. *.. . ## ..##...... .#. ..... . .* ... #  ..\..*...\. #
#.  .. ..*. *.*..*..\....... #... *.#. * #.. ..#.\....*\ \... .. ....#..  ...\...... *#.#\....##.**#
#. ......\.**# .* #.. ... .. \.. .* . ..# . .*. **.#*. ..#..*...#. *.**..*...##..\.#.*   ...   .\..#
#....   **.#... . ....##*..*. *#*...#.......*.*.... ...  #..\..**.  **....#...# ... * . \.. .... *.#
#  ..*.....\\ *.*.##..... *..#. # ....* .. .#. .#..\ .#  .. .*.. *  #\. ...*... *#..\ *...   ..*.#.#
#.*.*# .*\..#\ \.\... *. ... . ..... .. . ..*.. ....... . .#.. .*. *. **#**\# .  *..*.*.... #... ..#
#....... .\\*.##...**\ .#.**#\.* *. ..*.** . .#*.... \..\.*.. .*..* ... *........ ...#..*\.#..  .. #
#... #..#. * .....  . ..........*... # . .*\.... .# \.*\..\*....\  .# #..#.#..  *..#...#\  ..*. ...#
#. #.#..... #...#.#..# #....#. ... .#..... *.....  ......  . ....# *.. .  \ *..#.#.# \\....\.*.*.#.#
# *....* ....#*\\ . .... ...*.#... .. .* *.# ..........*....\*.\* ..\..... . \......#.#..   \. \..##
#. ... . #\... .*.#....  \..\......##*# #.#*.. *#.....#.*\#....#. ..#.. .##. .  .  **....*....*....#
#.. #.#.# *.. . ......#***. . . ....#*..#.. *..*. **. .\   ......... .\#..#....*. .*.\ .......#. ..#
#... . *.. .....  #*.#*.*..*\. ..\. ....# ......# ... .. #....*.\ # #* ...*.#.... *. ...##. #.  .*.#
#. . ..**.. . * #.. #... . .... . .. *\ ..*... #..*. ..\**# .   .. *...#. . .***. . . . .\. .*.\ ..#
#..\#..##..*.  . ..#. **.#.  *...*.. .#\. .*#....* .............. .  #......# *. #.#....*#... *...##
# .#...\.#. ...  .... #*...* # *.... \.*##.*..*#..........*..... ....* # .......*..  . .... # ... *#
#... ..\*#. \ \.#.*. ............* *..##. *...## . .....*.... ...*.....   ......\# \.. ..*  .* .. .#
##.\   .#.# .#*.... .\*#..\... ...*..# *.... \ .* ..... .#....*  .#....*.#. ....*....#..   . ..#. .#
#..  . .. ......*....\.# ..*..\#.# ..# .#....\. ........# ...#  ....\...  ..# ..#.. * .#.....# . .*#
#..**...*.  .##....  .... #... . ..#..# ..... .* \#*\.. ..   \...  ..... .#*...  . . ... #..#.. #  #
#.  .. ...*.* .**\....#.*\..## ..  .\..#.##*... ..  . #..... #*.#.......    . #..#.#..*.... *...\..#
#.*# . ..... ....*..*. ..   #. ...##..# **. .... #.... .*..    ... ..\****... .. *#..*  #*...#. ...#
#...#..* . *..  \.*# ......*.. ...... ......#\ * ... *....  ...*.#.... ... \*. ##... ..**...#. .\* #
#.#.. ....#. .. *.\.\..  #** *\.. .*. ...*...*.. *#.**.\... .. *#.. .#  .. ##. .... #.. ##.#.... *.#
#...##\.... ...\#\ .#*\\. ..#  ..*..... .*.\*...\..... ..*..  .\ ...*...*. . ....\..#.. #...  \.#..#
#..#....*. ...\  .....  .*#.  ......*.   . *... ...#.# * .. \\# .....#  \  .# ...\# ..# ..\ .\* ** #
#***#.*..... ...# .*.... *..*..*....#..... #.. .*......*.. .\.#.. . ..#... .\. *#... ..##\. .    . #
#.\. ... *.. ....\. *# #.*#.. #. # .*.. .. . \.#.*#.\.#. . #.. ... \*.** \*  ** #.#\.#....#.*....#.#
# ... . #.* . .  . .*.\ *..#*.\....#...#\. . .....  ..  ...  ...*#. *..*...... # *\..#..* ...\. ..##
# .\... *...  ..#.*....*#....#... .*.* .#..#..*.* ....\. \\.\... ..#* \.*.. .. *  . .**......*. # .#
#.#..... ...*.#*..#........*# .# \....... \# #....... ..\... # #....* ...  #. .*. . .#\.#.**. *.. .#
#.. ..* \..*... .* ..##.... \. .\..\    ...#* .#.   ..... \ \.#.*..*\.##*..*...........#.#**# . .. #
#.. .#.. . ...#\.*  ... ##. ...*.*. #..  ...#. .\.. ....\#...#......  ......\.   \\ ......*.\ ..# .#
#\..#...##*. #  .#..#......\.    .#..##\.  \*.#.. * ..*.*... * ##...#..*...*. ...*.*#\. .. . **..# #
#.*#..* *... .* .#..* * ....#. . ..*  .\#.#\ .#. * \... ... . ...  \*#...# . ..#.....*. *.*.....  .#
#* *..*.\# #...#..........*. * . .*.... ...*.#. #..#...# #. .    .*..#.   *# .#.\.*##..\#..... . * #
#*#\..*.\.....#*...#.* * .*.*... \ \*.....# # #...* ........*.. #. .*..**.**..*.. **...*.....*\# ..#
##.\ ..#... ... *#....  # .**..#....#. ..#   ..#..##....\ .*.\  .\.*... ....... .*.  ... ......#...#
#..# .\. .##. #*.  #....\.. . *..*.##. .* * *...... .....*.*  ..* ...\.*.   #.... .#...#...*..# *. #
############################################################L#######################################