####################################################################################################
#\ .... * . .\..\.. ......*..*    *\.... .. *. \\.#.  .#. # . .. *........*##\**#.#..#.*.*..*.#.\..#
#........\... .. \...\..**. . ... ###.*.  **...... **..*#.... \...#..*...*. . \.. .. .. *.*. ..  ..#
# * \ ... *.. .....*...*.. \. ...*. ..\..  \.\ .....#.#.*.... ..* ...#*..\.* .*   .... \* .*.*. #..#
#..  ...\.... \.## #  .*\*.*.*#.... .#. . ...*.. ...#*...#*..\*.#.*.#   ..#....#.*.#..\..\.*#*.. ..#
#*...  #* ...  ..#  *... .... ...*..  \#...*..***#. ....*.....  .\\... ..#..*.. ....#. .  ..... ...#
#.....*...  ..  .\..... ..#.**.... ...* .***# ...**# ..  .. . .\ ...*...**.  #  . ........#.#..*.*.#
# ... ...**.....#.#. .. ...*. ..*..#...*#.#.#..\..# ..#....#.* # #*....*. #*.....##. . .* ...*#   .#
#...... ... .......#* . ... . ......*..**#....... ..\ ...*\ ##... #.......\... #.*..#.\.....*..** *#
#..# *..  .\.*....*.\# .*. .\\....   *  ...\ ...\ .....#*. #\  . \. . *. .*.* . . .*#*#.... *..*.*\#
#. ....  .......  .##..#..\... ..*#..#..#.#.*.. .. ... #.\.....###.  ##.# .. . .*#....*..# .. .# . #
#*.... ....* ..... ..* \.   \ ...  ..#.#..#.. . #*.  ...... ...  .*..#.  ...*.#. .#.. *....* .  ...#
#..* \.*...*..  ... . *#. ......... \....  .. . \. ...\ .....#....*....\*. .....#.# . *..  ....**..#
# # .* ..##....\.*..#..  ..* ...*...*.  * .\*. .. .  .. . ....*..\   . .#...#... .\... \* .#.* ..#.#
#..........#*..   .#...#.. .#.# .. *... . ...#.\#. * ..#.#.#.#...#.#.... .*.*  ...#**...#......*.. #
#  *.***....\......   .\ . . . ..... #\.\ ..*.*...... .#.*.#\.. #   .\.\\... .\.\... *...*..# **..##
#.... .#..*. . ..... .* #*.... ..##*.*##  **.*...*.\... ...... . .\....*.**....# ..*  ...... \.... #
#.. .# *###\.#*......# ..... ..*#**..*... # #.* .*..*.. . ...\. . .\#.R#.#...#..   .... #. ........#
#.....*     . #......\.....#.... ...*#...*.* . .. ...\.. . .\.**  ...#*..*#*.. *.* .\.. ..  \...*. #
# . .*.#.. *...##..*. ...#...... #\......#. .*#... #. .*.*. .\*... #..\...#* ....*... .*  \..#..*..#
#.#.*.* #.#. #\. .. # *  .....  .#. . ...#. #\#.....#. ...*. .*  \...\..* ....\. #. . *....   .\.#*#
##*#.....  ..#\*.... . ..*.*.  #.. ..\.. .....#.*...# .. ..   ...*... ##..#\ *#*...  .. *  .#.... .#
#*....#. . .  #..  .... .*....*... . ... #.. .#. \# .. ..*.# . *. ...#*.  ...... .   ...... .#. ..\#
# .# .#*....\. ..... #.. .. .....*. #...\..\..# ..... .\.. \.#.*..*.. .. ....# ...##......**.# ....#
#  *\   * # .. *..*.*.#..\ * #. .#*#...  ..\.  .\. * ..#. .. ....#..  .....**#.. .*..* .  .# **....#
#.......*... *.... .# . .#. #.. ....*.\*..#.**... .*.#. \\. #* # * .... .*..*.#\.....## .\.  #. .  #
#..   *# .\...#.  . #. . .#....\. . * #*...#.# ..#.. .. . #..**. ...# ..##... ##. *..\... #   ##..*#
#...#* .#..#..\.. #. .\ . ..*\.. ....*#...  *. ..  .#.*. .###  \#   .*. .*....#\.. . ..... .. #.*\.#
# .#..*... #. .... ...# # ..\.*..* \..........  ...#...*#. ...#  .....** .#..#..  ....#\\*..*##.  .#
# .*..##... . ..##...**.#**\...... **  \. .. .. \.....*..#* .......   ..........#.. .. . .#..... . #
##. ......\ *.. .....*. ... .  ...\ ##........*......* .*. ..\...* .#.. . ....#.*.*.\ \*.#.#..\**.\#
#* . \. ..* ..#.*. #. ....*..#.  *.. ...#.#. . ..*# ..  ..\ ..*. *.......#.. .......#   ..*\....*..#
#*....# . .#.. ... ..... ..#.. # \   ...#... ..\ . .#\...#. # ..#....#  *... .*#.. *.....##*...\.# #
#.  ... .  ... ... *#.  ... #... ..... . .....**.. ..  .....#\\#........##.*.#. \.\ #. .\#.....# .##
#\..# .\##...   #* *.#.. #.*#*#. ......  *. #.**...#  .# . .  ..*...## .  .#. ..*... ..*. .... ... #
#.  ...... .#.  .... .. ... * \...\*.. .. #.#.\...#.*...\.*.. . ..*. ###. ....# *.*.*....# ..*.# \ #
#  ..\# ##..#.. *..#. .#...##.....#.#* ...*.. ...#\#. ...*  ..*. .\. *.*#...   *..... *...# *...*#.#
#.......* ...\........*..#.. #...#..... ...#*. ... .......*.. *..*  .. ... *  .\...*...  ..\ \....*#
# ........ .* ...#.*  *#.#.##..#*....*.. ....*...*. *.## *.* .\....  .....#...\ ###...\..#.\.* #.. #
#.. ... .....** *#.. #. ....#.\....   . .. .  .*.*..\ ..\..\ ...... #........... .* .*  .\ ..*.#\#.#
#*..... .#. #.. . .. .   .#. .... * #.**..##**# # . .. . #..*...*. # . *..\. .  .*....\.. . .......#
# ..**. *. .*.....# .***....#. .#.......*..*.. \.*. ....*..*...  .... ..*.. *....**.**..*.. ..###\.#
#### .....*.\   .#.\.*..*. *..##.**  . ....   .....#..... *. #......... .. . . .*\.\  ..#.....*... #
#..* \**.*..\.#. #...\... .. .#.\..... ..**...#*.*. #....#.. .. ...#...#. .*\**. .. . *.....#.\.  .#
#.. ...... .*. .....#.*..  .*#  .#  . #. ##..# ..#....... *... ....#.......#...... *.#..\*. .##..*.#
#.... .*#..# ..*.*.**... .\#.#..#.... *.. ..... .\  ..*.**..  .\\ ..... .. * * . . *..... .. ......#
# .... . .# ...  . .\....#....*  #.*. .  ...*. .   ..* .. \##*. . .. .\...#.\......# ....\ ..# * ..#
#... .** .*.# .. . .\.\\ ... ....\...  # .\. ..\...  #.....#\.. ....  . ..#** .\. ...#....* . ....*#
#*..*. ....#.... .##..#*.. .#...#..\......**.. ...#.*.*. .#. .#..*.*  .#.*.... ..#. .. #\.  .#..\..#
#*. .  ..... #.\#....#.\#.#....#.. ..\#..#..##. .. *#*... ..#.\#.. .###.. #. \..........# .#. . ..*#
##.........\ .. \... ..\  .. . .. .   ###...\# ..\ .  ..#*.... ..\* ...\........* .........#. .. #*#
# #* . ..... ....#. . ......*  *.. . .\\.*.... #..*.\ .. # . .... ....#...... .#...... ....* ...\..#
#*#..*... .#**.  .. ..*... *.  .. *..#... \ #*\..*\.\.... .......*#..  *.#... ....*...* #.*..... *.#
#. .....#..**.*.\.#.* .*...\. ...... .............\..*..*. ... .* . #.#..*......#....\....  ... *. #
#.....#\* .#... ....\#. ....*# .........#. . .*...*. ...#.*.\.*#.. ...   . . . .....# .\    .## #..#
# ...#.. ...#*.. ..#.* .#...*...**#. .\.. ..\....*........\..*..... ... ....* . .   ......  ... ...#
#.**.#.......  ... .*##... ..*#.\.*.. .. *..  . .  ...* #*  .....  ...# . .#..  ..*# .***  ..  *...#
#.....#*.. .. .# .. \.... *. ..##.. ..*..  ..\. .\#..#...  ...*. .\...*..*.. *.  ....#. . .........#
# .\.*.......  .  .#.....**.#.....*..#* ...#....  #.*#.#. ......##. .# *  . . \..#*  .# ....* .. ..#
#....  ......*....*...#..#.**. *.** *  .. ... ... . . . *... .. ..\ .#..  \##.. .... ..*\.#.*..... #
#. . . *.. .*#. \  *.*.*.*.#. ...... .#.  . .....\. .#*..##. ...#.\#.*.#.*.....  *.#.\.. .*##*#... L
#..#..\ *... . ..*  ....*  *.. *...*  ..  # *..#...\ #....... .\..# ..#..*# ...*\\..# . #...*..#..*#
#..#.#.*.......#.\..\. *.. . ..#...   .* ..*...# . .. *. . ......... \. ... # \.  .*..\*..\  . .   #
#*...#... .#.\ .. .#*#.. .\..   .... *.... .. ....  ....... ..***. ..*.\##.# . \......*.. ..... \.*#
# .. #... ..\. .......#.*.#. .  *\ \#..    .*#... ....*\.# ** .  . .... ..*.## *\ *#\* #   .*...\ .#
# ...# * ..\*.  .*\#*\..#..# #..*..*.  ...* ..#..\.   .*#\\...*. #.#..  ..*..#.*......... .. *. ...#
# #  .... .  .*.**. #    .# #.*.....  .#....#...#\#. \ . . ..... *#. .#.\..\* \ * ..*\.# ...... .\.#
#........#**#.. ...\...\.#.*.. .# .  *.\ .#. ... \*..##* ...#  ...\.   \#...*. *...*.*... .........#
#..  . .#. *#...   # #\ *.. .*.. .##.\ ..# . ..........*.. ....#**.\.*.*. .#.*...  . . . **...#*** #
#... .*.#.#.\. ...**....#  ...*..... ..#....\....\...\.###....*#.........**..#.  ...# ..\..*.\.\#.*#
#*.. #  .*. . .* ..* ...  . **...# ..#.....  .*.  .*#..* ... \*.  . **..\. . ...*.#...#..*....#.  .#
#... ...\ .#.*.#.*. ...  . .*#*.*\...*... .#....##.#*. . \.\..#.  * ..#.. #*....\.*#*\.\..*........#
#.#*. *..*..... ..#..#.. ..... .  *.#..*..    #*.. .\.\.\# ##... *.. \*\..\#**.*  ........   .*\. .#
#....... ...  .#..*........ ..... ...*. #  #.. #*.*.. ...........\...#.....#......# ..*...  .##. #.#
#\.*..*........#*#*##...*....*.\\. \.. * ....\#*. . .**.. .\.##........##....*....... .\.. . ......#
#. .** #  .*.#....\..    .*.#..**  .. .*.  ... ...#. .... ...\*.... \...* *.... . .#*#... *.. ..*. #
#\# ...\  .\*. .... .#. .  ... ..\.....**...  *   #.. ..........\..  *.#...#..*.#.\. . .. .. .#....#
# ...*..... .\* #.##.*....... .*#.. ..*..... .... ...#. #*...\* *# ....*.. .............\ ......*..#
### .......\.\.#..... # #...#\. .#....*#.  ##.. . ...*. .\  . .#.*.# .#\# ..#*... #\##..*. .\ #\.. #
#.. ....#. ...# *.......*. . ..# .  .**..... .*.*.......... . # * ..*..## ..\ .*...#*. \... . .. #.#
#. ... .....*. * .#.. .. ....  .* ..*.  . ..#. . ..\..... # ...... *.... * . ..#.#.#.  .  .. #. ...#
#.*.*...### .. . * \..   *.. ...\ ..#..**.. *..#.  ....... ......... \ .#..  .. . *.. *#..#.. ....\#
#   . ...  ...   .....*..\ **.*........\ .....\ ..  .......*. ..*....  #*#...........   *..*..# *.##
# *### . .. .*. #.....*...*\ .#.. .   #.#...*.....*.. \. . ...  ...... .\.\.. . . ....  .*. ..##\# #
#...  .*#*.*  .. .. ... . .... \.#. .. .. .. ... **.#.. ..#  .# *..#... .*....*... .. ... *...*..#.#
# ...* ...#....# *.#*.* .*..* ...\..## .\.\.. .. ##.....#..###...#........#.. ..*... .#.. ..* .#*#.#
#**....  .. .#...*.#.........\.  **. .. .#*#..\#.##.\. \..*. .#.......** .*#..#... *...*. ..  ..* .#
# ..#*.#. .#......*#.....#.... ....*. ....\#..#*..   *.. . ...*.*##. .*..#.....  *\.. #.. *...#. * #
# ## .  #.. ... ..  ...#.....*..  .\....... .. . .# ..#*... ...**#* ..\.#* ..*  .. #. ... #.#...\  #
#*. .*..... #  .. .  .##\.. ....*. ..#. ... .. *.*...*....##.*. .. ......\*.. . #..*.. ...\#*. \*.##
# ......#. ..\. #.....#. .... . ... .* ...*\* .....  *..#..*. . .. ..#.#.*## . .....*. *.* ...# ...#
#.#.*. .#. ......\. \#*.*.... .. .. \. .. #.*....* .\*..\.* *  .# ..## ..*....\ ... .*.##.. ....#..#
# ... ..... .  ....  .....#... ..*...\#..#.... . ....\. #. ....*#..*.#....*..#*..#...## ...*....*\.#
###... ....*\.. ... ....#. ..#.. *.. .. * #..#.. .*.#  **.#*.*.* ##.* ..#.* .#..*.... **....... **.#
# .. ...*..#. .. ....  ... .. .*...#.*\#...*.   #...* #\. *.# ........ \*. .*#..#.....##.. .*#*.  \#
#.. ....*  ......* .*........... .\#.\. ...\. ........#........*..**.#..* .*...#\## . . *   ... .. #
#.. .#...... * . . #.  . ...#*.......\*#.#\.  .......*#..\..\...#..... ..#... ..\ ......\..#..#... #
#. ...... #. .*.\. . #.*.*\....*..  ..  *.  *..\.  *.. *.... .. ..#.  *.. \#...* \. .. .. . ..# .#.#
#.#...\. ..#*.... . *. #...* .*#...  .#.#...*#..#*..# .......... *#.*.. .. . ..  ...... . .#..... \#
####################################################################################################