####################################################################################################
#*.##..* #.#.*.* .*.*..##*#. ##..* #.#.* ..\** ..  ..\.. ...**\*.*..#..  .. *#*#..# .**.  **...*.. #
#......  ##*\...*. .*.*.. #*\. ...**  .#..*.*.#.\.#.*..... .* .... ...#...#...#  .*..  .#...  ..\\\#
##.. . ...#.\ *.......... #*....#. .**. ..#..#.. *.   .*#\. .. .. #. ...*...\.##*..\.#..* .#*..#. \#
# .  ..\*..... \ .\.#....#.#*. .\*...\*. ..\..   ... ..*. . *.\..  .. .. \  \. ..  . #......##*. .*#
#\. .  ..  ..*..\..#. #...* .*\\. ... # *.* .  ....*.\ .#.   \  .**  .  ..#.*#.... .*...   .*.*.#\*#
#*.*....\...# ....*..##..\..#  .#.. #.  .. . #. ...*...\.. .\....#. ....##*....#.\.#..*.. .\#.... .#
#..*...* ....\... .##. #..\ .......*\.. *# ..#.#.#..*.. .# ...*##*..\.*... ...*.*.............#..#\#
#  ####**.#\\*\#.. # .....*#.*......#*..#.\. . .##...#..\#. \.** .. .*......*...*.*...*.*...#.. ...#
#.. #.... .....* . .# ......#... *.*... #*. *.#.  *.#.** .#.# ....*\..**. *  ... ....#...\.* # #.*.#
#..# ....*.*....#.  ... ...*.....#...*. \. .\...*..\. .#...... .* .#.....\..*. \ .# .. #. *...   \.#
#\..* .... ...#.. * ### .\*\ . \.#. .....* *#**  .\. .*... ...***##.\.... .# .. ....*.*.. .\\.  .*.#
#.. ..*.. ..\# . ..... #.* . *..... \#. * .....\.*.#..  *\.....*   ... .. \.\.#... ..*.# ... .#...*#
#.. ..#..#\...#... ....  # ..#.**. .*..*..*.. .# . ..  . .*..\....##..*.. \ ... #... .# .. .*. . *.#
#   *..*.*\. .##..* ..... ## . ...\ .#..... ..*..** .*...# .\ .  .\.*. .*....\.*..#...#..*.. . ..*##
#.. .*# . * .  .#\# ...#..**....... *.# ..... .*.....\#... ..#.#....  \* .#... ..\...#.#..**#\.\ \.#
## .. ........  ..*..*.. #.# # ........ ...\ ..#.. ..  ..#..#.\.. #.  .\.......\.....#..***.#.* .. #
#*....... .*.# .## \*#..\...#   \. * #..#..#. ....*\ ... **..  .... .  *.... .* ..*#..*. #... .. ..#
#......  *.# ..#...# ....*\.# * \... \... .* ...\...*. .\*...#...# *.*\.\. # \.# .\ ... .. ... ...##
# . .  .\.  .. .*.\..** *.. . ...*.......*....*#. *. ....*.. ..*.\ . ... .........*  ..* .\... .. .#
# ...#.*\ .........*..* ... ... * ...**.#..#..# .\.\.* .#*.. .#.#...*.# # .  . . ##.* . #.#.* .. ..#
#.. . .#..#  ...*. \..#*# .... .#.## .....   . # ..... ..  .#.. *.. ..*\**.. .\.. ..#\...#..* .#..\#
#.* *#.*##.\..*.....#. *.. *#..* .. ...... .... .. ....*\ * *....*#\.\.#. ... ..*..\......... ..  .#
# *...... ...  . .*.. ..#.** .#. .. ##.\. .... .# #**.#..... .........*#..##.... . #... ... .\..\..#
#**.*.*....*....\ .#.*  ..\...#.... .* .\. * ....  .. .#.\ .  .....#.##......#......... # .#.**....#
#.#*\.#...**...*.......*. .*..#. ....*# .. #...#**...... ... .... \* \#...  # #.... . #*..   ...*#\#
#..*....##... *#  .* ..# #..##\.. ..\.. .*.#. *\.....*..\..*..... . .*....*. .... #*... ..#... #.#.#
#....\.*.\.  .. . .\# .*.#*..\.. #*. .\.\.#**.. * .  ....\  \. ...  \ #..#\.  ...#*...\ # ....\ .. #
#  \...#..\. .  . . . *.\ . #..\ #...# . .*\#.. .. . ......#.*** ...*. **..\*..*#*\..## *...  .*#..#
#.*  ...*.. # *.#..\.#.** ..*..*... ...\..* .#.#.  ... .. # #......# #.\ \.*..\. * . *.....*..*\*..#
#\#*.#.....# *  \ ...* #.#. *..#.*. ... ........ ..... .\..\... ... ......\...  .#.*... ....\#\\**.#
#. ## ....#.\.*. .\.#.. \   ..*...\#...\ . .. .... ...\.#\... #...*..\.  .* ...  . ...#..... #  \..#
#.....#.# ...#.. . .*\  ......*. .. . ..* .*....\...... . .#. .  .\# .. ..*..*.. ..*.#* ....* ... \#
#*.. *......#..*. ..*\.. ..* .  .#.... .#. ..#.#* . .** *..*...*# *.\.*.#.*\....*.. . . \.# ...#  *#
#...#.#.. ..\.    .\#.. ..    ... .\#..** ..**...#. .#  ......* .  ....  ...*.#.......*..... #.*...#
#*..# *.#.# ...  *... ...*. \.# #\..*.*  .*.#.* .#....# *  .*#. #  ....*\.#  ....#....#.*..#...\...#
#.  #... #\ . ... ...  \. ...#....**.. * .#. .\ . *.*..... ......... ...*\.#\.*.# ...## #.....#\..##
#..*... ...  \. ..*.....#.*. ..*#.. . .*.  * .\*.....*. ..\. #.#**..\....#..*..   . ... ##. ....*..#
#.*..\# . . .. .*.*....*\...# .*.. #*. ...*. .. .. .. ...#  ###....\*.. .#*.. * .   * . *..*.... # #
#\.*  .\.\ ..... ... . \. #..#.*.#.#\#...*...*\ .\.... *. .. ..... ....* ...#\..   .** .#.. . *..\##
# ..\ ..... ...#.*\*..#...\#..#\... *.##.   .*..#......... \.\. #\  .....#..\\.. .# ..   .*  .## . #
# *..# . #.#.  . ... \. . . #.#...#. #* *. .* ..* .\.. .. .. #. *.\ ##........  ...*..\* ....#..*..#
#...*# .. #... ##....  ....\..#. #. ........* \...*#.  .. #.*. ...*. ..#**\.....#.. .......*#\#.. .#
##  .#.*. ..# #*# ..#.\.#.......    ... ..# . ...  \  ...*.. *\. ... ..#. *..*. .#..#.#...#..*.  ..#
#... ........##.... \..*..#.* .. \..**#..*...#..#. .#.\......#. **#. .#....#.#.*#.*#.#...\. \.*.#  #
#... .  ...  ...##....*  *...*#.#.. *\#.#.... #  ....*#  .. .....   ....* ...\.*.  ....*.. .#. ...*#
#.*   ... ... ... . **. . .   *. ... #*..#.  *.**..\... .#.*. .. .. *.. .. ##*.*... ..*..# * ....  #
#. ...#.........\#.#..*.. ...\..#*.....*# *.... *.*..\#.\..* .  .* ...#*.   .. #*... ...  .#*...R#.#
#.. . ....#... .#.....# .... ##..... ...  #.. \* . #.  .\. .. ... . ..........*#..*\#...*.*...#....#
#...  .#..* .#. ...# ....#.#.. *. ........# .  ..... .\..*\#..#.*  .#.#...*..... *  . . .\. #*#....#
#..*.. .. ... .# ** #..\... .#.. \.\ . ..* \\.. ..#*.........*.... ..*# . *.... .\.#.\. . .#. .\.. #
#* . .*....\.*.#.  \.. .. ..   #*... *\##*. *\ ***...*.# \ . .*.# ...\#.#\ ..**\... ...    * #.... #
#..* ....... ..*.. *\*\.\ .  .*#....  ....#  . . .***#. \*..*.  .\ .....* *...* * \..  .. *... ....#
# ..*..#\....  *#.#.*.#....#*..*..#....*..#..#\.##......#.... ..*.....#* *..*\ .#.   ........#.#...#
# . * #*\... ........##\....\..\.#...  . . .#.....\...... .\.# **... \. .*.. .#..*.. #..**\.....* .#
# .. #.* . . ....... .#**\. ## #.. ..# . .  .#  #* .   . #....#\........ **. .. . #*...*....  ..*#.#
#.\.. ... ....#.*.#......*.*.. .....** ....... #.. ...***..#..* # ## #. \* ... * .\**...* .#.#*... #
##.......#\.#. .. ... ....\..#.... ..**.....#*. ..**\#.*.. .. .....#.*\#*\. ... .*.*#\ *.*...*....\#
#. .  .#.. \ *..\..... .. .# ...... .  .* .... .  ...  \\ .. \. ...  .#.. ..#....*#...... . ...**.##
#... **..#.   . . #. *. ...# .  .#* .\  . ...## ....\.\...*##..\#.  ......# ..#.\...#.* .. . . #.* #
# # #.*# ..#.....**##... ..* ..**. *#.#..#.\.\*.* *\ *...#.#.##..#......*.. *\..* .* ..\ ..*.. ..###
# * \# *#... ..........*#.# #...\. * . .#...*## .. *..#. . .*# ..\... .......*##...*# ...  *##.*.#*#
# .# ..*. ..\#. ..  #*.....  ..**. ........*.#... ......  ...## \...*... ##  #..##.. ##*#.#\\....#.#
#..*..#.#....*.#. . ....\... .*#\. ........  .*.* ...* *.. .# .*. .. \. *...... .....#...\ *.... .##
#.*..#..#.  . #..... .... ..\*...*.#..........\.....#* .*\ ..* .. .#.. .##....#** .. . .  . ......*#
#\#......*........  .\.... ... ....   .\. .....#.#.* ..## .\.# .*\. .   .. ##.\...*  .\#... .*.. ..#
##*........... .\..\..* #.##**.#. \ ..\..  .. ... .\ .###.... .\#  .#...\ .*##. .*.\. . .#...*.....#
#*.... ..#....\.*.     .\..* \.*#.. ##.* . #..*  #..\...*.#* ........**  ..  . .. \. ..#..* ..#. * #
#. .\. .*. ..  ......#.\.* *.\##  ......* #.   ..... *  \..*#.\..* .*.\ *#  #\. .##  ....* ...** #.#
#. .#  .*......  .#.... #. .\.\.*. #...#\*...*..... ..........###\*...  .. .. ..# . .*..*.\ . .#...#
#..\# . .. .  ..*.*## ...\#*####. ..*...*... .##.. ...*. .**....*..*#.  \#. .......  .  ..#..*.....#
#.#.#** **#  ...#*.  . \. .  .... . ...* #..#.    ..... #.#....\. ....#. ...##. ..##\ .#.......* . #
#..    *\.#.. ..#....... . . ... ......#.#. .## ..#  ..*..#.\. ..#.#. .. .. #..... .#..*......  .*##
#**#**.....**##**..... .##....... ...  .# * \ \.*.. . ..*...* .  .*. ....\* .. *.#........ . ....  #
##.#...*.....*\#\ *...*#.#.... ...  \*....  ....* ..\ .. \........#\. . .....\.  ...#\..*  . \*...*#
#.. # ....*.*.*........ . .#....  \.... #. \#.#.... ... .#..#..#.* #\..\     .. ..*...  #.\.....  .#
#.. .. #....\.. .  . .. #.......#  ## .....* .. .. .#..\ .#... . .\ # #..*.* \*.. *.... #...... ...#
## .  *.. .\... **.#.\.*..#..   #  *# #..... #   ..* ...# # .....# .  . ... # .... *.. *.*#....   ##
#...*....\#. .  .\.#\.\##  . .# ...\. ..*#..#**..#* * \.......#......##.#...# ... .....\....*\.*. .#
# .....\ *. \ \.. #  .  ..*  ..#......#*....  ....*.*.*. ... .#........ .#...#.*##.\..#....#*\*.# .#
#.   .*. ....*. \\#...#.# .*... ..... .. ..***#..... ##... . . #. . .**...#..*#.#..............#.. #
#. ...##. .. *.#.........  #. #.. #\*\.... ....*...*. ... .#. *** *. ..*.** . ..**#. .\# .##.#.#.#.#
#.. *. . . # #... .*.**  ....\.  #\*\.....#..  ... ..* *......\ . ........ ..*..#...... . .\...#.* #
#.*.#....\*.#.*#.\\#  ...#\...........# .\..# .*. ... . . .. \..*...* ...*..... ##..#......#* *.. .#
# ...*.\#.*#.\ ....# ..\........##.  ...# *...#..*. ....# ......# ..\.\. .*..# ..#. ... .. \#.\.*#\#
#..  ..*..*..... .#......  . #\ .#... . .*. .\*. ..###.  #... \. ... #......#.... .#.#...***.  . *.#
#**.#.  \.... . .*##.....  .# \... ...#..... # \. .#*\...... .#........*\..*... #... .*  .   ##... #
#.\...\ .#... ..#....... .\.* *.*. \**#*  *..# .#..# *..*..* ... *# #..* ....*...##.\.. .. ..** ...#
#...\. .... . .....*...  ...#...\... . ..\....\ #..#....#.. #..\#.. . *. . #**....#.\ ..... *#.....#
#\ .*. ...#.. * .. #...#....#.#.. ..\##.  #\.....#.. ..* ....*......\..#.. .*#\*..\... *  #....#. .#
#..*...#..#*. ....   * ..#.. ...# .*.*#* ..#.\ *.#..###..*.. ...#.#*.. #**.# ..#....* # # .  #.*#.*#
#..*..... .......*. *.#. ... * .. ..*  \ . *. .**..* *. # .#...#.\.#........#. ..#.... ...*....#*..#
# ... ....#..#.\. .. .. .    .*..*..#. \ .# ....#.. .*. .##... ...#.... .  .. ...** .#*.... . ...\*#
# ... .\.\ ..*# ...* . ..# #*\..# .. ##..**. .#...\#. ...**. *. .. .... .*   *......* .....# *# .*.#
# ..#\* .... .*.*. ....#...*.\*.............##.. \ #.*....*. ###* . .\ ** #... #...#.... . ...#. . #
# \..#\  .\..\.#. .... .  .**\ . .  ... .* .\..*\* *\. *.........\..\...   *...\..\* *.  .#.*......#
#.**. ..\ ..#.\......*.#*..# .\... .\\. ..*..*... \..  ..# .........\ #.*...# ..*.\ ...* .#.#.*#..##
# *.*.#.#...# \.. ....... ......#.. ..##.#.#. #....\#....\.#...  ....\  **.*. *..  .  ....#\ ##*.  #
#   ...**. ..*..# ...  ..\... . ......  ... *.*. .\.*.#. .* . .. *#.#.# ...  \\..   ..\.##.....# \ #
###############################################################################################L####