####################################################################################################
# .* ..*..#...\\.....**..#  .. #.. \. . ... ....*#.*.......# ..   ....\ ......... .* ...  *.... #* #
# . .# **.. ... .#.........  \...# *.\# .\...... #.....#*.\*  * \\*.......\##.  ##*.. ..#..*.#.\ ..#
#\.#...*. ..#..*... . *..#. . #.#\...*. . *. .\.. * \*  . #*...# ..   ....  ..* ...\*...\. .*....  #
#....*..#.  . ..... ..*.. #   . ..... .... ...*... ..*..#. . .\.  ..#*..#.  . *..#....*#*.\. .* \..#
# #..*#.#...#.#.** *.*\.*....     ..*....  ..**#\#..#..*. \#.*..\.*. .. . #*..  ..*#........#\.*   #
#  .. .*  .*#\..... .. *.. #..  ..#. .... #. . * ...#..... ##.\* #*\ .  *. ..  ..##*.. ... *.\*#*###
#..\.\.*..\...* .  .#.... .....\..**..#\  . . #.# # .. *#*.* # .*.. ..#. ....#.... .\** .#...   ...#
#.. ##....#*. \.### ....**...  ..*#*.#. .... *** . ..\.# .  ...#... *.*...  .*#. *\.. .... .....\# #
##.* . #.. .*...# .. . .....*.... . .....#.......####. \  .\ .   .#. \ ...*..# .  ....*... ...*.  .#
# #.. ....... . .# ** \*....* .. . ..* ...#\* .. .*...*..#...#.\.#..*...# . ..... . .*.#....##. ...#
#.##. .............\...#....**.......#.#. . \...*...... ..\...\  #.......*#.*..*.  .\*....*...\ .  #
#.  \*....#. ..  ....#  ..**   ..*..*. ....  . .# *....#... .* ...**#..\# ...* .#..*#....... .. .. #
# . .. ....#...\......#.*#..#...#...*..* ..#....   ...* .. ...\...  .**.\ . #....#  #...#.... .#.#.#
#* ..* .....*##.* .. #.  .........#.*... #....*.# * .... .\... \.. .# .....\\*...* *... .. .  \ .* L
#.... ..# .#.* .#.\*. ....\....   .. ....*\......#.#.. #..\.... #*...*. \#.. .\....*.#..** .*..# . #
#... .. ....**#....*.#....*.*# ..\.. .......  .* *....*# ... .. .*\ .... \... # \..*. ...... .#.\.\#
#. ... *...\#....... .*...#\.... *.* .*.........\.#.... .\.*.. ....*.*.##..   .#.# .....*\...#..\ .#
#.......* *...\....# ....*..........***.#.  ..#.....\.. ....#....#.. .#..  ... #*.*\.. .  ....*....#
#. *..\#.. . . .#\#.#. *. .\....\.\#** .* ... ...* ..#.*....*.*.#*...\*.#..#  .. ...*.\#..  .# . .##
#. \*..*..#.... .\\..#.... **##......  *.#.. ..# ...*..#..#.. . ..# . ##...#*..#....*.*# *.*...... #
#.*.*.. .# ..\ # .. . ..# .\...... . .**..*.*   ...#..\*  ......  *...*.......  \*.... *.   ...... #
##.... *.\*.. . ..#**##.. ..... .........#..* .#.\.*..# \#.  .. . .*. ..\*.\#...*.*... \ ....*##. .#
#. ..... .#  ... ....#\.. ...*.....#  .. .. ...\**#*........ *... .....#.* .. *##.# .*\.\ .. \.*  *#
# .. ..# . #. ... ..*.*.**. .#.... .*..*.*.... ..*.\.* .\ .*#..\ #...... .\. ..... ........*.....\ #
#..*. ..*#\.\.. .\ .  .\..\*. .. .\.*.#. ..#.. .......*  *.#...\. ... ..#. .\*##  ..*. .... .    ..#
#.#* ...  ...*##..#*..#..*... .....*.. ...#. #  *..*.* *..# .\. .# ..# ...... ..# ..\  ...  #.. ..*#
#.. #  .**\.*.. .. ..*.....\# . ... .   .* \ .\.. ...*.*..#  .#..*.. .....\ ..*#\...    ..* ... *. #
#..*... *\ **....#.......\ ..#. *...# ..*.....#...\###.\.#. . ....#*.*... ..\... *#\.#..* \ ..... .#
# ... ..#.......\*...  ##\.\.. . \*.*. *...\*. *.. .**...*\... \...* ..# ......#*. .....\...# .... #
#.  * ......  *\.#  * **.#. .# .\. .*.....*..\.#  \...# .#*# .. ...*.\.**   .#... . .#. . ##.*...  #
##.**..#..... ... .. .#.#. .. \*........# . .  .\ ..  .*..... .#.. ##*.*..*.  ............* * .\...#
#...#.. .* .*.... ... *.... .**....#\..... ... . #. . ...#..#.\**...#  #. . #...*. .##...\* .. ....#
# .... *.\... # ..*..##.*...#  .#.**. ..#.#........\ .#..\ .....# \..*#...*\\ #. . ..*.\ ........###
#...\ .#*. .*.##.. ... .. . \.#..#......##*#......  .# \ ...*.... .#.. .*...*...\# .*......  ..*##*#
#..\.  #*.  .....* .\ .. ....... ** ..*.*..#. .  #  #...\..... .\.. . . .... .....  .*....... #.. ##
#\  .# #... .#.\...*.... ...\.#* #\*...#*.\ ....#..\ \  . .#..#**....#....... #*.#.. . \... **. ..\#
#*.\....#   .*..... . .  . #*# ....#.# .*#. #....*.. * .. #\.  .*.# ... ......   ... .  #  ..#*#...#
#.....\.#\. *  .\* . *# *#. ...\*...\...  \... .*.. .# ....#... #.# .#. .... .......*.\..*.#. .# .##
#.. .#.*.... . .#*..... ..#...#*. .... \#..  ..*............. #*.#.#.* .  *  ..#.#. \*.*..###.\.*. #
#  *..  .\...#. .#  *#..... .## **  \...  # .. ....*# ##.#..\..#..... *   \..*.#. \\#\.# ......#  .#
#  .**....#... ...   .*.*. \..*\*#*..#..#.#. \.# .....#.\.. ..\ #\..#*.*.\.*.......  ... .*** ..*\*#
#**#.. \..*\ \.. ...\ ##***. .. ..\\..#.....\.. . \ . .....\ .........  .   *. #*.\.....#.. \ .#* .#
#....\... \ #..\..... .*.*#...\.*.##.\\#.*.#.#.** .  .*.* #...*  # .........#*.\.. .. . . \... .#.*#
#...... . .\\. \.#..*..*# .# ..*... ..#.*. ...#.#..*. ....\..#\.* . .... #.......#..... *..#... ..##
# .....*. #*..  ......\.  .*..  ....#. ..*. #   \ .. ....  .*  #...***\ #  .\\...*... ..R. #*#* ...#
#.... * ..#....\. ..#...\#.. *..*.*  . .*#.... . ...#.  \. .##.. \ .. #.* \    \*#...\  ...  #..#  #
#*.*\.#*  ....*#.... .\.#...* \..  * .  .##. ... #........ ..*.**.... ..*. . ...... .* \..\#..\ #.*#
# \ * . .#\* ...* ##.......# ....#.. ...#.....  .\ \......\.#\.   ..  .#\.#.  .... # *.*# *. .#*..*#
#.*..  #..*.*#....# ... . \. ...#...*# ... *.\**\   ..# *#.... ......  #  . .* ... . .*## #\#.... *#
#.*..    *...#......** .* #.#. ..\  ......# . *. \...#..#\.  . #....  ...\*.#.*.#*.......##.*.*. *\#
# .. ..#..##\* . *. \... \.#.\ .. ...*. ....#. . * .\..  .. *.*\ . .\....#..#*.*.... ..*    ..\... #
##.#.  .... \..*. .. .*..\.. ....*.... *.......* ...*.**#.. . . \.##..  ..*. #\.. *.. .#.*#*  . .. #
##..*.#  \ #...... # **.....*.........   . . # . ......\\*.*..\#. \.... ....*. * .*  .\.. .. * *#  #
##  .*. .*... * . * .  .#. ... ...# ......\ ....#*. .#. \. \*.#\. *... ...\\ ..*.*..  ###..  ...*  #
#.\#*##...*#*#\.....#.. .#.*  #.#*.* ..*.. \..  ... . #.    .   . *..  .\. .....#.......#...#.# #\ #
#..#...\.. ...\.#.. #. ....##.....\#*.#\..#....* . .....##....#.......  \.  .... ..\.*.... ..#. ..*#
#. ..# . .  .. ..\....\..\*. . .....*..*.* ...*..\*.#...*.*.*#.*.. ....*. . #...  .....  \.#.*...# #
##.#... .##  .\.*..\*..*...\#..... *........*.#....* ..*.... .*#.#.. ..*....*..  ........  ##*   ..#
#\# ..   * *. \#..# ...#...* ..#.  .#... # .#... #....** ... .\ . \ . *.*.**...#\..#.#\*......*....#
# ..*...\ .\*. .# .*....*.* ...... . #.*.#*..   .*#......*.\. \....#.**.....#.#*  * .. .\.....*\...#
#....   \.#.....*. .....#\...\..\. *..#.. *# #.#..#..  ....*#.#\.*.#  . *#\**. ...*.##.. *.#.* .*..#
#... .... ... .......*. *#. .#\#..** ... *... . .. . *.*.... #.......\#*#*....*...#* .... *...#..#.#
#. \  .. ...* #**#..#.*. #*.*... *..**.*..... \# .. .....*..\.#.   ..##.*.#. .*. .... ...#*..##.*. #
#*.  . * .**...\. ....# .\.#  #.. .....## * ....... .#...#*#.\ .#...... #.... *.......*.\*  * ..**.#
#*.*.#..\..\ *.. .\.\..* .......*...* #. .**\  *.# *.*... #*# ... .*.#....#\...\# .#. *.\...\....*.#
# .\#...*#.\... .*# ..#..*#.*.. \.* * .. ... .  ..**#.#..#. .  .*.#  ...#.\...\. *. .. ##..#.. ..#.#
#\ .\*.*#*    * *. ##*...  ..........\. . #...#.. . #.....\.\ .*. ..  #.* \.\...#. *...#.. ##.  ...#
#. .... ...* .\ .. #. ..... *#..\*.*...#\.. .#..\..# #. **.#* #*.#. .....#......... . .  ...#......#
#...*#..#..*#*.....** .* .* ..  .#..... ..\..... .. #.\... \.\.. . .# \ .  * ** .*. ..... ...*..#.*#
#....#.* .............#  ...# ....*##. .  . #.#. * .*.**............. #...#* .  \..\..*#...........#
#..*# ....\.***.. .*.#....*.#.#. \#... # ..* .  .#  .. *........*...*.#..  .#  \#.# * ..\*.  .*.#..#
#...*.. .... ...*.....**.....\ .#*.  #\#..\#..#.....  ..#.. . #.#... .#... \\..\...... ......#....*#
#. ..*....#..  .*.  .\..\** \.. # ..#.##\.....*# .*.\.. \..\ ........ #.... ..  . . ###*......... .#
#.. ... ..*.....#** *#\ ..*#  .. .... . .*.\.*.....*# ..*... #.\*.  *..\\*... .... \ ..#. .. .\....#
# ..#\... . .* .. ......*# ..* . .*\.  ... #...##. .#........ ..#.#...*##.#.#.....#..* .. .. ...\. #
#.. * .\\#*\*........*\...\. ...# . ... *... . .*.....#........ #.*.\#..... ..#.  . ........\.. .  #
#  ..... \  .......# ..#......#..*. .......*.*....*#..  . *##....\ * ..  .* ....*. #. ..\#.. .#  ..#
# ...#... *.#...\.# \*#...* .....*...##.. *.**  .*. . .... . ...  ... ..\.... . .. ..* ..#...*\..  #
# *...*** *. .#... ...* . ##* ..*.. . .... #..* .* ##. .... ..*.... .\#.# .*.....\..*.#.. .. #.**..#
#\.  ..* ..**    .# *....... ..*.  . *. ..\#...... ... ...##.*\.... .... \.... # .\.....**.....* ..#
#. .*#.*  *.. .*..#..*...**.....\ .\#  ..*. .. ... .**........ *...*... *.#...##*  #..  \.#...\.  .#
# .*..*.\##.*.#..# ..*  . ........*.# .# ..#... ..  *...\.*...#  ..* ..*... \..#. * .#.... .#....\##
#.\.. ... .#.*.#..\*#. . *. *. .... *.... ...\. .# ..**...#... .. *.. .... *\.#. \#..#. *..*..*.*..#
# .#.....#.. .#.*..... #.. *. \.. ..*. .\......*.#.*...\.#............... ........ . .... #. ..**.*#
#.\.....  ... ..  . *#*\ ......#.#*#.*.#**. *.*.*...  . #.#*.*..*......\.#..# *\*.*.... *.*... #  .#
##.......  * .# #. ..  .... .....\ \#..#...... * . ...#.* . *..*....   \ ** #..    . .*. * ..\.#  ##
#.*. ...*.......#. . . .\  .. ..... ..*#....*..*..... ...\..... #. .. ...*.. . ..... *.*#...# .#. .#
#..*..# .... ... #...# ... ... #..  #*.....#...*\....**....# ..  ....... . ........\*.  *#.. *....##
#\#...#*. ... #.... .. .*...*. #*.. ...#........#.... *.*\\ . .* ...* * *.. ....... ....* **.*... .#
#..#. ...\..*\*\.#..  #..#.** .. .\ .. . ....  . ..\*....... **.*# .*.. ..#....\. ..\. #...... \...#
#...*..* ...**.*... ...*..  .. ..  ..*   .\ *... .  ...**\...*.\... *. .  *..\..........##....   ..#
#.....*. .. . ...*....... .#.* ..... .* ...#.....  .#. .* .. #..* .#.*..*\.*.  ........#... .#.\ *##
#.* *.....\..  . .\..\...*.*\*.#.\.......*....\ ..*. *  .... *\..\. ..*. .. #.#*. ..\#..  .....*..##
###\.......\ .......#*..\. # *#.*.# \  .*.#.* ...\ .##. *  #. \#...... #. \#.#...#.#..\........#..*#
#.. .....\.# .. ..........##.#.* .*...#.#\..... ....   #*#.#...........  .#... .... . . . ..\.*#. .#
# .*. . ...*  .\.##......# .** \.......# *...* #. .. .... \ ..# *..*....##...*.......* ...#....#. .#
#. ...... . ... .#..#.#.  .\*.*. . ...*...#..**. . *\..... ..*.##.... . ..\#.**.*.. \..\\\#. .. ...#
#.. .....\. . .*...\...* .*. .....*.. . ...#...  ...#.. .# .. .....*#.* #..# ... ..#..**... .....  #
####################################################################################################