###################################################################L################################
#..*  \*......#....# . . .... ..   *.. \  ..*..#.#. #..... *..*.#.#.\.**.*.##. *....# .*..... .\...#
#* .* #....... .#\ # . .\#. .##...**#......#..\..#*#.\.* .#.\\... #* .#.  ## *.. ..\. .. #  ... *..#
#....*.#.# #...* . #...*\.#...##. #.. .*.#*#.. .. ..#.*.#  .....\#.... .# .. \.... \..*..#..\.#*...#
#\  ....#...#.  .......*....#  ..##.# . ...\..*... ...#..* ...#...  .*.*. .. #. .#* .\ ..# # .. ..##
#.....*.. ....... .*.##.....\.#..  .. ..#. ... ..#..*  ..#.. ...  .. .  #.\.... .  . ....*  ......##
#.....\.....\#.  #.#.. .. ... .#. ..*  .# * .#.. .......** **....\#.  #\\ #.. .. .#.....#. .# . .#.#
#.*...#. ...\...\. ..*..  ...  \.#....... .#*#.\ *#.#*# .*.  *.. ..*..  ...*\##........#*.  *.  * .#
# \.... . .... #**\.\..\  ...*.# .#..#.* * ..\. . .. .#  ..*. #.  \. ....*. .    . ..*. . .***..#..#
# .. . .\..*#..*.* .#. #   ...* .*.......  #...  ..##.\.....\.. \..##. # * * ... #.. \ .# \........#
# ..... \* \.*..#........  ..*....... \..#.  #.\.#*. .#....*. \.#.\#*...** .*....  ....#..... .#..##
###.. *..... .*  .. ... \.#...* *.# .. .* #... #.   *  .#. *...  *#*  . .*. *.......#\.. .....# ..##
#...#\*.#. ...  #...#.\..... . \.. ..## ... .#...*# ....#*#.#  .#\..\.....#........ ... . *....*.  #
#*..... .\...*...\\...# *.# .*. .. . ..*.*...*..#. ......*.*##.*...#\. .     *#.# .  ...... . .... #
# *...#  .. .. #.*. **\..#....\...\** \...\...*#\.#.....* #. .# .* .. .... *..... *.. * ...*#  .. ##
#..#.* ....*.* .#\..*. .#.* .# ##....#... .....*...\......  ..*..#..  # ..  *.#*#. ...\.#*..*#*.\ *#
#\......... *\ .##*\ .#...\ #*....\*#.#. #** . ....*. *.. . .*.#*.*#\*  \......... *.. #\.*... #..*#
#*... ........#. ..... ....  .  .. . .#.*......#..#*.  .  ...#\. ..\.* ..*.#..*..#.. ...*.....#*...#
#......*# #. ...*.## * .#.. ........#..... .... . ... # ...\  . \\.#.......*.\  ... ..   ....  .. .#
#.#... . *.*....#  .. . #.#..**.....#... ....**#... . .........*# # ...#......*. ...  . #..\\  \. \#
#.. #.*. ... ...#..\.. .# #\...#*.... ....\ .. #.# .*#. ....* #. #...\... * .R.... .....*.....*..\.#
# #... ... ..*...*.#. .* ......\. .*. .. .*#..\##\* .... * ....##*. ..#  \ ..*.\ #........\ *.. \*.#
# ..* .. ...*. .....*#..* .....*..*#.*..*....*... ..*..#.#......\..* #\.* #....#..#........#.  .# *#
##**\..**##.*..#.  *...#.. #...\..\*....*# .#...\..**. #.*# .....#. #.#.. .#..... ...#  ...##. \.. #
#.##..  \.#.#. .##............. ...**.\\...*#* .  *.#....#. ..\.... .#...\#  * *..*\......* ......*#
#.....* .\* ...#. ... ....*.* ..  ##.*. ...*#.## \**........* ....... .#....*\..\.* .. \.. ....... #
# .## \..*.. .. \ .*. .. . #.*..#.  ..... ...\.\#.\   .#..\.... ...\#..\...#.#\  ..*#..* . .**. . .#
#.#... .. .  *.\..  ..#*# ..... ... ....**  \*...........##  ....  #*.*#...*...#..... . \ .#..  #*.#
# * ...    #..#.... ..#\.*...#  *.. .\.*#.. #.   \ .*#.#\ #. *...  ....## .*....*#..# . .. ..  *..*#
#..**##...#. \*..# ..\..*....#.**#.# ..*##  #.  .#*...*....*\..\  .#..   ##**.. ...... *....*.#.*.##
#.\.. *.#. . ... *.. ...   .. .. . ..... *..... \.. .. *\*.... \ *...... .\ *.#.#.... # ## .#. ... #
#.#. .*...#.. .\ .  ..#...... *#* .  . .  .#.... ...#..#..*.#..*..\ ..... . \#..*.\ .#..* .*. ..* .#
# . .#\. .. .... .*  .. .. .....  *....*.#..##.\.\..#.#.. #.. .## ..**......   ....... ... #*#.\*..#
#.# .\...*\... .# #.. .#  ...  ...  ..* .#. . .\...*...... .\...  ..\ *  . .... ....#..*.#.* * .#*.#
#.#\*#..  ... *#.  .\..*  \\ ........ .\..\ .... ...* ..  . ..** .#.#....*  .  .#......*... **..*#.#
# *\.##.\..# .. ..##...... #\. *. #.......#. ...# *## .*.. ...#*#....#. ..#. .* ...*..* * .\## . ..#
#*#.#*......#.*...*. ......*..*.*.*....\... ..#.*. . \*..... *.##....*....#\ #..*   .\#*....  .#...#
#. * ..\.**..*..*. #. #....... .. *.. . ........ .#..\ . ...#.....#..*.\.. #....* ..  #.#. *...... #
#**..*##\*.. #.# . ...*.#.* * .\.. * #**.*..#.#..  .. . *\....*.*  .\ ##.#..#\ #\.. *.#. ..*.. .#\.#
#... ##  #.   ##   .. #.. ...#.*.##. \.. .... *.*.  .* ....#..**..* #*.\*..*...  ..\... ..*#*.*....#
#. # .. .....#..#* .\.. ** *.   ..\.\.#. ##.....# ##.#.*.**. .#..  \ ..#\ .. .....\\.#.. ... *... *#
# ...... .  ## .*....#.#....\\##..** ..*.*...*.*   .# *.#.. .   .\...\ . . \ ***..   .... . ...*.*.#
#*..#...*..*. ... ..#  ....#.#........\\..  ..*..# .*... ........... .* #.#. .... *...#.. .   .# ..#
#* .##..... ...  #.......  #. ... ...#...#*  . .  \.# .....# #.*..#..  ...#\...... .... .\  #...  .#
#.\. .*....\.  .. ..# .... ..*.. ...\.#...  ....*.... ....\.... ..#.#.\#*..\\..#.#.. .*..#*.\ #..\*#
#..# .*....#..##.#\.#.*...\. *.\#*.*.#....*   \....* . . #.#...#.. ...*\..#*   ... #*.. .  \....#  #
# ......* ... ....*.... ... .... .**\*.#...\\#**... ... ... * *.. .* ...\..# .. . ..*..... ... ....#
#.. ..#*... . ... .#...* . .  .. . *\. .** ....#*.*.. #...\ ....  ..  ..*........#\ .. .  . .\ ....#
##.#\\*.# .\.* .......*. * .\ *#*..#*. ......*\ #..* *# ...#....**.. *#. . ...#* #.#* *.. ** ...#..#
#..\.# .# .#*......#* ..\ ..  .. *...#...*  ..*..*..** .##*. .#... ... *  ..... .*..\...... ..#.. .#
#  ....*........ # #.\.. \  *.*. .. *.  #.\. ...#......*  *...#. ...\*.* . . .. ..   \ ..... ## *..#
#..*#...  ..*.. . .*.*... ....* ..... * .** #...  .\. .*. .#.  *.. .... .. ...\# .  . ..*.....  .*.#
#.\ ...  ..\. .*. .*.#....*  .#....\#.. . ... ...\. ... ...... \.. .*.#   * . . . . \  *#.**.   # .#
#...*.. \...*..#....  *.......**.\. .# \##*..  # . .  .  ...# \......*\*#...... .## \*...  *....#  #
# .*.*# .  * . #....*.*...   .......**..  .*....\.*. # ...#....   ..*  ..\ ......*...#......*.# #..#
#.* \#.. .....# ..# ...#. ....**..*...... #* # .\    #.#.\.. ## \#.  .. . *.... .....#. \*.. ..... #
##..#...#.*..*#... ....**..... ..#..## ..*..# \..\. .   .#.\.#.\.*  *#*\..#\\*.# ...#..  .  .*...# #
# *.  ....*... .#..*\#.##.#..*... ... #...*#....\ \.#..# #. .. ##..#. ... #. . .. .*#...  #*\ \* ..#
# .*\\..#....#..*.  **\  .. ##\.. # *..*.. # #.....#  ..#.\##*....\.*. *.... \. **.....*. .##... .*#
#.. ...# #\..*....... * . .# \..\ **. .. .  \# .. .....\.. **..*....*.# .*.....\#........*. #.    .#
#\ ** ....\...**. #. ..*##\. *...   ..... .\..  ... .#*..*.... .  .... *. .*. ..#*   .....\.... ..\#
#..\.....  #...* ...............#..*..\*#  .#.. . #*.#. ..*....# .\... .*.\..  ##*. .. ...\.. *.*..#
#. .\. .. .#....# .#.. \. ##....##\..* .#.\.\...*...#* .\ ..\.. ...#..*#.. *  #....... ..... ...#. #
#\.  ..*.#.#... .......*..  .*  * ##.#.*#. *.. ..#.#....#. ....*  *..# .\*...# #. \.*..  . . .. ..*#
#... *.. ...*....*#..*........ .*..*.#..##... *\#..**..*.*#.\*#.\\. .. ..*\.......**.*. ..#  ..## .#
#.#** ...*#  .#.\*.....#.. #..#\#*.. ... ..*.#.#.\. #........ ..#..  ....... ...*........ \.*  .. .#
#.*..   .\ *#.\ ..#\.  #* \* ..* #.. .#..........*.. ....** ...# ......#.#..... .#*#....\.... .....#
#...#.. ..** ....#..\. ## \..* . .*....  ..*... .\. #..*.#....*..... # ... #.. .. *#..* .*#.#.. .  #
#\ # \..  ..# . .*.....*.# ..\#....*.#..## ..#. ....  ... ..#*.#*... ..**. . .#.*... ..*...  .\ . .#
#.*#...#  ...  ..# .. ..#. . ..*. *  . .  .. ...\ \.\ #\....#*.#.\ *.. ....#..# ..*..... . *...... #
###.. *. ....#...... .#.... . #\.# ...\# ..*.***..*....*...*..\ ....#.. *.##* ..#.# *..  \  .#....*#
# *....##...#*. #....*....#*\# .. ...#...* ..#\ ..# . .*##\...*##* #..#.*.. .....*...\. .  .. ..*  #
#\..  ..#\..**##.. # .*. .. *.... ..* .*.   #.##\\ ..#...*#.#*. . * ... ...\..\.#.. \.\.# ...\... .#
#.*.*...*....#\.  .  \.*...#. ..####..  .. .#... ..  . .... ..\.....**\* ..*.. #. .#...\*. #..  .* #
#  ...... ..\* * ..... ..#**..#\##\...... .  .\ \\..#.#.. **   ..*.. . * .....\*... . #.... #.* .. #
#. # .   .* ...\..**.  ..**.*#.....##.  **#...  .  .......*...##.\*.. #...##*.. #.# . .  .#*\ ...#.#
#*#*  .......  *.. . #. ......    .. .#*..\....  *.\* * .#  .*. .#*. .. .. ....\.....* .#. #.  .#..#
#.. ..........#  ..  #..# #.... ..#. .* .\....... #*.*.. *.*..\...\#.. .  *. .\...*.  .# * #..**. .#
#.#**. . . .......##. .\ ..**.#.....* .. ......*..#.#\.. #.*# ...*. ..*.....#......  .*...# ... *. #
#* ...  #.###.*..#.. #. .#* *\.. .#.  .......\...*. #\..# .*\.# ..*   ..... .\ .....*. ..#.\.\..*# #
#  .. ....  .... #...#*......\.. . .*..##  ##* .*.. .....*...##. .. #.. .#* .......... .#*... ... ##
#....*. .. .......#..# . ...... ..*.\......  .*.........\.  \.....###. ....... .#.... ..#......*.. #
#* *.*... # ..*.  **\. *  ....* ......##*..#*\#**......  . ..\..*....##. ..# .... ... .  #.** ** \ #
#  ...  ... . .\. .......#..* *.\#. ..*  #.#. . .*.. #...#... ...###\.. .. # . .. .. .    \...#... #
#.. .....# .# *...##..*........  .*. #\....  ..*.\**#. #...*..#....*... .#*..\.\.. ## .\.#*.#.....*#
# ......#.*..   . .**...# #.....##..  ###.. #.#* ...*...  . #..* . .* #..   .*..  .\... .\#..... .*#
#.. ..*  *.*. .  ..#.\.....\. ......\**.\..#............  * \#.... ... ...#.  ......  *  . . .* .#.#
#*. ....# .*#...#.  \#.. . ..\.#.  ** ... .. \ .*.....\..  . .  ...*.*   .*.*..  . . ..*#. .\..# *.#
#..#... * .##...*.. \#.# .#\*..\#..#. .#.  ...#. .*. ..\ #.*..*#.\.  \...#..#.. .. . .  . ... .  .*#
##\...# ......... * .#...*.. # . .. .\#.#.\.**\.#\... .##  \ ..#.*.. #... ....# ...**\.. .......# .#
#..*  \.......  .... *.... .  \.#* #.*...\...\ .* .*  ... #...  . ....  .  .\ ..*.....\.*.. . . *\.#
#.*.*.*  .*.#.#.  .  * ... *...... ........* .#.\.\* .#... ..# * .* . *.*. ..  .*..#.   . .# .... .#
# .. .#.** ....#**# .*..\ * #** ..*.*. . #...... *#.. .#..*.# . #\..\#.  .#.  \ # . .... # *. ...*.#
#*\...*.*.\*.#.... # ..# ..\..  *. \.\.*.*.. . .. \.....#......\\* #*..\ **#\..*##... *## ..*.# . ##
#.. .\..#. .**  ..... ........#*.* #.##.#* .. .*.. #.* ......\.......   . ....#..   \..*...#..*.* .#
#  \... ..#*#. .**...  *  ..\.#.\ \* .***.\ .. *..###... #\.\.\. . ...#.\..*#. ...*...*. .. . .. ..#
#.... .#.. ..#.....#*# .*...#.. ...#.# .# #***.  #  #\.....  .**...#*.... . #*. . *.. .# ...##... *#
#..... .#...   *.#*. .*#... ... .* ....#  . * \ .##..*..#.*.#*.*..* \.....*#* .. .\......#...#..# .#
# .#.#...# ...*. . .#* .  ..*...###  ....#... . *. * . . *.. .... . ..#. \. . #*.\..*. .*#......*\.#
####################################################################################################