#############################################################################L######################
#\..\\*.....#.  \....  ....#....**.  ..#. \..*\... #.*...\ #..\...# #*..*....# \  .. ... .\. \.***##
#..  ......\. .#*#....# ..\.\...*.*.... . ..#...#..#. .\.*....  **. ... ....  .. ..#\ ....#.....***#
#....*#*...*#* #... ..  .. .  *\  \#.. #..  ..**  #.. . .\..#...  ..*###   . \.   ....*...\....*\  #
#.*.#*.\ . #.#.\.*#.....\# .. .. . ...#..* #...*..\#.  . *..\.... .*.  . .\...   #......#..\... .. #
#.....\*  .# ..  #....... *..# *.  ....*..* .*...    * .#..... .*.*....\.\#...*.  \*\.\...#. .... .#
# *..  .....#...  ...... *.. .\*..* .\.. *.\ .. .** .   ..  * ..*. .  \ ...#*..#..*. *#...**....# .#
#. # .. \ ...  . #* \  ..... # *.*. *#.*. \.   ....# *.  #\* . .\**.*..  .\* ...\#... . \.  .... . #
#. .#. \ ..\#.*.**...... \..#\....#. ..\..  .*.#..\**.# *.# .* ... . .. \ \.\.*... *.....*.. #*....#
#.... ...#. ...# *....*.. ..* ..\ \* ..*. .....*....# .....#.*.... .. . *...   \##......#..  .\....#
# #.*  .*.***.*...*.....  .. ....... .. ..* # ..\.....**. #.. .*...* .#. ....# .. ... ......  ... *#
#.\*. ... ........#.....\\.#*#.. ..**#. ... #  ....*... ...\.# *....# ... . #.....*. ..\.#.#..  *..#
#..*.  \.. .. .\#.*\.. ..  ..* *  \     #...\. .\**......*.. . .#. #.. ..*..* .*.....# . ..*# * *.##
#  \.. .....\. #.. ..*... ..\.#..  ..*.* . ...... .....*# . *.*.... .*.*. \.# *.. . .* .. *.*...#  #
#. #...\ *.. ..**......#..  #....#.. .* ..*...\#...  .. .#..*\ . . .  .**#........##.\. # .*\  .. .#
#.#  #.## ..\ .....*. #*.#*.* . # **.... . #..#*.*........ ... \..#*#...  ...\... . ... ...#...**#*#
#* ...  . ..**.#.# .....**...  .*#....#.... .. *.\. ....*...*.. ...*\..   #.# ...... .   # * ##..**#
#.* . #.\*\ ...#..*...##  **..... #.*. .#......... ........ .**.*...*  ##...  .#.#*..   ..*......*.#
#. .. .**.\# .# ###.###.#. .*.* .*..... .*. ....*.*  .#  #. .# .  ..  .....# .#..*.*..# *  ....*.#*#
#....\....  \.... ..*..* \.*\. .\..*#. . .*...  .*#*..#.... ..#   . .\.*. *\.#  ..... #....   #....#
##.*..# *..  .\*\.*......*.# ...*. *.. ..#...\#.*  . .   .\.... .#.....*..*..*... .... .\*.\..*..###
#.....\. # .. .#* *\#*\..#...*..## *...  .##.. .\..... *.#......\#. ..# .#.* *.*.. . \... .......#.#
##*... .# .... *...\.. * .. . * . .*.*.#\.#. #..   .\.. .## ... .##*. ..*... .* .... .*.....\.... .#
# #... * \#.#.#. ..*....  .*. .\...***.##..# .*. .#.. *.#*.. . #.. # ....... .*.  ...  *#... ..*\..#
#**#\#..\.  ...*#..... .\ ..# . .#.. ....*. #....... .#......*  ... ..#\...*. .*...... .\..... \*..#
#. *.*\.\\.\.. *#.. *\  #... *.\..  ..... .* ....*.... .#*#.   ..#*..#.##  .\#....   ... ... #. .*##
#...  ..#..#....... . * *   **....\...\. ...  . . . .#  ...... ...#..... .* ##*. ....\...*. #.\\*..#
#...\..* . #.\.\#. .*\.. *.... ....*.*..##\......*.. #....**.*#...\..#.* ...\* # ..  .  *  #*..* *.#
#..# . \. * .. . #.  ....*\.*..\ *.*#.#.... ..  .#.\... .*. ..#.*....*..\ .. .* .....#..   . *#. ..#
#.. \.. \.\..*. .\*. .#\.# ##. . .. ....\ ....\..\....** .. . .# ..\.... .*.\#  ..\...*....# . ....#
#.*. ...  .. .#.......** # .... .*..*#....*..*.. ... .  ..  .. ..#.#.\..*...# ..*\ . .*.# ...\.#.*.#
#*........ . .. ..*.*.*.*........# *# .. .#.. . .*. ...#..*  *...  . *. .. * #. .* ..*. *\  ...  .##
## . ..#*...\ . ...* .##. #..#** ... *...*.* .. .  ....*.. ..*.##......* \. ..........\..#.  .\..  #
# . ....*#. *  ...*. #\...*#.. ..  ##... ..#. .*\\. .....# . *. .  ...#. ##*#.. *..*#  #.# . *  ..##
#. *. ..* . ...*.... ....#*.*.*..\..#.. ..*...*  .# .  #...#..##.#.   \ . . .. *.#.#... *.\ . ... *#
# *#*#..#.#... **  #..#.* *\.. ..* .**.\ ...*\  *.... .. .  *\ \*   \..\* . ....*  . . # .*# .#....#
#...*** #. ..#.\ \..* ...\ ...\\..#..**#\.\..\....  \..*#*.. ...#\..*... .. #.. ##.. ..... #\..#...#
##\ \ ...  .*...  ..  ..  *#...*.....#......*#..#\*#..#.... .*. *\.*#*.. .. .#*.......\\*\.... ... #
#*##. .....* .   .... .* #...\..# * .* ...  *...# .*. #.# # ....*#. ... \. ..\ *# #.#*#..   ......*#
#\* ...  ...# ..\ * # .......\   ...\#.*.*\.  ....##.*. #*.*.\... **.. ..#.  .\..#\  ....*#..#... .#
##.*. #..*....# .  ##.#\**\.#\... ...#......#. .....#  ... ........ #.*.#*.. *# .\..*..... \ *.....#
#..*...# ..\......\ *....#.. ... ##\.*. .*. .\.. .* ##.. ....... *. ..... ..\\. .. #.. ...#*..\. . #
#*.  ##.\*  *.#\ ##*.# * #.#..*.*.. ...*\.*# .\*\.##........... #*....\  .  *.# *##*..... .......*.#
#.#*.. **...... ...    .* . #..#....   .... .#..* R..#.*...  #.#.\.#.*  \.# . . \.#..*.  *\ * .\ ..#
#.. ..*#...*..#.. .. ......\    \ ...#\#..# . ...* **.\...#   *.** ....# #.... *.... . .\. ##......#
#. .#.. #\..... ......... **\#*..*.....\.........\.#.\#.#*\  .**..#\. ... .\...#.* .#....#**...* *.#
#.\ *. ...*.#.... #..#. ..* . ... *..#... .....#..#.  .*. . ..#.... \. .#.  *....#..\. .*.   #.. ..#
#\. ..... ... **..*. #.. ..#.... . ..*... *.. . ##.\.\#... . .. . .*.# ..\..........  .#.\.*#..... #
#.. *#..#.# \..... .#..*.##.*. #  . ..*.*..#.*    ..##* .  *.....*.** *#.#*.* *.#......\...*#.*..*.#
#.. ...*..#. #**.  ###. *\ . # ###  ... .*..##.#..##... .... #.\*... \... .... #. \*. \..*  * ..# .#
#...#..#  ...*   .*. ....     #** ....*.*#. .#..**.\. ..  .... . . .. .\..*. ..# *\ .... . * ..*. \#
#... ........\\ ......\..*.....\.\..... .. ... ..*...**..*.#*. ....#...  . ..* #.... ..# #...#.....#
#  * *.  .*.* .***##....... ..#.*........  . \.*... *..... \.*#\.*#...##.  .....*..*.#.... #  . ...#
#..#.##.# .. ...  *.#.#... .##... .....*...*##.#. ..** \....*.. .... *#.#...**. ...  . .....#.....##
#...... \.#...# #... ..#.. ...*.*..... .*... .\##*.#......#.#.*.....* .*# #*.. ...*.#\#..**......#.#
#.. ... #. .*.#...... . .  * .#  .*..... ... .\#... . .. ...*.  .##..  ......*...\ #. ...\*.*. .\..#
# .   ...... .....#..\#.. \.\....#*.*.* .*\#.  .*.###  ......#...\ ....... .... ...   *...*..  .#..#
#  *. .. .....#.  . .\  **..  .... . *  . .. ..  . .##...*.. *#* ....\.. ..\*........ .##...*..... #
#**..*#... \**....*.. .*.........*..\.*  #. ##..... ..*.*..#.#....#**#......\. . .# . \.... .. .# .#
#**. .* ... ..#.# *.  . #*.*.. * .\\.*..* .  \ .  ** ....  . ..  . #..\#. ......#* .. #..*.....   .#
#.. .. .  . \*.**.*..*........** \...  . *.#.* .. ...  . .#...#.#..*.*.#..\*..#.\.#... #.. #. .....#
#..*.#   .\. ..*\   ...... .  .\##.. * .*\... ......*  ..#... .#.\ .#...... . * ...#\..    *.#.....#
#*.. . #.#. .# *.#..\ ....... #.. #  #*.. ...#. #....  #  .## *........**... # .*. .\.# .   ...  . #
#.. #..... ..*. ##.#.  . ..#.....**# \#..\ . .* ....... #...\*...*#. #..\ .. .\#.#...#.... ..... .*#
# .*... ...  *.* ....\.###.# *.. .. .#..  .\\..#.#....  ..#..... .... .* ..*...   . ..# #  ....#.*##
#..  #..... ... .. \... ##..#...  #. \.. *...* .....#*.#*..\.#...#.\...  .. ..*.\..*.* . . #.  ..*.#
#...##* ..#.*.  .* \....#.\.*....*.. ..  *\... . ..#.\...#\ .#. . *.#. .. \..*...\..  #...#.##\  * #
#..\.. ....\..  ..#...# .\ .  ..*.  \. .*\. #\ #.. ... ..#...#..  *#.*# *..#..\   . *.. ....  *#...#
#..#..#.... .  ..... * #...*\ .*....#..* ..**  ..#.\  ......# ... .... .\. . .##.... ...#..#*... ..#
#*.# .  * .. #.....   ..*.....#......#  #. ........   .#  .. . #. ......  .*\#*...***. .   \*. . .*#
#...   .............#. .#.. ...##.*.#    ##*. .. ..... .#.. .** ..#...... ....\.*.. ...#...#. ....*#
#..**.. *# \\.. .##.\*...# #..*.. #.. .   ...**.\ .#*  \.# ..... .. .. .. .. ...*..*. ..\...#... * #
#  .*. ..\ \*.# . .#..#....#.. .. .\# .#.\*.. #..*.*..\* *  ..**...*.\... . .\.#. .  * ** #. ...  ##
###... .......*. .  \  ...  . .  .. .*. .* \#.*. *.* # .. .# ..#.  \.\* * .  ...#..*..# . .\* ...\*#
#...  ....# ...***.\.*..#. #.......* . \..   .. ..\....##..*#.  *.#......\...# \\ .  ..... . *#*.\##
#.#....\..\...  # \......#. ..  ..\#.. *..*\.\*\.*...# #\  #....   ....\*...##. #. .#..#.....# ....#
#..*..#\  #\#...*.  #.\#.....#.#....*.*..*. \* ....**... *. .... *......  ...#.. .\**.\ .#. ..... .#
#.##*.#.#  *...#.... .*...... *.\... #* .  ....  ... .\..*... ..\ .#**..# \\ #..  *#*.\\*...\.\ . .#
#. *#*# ....*#.*.\..... .*..#.* \..  . ..# .##  .....*. .#.  **#.#..\.*# * #  .*#  #.  . \   ...#..#
# *... ..# . #..#.#.* \.\.. .....#. .#. #*#..# ..#.  .........** #. #* .\.* #......#* #..\.  . ... #
#*.#.  **.. ..#..#.#..... .#\.....#..*#  *....\...# #*..\.*.#.*......\.* .... ..#..#...#.*.....#   #
#.. .*.\ ...#....*..\\.. #....# .#.#.  ..#...# .. *.#.*.....  * .#..#   .. ....  #.........*...#. .#
#.... .#*. .*.. .#. ....# . ..... *.....#  .... . #\..  ......*..#...*.. .....\..*.#.*# .#..##*. *##
#\*.. *. .# .... #.# ..  .\ ....#.#\#......\ **. \. #  ... .#....#  .\#.....*.*.\ *..#*.....\.#..# #
#*.  * . .. ..\*.*.. #. ..#.. ...........*  ****.*.#..\..**.... . .# .#.... .. #.  . \. . . ... ..*#
#.#. ..#..*......   ..*#.    ... # .. ....\. .   ..  *#\....\ .#*.\.. #   ..*.. #..\ .....##.#..  .#
#..... . **\..**..#.#  .  ......... ..*.  ..  ...........\. .....  .... . ## #.#.*.....*..  ..... .#
#.....#\. . .#....#.*. ..\ ...... ........* ##... ..#..\#****..## *#.. ....\\.  . . .\ * \....*#\\.#
#.\  *... *#* .. .. .#.....  .*. *. .  .....\\#.. .*..# ...... ..*#...*..**... ... #..... ....\ .. #
# .##..#. ..#*...*...  *   . .##.  ..\\..#\.......** #..*..#\..  .\ .**  * ...*... . .. .. * \*....#
#.....#... *.# . ..*..* ..........##.\ . ..*....... ... ....** .*\ . ..#.. ..#.*..#.*.. #.....*....#
#..*#....#* ...\ .\\.*.#. . .\...#. . ..*.#....## .... .*.#.# .......*.. ..\#.*#.. . # .....   . . #
#. #.\..  .\..\.. .. #.## #...*.\ . *.  *..  * #. * ##.. .... . **.*...#....#  ..\.*\... #...\.*.. #
#*   #.....  ...#..\#. ....   ...\..##...   #   ....\ .......* .#* .\.\*....*#..# * .#... \* # \  .#
#.. .**#**. *. ... .....  ...* ... ......*** ... * *\.#. .  .#.#     .. .#  .......**    *.. ..## ##
#. #.**...\\#..\.##....\..#.*... \. ....\...##. .. .. .*.*.. ... .#.#. ........*. .# . *.***##  .. #
#. #.. .. ..\ \.#.*...   ...... .  # #   #.#.*#...*.#....... #....*. *  .   . ....*..#*....#.* ..# #
##.  .#...#...# .. ...#.*  ..# . .  #**. .*.*#.*...*.. .* .*.....  #...#*...... . .. #  ..#... .#*.#
#.. ..\#...##.#....#.\. *\..   . ...  \...  ##..  .*.\#..#. .##.#.. ....# . .\..#.###.*.....#.*..\\#
####################################################################################################