####################################################################################################
#...............#*.\.*....  ..#..*#.#...\....*#.........*......#  . ....  ... ..#...#. #   .### # .#
#   .\.* ..\#... .*..# \.....#* .# .#.**......... * \ ..\\.* ..*  # .......    ..#....#.  .#\..*...#
#. .\ .*.. .   ..# \. #..\.... ..........*.*. * ..# .*.... #...*.*..\. ..*...  #...*.....\.....  #.#
# .... ..... .*..#..\   ..####.... ..#.....  # **...\**... .  .#. .#.. ...... . ........ ...#.#**. #
# .. \.. #. ##*..*..*.* #.#*.  . *#..  .#.. \#. .# . . .....#.. ...\  ... * ..*...* ..#..*... *..# #
#*..#*.....  ..#.\. .*.  \... .# \... ..........**..\* #*.#.... .**...\  ## #*........*.*. ..#.... #
#\. \....... .*. .** . #*###.\.#.#   . ..*.. .#..*... * *. ....*..#..## . .* .*....#......** ..... #
#..#..... .. .*..  * .. ..*...#. *.  # .\#.*. ....# . #.... ..**. ##\.# .#  #.#*....#...  .. ... \.#
#.... #  .# .*.. ...#.  #.. # ...*.#. . \......*....#.... ..* ..##... .## . .. *...*.# ...#...*.**.#
#** \ #*.*..... .#..  .*##.... #*..  . .......*  .. #.\ ... \.. #.  #. \.....#. .. #*#.*\ ##.# *..##
#. ..*..*...  #....#...\#.... .***. .....  .. .## ...\# ..\.  *.*.#   . ....*..#..*  ..#....##\....#
#. . . ... ..#...#...* **..*# .. .\ . . . #\ ..* . ... .......  ....*.* ...\.\.*# . \  .. \**. *. .#
#*..\....... *.##.*.. . *.....\ *. ..  ....  #.. ..*.#... ..*....\....#\ .#*..... ...#.*\\.*.\*.\ .#
#.\ ......*.. .#.# *# #....**# ... ....#*.#....\...  .*.*. #.*.*# ...*. .*.* . #*.*..  .... *.#.*. #
## . .. .. #...##*.# . .***..  . .\ ... . .. *\#. ....* ... . . . .. . ..... ....*  .... .**# ..#..#
#..\#....... .*.*....#*#.#...  .#...  .*. .. .##.. ..#..* .*..#*.... #* #\#*..... . ..* #.\ \*... .#
#.. ....#..... .\*.  ..\...#.*.... .....*.#. #.....\..*..#\.*..... ..*\#. \ ....#.\..# .\   #.#...*#
#.. .#. #. ....#\.... .....  ..... .#...* *.*....*.#...\...*.*...  *....\.#...... ..  . #..........#
#..\..#. ....*....#...*...#.....* ..**.\.#... ##..  \** . .   *#.. .  \....#\#....\....#......#....#
#\  *#.. .* .* *##.*.#.... #... # *...*#.  ...##.#..\.#.#...* ##. \.*......*...   .\.*..\.*. .. .* #
#\.. \..#... ...* ..*\.. #... ................. . ....  *.*#.. .#..*#* .\.\*.. .. . *....\..*...#. #
#. *...*...\.....* *..... ##\.... ..##*..... #*.**.*..**.*.\..*...*.  .. .#..... .#..... .*.. *.. .#
#. #.#.*...#..   ... *.#. ..*.*\ .*.. .*.*.*..#*.*. .\#......\#..  ... .\. ..*. .*.*..#..*...#*. \ #
#. *.*..#. .\...*\#..#..##...**\.#..\. ..#.*.. .\.....*#*  .# ....*......  .....\# #......\. ......#
#* .. *...\.# *..... .\.*#......*  . * ...#*.....  ..... .. ##  ..*.\#\.   \.. . ....\#\. .. .*.*..#
#.... *....... #. ...*#..* ... . .  *#.#\*.....#  *....##.#**.*. . # ..... .  * ..#\ .......# ..*..#
#..\... .......\...#...\*.*.\ ..*  \.*...#...\. . .....*... ###. #. ..  ..*#.   ... ..## ..#...  ..#
# ##..*.. * ... .#.\....\....*..# *##*.*. ..# *\.. ... .## \# . .\*. #....*\.  #.\#. ...\ ..... #.##
#.. ... ... \*..# ..*..... .... .*.\*.* *.\ #*\...** . ..# ... .#*....**.**.. ........ #**##...... #
#.*.#.....  .  ..#..\** .. \......#......#.#.....*...# .*...... .#. .   . .*\# * *.\.*.*. \#. ....\#
#\.** ....# .#..*##... ..*.......\.. ...\.#. *.... \.\ . *..*.  ....#.#.**.....* .... . .\. .. ... #
#. ....*.*.  .*  .....#.. .\.#.#. ... ..    ..\##..# ......##......\... *.*.. ... .. *#.\...#*.#..##
##...##..\..*. * *.*..\ #.\*....*#...#...*. . ..*...#\.. # .\.... .\ .\#...#...* #.*. . .. **.\#.*##
#.\\.  ....**.. .* . . ##. .. ....*# **. . .  \#....#.* # *  .# ..* *\ ..*. .. .  ........\ .  ..  #
#.. .#  .. .##.. ....  . .. *...#...*.. .* ***.\ .  ..\#........ *.\. . # *.....\#... .\#...... ##*#
#*\.*.# #..# #...*  *. .. .... .... .#......  .\#*.. ..*#*\.* . ## .. ... * *..*.*. *#.  .*\.**..#.#
#. .*.\*. \#. .  ..*.. .\**.#   ..##*.. ... .#... ..#.*# ...*....\.. .#..... *..  #.*#.\  #...   ..#
##... .. #  *.#. \.#.#. \...... ...#.#......  . .... .   .. *....  ..... *. *.*.\...\#..#... .* ...#
# .**.  .#.... .* #..\ .. ...* #. ..\.....\..\ ...#...#\#.\ .\...*..... \... .#...#*. \. .*..#.....#
#.... ... ....**...* ...#.. .....#  ... ........#* ..... #.\... . .. ...#\ #.....* .*# . .\...#....#
# ...#  .... .. ....*\#\..........* ........ ..  #.....#. ..*\\..#.....# ...#... *\  #.. ..\....  .#
##*.....* . ...\*..#..*#..* ... *..*. **.##. .* .. ##.*..*..*####... .#. #\ #.#.. ***.\......*.... #
# .....*...\ .. .......\.. . .*.#.... .*.  ..#..*  ..\.  . .* .## .\... .. *.   ..#.*...#*. ..#....#
#. ..  .# #..*\   ...#... .#....*\* #.. .#. ..* .# .\# ...\\#.... .#*\.# **.. **..*.... .\....#.. .#
###\ .....#.*.* .#..#.* ..## *.*.\*..*. .\....*  .*.. . ..#.. .  .* . .* #\.........#...*.#*..#\...#
#..#\..*..\ .# *... .**.##. #\ \...#...*##.. *...#.**... .... .\ .###   . .  .... ...#\.  . ...... #
#.. .. . .  ....#. ..*..#..#.*.. .#......\.....\.....*\..  .. .#. .. .\......  *.  #....#.. ..*.. .#
# ... . .*.*#* \..# \.. *....*\.. ..\.#..* ....#.#. .#...  *\.  #.#\.*. # *\.. *...\..  \.....\  \.#
#..#... #. .. . ..... .*# .* .. ... #.. #  ..\   .... ...#*#.\#..*#..........   .. #...## ...... .##
#..*.**. . \ # .... #. *    .# #  .. ....##\.#. \. ...*.*... . \..**#.#..*.  . *.*..#.# *. .#.#.*..#
#.. .*. *.. * . #. #.... .\#. . .. *.# \.... ...#....#...#*.. .   ..#. .\*.* .... \...#*..#.**.. ..#
#* .. \.\... *. ...  ..  . ...... ..  . ...... .. \..**.*. ##..***#..   ........... .\##. *   #.  ##
L.*##\. *..***.*..*..#\.....\.*... ...  .. ..#*#* *..#.*..*. *..* .. .. #... ...#.# .\.... .....\. #
#\ .....*.\ . .. ..... ..#*#.. ...#. \.  ....#.... ...\ .. \  .**.# .#* .. .... ... *.....\..# ..#\#
#.. .*\ .#...#..*..*.*.   ##..#......... #\.... *\\.* #.  # .#.\. .\.#. .*......#...... ...\.#*# #.#
##........ . ..#. ..*. ## #... .. \#\. .#....\. ....#..... ...**.....\#\.*. .  .  #. ... . .#\..\..#
#.*..#*#\.*. ....*#. .........#.. *.##*.... . ...*. \ .*.. .* *.  ......#*## .*..#*. #..#.*.* * .#.#
#.#*.*. . *.. * .. ....*  ..*...##. .\#  *..*..*  .\.# ..#. ....  ...*.# .. * ......**.. .. . *..\.#
#\. . ....#.**... .#.... ............. *....*.#..\.  ....# . ..\. ....... .  *..#.*..*...  ..\...#.#
#...  .*.. . .#\.\ ..\\..\.. *#..... ....*.\. ..#......    ##....*...#*..... \...#\. ....# .* ...#*#
#* . ..\# . \*..* *..*.. #.\..\......  *..*..**..#...* \ ..\  ..   . #.*....  *.. ...\ \..###\ *.*.#
# #.. .*.\.\* ....##.. .  ..\..*. \*.*..*  .... * .. .\# ..... ...*..\.. .#.... ..*. .....\#. . ...#
#\.# #*\. ..# ##. .*\... .#\..  ... .. ...... ..*......**.. . .# #*#*...... ..*#.... #..*. *....\*.#
#...* . . .#\....#*#. #. ... ....#..# . ..#.  ..*...... ...#....#.#.#... ..* ..\.#.##... . . \  ...#
#.* .*** .... .. ..... ...**.  #......*.\..\.*# . . .#.*.##... ..* #....*.... .  \.\.. #.  .\ .....#
#......*...\.\ .*  #*. *..*. . ...... ......#..#\..*#. .*.......*  \.  ... ..*......#........*..*..#
#....*# .. .*#  .... ...  #.. .#*....\... ##...#.\.#....*......*.#.\.... ..*  ...  .*.\#.....\.\\..#
#.   ..**... ..\..* ....... *.... \#....\... .  ....# .....*.. ..\*. \.   #*..# .\.... *..  *. *...#
#. ... .. .#....*.............*# *#..\ .. #  ........# ...*....\. \..* ....##. **... .\ .*.# .*#\**#
#..\...\....  ..\.**. ...\ .....#.*. .#* ..**#. .\*.*\*.#..#*.. #.*....##. *. .\..... .#...*..*\...#
#. **..#\.. #. #...\.  .*..#....* ......\#. .#. #.\#...#.#. .....  . *..#.........* *.. #*.#.. . ..#
#..\*#......\.#**.. .....\\ ..*.\...#.....\.*#.*.. * ......\ .\ .. * #... ..#..\. *..*# ...*#...**.#
#...###* .. .\...... .....\...*.....  ...*  . ..#.\*..# #.*.\..**....#...... ..#....#... .*#.\.. . #
#. . #..\.#. ...*...\.. . .. ....#. #. ....*..\ #. ..\. .##...  .\. .  *\.......\*#. ... #  *#. ...#
#. ... .*....*.  ...* . #. \.... .. .* * .. . \.\.... .#  *....# ......\*..#..\#.*.....  #..... .. #
#..#..# *.\..* # #....##\*#. .... ..*.* ... #......*  ...* .. ..... .# ..  . .. ... .  ... ...\ ...#
#.\ . .. ... **.. # \......*.... .*### ##*.\..* .\ .*...# * ......##....* .\ . . .....*.  ..#*.#.*##
#..... #....#.*###.*.......  .*.  .*.* . .\*..*.. .*..*..  ...*...  .*..... *..... *.. ...*....#...#
# *. . ......*#. ...... .\*#.. * ..*. .* .# ..# ..**  *.....  .. ...# \  ..   . ..# . ....#. . ..\ #
#.... .*#.#   ****.....\.....\ . ..## .\. ....\.....*.#.#*. .\. ...##.. \.*  *. ..  .\..\  *.#.#\*.#
#......*... #*. . ..#. * . **##\ *.....\.... \....#** ... . .....*   *.. #.#*...# *.# *..#..*.*#.\.#
#.. ## . . .... . ....... *. * .#....#.# .* ....*.. .  ##.*.....#......#.....  ...*..*.#*. ........#
#....*....#...* ....#.**  #*...*.\...#  . #.. .*..........*.\  *. ..... .*.........\...*.. .\ .. ..#
#.#\.**#.*  \...\**#.. #.....*.###. #*..#. . *. .*.\.. ....#.\*....*. ... ..... . .*    # *..##..*.#
#\##...\#......* ... .. # . . .*# .. ...#....   ..*.# .*... ..* . #. #.. .\ .*#.*..##.. . .. *..*..#
# .....\*..*.....*.\..*# .. ..* .. *. #.. #  .#..... ....#*..... .......... \..#.... ....*#...##...#
##. \  . ...\  . *  ..... ..\.*#.*.  ... . *  ..#. ...##\*.\..\##.\#..#..** ..#.#...\......\..# . .#
#  .. .# ...* . . ...*.*   #  ..#.. \ ..**.\.#.*## ..* *.. #... ## \.\#....... ..#\..**.... . .*\ .#
# ..*.*..*.  *.  ..*... ..*. ..\# ....* # ..  #...\* #...#.. #.*.....*# ...#.##..*\.. #. .  *.*....#
#...#. \. \. ......*........#..# * .\..  ..\** ..  ..#**...*........ ....*....  ..  ..\.#.*\..*..*##
#. .  ........* #.** # . # #.#...   \.*..  . .... ..*.\ #*. ... *## . .*... .*#*...R ..#. ..* .#\.*#
# .\.#.*  . .##... .*\. #. ..*.......\...#...*# .* . . .*\..*# ..#...\. .. . .*. .*.#..... . *. \..#
#..#.... .  # * ..*....*.#...\. ..#* .*# * #..#.*. .\.#*### #  .. *... .#..#*.#...* ..*..*\..\* .  #
#.*..#*.#...#.. .... ...#.# .*. ..*.\ #* .\.. . *# .#*\#.. ... ...  *. . ..#..#. #*.*. #.**\ *.  ..#
#*. ...  .. . *.   #.\.. ....*. ... ..#**  ..**.*. . ..\.\...*#*... ...\..#.*#.#. ..# #  ..* # #...#
#  .*.\..\.##. #. ....*  *.......* .  .#   .#.#....   .. # .#.......#. ...\..\.\..**.....*.#..\\ ..#
#...#.#..##  ... ...*  . \... #.#. ......#.. .*.#\.. .... # *.#............* .#\..... ... \..\\....#
#\ .   ...**..#.. . \.*#* *. .##  . . .# .#..\.*.# \ \##..\....**....#.#.##*.\.\...**  ....#. . . ##
####################################################################################################