####################################################################################################
#.*. *....* #.  .\..#....\...*.....    ..*. . *..*# ... . \\.##... ....  ..\ ..\#..**. *.*..... *#.#
#.. *.. *.  ...***.*   ...... . .... ... #.. .. ...\.... \* *..#.*.**..\ .##\.# . \* #.... \.... ..#
#*. *.* ..*. ..... ..  .#.\#...... .##....*#\ . .....  .. ...   ..* ....#  .*. #***.  . ...\... *.##
#    ....*.....#*.# ..#... *... ...  *..#. ...* . \...*.  ..\. ....*.#.. .#.. .##* ...# .. *.   # .#
#...*..*  .... *..  ..\ . *.. ..#*.##.. .\...    .* ..#.**#..\\. ..*.....*.#.. ..*\# .*..##. \*.*# #
#..# .. *.#..**..  #.. ..#.....*..........*. .#..#.\.......# ..  .#.  *. ***.*#. .#.\...... .  *. .#
#... ............ ...##..  .\   .. *..\#.#* #   #..*. .*...... .....*  ...#.##. ....#.*.\......#.\*#
# \.#..*...\*.*..#....#.*  ..\  ..*  .  *#..   ... .. .\.  *. ...*... #...*.#..\.. ..#***...\.*..*.#
#. ......... .. ..*.. .# \. .. .. \....#..#*.. ...*..  \... #*....#. .** . ....#. #..#*..\\. ...#..#
#..#  . .. #.# ... #.*....#.#...* .....*..  .  ...\# .....*.\ ......*# ..\.. . .\.* ....... .#. *..#
#.... ..#\..\..\\ . #..*#\. #. \#.# # .#....*\..*......\.  .. .#... ... ..  . .. ..*.. #.*.###. ...#
#  #\. ...#.......*.#... \.. ....#..*...  .. * \ #. *#.... .#.##..\...\..\#*#.. *..* ..\ . *....\..#
#....*..#... . **..\..*.. * ... ..  \....  ...\ . ...* ... .....*  . . .** \.\.  . #.. .*  ...* .. #
#.... .. # .....**.#..#.....*... . \...... ... *. ..\#*.** .*  .#. .#. . .  .# .#*..\. .#* .. #...*#
# .... *..#.\.... .#...*. ..*..  .... . # ....#.  \#.  ..#.. ....\.#.* \#...*.\.. ..#...\\.#*..#. \#
#..# . . ..\ ....#..\#.....#.##. #..*.....\...*...*.... .. .\. #.. * *#................\ *. . *.# .#
# .*.#....*..... . .#....# .....# ..#*\..\ ..*...  ..#*.#. .*.*.*..\.  ...  * *.... .. \ .. ....*..#
#.   # ... .........#. *#. ...*... .....  ....*.#.....\. ##  . ..*... .#.....#..*.. ...\ .*.*. . # #
#.#.....#..\ ..*.#. . *\..   .*.. .** ..#. ...... ...#...  ...*.#. .\ .*. .* .**...##... ....... ..#
#.#. .*..# .# . #*.. ..  *. *.....\.*\..*.#.. . ..*.* *. ....\*.#\..**.# #.....*.. ..#.... .\*.. \ #
#.  .\....... . .*#......... *... ..# .## .\...#..#.........   .#.#  #.\....   ...\.....\\.*...... #
# ..*....*.. #.#. .....*..#. . \. ......\ **.* ....  ... . *.\*#... *# *.#....\.. ...#...**... .. .#
# .... ..* ....  ............*.... .. .#. .. . *... .. *. .. .#.*..#.\..**.......#.*..#...*......*.#
#...\*...#  . ...#.*.\..... . #..\... . ...*.. ..#..*.#.... *... .###*..#...  .. .. ..*.... .. ...##
#.......#..#..##..... *#*..*. ..*. *.. *. .#*.... .\#.  * ... .\... ....# #....  ...... *  .*..#...#
#   *.#\ ......\..*.. .*...*..* .#. #.#*..#..#\. ..*..........*........ #..* ..#....#. . #*. *.  ..#
# . ........ # ..  #.. * ....\.. ##*......*#.#...#*.  .. ....#..*. .. . #... .*. #...... #.\..*#*..#
#..*.*.\. #..#..\..**... **.....  ......\\\#.**... ... . .......  .. ....*...*.. ....# .#.#.....#* #
#...*#.\..#. . .   .   ... .*..*.*..*........... .......# . ....  ..#. .*\.*.*.##. .......\  ...*..#
## #*. ...\ ..#*.#.#*.  # .\....#. .* ... .*#... **.  .*...#. .... . ... ...# .\.  .. \ ...\.\..#..#
##\*\#... ...*# .*.\ ...#\..\# .*. *#..#.... ..#. ...#.#. \#.....# #*...#...#.   ....#**##..*#.. ..#
#\ .\ .....\#...... ..\..... . #...*... .. .*..*... #.*\#.*..\....* .##.## ......*.#.. . \ ..#*#.. #
#.. \.#.#...*. . .#. .*.. .. .#....##. ....**\.#.#.* .. ...#*..... ... #*...**......... ... ..**.. #
# ..##.*.......#.  .. * \ \ # ... **##.*#....... \...#... #  . *  . *..*..##  ....# ...* . . #  .*.#
##.....#.\ ...##. ... .# .\*. ..*. \.    .... . \..\..#.  #.# .#...\ .*.#..*.#.....*.# #.*.\ ... . #
#......# .**.....* ..  #.. .*...* ..* .\  *# ........ . * .*.*.... .   .*......# ...#.... *..*.*...#
#*....#... .\..\....#.. ....* ...... \.  .. ..# .*#. .\. .\#...# ..\ ..#.... * . . ....... .....*..#
#.\**.#... *.*.......#*... **.#. ... \.. ....#. . # .#.. .. .... #. #.*........ #..... \ ...\..#*.*#
#.\ .#  ........#.. #* . ..# .*. .#* # *  ...  .*.#. *....*..*   .. ....*....#. \. .  . *...#.....##
#  ....... ##  ..*.*.\#. .\. . *...*..*.#.. .....*.* . ..#.*# ...........#  #..  ..\#... ..\ .\.*. #
L...    \.* ...*. ......*..  . ..# #....  \.*.....*.. . #... \#.. .#...#..*. ....*...\. .###. . ...#
#....#..   .\........... .*. . *. ....\ *. ... ..*#.#. # #** ..*.  .....#.*...#\.. ..#.*..*.*# \ \.#
#.\...*#..    \.. \... ..###*.....*.\  .. . ..\.....#...  \..  . ... .. #. ...\.. . .....\ *#.#...\#
#. * \...*#..##  *\.............. .. ...#...*.......*...*. .. .#.. ...\..    ..  .....#..... .*... #
#.. ...\*. ....##.. ....* #..*\... . .  ..###...# .#. . #\  **....*..*.\...#\ ..........#*.#.. * ..#
#.*.#. ... . .. .* .#. *\...#.#.#..... ...  .. #\.*.# .*.*\. .. . .. ..*. .#. ..*..*.....*  .*.....#
#..\....*... ..... ..#.#.........#. .\..   ..**. ..*.....#*.*\. . .# #..* # ...\....*.*.  . ..  .\ #
#. #...##.... \.  ##.*.  ..#*.. #\.. .#*.*.*.. .#. ..\.#.* \.. .... * * ..*.*...\*..#. .*.. ....#*.#
# . *.  \...* .*.#*. ......\*..*. .  ... .#.  .. .*\ . #..  \.## . .\...\..\#. .. *\.*.*. .. #.# *.#
#. ....#.. ..  #..\\..* .*.......# ..#.   ..* \\..... . ....#..*\  ...\. .\ ..#..... *..... .....\##
#...*#. ....... ..***.#...** ..# .*\ ..... * *...*..# **.#  ##...** . .#.   #....  #*.. . ..\#.#.#\#
#*... #.*..\ . .. .. .*#.  . . . *.*. . ... .#  .... *  .......* ..#\..... .#. #.#.   *... .#\*.. \#
#\..\#   * .*#.# ..#.*...\..* *\*. .#*.#....#.....**.*..  #*.#*.*...... ##.. *.# .*. .# . *. *#.*..#
#. #.. .#. *.   ........#. .*.... .....# ..#....\.\.... . .. . \.....* .#... ...# ..*.. ......\ . .#
##*\ .\.  ...##.#..*# .\*..*\... **............## ..\  ..##...#. ....... . ..\.  *.#.#...  .#..\ ..#
#...   . . ... . .#.... .#.. . ..*...... .... *.#* ... .*.. . #.#.. ... .  . .# \..\*. \.\ .*......#
##..... ..\.\..  ##* * *#\ ..*# ..... *#.#. .*#..... ..#*.  .\.**.. .  .\.*. #*#. . \.# .* ....* ..#
# ..*... ... . *.... ...#.*   ...  ... .#.\. #. .. .##..\\ *...... . .*# \.*.... ... ..*.... .  .. #
#. ..#. .##* . \ ...\\##.#....#.\..\* . .#.... . .........#\\..*** \.#\*#\.**.*.\.# ..\*. .... *.#.#
#  .. .\... ......\ * *..**.... .#.\....*#** ....\... ... . *...#.\.\. .\....\..#.... *....# #.* .*#
#...#.\...\..#.\  ..*\##.#.  .........*#..*..\....#...*#..... .#...... \......# ....... #.##*  ..\##
#.. .*...* ...  ... ..... .*..\.... .* # ...*. .*  #..\....#.# ..*.\..*.\..*#*.. .#...\.*#.#.  . ..#
#.  .....*.........* ##...\.*.. .... *...*...#. .  . *. ... *..# *#.*#.. #...\..*.#..   \...*.\  ..#
#. .......# ..\.*..#..   ....#.\.\ # ...... * ..  *..    #.#.*.#........\*... *\. . #.. .#......* ##
#  #.     #\ .. . .*....*.##........** #....*.*..##.\. ..#...#.#* .........*...*\..*.... ... . .# .#
#*# . .#..\.... . .  . *......\..*..**.. * #\......\.. ... .**..*. ..    ..# . ..#.**... .\. *.*#.##
#.  . ...*. ..#.*.#... .  ...#..* #..#..**.# . ..\. *#...*..* .\* .... ..... *## ..   *.....   ... #
#.#.*.#**.. ... .* #.....*...\.  ..   ..*...\ .... # *.*. .  ...#.*.... * .#*#...  ............#...#
#.#......\\  . ..#*#...\. #.   ...........* #. *.\..*\...\.*.. ....*. \.....#...  .#.#..#.. ... ...#
#*....#... .#...#. ..*\......  *#\..\..\.*.#. #... ..#..*.. ... # .. . ....#*# ..\*.*. ....#.*.  # #
# ... .. \.# \    #..# #*... \....   .  .....*....* ..**......R.\...#....*#... . ..*.. .*..... . #.#
#...  ..# .#..*..  #.## .... . \....*.........#.. ... ...*#. .. .. ... ..\... .. .#  . .....#  .  *#
#\.#.* #. . ..\.. *... ** ...* .\.... .....*..#\.#.\. .#*. .. # ..#...#. *..\.# .. ..*.# ..*....* *#
#.. . ....\ ..*.\ . #. ...* .*** .\.##.#. *......*.  *.....**..\*...#..*     . #....#..***.. ....###
#.\......*\*. .. **...* #*.#.. . * .\.  .... ........*.... *.   #... . .#*# *..*. *...\ . #    ..*.#
#....*#. #.#..\#. ..*.# .#*........ *....#.*. . ..**..    .*... .*.  .* .#*...#*...\* .##. . #.#\.\#
# ... ...**.#.. \...... ..\#\#.*\..#..*.#*.*..#......#.\.*## \ .* #....*. . *.....#..** # ..* . ...#
#*#*.##\  ..* ....# \.. #. . #*....... .#.*.# #.\.#.*#.......  .. *.*.***.. **....# ... *. **..... #
#.. # ..*.. .*. #* . . .##..** .\ .. .....  ..*.#  .*   . #.#.....\. *.. ..*. ..... ..\*.#. .#...\.#
#\...\. .#... * *..#..*..*.*.. .. ..\ .. .#*#... \*..##  . \\....\# .. .. ....** .#.\##  .. . #... #
#....#..\.# . .. ...... ..*# #..*..*..*.*\..\.... ..    . .  . ..*..#.....*...  ..* .#..\....*#..#.#
#..# **\.   .....*.  # #    ...# . *.*#.*..\.*.\\ .. . * .###......\... ... ... .\.....*.... ..*. .#
#.....# * *.... ..... .  ..  .*.. .........*. ....*..# ##...*#.*\*......  ..#..*...  ...# ...*..*..#
#.. ...#.. .#....#. ......#\..*.. ....#. .**. .#..** ... .  ..#\. ... ..#\.\ ....*# .\... ....* .*##
#.... *...\\ \ **..*. ...*.. .*\***.#....\\  *\..*....#..*.\.... *   .#..  .. ..# ..  \..... ...\ .#
#.*.....\.... ......#.*#.. #. . .*  ..  *.........#..*.\. *.\*.\*..#......#..... \.\...  .*  ..*...#
#....##.....# . ...##.. .. *.*   .#. .#..#.\#. #..#..#.. *# .......... ... ...  .#..#..  \ *.  * .\#
## .....#** . #..\#..... ..  .#.##..\..\.#.# ...**.\#.*.. . . . \*.. . ..*.##*... . . # .#*... .. .#
#. . ..\..... \. ...#..... .. #*.......*. .. . #*....\#\*...**#. .#.... #..  *.#.# ##.*.. . .#.....#
##*# ..*..** #. ## .#...*...*. .*..\. .......*.. ##.# #\..*.*..* ..#\\...... . .##....... .* .*#...#
#..... ... .* .\* .#\. .*...\*.\..\ . .. .\. *## ..# ......  .\..*...\ ....\.  .. . ....*..# .....##
#.# .\.....*. ..\*. .... .*...... .##.... ... ..*. . .*.# \ .*...# ..... ##*.... .. .#.... .  ... *#
#.......... # .. .\. #.... ...\....#.....*... . \.....#* ...*..#.*.*. #*...**... #* ........#..\.*.#
##. #. .... .....#.\.....*.  ....\ .*  ....*...** . *.  #.#.. .#*..\ .#.*.*....*. . .. ..*......*..#
#.. *..#. ..* . ....#.  #.# ....#. ...* \. .  ....*.*...  ...# . #.. . \.. ..**..... *.#.*.. . ...##
#....  *....*#.... ##.\.  .. ...#. .. ..\.*.* ....*... ##.**...*\#*.. # . ..#   ...\*.\ #... ......#
# . . ..* ..#\ ..\....#  *\ .. * .###  .\.\.*..  ....*... #*..... .*....   .#.... ....#  *..... #..#
#...#*#.. . \..# ....*...... .... .#*.#.\#....#*.* #  .\..\#.*\.##\#..... **.... ...*.*.#.*.. ..  ##
####################################################################################################