####################################################################################################
#  .......*..... .*..\.*...\...#... .. .#*..*   .... ..* . . \.... * ...  ..# .\\ . ...\.*.# \.... #
#*. .. .  *.*.... .*.\ ...#..#.. ..#....*... . .* ..* .. **#..* . \..*\.#.  . . \... . .... #.  ...#
##.. *.  . ...#.*. *   . .#..........  # . .*.#.  ... . ... .. ........ *#.#.*....#..\.. . ..  ....#
#.. \## .#*.... ..... .#.. ....\...\*..\ . . ..  .\...#...   ..*. ... . ... *..*. \*..... .#* ..#*.#
#  ..*.#..#.. ..  ...  .#.. .#..  .** *\.#. .. .# *#*\ .....\. .#*.....  ....\ ... ...* ....... ...#
# ...#...  \.#.. *...... ..#..... *.#.#*..*.  #..... ... ....#* .#..#.... ** #*\.#......* .*. ..# .#
#.* *#..***... ..#. #*.##...#.. *. .  . ..#.#...#\ .*... ..\.\..... #.... .. #..  .. . #..\\. *. .*#
#.. .#.#.*.....#....*. #...##.\...# #. .# .#..##. .. ....\.*. ..**\ \.* #. .*.\. . \ ......... *#*.#
#*.. .*.\.\ ..#.....# .. ..\\.....**... ..... ........#.*. . .....\....*... .*#\...  *.. ... .#*.  #
#..#.*....*#.. *.. .... #\.. ...... .\#.  *** .....\..#...#..#.......**   . * ....\. .#..   #.. .  #
#..\. . *#. #*..... ..# .... .... . ...... ..* . *....#..\... ..\..#  .*..#. ...*# ...\*...# .**.. #
# ....\.#.#\. ....\#.#.  #.  \.  .#* * *......\..##.\. .*..*...#.. .\..#. . . ...*...*.  ....*..* .#
#. *. ... #..*  #.\#.*  # ........\.##...*.. .##. ...**.. * ..  #..*# .*.\ \  .\. \.#.##....* .  ..#
#. .#*.......## ...##. ..... . *.....\.....*\. *.#\**..\#. . .* ..#.* *.# ##..\*. .....*.# .*..*.. #
##\.\......# ..*.**.. ......  ... ..\......*\      .# \.* ... .   #. #.. *...#\..**...#..#  ...#  \#
# .#.. ..*#  .. ....\ ## . \ .....***.. .#.........#. *\ # ...* .#. \#\  #  #. .  .*..##.. . ......#
#*.... #. .\ . **......* .*.#*.. #..#.. *.#\ .. ..   #.....#.#..   ..*.. . ..#. #*...##...\..* . ..#
# *# # ..... #..*... .#  .#.*#.. .# .\..  . . ..\..\  #*..*.........*...\...\. .......##*\..*..*...#
#*##\........\#.\.\..  .\\\....  ..*.#*\...*.. . .....\....#.*.\.. ..##........*...#\ .  .....# .*.#
#.#....\ .* ......... . * \*#.. * ....#. .*......*   .. ... .#\ .**\*.....* ....*. \*...#.. .. ....#
#.# **.....*. .*.... \..  *.*#.  ..*..#.....\.. .*.#\... . * .*# .#.. ..**..#..#.....\# \.  .....#.#
#*... *\.#. \.\...\..\#......  ....    ..##.. .\  ..# * . . .#. \#..... .* ..#.   ... *.....*.*....#
# .\ #. ....  . . ##..*  *.  . . . .  * ..*\...*.\..\\\..#*#\.*.. .. \..#.  \.#.   ........##.  .#.#
# . .. . ....**..*.# ... .  ** *..........# .* .#...#  .....  \*.*.  . .*.#..*..*.# ... #. ... #.#*#
#.#.*##...*.#.#..*.. .... .\...* ..\..*#.. \#. ....*..  ...#  .**\......#...  .. . \*#*..*.........#
#. .  ....*.*......# #.*.  ..* ## #..#.#..... ....\.. #\...... .*....  \*. ...  *...\.....##..# ...#
#. . .. .  #* ....*#  \... ... .*  ... .. .# ....*#..#. \..*..#. . .#.\. .#*.... ....\#.*.. .   *.\#
#\. ....#.......#..*.. ..#*. ...*.\ ....#.# .....#*........#.*.\*  ...###. ... ...*..... ..\ .#....#
#\...* ...  .*\..*\.\. .......*. ... .#. #.*#. #\ .  ...#..# . *# .... *... . ....\# *##.#.  .#*. ##
#.. . ..\.*#..... .....  *.... .#* .* ..*\ .*\. ... . .\. ...\.*  .. ...  \. ....#.\.*......#*....*#
##.. \#.*##.\ ..*#.\  . *.. ..    **..*##.. ...    .*...... ..* \#....... ..* .\.** .*..\...#**#.# #
#...*. #.... #.. . .*#.... \  *. **..#.* .***  *..\#. .. \#***#.*.....*.*. . \#\..*...##\.... . *. #
#. . ...#*\.###*.... . ..*..#.. *....* *.  .*\  #... .# \ #..#.....*..  # . *..* #.  .#.... *.. * .#
#..*..\.*.*... *#.*..*........... ...  #*.#*. .##... .\\. .... #..\...*.......  .....\.#*..#.... .*#
#. ..*.........#.*. *. # ..** ##\ #. .##\#\. \\.# .*..\....* .*..... ... \ ...\*..#.. .. ...* .  ..#
#.\..*# ....#.\...*.#*  #\.....*...   ....* . ....#.#.#. . . . # . ..#....#. .*. . .. \.# * ...*. .#
##\*#\ ..*.. .**.#.. #...*.*.  #\....   ...*#  ....#.#..#.....\\ ...# ..\ *..   .#.. ...   #. .# ..#
#  .#\*....*.. . ..... *..#.#\  *# .. . .........*.#.* *###.##. ..*.  . *..#...#. #\. \* .. .*. \..#
#. *\ ....*\#\ .*#.. ..#... #. .......##.....* . .. ..#...\*... ...*.#  ... **#... .. .* . ..#.*.#.#
# ... .. ..#.#. ..*. \*..*.##...*#. ...... *\.#......# ..... ..#.... ..*#..#.... .*.  .  #*.  .....#
#.. .\.# #. \*.. . ..# #..\*#\....#.. . .. .*.\..#.. .#.. #*.*.. ......*.\...**..# \\.#*..*.* ..*#.#
# ...*  ....\\..\..... .. .#..#.# # .*.#. *\#\.#\\...#......#*#. ..\..... .....\.  .....#\.\.  #.. #
#......*.#.\\ *...#...........* ..# ....#* ..#..#.. .# .\*.........#.#\*.#..... # .*. #.*...  . ...#
# .#..  .\# .*..*.. ...* \.#.#\ ........ .\. ..... ..  \  .........\.. . .#..*.... .....*....\\#  .#
#. ....*. .*......#.* .  ...*...... ........... .\......... \..#\.. * ..  .....#*.*.. ...*. .... .\#
#..*. ...\#*..#... .......#......*....##. .*.*. #....#.*... ......*... *..... ...*. #. *. ..\. *  .#
#*#. ..*..#.# . *# \#\...* ..* .#. . ...\.\*.#.#. ###. ..\.##. .  . . .\*..* \#..*  ....#.#. ..#\.##
#...*.\..\  ..#.#\.. .* \.. \ .*#.. # ..\...R....... *.*  *... * .. *.*.. .#..... .. .....##.# #**.#
#\##. . .....#..**...* ..# ....#*  #.\.... ..\...* * \*..##.*.....# ... ....\.*...# . #*....*#..*\\#
##..\*  # \# ...*.. . . \..*. .. .# . .**.## ...# #.*\#.....*\.. *\ . . ....\...##.###....***\ .. .#
##.\.#....*......##.*...# ... .* .**.# ................ \ #.*.........*  .....  . ..**# . ...\... .#
#. ....*.. .*. .. #..... .  *....*.. *#...... .....#.*....  *.. .. .*.*.... \.#...... .#..... .#*.*#
##..# .. ...# \ *#*..*..*.. .*#.\*\. . .. ... .. .. ...\#.  ..#..\# *... . . . .##\ .*\.*...#. *.. #
#.*.  ..\..\....\. ...... . .....*  ..#...   .. . . .#. .\.* ..**\.. .* .* .*........ #*  \.* ...  #
#.. *.....#.\ .* *. .#.....#.*.. ..\....#*.** ..#. \.#..*... ..*..#*\*\..*. ..#. ... ..*..   .\..*##
#. ..#.*...*#\..#\....##.*...*...# . ......*..#.#. ..   ....*... \...  #.... .. .... #...\... *.## #
#\..*##..#.\.*. .*....#\#.*** ..##.. # ##  .* .  ..* ..#.  ...**. . ......#...\.#  \.  ..#.# .#..* #
# .# ..\.\*..#. #.#......................#.# ....#...* #. *.  ... ...\... . * . . .. *.*.#\..#.*.\.#
###.\.* #.*.*...*. #..*\.*   ....\#.*.#**...#...\*.\..*. ...# * .. . #. #   ...*#. .....   #..\. . #
#..  .. \.. ....  ...* \.. # ...#...#*. .#.*   .*. ..*..#\.*   #.#. .\.... *.#  .\. #..##..#...#...#
#* .#.. *..**. *..#.. ..*#.**..#.#.. ..  **#.\..##..\.*\.*. .#.*####.. .. \\*.*..... \* .\.  ....#.#
#.... .#* #....\.. ..#  #. ......#\. .#.....*.. .#**... .  .*.#.#...\*....*\*.#*.*...... #\\**. *..#
#..#**#  .\.*\*.....*..*....* .#..#. .# *.. .\#  #\.. #  .*. *.* . . ...#.. .. .#....# . ..#..#\# \#
# *........ #.#. *....*#* .#.  .... ..**....#..##*\...\. ..*..#*.. .. #* #...*....  #.  .##....#...#
# *....**.......  \.....##.*.. \.....# . #..##... ##. . . #. # ....#*. #*. .#. \....\ #.. *. ..*...#
#.#...#*. #* . ..\...  . #.*...#.* \..# ..... *. .#  ..#....#.\#.\..  ...#. .*\ . # *......##.. .. #
#.. ....  #..*..*.*.......*.. #...  .. .# *. #. ..\. .#... . . ....  ...##.*\   .*....#.......... .#
#.\.. ... ##. . #... ...*.... *.. .  .\*  . ....#....*.\.. ...# .*.\# ...#..  \...........  ..#..  #
#..*.   . *... .#   *.#.#\*\.\.#...*.... ........#.... ...*  #.#*....#.#....# ...#*..#.  ...*  ..*.#
#  #........#...#.... ...*# .\#..** . *#........ .  #..\..  ....# .....*..#*. ...#*. ..\....*......#
#\.. .....*. .**.*.*.........# .#  \.. ......#\.. ... #. ..\.\* ... .*#.# . *# ..#.*#*..  ##.*. . *#
## .*. .......#... ..*...\    .\.....* ...*\. .*. #.  #.*.##*  * . .\.   .#. .. .#..\. . ..  .    .#
#.. .*..* *.....**.* . #. *.....#* .#*..  .*... #..*.\....#. #...*#...#...\. ... ...# .... . *....\#
##..\.* .. .*. ......*. .   #..# * .# ...* . ..\.#\..*.#.. . .*....#..... \... .....*.....#. # .. .#
#.* .#.  \ . . . .. *.*\..#.#\ .# ..*.#* . . .  ..#... .# . ..#. .*..\.#........#.... ....#...\....#
#..**#*. . .. . .* ..  ...# .. .*#.. ... .. .*....#..# .#.....#*   .....\.##... **. .. ..\.\ . .*. #
##...##.#...#  #..\  . ...***\..*...*\  .#...*.#.  ..  ..*..\.. .\ ..*.*..#\*...#.. ... ##*\..\* *.#
#...*..#*\..*...  *\..# .*..  .*.#. . ...* ..#. ...\.#..\ ....* ..............#\..*  * .*..  ..*..##
# #. \.#\...\#. .*..... ...\  .*. ...*.* *..* * # *.. .*... .* # ......#.## .#  .\*.   .. ..\ #.#  #
#..\..*  .. ...*#.*  .*..*.* ...... \.*.... . .#..## ..... .. ....... . # .....\ .... .... . #.. ..#
#..*.#.  .....*. ...... ... ...*.* * #... . .#......**.....#..*. #...\..  .*..\.***.# *. **#.#.#.. #
#..*..#. *.#.\....#*. \*..#. *...#* .*....* . ..#.  .#.. #... .. .*#.\ ..#. .   #. .\. . . *#...*.\#
#.*.\. #..#.  ..\.# ..#..\ . .....* ... ..*\..*..\...#..*. .\.#*....*\..# ...  .........*.#....#...#
#.. .. .#\... ...  .*. *.*... .\*... # #*. . # ..#* ... . .. . .\. .*....#....##..... *#.** . ...* #
#.... ..#..\..... ..* ..# ..\..**\.. ... #...\* ... .* #..#...# ..#*. .  # ... .#..\. ... ..\......#
#  .....#\#....\.. ...##.\...*..#.. . \\....*.....#  ..#.. #..*. .. . #.#..#..\.. ..#.. * *.. .....#
#\.#...... . ..  .\*.. . ... #.  ..*. .\.....##....#.#**.*.\  ......  ..... .#...... ... ...   ....#
# # .\.... ....##\.........#... ... .. ***.#*. *# *  * .# \\.*   ...*  \# . .*.#..#*....* ..#*.. #.#
#....  \*.. *..**....*.\ ....# #...*.  *..#\#.. . .....#....*. .... #\....#\ .. \... #.#.# *.  .#..#
#...*# .*. .*...\\ .  .. ..*#.....*#. #\....#. .. . ... ..*\.   .... .  #\*\.\ . ... ..#   #.*..#.*#
#...*. . \....## \ .  ..# ..*.#* .\ *..... .. *#.#.#. .  ...#..#..  .# #  ..*.*... . ...#*.\..*# ..#
# # *. ...*  #...\.* #*.#...#.#.... .*..#....\..#..#*..  .\....\. .* * #.\ .*\.  \. \...##\. ......#
#\*.*. .. ...\. .\.. \*..#* .#*. \. ..#.*. .**.. .  .#... *#..*.\.\.. .. *.\.....*...* .*.\.*# \..##
##...   .....##. #.. . *.*. *#.* . . ...\..  .... #  . . .  .#..*.\.   .## ... . . ..  *....   .*\ #
#\#.\.... .#...\.. ..*..#.....* *. #.\.##  .#..#\....#..*\*.#.#..**#\ ..**.  # *... .* .....\ .\...#
#..#.. .#*.....#..  .*\.. .#.# ...  #.#...*.... ...\#  ............ ..  ..... \ ... . #.. . .......#
#...***..* ...\.# ..... .\*...#. ...  ....#.#   .  .. #.\..\ . *#*.*  *.... ..\.... ..\  *...... #.#
#.. ..*.#.*\.... .. ....\ ..\...... .. * #. # **.\ #.. ..#.\. .#. .. .#.... .....# #.. *..#..*.....#
###################################################L################################################