##########################L#########################################################################
#. #....*..#... ..#....  ..* ......#...*.*#......#.*#. . **. .....*.. ....*. .... ...*##   #..*  \ #
#.....*##. .. ...#..## #* ## .*.*......\*..**... .....*.#..*.*. .  ... .*#..  * .*.. #.. .  . ..  .#
#. *. ... # *\. ... .*.*...*......*............ . .#  ..#.. ....*.*.  .... # . ..#... ...*.. *..#.*#
#...\ .  *##....\#..##.#...... \.. \..#*..#...   .\#.# **. # #\#... . .\ ...\  **# . .....  . ....*#
#   .. *......\.... ..\...#.\ ....\ *...... #*..... **.  ..#....  ...#  *\#. ..... *#..*.#**.*...* #
#....# \ .  ... .....* *..#. #\\ ..#... .......*\.\.......#.  .* .R..#*  *#\..  ...*#..#. #..* #..*#
# .#*.#.. ..... *..*.....#.*..#...... ....\   .. ....*#.*  .#.....#.*..#.. *..#.**..... . ...*.... #
#.*...#.*..\.....# . .   *..#  .. *..*.\...#.. ..\...#.** .# .\. .....*..  ##*#.  .... .  ....... .#
#...  ...*.* . *.. ..*. .\ ..\.*.#. .. .....*\.......\.  * . \\ #.*.** ..**. .#....##*.. ..# *.# #.#
##....*..... .\ . **...  .. *....... ..........###....\....# .  .... #...........  .....*..*.... ###
#\*.*..*.....#.. . .* ..#  ...#. . #...... \\.#. .... ...#.   .....  . .. *. #.*.*..*.\...#....\ .*#
#.. .#*  . *\.*...  ..#  \..#........ ... ...#. . # .. ..*#....#.... .....*...*.\.  ..#*. .#. . #  #
#..*. # .\.*#..*.......#.. .  . ....   ... .#  . .. #\... *. * ........#*#*. ..*\\\. . #......\.\..#
#* . .   ..**#*.\..  .*\..*.*   ..# . *.. . .#.\.. . #  .  \ #  ... ..... #..#.  ....*..*\... # ...#
#*......* ...\.** *. .* #..*.#.. * .# ...*#... . ...  ..*. ...*.  .....*... .. .. ..#.....*.*....*.#
#.. .*. .# .....*. . .\... *# \...  .#...  . .#... # #*.#.....*..... #..*#. \... ....*###.... *.\*.#
#### ..#.# * . \**..... .....#. .# * #.\..*.#... .\.... ## \......   #.. .\ .... ......##. ...* #..#
##. . ....\.#*... ...\...\*..#*.. .#. ....#*\...#.  #\ ........ . ..  .#. .  .*. ..#.. ..*.*# .....#
#...#*......\...#.#*.\.*  ...\#.* \\...*. *# . #.....*...*# .  .\#**#* * .*... . . ..*...# ..*.# ..#
# #.#.....\.#.  ..#.....     #. ....#.......#  *.. . *.  *...#.. .\\\ ...*.#*.\...*...#.. ...#\.*.\#
#. \.\ .. ..... . . * . . #...*.\ #.\.*. .*...*......*........#.*.\.. .#*.......*..... .. \........#
#.  *. . ..*..#.# . ...  #.*..#......* . .........\   . ....  ..\ ..#\......\\..... ....# ........\#
#..#..#*........#.. .. *  *\ .........#\.#*....*#.   .....#\...#...#.*.**\#*..*. ..\... *.  .. .. .#
#. ..#.#.. ...#. ....*. .** .*..#...#\  .. ... # ..  ...##.# .*\#*  ...   .#..*. ....**####.**\ *.\#
# \ * .\... \.*##.\ #........... ...# .*. *.. .\\.. .\..# #...#*#.  # ..\    . ...#\. \ ..*...*# ..#
#.. .... .\.. ..*..##.*..#..#.#...* *..\\\..#*. \..#. #* .*. ..*.. .*#. ..#.* .* ....**..#.  \..* .#
#. *..*..*..##   #.. . .\.*.......*..##....  .#.*  ..\#..*..#.... #.....\..\... . *......... ......#
# . \...*. ..\ \ #\#*.. # .\#.. . ...*.. * ..*..... #..#..*. .... .\. . \......*.......##  ... . ..#
#....#..# .... \..#.\*. *...**..*  .#... ......... .. ... .   * ......#..\..... .* ..*#... ...   ..#
#.* . *.*.\.. \*#..... .#.# *..    *....#.. ... . ..\. \. .\......* ##\\. \ \ . .....#.. \......  .#
#**..*..*#.....\\ . ....*..\. *.\ .*....... .......   *....*.# ... *..#.* .*.*\..# . #.*.#*... *...#
# ...  \... .* ...*** ........ ........*.. .....*.*. .* .  *#.\.#.. *\.*# ..  .  ...... .#. ..#. .##
#...#.\*#..\.#.. .#\.... . .#**. . \#.##  \  .....#... . . .*...#. \## ## .....  ...##. #\.# .#*. ##
#. ..  .  \*...   ..*#...#.  . .*.\.\.* .*.*... . ..  .. ##..*.. .. *.......  .#  ......  ....\....#
#...#*.# .\ # \.  #  #.\.* . .*. #.... .# *. . \.*..#*.*.. *.#.\.... ..###. .#*\.. *....  ##\  ....#
# . .. ..\ .  .\.. . .... .# . #* . \.  .\.*#* ...*...#.....* .  ..\...  .##*  ...*.*. *. . \.\....#
#.***#*#.\..* ..*\ .*\ *#..**...... .\.\. \  *....*....  *.\ #....*.. .\.* **\.....*..*.\# ..#*....#
#.*.... .... .. . ..*..#...... ....* ....\.* *.. #..**. # .\***...**. \.# .#. #*....  #. ..\*..*. .#
#.... ....#.#..  ..*.#... .\  .....\ ##\*#.........*  . ...  #..#* .##.. ... \. *#.. .*..\ * ......#
#*.. ...*..  .......\#*..*..# .# ... .*..* ...... #.. ..#..\  .*.#  ..*..#*. .... .... .\..#.* . ..#
#   .#...#*....\..#..#.**.*.*. ......*\... ... #*.#.  # \. . ...\....#* *.***....\.#*\*.. # .\ . .*#
#\.# ...... *.. ..\. ...*...#. ..**...  .#.\.\  .... *.* ..... .......*..  . #* . *..#. #.. #  * ..#
# . ## #.........\...#.\... ...# .\... .#. #.....*#.#. .  ....  ....... #.#.#*..... . ... ..*..*.\##
#\. *..*.#...#.#.*....*. # ... ....\. ......# .*.....##...#.\. .#... ..\.#.#...#.......#*........*.#
#....\... ......# .. ... ....**. ... \*##. .#.\.##.* . *..#*#. .*.\....*..#.#........**. .#... .. .#
#....* \\. ....*.#...#...*.\ .#. .*. .. ..#.. ..**... ......... . *.#.... ###. *\*.. .#. #..  .....#
#.*.\ .\#.* . .. .. .. . .#... .  ..\  . ....\   ..*...  \....*   .*#.\ *.#.....* ..*. ...... ##*. #
#.#. ......*#.   .....*.##..#... .   #...#.#. .....*.*.## .**  . ..#... \#.*.* #... .* ..*. ... . .#
# *.  .... ..*..#\...#.. #\*..*. \.\*.. ...*\  ..*#..\..... .. .  .# .# ...#..*# .......  *..\#..#.#
#.#..#.#...**..\.......  .....  #....  #\. \ ..  ... .....#........ *.....\...*.# \..*#.* ....... .#
#\. .*# . .## **..*. .#.# .....\.  .#*.\#.#.... .......#. #  #..**#. .. .# #***... ... .. .#... .*.#
#..\\. * . #... \....*.*. ..#...* *.  .. .*..#.*\. ... ... .. ....*. ... ..# .  \#\ .... * ..#...* #
# ...##. ...\   ..**.*\ *.\... #.. .**..\.. ..\. #\.........#....*...  ##.. ..*  .....* ... .. \**.#
#..#*#\.  ..#. . ...*   *\  .\ ...*#*#..*..#.. .. *.. ... * .#.# .  #.. #.....** ...##.**. \.\.\..##
#. #......*.## **.   .... #. *.\.*..*#.*  .\.... #..#. ....#........   ..... #.#*.##  ..#\..##..#.\#
##. ..*.#.. . . ... ... . .  . . ....#..#.# ........ ..#.  .....\**  .. ..#*....\# .  ..#. .*..*#*.#
#.*.... .#..#..  \.*.. #*  .. . #\...#..*....\ # #.#.##*. \.#.\.....\..\..*...** .#.*   .... ......#
##. *.*. . ..#.# *.#*...*.......\ .   . #.. ...  ... ..## ..#..... .# .#.*.. .  ........ ..#.##..#*#
#\ * .#  #*.. *##.\. .  . * .*......  ..#.#.\#... \.* ... #...\.. #.. \# .*..\#.....* ... ...*. ..*#
#...#.  #.  .#..#.*...*..\ #.... ....*.#* . *. ... . .... .... ...#. ##.... . ..*.*......# ....*\.*#
# \*... .....#.\# .....  #.#* . ... *. .*.#.# .  #. .....#..#.. . *.*. .* ..  #\*.#.#.... . ... *.##
#.*........ ........\...\.\ .   \...\#...#. ... ..#...#*..#  .#  #.*. # *.\ * .\ ..#.... ...*#* ..*#
#....##**...*#...#..# ..#...#. # . . #  .\...#... . .*.*... *\.* .....# .\. .*... .\ #.*. \.\.#*.# #
#.*. *..... ...  *.# *.. .... #. .  .* ......#.\.........#. .#..\#.\..#.. . . .....#.. .... ..# \..#
#*......* .. # #.*.  .... . .*..*...*...\* . . .#\.\ ...* . . . .......\. .  .\\*#..\..#\... .. ..*#
#..*.... . ......\.\....##....\# ......#.*.....# ......*...*....*. * .*...#..... \.#.......\**.....#
#....*.* .... *. #.. ..  .* # .*.....# ....*..... . #  #*..  \*\#*.* . ...**..*#..........#...* ...#
##...*. .# ... .... . ..*  * . . \..## \.*#  .....*. *#...   ..  ... .\.#*. .... ...#. ..*.\ #.\.#*#
#.#. #..##.* .. .....* \.. ...*.\* . .#.#....... \\. #...#..*... ...\...\\..#.. .#....... .... * . #
#...  ...#\..  .\#..* ... .. .. .  ...*..*..... #..*...*..#  .... .#..#.*..  .#...\*. ..#...*..  .##
#*.  * .# #..#....... ..*....... .......#\ .....*.  ...#.#.*... .... .. ... .# ...##......#   .\*..#
#... *.##...*..#......\.  . ..*. ..#\. .... ..*...... ... *\ . .. . . ..*  # ##.. \*.*.* .#.#..*...#
# .. *. #  . *..\**.#.**.... #*.#.  .. .#.*..   * .#..#.... . ....#..*.. ....   .*...*.\ .. . #* .##
#. . #.#.   . *.\.....*.. .#... \#. .\# ##..#..#.#. .# *.  *. ...** ....*.  **\...*........#..# ...#
#....\# . #.\..... .......**..*..#.* .... .. .  *.# . . ..*.*#....\. .......*..\.....*#..\\*. #\*..#
#..... ..\\ . .  .....*.#\. #..# .##.#. *...#. .#... \ \#.....*..##\.. .\.......# . ... .*....#* .##
#.....* .* .. ...# ..*.. .... . ..\#..*..* ..  *...  #..  *......\. . \  .*. . . #\# ..#. .#**...#*#
#..*..*.**\.. \...........\..  .#..  ... #..\.... . .\..\..  ..*.\..\ .\ .*.... ...\*. *   ..... .*#
#* *.# .\. #.*#...  #. ... . . .#.....##* .#..\##........ .  ... .   . .#...*..*....*#.*\...* ....##
#...* . .\ ..#.##... *.....# \. #. .... . *\.  *  .#\ *. .....#...*#.. ...#.*...*  *........  ... .#
#......## . \  ...#...*\...  .  #... ..#... # . # ... .* .#\# ..\.*.......#...  ..*.  .....\...*#. #
#.. # .* .\ ..#. ..\..*. . ..\..#... ..*.#.* . \. . *\....**.\\##.##\.....*..\. #*.*.## .. .# #...*#
##.  ...\..*. .*...* *. .  ..\.. # \ .\ * ## .*#..*  * .#.# #. .. . .# . .. ....##. . ..**\*.. #.#.#
#. *. * ....... * ..*...... # .. ... ..*..\#. ....#. .. \..\...*  .  #. .#\*..*.. .*.   \. .. . #..#
#*..##..## .#.#   .......#. . .#..#.\#.#. .\...\.* .... ..#...... .*. .#*..##  .#.* #.*..#...  *..\#
#\..*  ..*  .*...* # #. ..*.. ..#\.  .....\.\. ..#..# #..*.*  .......\.. *#........#.#. ...#.  #. \#
#.*.\#  ..... ..#. *..#...*##... #...\.....#..  .... ..# .* . ..#..*.#.# .#.\...\#.. ....*...*\.  \#
#.... #*.#.\ ... . #*.* . #.#*#\#..#..#\** \\.# ..#.  #..## .. ... *...#....  \#......#.*..\. .\ ..#
##*.. . ..  .. ... #.... .. ... *..#...*. . ......#*# *.........#....*..... *. *.. * .*...##*. ..###
##. ...*  .*...\#.\... ...  . *#... #.......... .#...*** *...#..* *...\ .\.#.  .#..#.*..*. .\ ..  .#
#*\.. . . ....  .... *.#.... ...  .*.. .#  *\. ... ..*##..#... ....#......*........* .#*.. # ..##..#
#...**... . ...... ..  ..\ #.. .. .....#.... #.*. .\.....\*.....\. .*..... \.. #.\  .# .\. .......*#
#. . ##..*. ... * .......\....#.. ....   . # \*. .. .##...  .....*.*.* *.*\....\#..  ..**.......* \#
#.#\ #..*. *# ..\*. .*.###.#*#. *.*..#...*...* . *\.#....... .  #\##..* . ...#*..\..\ .....*... ...#
#.*..#*... ... .*.\.\ . ...*... . . #.....\ .. *\ # ... ....# .*..#.#\*.\...\..#. \.##....\  ......#
#.   .....#*.  ......# ......## *#.. ..  * ..... \... \.. .##*  ... .#*. ..*.. ...*.....  ..#\.\. *#
#.  .***.... ..*..##.\ .#. * . ...#\*#\.  ..\ ..#.......... #......#\  #.*  .  . ...... *. \ . .#. #
##.... .*.\ *..    *.  .. ##.... .\  .  .. *. ...*.\.*..#* *...*\. ...#  #..# . ..* ... .. \.# .##.#
####################################################################################################