###########################################L########################################################
#. .. ..*\.  #.*#**# ....#..\*..*... .... ..... .....* *........* .#\...#.  \*.......#.   # \ . ..\#
# .#.. .#...\#..**..*# ....*..* ..\.\\ ##..##*.\\. * . *.. \..  .  .**.# \  .*...*#..* \.  . #..#* #
#*......*..#.#...#..\....#.. \....#.#.. . ....** * .##.*...*.*.. .* .....  *. .***.\*. .\.. .. .*..#
###...\. ... .. ..*.....#..*..#.##...........*.. *..# \......**.........*. . ..  .#.  ...#*.*  .. \#
#....# \*....  .*........  .    .. . ...  ..*..* ..#  .*.*. \. .*...#. \. ..*#..#\.# .\....#* * *..#
#..*....**..  .\ ..# ...#**#\#...... *#.. . .\..\.#...#.#.\...... *..#...*..*.......  \*.#.  ....#*#
#.. ...\*.#..*.#. ... #.   ....# .... .\ ... ...  #...# .. *........#* # #...  . ..*.# .#..* .#.. .#
#. .# .** ..#.  ..* .#.. ##  .*..#. .*  .. .\. .*.  ...* ...*..*.# **..#....#..*..*......... # *.*.#
#..#* .... ..*..*#*.... .. . . \.... . ......*.......... .. *. ....... .  # ..#.*....\  ... \ .#...#
#.\.. .#.....#....#..# . *.... ..*...... *..*.*.. \.. \\..  .*# ...# ...  .*#..... ....*..  .\....\#
# *...#..  . .. \ ..... *.. \\.. .#..... ....* .. .# ... *#.  .  ...*. .. .......\...# ......*. *..#
#.\.#\. .. . ##*.. .*...*....#. . .. ..#....# ... ... .\ .#..... #. \.*......\.# . ...........* . .#
#*.#....*. ......**...* . \.\.* ..\  ... #*\........... .#..**... ... **......#.....* .### #.#  .. #
#*.....\. #*\... ... #.#  ......*..*  ....\ . ........#  ** . ..\ ... \* .  \\*..#*#...... ........#
#  . .. ..#..*.\\#. .. \* .\ .......#  \.  . .*. **..\.#.**....*.* ..\*.*........*... *.#. ........#
#....#.\ #. .. . ... *..##..#.... ... .*.......  ....\...#.. .....\.\#. .. #**##... .. . \  #. .   #
#.#....#..... .#..#.............. ...\ #.* .*.... ... ##  ....# .#\.....#. * *.#*#*\.\.# .*.....##.#
#.*.....  \*. ..*..*.\......* ...#.....  # .# *.*. #..# ...\#\...**# ... # \  . ## ... .*..\*..    #
# # .*.**.. .\.. *..  #. \ ....#* . * .. **.**.#.##.\. *..#...... .#..... ..*...  . ....\..... *#..#
#... \.. .   .\**..*\....*.\..*... ... ..\..#...\ .. .\.\.. ..#  ... \......*..*.. \..*.* . .... * #
# .*. ...\.......#.*.   # . .##.....  # \\* *....*.*..  ...  .**  . . .. . ..#.  .*.*  ..*..*.... .#
#..\.....#*. ....*#*.*.**. .*. #\.\.. ..\ . .##..  *.*. **#.. ..#. #. ..#....#.*.....*.*.#.*\* .. ##
## *..   \..... #. .*.\ *.. ...\......\...#  #\..*  ......... *... ......* \..##  .. ##... .* \..\.#
# \.\#......*.\..*..... .......* ..*.. .#\..#.*..#..   #  .#  . #.#.#....#  .. .#.*..* #\...#.*. ..#
##\#*.....\ . . # * ...*.*#. ........* .........#.  # .   .  #.. . .*  .. ..#....  ..\.*..*.\. #*. #
#..#...\..#. #.. .*..**...**. .\.\..*..##.... . . ...  .... .....# #.... .  .## ..\*.\   .  . * ...#
#*. .... **....#..*.\.\... .  *....*..*.  . .\.... ..#.*..  . .* ......*..\. *....### ..#.*.#..  ..#
#*..... .\\ .#*#\. \..\...........\.. ....*  ... ..\*. ..  .##... ...# *  .#..\*  \\... *.*.## ....#
##..  .. #  .* ... . . .#...*.... ...  .......## ..... #* .*.## \*....#  .  *.###... \.*. #......* #
#.*.# ..   #*  ..*.*..*#. #.\ .  .#*... \*..  *....#.#  *...*.#..  .. ....* ..   .**.....*.* ..  ..#
#. *..#.. *.........#* ..\. *.. *  .  **. ..... .\...  ... ..#..#.....*#.#...  . #...#.#.. # ..#.\.#
#. .#....#  .  . .*..\ #*. ...\ .# ...   ...\..  ....\.\. ...##*.#* .. . .*..#.. ..#.*....#. *  \. #
# #..... . . . #.#. .. \ ........# #. ..*. \... .*..*....#...... *..  . *\##..#\\ .*. *.....* .. ..#
##..*.\#.....*....#.  ...#* .*. ... .#...#.   .... *.. #\.  ..#....*......# .#. ...........  *#* **#
#.. ... ..#.#\\*.. .\.. . \..\.. ...*..... \ #. #\.#. ..# .....** * *..#...*#...*....\.# ....*..##.#
#. .. *...\\\#..**. **....* .....*#.\.  ... ....#  .#..... **\.*.*.. .#.....#**.. #.. ...# * ..... #
#..*. ....# . .. #...#..*...##  .. . \ ... *.\..... \.......##.#.....#\#......#. *..* ..*...... .. #
#..... .#  . **  ....\ *.##......\..*\.#.**...#.. .##. ...* * *  ..\ ....#..# .#*###. #... . .  . .#
#..\*.*.  ..\*..\#  .  ...*.\..... ..#...\..#..#\.# .\...  ..  .. . #  .#*.##.*.#.\.\#..*#.. .***  #
#.. .*#  ...* .#.* ...*...\\#.\.#  .  . .\.\  .. .....#**..*  * .**...\...# .....#.# ..*..\#\.... .#
#..#.... .\*... *\.*.#* .**... *.#..# #.. #\. ..#..**\.# .\. ..#....... .....\#..... #..#.#.  ...#*#
##.# . . . \*.. ...\.. *#..#.**...# #*.**. .* .....*.  .......... .*. ...* *.#. .. ... # . ...#*  .#
#.....#..  *. * .#.  .*# ...\*.........*.*\...*.\.. .....  .*... ..**. \#......# ......  \.. ...#. #
#\# . .#..*##...\...*......*  ..  ..  .....#  *.........  . * . .*#*...#.*#.... #\*\  .*. .. ..*.* #
#*.#*.. #\\. . .... #. #   .*.. .. .*... . \....*#...**\.#. \ #\.####.. .#. \.\ #.... . ....#.#. ..#
#......# *. *\*\#. ......# ........**. \.... ...#   .*. # ..\... .#...#.*.*.##.....#. ..... ..*.. .#
##...*\...\*..#  ......#. ...#.* #...#...# ....  #  #\. ... . ...  *....#... ...# ## ..**.. .**.\# #
# . ...# .* #..*#*....#..\.*\ ..#... *\* .*.... ........#...*. *. ..\##. \  ...** \  .#*..... ... .#
##.**#..#.\...#  ..#.*\ ..* .*. ... *... .. *  ..*.... # . *..... .. ........ ......*..#..*.... *#.#
#.\*....*.\\.  ....\....\..   .. ..#. .... *...  . ..... ..\.\. . ##. .R . . * ..##*.#. .*.* ..#...#
#..... \...#.......* ....# ..*.\#. ...  ..*....* . \. *.#*# .......... *...\.  .#... *..#.... . .**#
#.#. ..* ...  .... ...\.*.. ... ..... .. ...... .... ... .***#..*.......##. *..*#.#....#.\..#.* *  #
# ...#...  ..*..\ . .... \. \..#...  ..  .\ #    * #*.* .*. *..*...... *.\. \#*.*..*.# \.*  ..... \#
# . ....*.... .*....*.* .... ...... . ... ..# ...\ ..... ......#.... ..#\..*..#\ #............ .#.##
#.\.#  #... \*...## ..    ...# .*.*\..\.#...#.***....... ..*  \ ...*..\ .......#..#. .*.. .....  .*#
#..* .#... .. #.* .. .  .......\*... #. .#\...*.  ....*#.**...*# ........**# ..... .. . ....#... ..#
#....  *....*..#*. .... ....#..  ...# ##.#.*  ....... .. . #.. *. #*.  .\.\.  #............ ...... #
#\  .###.*..* .  .\...  . ...##. #.. \ ....*. .* ..* ...*... .*..*\.#..#.. .......*.*.#.... #..\.*.#
#.....*# ... ....*... ... *.*.*. ....#. .*. # .....\....* . ....*\ ..\.......\.* ..###.....#.. # .*#
#.# . ..#   .. .#...#\\#..  *#.\ .#.   \.#.*...\#\  ..*. \...*.. *\.* \ .  *.#\**#...*.#... *#. ...#
#.* *..*#. \. #. ** ... * .\......... ................*.  . *..# ......\#. .\ *\.#.*##*..#..*  .# .#
#... ...#.  ...* ..#... .. . #. .  ...... .*# *..........#..#.. .#.*  .# ** *. #. ........\.#.#.  ##
#. *. ... . *..* *#\..*..... \ .\ ..  ..*#. * *#* . ... \.. ...* ...#. #*.*....*\*#. .#* . . # . .*#
#*..# *....#. .#*#... * ##.#...**. .. .  *.....*.*.\...*...# . . #.. #.#.. ##  . #.... . *#...*  ..#
#.*  ..\ .# #...... *.#..\ .\\*..* ....*....*  ... ..*\.***..*... *#... ..#..#.#*...  ..#... ##....#
#.. .. .#.**\*.. .##..*\.\ ..  .* .*.*....\\.. ...#  ##.\...#.. #... ..** . *....... .   ..*. .... #
#....*. ..#\.**..\**... #.. **...\  #.#. .....  .  #... #..* .  .. ....  .\\. . *.   *   ..*.  .#..#
#*......\.*.  *#.. ..##...#. ... * .##.*....#* *.\ .... #. .\ . *. ..#... * ... #.*. .#...  .  ... #
#.... .\..* *.. #*..*.#.*..##....* ........ #\*#. .* .... .......  .#.*\... ..*. *  . ... #...  ...#
##...#. .  ..# *.  ....*...............\.....*.... . #.. .....# . .\... *.....# ..*#..#...#..\#. *.#
#..#....\.. .....#..#*\#.   **. .. . ...  *...\.* .*. . . * *...#*  .*.#\\...#.**..##..*. #*\*.. ..#
#*... *. \ \****..#...#..*. ...  \.... **.\.##*# \.#...*.* \.* # ..... ..... .#. . #............  .#
# ..#...*...#...#..... ...*  .... #. .*..\*.*..\.#.#*...*. ...#..............**.#.  ...##*..\. .***#
#* .#* . .  #....\\...#...... . *.  .  .........\*  .. #. .*#...\.. .  .#.... ..\....### ..*.# ....#
#* ...#......#... .... .\..#.* .#  . #.....\#\#..........*.. ... ......*.*...*  ....*.. ..*....#...#
#*. *. # .*.  *. ...\ # *.*...  \...#   #. ..\   . *.\.#.#..#\.#  .\...*.*... * .*... ..#... ..*. *#
## ......*........#\.. .# . ...*..#...*\...*...*..#.... ......#....*.*...\.#........  ##......\..# #
#.. ## ...\..*. ........*.... . ..#. ..##.. ..*..* .*  #\. ... #*..... ...... *  ........* . ...# .#
#...*....... *..\ #..#*.\....*... ..... #.. ..  *.. . . ...#..\......*#. #.*..*..#. ..#. * *.... \.#
#*..#.  .. .. .#*# *..#.....#.* ....\. \*.\\\..  #. #*.....\* # \..#...... .... #....#.#\..\#.....##
#*.... ...\....\##.. . ... ..\\  ...\\ .. .*.* .# #*.# ..#*..*#.#.#\ .* .. \.. .... #..**...**.#*. #
# ..... .*....... \  .#. .\\   .. .\....*... .*#..\. . .\ .#..  .#... *....*##..**.. . * .*.*#.... #
#.. .... ...  ......*.#....*..# ..  .*.....#.\. ........ . ..*.. ... .**#...*..*\\.  .*....  ... .*#
##.#. #.# ..\.  ...#....*. ..**\ ..* #....\. *.. #*.. .\.*#...\ .* \#..#...* \..#.. . #.#....*.. ..#
#\..\. . . ....#............#.  ..#\*. ....##  ...#\...*....#...#.\. ...*.  *..*...**..  #\ #. .*. #
# \\*\.*..... ...  ..##...*.#.*.. .....*...#. ..  ...*.#* . #..#... #*.\* #. # .**# . ......\#  . .#
#...#.* .  ... ...#.# ....... .. .\#. . #.* ..*.... #*....... .... #...*...... .....#. . *#*. . .*.#
#. .*. .#*. ..  . *..##..*.*... ..\. # .. \.......  ... . . .....#. * ..#.. ... ....  *..*...#  .###
#  . .*.*...... ... ...*** . ...# ..  ...*.# .\......#.. .#. .........#  . ..  ..#.....*.*# ....*..#
##..... ##. # \. ........... *\*.  . ...#..*\..*... . ..*.#..*.. \... #...#...#** .*# .. ## *#.... #
#... .  *. # . #*.  .   *.*.\...#.....*..\ .*.*   .#...#....\ ... *.. .\ *...#*  *. *...# .\#*.. *.#
#..\ *..#...#... ..  .. ...#..#.. *. .......... ..***.  ..#.\ #. ..\..#.  *..*....#..#*#.#....\#...#
#..*.#. ..* # .*. ......#.\. . #....  .  *..... .#*  .*..  *.....# .   .....\ .    .#* ..*.\*... ..#
# \* ..#..\.#.#..* ..... ....*. #.  #. .*#*...#.\*....\ *..*.#..#........ ***.  #..#........#. ..\.#
#. *..#.... ..\ #\.... ...# \\*.. .#\#. ... * . . #.# \.#..# \#.  .....\.\#...* * .##.... **\. ..#.#
##..  \.. ...#   ....#.. * .... ... .#.. \.#. .. #**#.\......*....*#..* .#..* ... . .#** ..#.. *...#
# .\* ....   #. .#.. .# *. .\..*. \.\#.##*.. . ## ...\ ..*..... .*....#\....#..#....# #*.*.#.# .# .#
#.... . * . .##..# .\\# \.*.. #  . . . ..#.. .. .. .. \\\ .. #.*. ..*. *.#  ....*.*. .##. #\ ....#.#
####################################################################################################