####################################################################################################
#.. \\    #...**..  * ..##*........##*.\*#  . .....*..*\ *#..  ......  .*.\...#..\.## \.   ##......#
# .*.  .*#. ##...#.#.... .  .....#** ..* . ....\#.#....  #..\.\#. .\... .#  .. ..#...#. .. .\.\ ...#
# .*.#.#.# \#. #...*....\. ... .. ..#. #\... ...*.*.#.. . . .#..# #. ..*.......  .*.. # *  ....\. .#
#. \...# ** ...*..#..* #...# *.#. * #...*#..# .#... .# *. .... # ..*.*. .....#..#\###. . . #\.  ..##
#..\.\ *..#...... ..... .. . ...\#...#\..**.#..\.\.*  #*.*....*...*.. #.... . .*##. #..* .....* .. #
#...*.... ... \#.#*......#. ...*... \*\ ..\.#\. ... . .. .*.#.. \ ##..#*. . \...*...*..  .*... *..##
#**..... ...#* #.*.*#.#.......#*.* .. ..# . ... \. #. .. *..  .*...*.#....   . .  .**\.#*. .   .*..#
# * .. ...\..\#...   . **\.... ... .#\.*. . . .*. ..* *  ...*#..  **..  .\*.#..*.\...*.# . . \.....#
#*.... .... .......*.# .#  #.. ... *...*........ .  .. ......# ... .......#...*  ...... .* ..**.\* #
#*.\#....* ..*. . .. .. #.... .* .....  .....#.......*.....\ .  . .*\. ##\...  .###  ....  ..**..*.#
# ...#  .# *.. ....   .*.*  .# ##. .#...\*.#.. #*.. .. ...#.... ..##.#..# #.#.... .. ...   .##\ . *#
#...*. .# .#.\. *....#.. #\* #.#.  . .#\ *...  #... \ #\.  ........*...#...* .#****. .#..** *.. **\#
#  ....*.*.#..\ #.........# #..\*......# ... # .....\*...#  .*...# .......#..... ..\  ..#.  .#*...\#
##*  .......#. . #* .*.# . ..*..*. .*.#...#...\.. ..\.*... .#.   .  .. .. #**#.*... . *.  # .... # #
#*....*#.*.#.  #  . * .. \....... .   ... ...\*.*.*.. *..#.\ ... ....*.....*.......#*..\ # ....\..##
#.#.\#.*## ..\... .....#.*...#.... .# * ..*. .. \##.  .*.. *..*.....#.. * .*..#.#..#.. . ...#.# ** #
# \* ...   . ...*\*#\.....\.\. ...#. *.. ... .............. ....**. ..\\..*.*.*. *\ .... #..#\. . .#
#.. . .... .\.*.#*#\.#\ #..  *... ... . . ....#....#\ #*.# . *.. ..#...*...#.##. ..*## .......\\..*#
#. .\**#.......#. ..... *...* .*....  .#..\*.  .##....#*..# ......\.#..*#....* \\#. #*#...#.*..\.*##
# . .*.. .. *.. #\... ....\..#. *. .......#  .. .. . \ *. .##....*. ...#....\* .#.....# ..\.#.#*..##
#..\*\.....  .. #.................*... * .#..  .#**..#.*#\..#..\\*.  . * .#.. *\......\...... .  #.#
#*.*.\*... #\#... ...\*... .#......*.\..*.. * #* ....\.*...  ..*. ...  .\ \*. .....\*.....***. ..*##
#.#. \ .... #....*#.....*\ ...\ #......#.#. ...* ......*.... \...# .  ....#. .*  . . *#**..#..  . *#
#\.\\.\  .*. ..*#..  *  #. #..* .. ...# ..\.....*...*.*.. .*.. . #.  \\..#\#.  # *.....   . . .* **#
L\ .\. ..#.  ...###.*.**...*...#. *..  *.. #..... .....#.\..*. ..... . ##...#...\*..#..\.#...#..#..#
#.\...#.#.#.. *.  ..   ** .**..... ..  . #. \.# ...\.. .\.\..#*** .. #.#. *.# . .*......... # .\...#
## ..#*..*...... #.. . .. .  .... . *.**  #.....*.\ *\  .   .#.  ..\.# .. . .... *. *..... .  #  ..#
#......\.*.  .*... ..##.  ..  .......\. ...*... \.. ..# ... .*..    .\.*.....* . ..#......**..*....#
# \..#.#.\\ #   ...# .* *.. ...... #... ....*. .##. .*.#....##...... . .. \.  #.*...**#.#. ... .  *#
# #. . . .... .. .\...*.....*\.#. *\. .*\.\\..\\ ..  #*..#*.... *#..#*..\.....*. ....*#.*. #. .. *\#
#....# .##.*#. *.#.# #. .\ .#.#  . *.. ..  ...  . *.  . ..##\...*\*#\\* .##.......*..\.* ...#.  .*.#
#..*...* . ..#*. .. ..\#..*. ......*  .... * *. .*.. ....  *. **.# .*........* ..#..#...*..\.  . ..#
#.. . .....*....\...*..\..**.*#\... ..## . . .\#*...*  .. ..\.....\# ...#. #..#....##.... .#....#.*#
#...\ * ..... .. *. .\ \. .* ... . . \ ...  .... ...\ # .\* ..\  ##.. ##..\ *#. .#... .* # *..* .*.#
##..#...... #......#....*.... ...... ..... ....*##* ... .*..*..* . * .# . ..###. ...  . ..*. .* *..#
#..*#.#. *## *.\# *. ...... ..*...*.  .\.#. . . .\. . # ... #...*...#*... ....*#........*\.* . ..#*#
#...  .........\  . *# ..\. .*# #*..#...\ ... ...#.  *.. .*...#*........\.. ..* ..#.... ##...**....#
# .. . ....#*#. .#.. ....\..*..#... .*...# #*....#*..#*.#. . ...# ..  .#...#..\  # .*.*#*\#..*\.. ##
#*.... *.. \. .\#...#... ...\.#. ..*..#....#*.. #... #.... . .  *.*..# ..#.## ..#..#.. .*.....#.#.*#
#.*#.....* .\.*..\ .#*. .#...  . .. *..*.# ..*..#.... . \#... .*.....*  ..  #. ...#..... . ...**...#
#....\  #..*  .*. .#..*.** .\##.*......*.* .... # .##.. *... .... ..#.#. .*#.*....  \#  #...#  ....#
#... ..... ..  * .# .  ...  . *#  ...# .*#  *.#.... .*#... .\.... .  . ....\#**..* ..# . .#*.*#.. .#
#....##..*..#...... ...#..*...#.* ..*\* *#..#..\.#..#*. ##  .....*.... .*\. ...  .....*.#..##..## .#
#.# .*...* .#. . .. .. .\. ..#..*.  .*.... ... ...*..  ... ...# . .  . .  ..# ..\....##..\..#.*..  #
# ..# \.  ...*\.### . .*#*  **..**......\....*.....#..*.....\..# . ... ... *\ .#\ #*# *# ..\.## . .#
#.*.  \.....  ...\.#  ...  *...**.. .\....\. *#*\.# *.* ...*# #..*....* . ... .......\.##*...*. #..#
#*.... . .....*.\ \*# #.. #....*# ....\\\ ....... .. ... .......\.. . *..#..*.*...*...  .... .*.\..#
#.# \.#*... *.# ...#.#. ..* .#.  \ .....#. .# .... *.#.....*. .......#.#*.....#...#.......# ....  .#
#. #.#.*..#...#.  # ...**  \..*.........*..*.\\...*..*.. \. #.....*...****. .***..*... .\... ..#.*.#
#.#.# .. ...*\ \.. \..*..*. .. #..........*# ..\  *# . #..* \#. * \.....*#.#...*..** \. . ...*# ...#
#. .  .. .. .....\*#.*.\ .#. #*. \. .. ..* . #. ..   ....*.#.    . ..*.\# #...  . .. *.......  . ..#
#.. .\..#... . *..\. ....#... \  .  ..#  #\...  ..\...*.* .. \.*# .*.* ..\... .#...\. .*.. . .* ...#
#..\##.##.\#......*.. * .....#* .  *..  .*#.\ . ... .  .... . ....\#*. ...#.....#**#  ...*...#.#.. #
#. . .. .. ..#.**#\ . .#.#.... .\.\. . ....*\...\.##.  .**#. .#*....... ... .#*  .... #..#... .\ ..#
#... ..\...#.. .\. .\ .\#.\ .. ... .#... *. #  *. #.    .#.   *.**...# ..### ...  ....  ...#..#\ **#
#.# .#.... *.#\ * .#. ..# .. #.*\.... .*.. .*.. ..... . #. \......#.... . # .R \###...  #.#\* .. ..#
# ......*.*.\*..*.....# .*.. # ..##.#.**.  .\*..\.. . .*. # ....*.  ..*\...*... .  ...* #.*.\.. ...#
##.*. . #   #*** #..  ..*. ...\. . .\...*.*.*..##.#..\.#....*.#  . *.*...*...#. #....## #..... . ..#
#....# * \** ... .# .##....#.... ..  *.......**. .. *#\ .. ..*#*...   ....... ...*. \#..  . ..\....#
###......##* .. .\ .......#***....#*#*...#.* *...... *.... . \.. .\.  .#. .\*#*..*....\.* #.#.. **.#
#  #*  .### .. ...## ........#..... #**.#.#.*...*....###.  .... * .* * #. ..*..#.#..#.*  .\..*.*..##
#..... \...\. . # ..\ .\..*.* * \##  *..**.*..  . ..*. . # . *..*.#. .#. *..#*... \  ..#.. #.....* #
#....##.#.. .. .  ........#......*.*..#.*... .# *.\..#...\.. # *.. #........ .#* #* .....#....*..* #
# ... . .. ..*.*.*. .. *#..\...  ........#.  .* \ .... .  ..##*.\#. *\   ... #.\..*# .  ... .*.. * #
#..... #.\. #.......... # . ...*..* .\..*.*......... .# ...... ... .  \.*#.*.. #\.....# .* *\ ..#  #
#...#.... #*..# .....\.......  ...*.*...*..  .\ #.*. ..  .#*.#.*.  #.. .#*..#\ . ..# ......*#.... *#
#.. #..*...  .**..*. .\ .\ *...  *..*.  .. ... .\  ... .... . .**#* . * . ..\\ .     #..**. . #...##
#..# .* .#.   **...\.#* ... *.#.*# *.*.... ..... ....#  ......*.. #.. .. **#. .. #. #.. ..#..#. . *#
#.  *   .. .  .**....\ ... . * .... #.#. . .\..\ *...#.*...*.# . ..... \.# ...\...#.\.\.*........#.#
#..#...\.... ........*..#*\ .\ ..#...*.\ ..*\.# *. ......#\#. .. .*  ......  .. ..*\  ..*..*. .. . #
##. ..#..... *... ..... *... .. \ .*.. ..*.*..#*. #..##. ..    . ..   .# ..\..#.  .  .# .#\ .#**.*.#
# ...*#. ..  ..#\..#...\*.... ... #... ..  ...*.*.. .\...*.\... . .\ ...*..*.*.*.*.. .... .*.  .. .#
#..* .#.. ...#..*#...*..*.... . .....* ..*.  .. . * ....#.*\..\#......*.#.*. ....*.. ..  *...\.*.#.#
#\. .........#...# ..  ...\ *..*. .*#.\... ..*..*  .#... ...   .#. ..#. \...\\..#.. .\.##   .#.. \.#
#*.. ...####.. . . .. **#.. \.. *. .#\.. \....\  ##*.... ##* #\..  ...*# .. *.  ....#..... .. .. .\#
#..\ . .....#.     ........\...\.    #..###...**#... #*.\* .. ....##... ##.....**.*.\. .#.. \ .. ..#
#.... ... .\..##. *.\ ...  #* .. .*# ...#. .*.. **.  ..#.#.   .* . .........*.#*.. ...\.#..\..\ ...#
# ...#.. ....*....\. .  #*\..#\**.*...*..  *.... ...*....#.#*.  .#. ..... \  .  .*.........* #.....#
#. * ..\**...*#.  .. . ..\. .#\.*\***... .. ## .*.. ..\..#*.. . .*. *. . # #.... ..**.. #...*...* *#
#....#. .* . ....\ ..*.# .*#....\#. #. ...#. ... \.. .. .. #.*.......\ . ....#.**#.  .* .\.\....#.\#
## ..#...  ...*.... .. #*..*......*.....\ .*. #. .  .. .... .  * \. #....... ..#....... #*.. .*..# #
#.......*#..* # *... \.* ... .\..  ....*....# . . \ *....\..\  .\\ **.# *.#.#*..... .......**#   \.#
# ..... .#.#. .#...#..#*\..*#...*# *..\ .*..#* *.#..\ .... ...***\. *.# #....#*  ........ .........#
#\..\#..*... .. \... ..*. ..#\#.   *#..#.  ... ..\..* .##.. .*  ..\# * .. #. . *#....* ....*..#...\#
# ..# ..*.*.......... .  #*#.*..* .#.#.#  ....\#.. .#. *...*#.#..* .*..*. .. ..\ .. \\ .*. ...#...*#
#. ..*.\ .\#. ..... ...   ... . *.#..*..#...#.*#.#*\..# .... . ..    .... ....... .  ....  . ..#..\#
#.*#.. ..## .#. . . . *....* * #. .*..* ..*.*#*.\.....* .  . \ ....# ..*  *... ..  \*.. .#..#\.*.. #
#   .#* .   *.*.\#.# ...# *... .\..... .* ... ..#.# . .. ...#* ........ .#. .*.  .**...**.*. . . *.#
#. . ## # . .  \.  \...\*.*.. \#.....\..* # \ *....#..... *..#*\ .#... *.  *..#.\*#..# ... ....* . #
##... ##**.. .. ..#* ..* .*.  . .*....\ .*... **.# \.##.*  .# ... ..* . ....#...  .*...# #..# .....#
##..*  .*....* #...... *.\...* \.. . ....## .* \*.# * *...*..  * ... .* .. .......*.....** ..* ...*#
# . * .\.... *.... . * .#.*. ... #.#....  .\\.. *\..#..\.\.#... ..  ... #....#.* .* ...*\ **..**..*#
##.. ......... ...\...#. ..#.*. ... .\. .*  #.. .# *#.. *.#*.  *.  \. .... ...\....# . ... #.....  #
#.. *.*..#.....#.....#...# ..# \#.. ...........*...#..   # .. ....*.. #.#. .*.\ .   \. ..*\  .. .*.#
#.*  .#.#*..#.....# \ \ .\.#...  ..#... .. . .*.... ..  ..\.  *\.  ..#....*.# ....# . .............#
#..\\..\ .##.. *... ............  .  *#...\..... .#  ...# *....##* . *.......#.. #.....# ... .*#.\*#
#. ... . . .*#*.* .....\ *..*# \#* #. #.\..  .. . #. .\ ...##. .. *#.. \ *..*#........*   .*.. .  .#
#...\#*..\ ... ...... ...\.  . . #. ...#*.* .#....  #.. ....... ...#* *.. \\ ....... ..... ..  ... #
####################################################################################################