##############################################L#####################################################
## .*...\.\.*.. ...\. .......\...  .#.#..\*.*\. *#.  .#....#...\... *....#.\. .. . .....# \.*#..*. #
#.  ...#.*.. .. #.#  \.#### .. . * # .#*........ . *..  #\## .# ..*#.  \*...*# *\.. .....\. \.** .*#
#.*\  ....* .#\... ..  .*...\ . .#.# ...\.* *.#. # ... .#.\...*.   #..#...... * .  #..*..#...*.....#
#  #.. *..#  \... ..# **#.   ..* \.....* . #\ .  . .. ..*..# ....  .  *..\ ..*.  . ....# .*....\# .#
#. \..*...\ \  #.  ......  . \#...... ..... .*..* ..#. . ..... #.#.*......... . ....*.\ .. .#..#.#\#
#....*.. ... .. . ... \... \\\....*...\   . *#\.. ...*.##..# #  . .*...*....  .. . .*.. *#..... #*.#
#....*.  #.. \ ....  .# ....#  .#.#..  #....  . ...*.. . . .... .*. ..\\.#. *..\.*.##.... . *#.. ..#
#....#..\*..... \. ... \.#..#*.    .#. . #.#. .  ...\. . #  ........\...*. *\#..*#*. .#.* .......  #
# ... * ..#...*#\....#.  ...\. ....... ..\  *.. .....#...\. . ....# .. .  #.....*.#...#*.... ..... #
#*** ..*.*.  ..**..   . ##** .. ...*.... #... .*.   ......... ** .*.. .*\#....## ..#.  ... \* .*#..#
#\*...*  #*.\..#....##..#..** #\#... .  .*#... ... *.  \  .  . .*. .. #..  ##..\..* *.* #.. .....*.#
#..... .....\ ##*......#..#..\....#.*.#.*#...# ..# ...##*...*..#\\.#...#.*# .* ..## *.\.#.#. ... ..#
#.* ....\\... ##.*.#..#. .. .. \...\.. . \....*. ..... *.. . ....*# .## ..* *  \.. .....  #\...##.##
#....#..\.*...... *#. ...\.\\. #..... *.....\#  . *.. #*. ..... \. \*...  .  ...\. ....* *.*.## ..*#
#.#... . ##*#.  #. *. .  #.*#. .. *..#  *# .. ..# #..*......#* .*#.\  .* ....\#..*....\.....# .#..##
#.#...\ .  *  ..# .  * .##.*.  ..#.#....*.*... . ..* . ... .# * .... ... ... \#..*. *.**.#.#  .. ..#
#. .. \ ......**...*.#.... *.. ..\ *.*... .. *. . ... .#\.  .#..#. .#..*.......\...\.. . .#. ..#*.*#
#. *. #.....R......  **#.....*. ... #.\ ..... #.\ \   .*##..    #... .##  #*...*.\ .. ....*..#.*.# #
#.### ##*. .*.*.*....* ...**...........  .\...... \#.#.. ....   ...# ... *... \....\.... .#. *. ...#
#..*#.  \  *  # ...#**... .....#.# #.*. .. ..#. .*......*.. ....#   . . ...#* .....\.. ..*...*#..  #
#.\ \.. \.\ .. ....*...\.#.***.....#.. \  ....*....... *.....#*. .\....#....# .* \#.#....* ..#.. . #
#.**\.......#. ....    .\.\.  #.\. .. ...*. . #..*.#\. .#... ..*....... \..\*...#..* ...\...*..\...#
## ..*. \. .....#.#.. *\#.#.*. .. .. #\.  \.. .#* ..*..\.* .....#.. .#* .*. ** ..... .*. ..*.#.#**.#
#.. .#...  *....*.... . ..#  .  .. ..*#.. ..\*.. . .\*\\.. #   . ..  . . *.*#..*....*. .. ... \  ..#
# *.** .. .*..#..# *..  ..*. #. ..... ....*.  ..#*  .  .* \... #...*.#\...* .#...  .##.. \   ..#...#
#... .#  *# .. . .\. ##.. *. . ...\.##...#......#. .. \ \... .. \.... #.*  .... ..*.....#. . #.... #
#\. .*.*....\ .*. \#.. #...#.....#  *..*#..\ .. ... # .#\ .#.. \..*. ..... ..*. ##. ..#  *.\....#..#
###.#.. \.  ..# .****.# . . *... .....*.......* ...# . ..........*..#*  ....  *.#.  .#\. #*..*.*# .#
#.....\ .... .. #.#.*.* ... *#.*.. ......#.  ..*.. ..*....#..*..  # \.  .*..#*.* ..... * *.**\.....#
# ..  ..#... .* ..... ...*.. *.***.#####.*.. ......\#*.#.. *. #.. .......#..##. #*#*...\......... .#
#....  ........#\   . ... .#..... * ...#.  \ #.. .*# ... \.... ..\*.. .**..... .#....*..... ...*. .#
#.\.*.# .# \...  ..#..#   .  ..*....\...*#.... .....   .  . ##  \\. ...#. ..*........#*.*...... . .#
# .\... . .  ##*..#* ...#.\.. ...  .##.......... \..##*.#. .. . .. #\  . . .... ..*#. .#..... . ..\#
#\. #.... ...  ....*..... ....##. #.#..  \..\.... ....  .\... .......*\....\ \ ..#..*.# . . .\. .# #
#..** .   . . \## ..# \.#.. .*** ..*..   # *....*..*.*.\..*.. .#. #.*  ....* . #...  ...\***#  .* .#
# .*#.....  \\.* * .# ......\..#. #\ . .*........ # . #. .* .#**#.#*..   *..  .  ....*..\\..\ . . .#
##.*.**...#*.... . ..*.....* * ....  # #...#..#*....*..**... * ...... ...... \.. . .\ *...\.... ...#
#.\#..*..  .#......... .* ....*.. . ##.\. .... ..  ... ....#.*#.#.#....\.*. .... .#.  .  *#*   * ..#
# ....... ..#..\ ..#... #..\#\.#.. # ... ..# ..* *#*.. .. ...\# . ......#.. #.*.. . .#.... * ....* #
##.  ... . ..*...#.* ...# *..##.#   ..*... #\.#..  \.#.. ... ...#.*. ... ...#...*......#.....  ....#
#  .* \..  .  .\.#.\..\   .......#.*. ..\..*.... **  .#..  *... .  # .##..... ...#.....  ... .# #.*#
#.*.. .... ..*#..* .*. ... #. **. .  ..# #..*.  \* #\..*... \... \   .#...**.**......#.#.*......  .#
#*# .  # **. ..#.#...#  ..#.#......\.....*.. ....   ..#..#.  . #... \# . #\#\   .#.*   *.. .#.#....#
#. \ ...*.....## #\#.#.# ....*#....#.\*# . ...#. #...#  *.#..\.. .*.*..* . ..#..\ *.*.. ..#...#. ..#
# ....# . ......#\..*.*...*\ .. #........*#*..*  . ...*.... ....  ........\... *.\..*.....#.  ...#.#
## .. .#.#* ..*.  .#...\.# . .... ...\ ....*.#.*......\.** * ..*..\.#...\ .* ... .   .#*....#.#....#
# \ * *... .#..#.\#. ...*..  . ........... .........*  .*. .   . * *.\...#... ...\*.*. ..\. . . . .#
#.**.... #. *# .### #. ..\. .\..*.......... .......... ..........\.#. #\..   .#.***#.##.#..* *.# ..#
#  .....*... ..*.. ... #. .#.#.. ...##\.\. \...*.#.#  ..*..**  . #.... #   ..  \  # .. *....#... # #
##* .....  ...*.*..  ...\*#.  \..#. #. .*.*\..  .*.#.#.....*......\  .#..... . .....* ... #. ...\..#
#.* * *.    .\. ......... \.  # *.  *** ...  .*#* ..**.  ***#......**...*.*.\.*..#*..#.....* .... .#
#*.....* . ..#...\...#.. *. .\#.. . .#  .  . . **  #. *#.*.  .  .#.\\. * . ..* #* .\    .\#.. ..\.*#
### ...*.*\  .. ..... ...#....###*.....#* *. .# ... ....# .*. #..*  ......\**..\#\ .*#. . ... **.#.#
#.  .# .. *# ... .#.#.. .. ......     ...... #*... ..#* *\  ..#..... ..  .\.\.. .*.....##.  . ...\.#
## #. .#   .   # \.. .* *...#.. .. #. ...*. .*#.*.#..*.*.*....*.* . *.*...#*.#**#*.. .#..*...#... *#
## #\.. ...*#...* . .....#...*..*..  #.... ..* . .. .....\  ....\. .*...*.\ *.\ *.*. ........ .....#
#....#..* ..  ..  .* ...... .. #  \.*..*..*  ..      ..*#.... .  ** *..*#.#...#.. .. \\  \. .  #..##
#....*.* # .#. ..*...  #. ... *..* ...*.... ... #.*....\...... .... ...#..*.....\ ..## .....#*\.. *#
#..*... .\.....#. .  \...# #.   *.**.#.......*... ...*.#*#* ... ....\ * .. ....   .\ * *. #**.* .*.#
# ..... .. . * . ..#.*..*...   .##.*.## .. .. .#\.. .  . .*. ..\# #.. *. ...*...\\..*... ...   .#. #
#*...#. * .*#. .#.. #... *#.* *.. .#...*..  ..   ... * #.*.# ....  ..*.#. . ... ..*\#....*. . ..#..#
#..##\ ... #.. #.. \*. ..*.#*.. *#....\ ##. .. ..*...*..#* *.. .. *..*.#.\...*......*.*.#....... # #
# ...\. . ... ... ..  #.  \ #. *...#. ..... .. ..#..* ..*.*....*.. .  . *....#  *... . .##. #. ###.#
#. ......  .*  #  #..* .. .*#  .... .  *...\.. \..*.#\#.... *\...**#.. *\.##..  . #.. ......*..# ..#
#.#..\ . . *... .*.. *... .\.... * .. ..*.*... #.. ....#....\ .#\.....#.*.........*...  #...# #....#
#. #.\*..  . .* ...**..#. *..#*..*..\\..#..*....... .#\*#........ .* .*. . .. ...#   ...#\ *#\..*..#
#  #\.#.#. ...*. ...# \ . #.*...... ... .. .. ** .... .\\.**...##. . .*...  . ..#. ..  ......*. *.\#
#....  *... #. * .\ .........#...*.*..\\ #. ...#..* * ...*..#   \*#. .  . \#. ..#.. ... \*. .......#
##....*. *. .... ....#... #...#.. ..\\..**.*. ....*...........#..#..  *........#.#...* ...*.#..**.##
# .\... **. ..*..# *. #.. ... ...*.*.# ..**... ... .. # . ..#* # .*.*** \.#  .... .....#...#\.... .#
#\* .\.* . .# ... #.. . .# .\.....**.... ...... .... .....  ....\.*#.. .#.. ..#.   ..* ....  *##..##
#. .* ..##..*... *.... #. \.... ..\..#*.  ......*.*....# \.\\#. ...#. *....... .......# .  .. . .\##
###..\.#...#....#.. ....#...... # \*... #*.# ..*...  . ..* ..#*  ...*...*. ... .. \.#*.#..  .  .. .#
# * ..*.......\ #*\....# #.*.....  #\... #..#*.* ..#\ .\.*.*. .#   .\.*... *.*\. ..  ...#* .\... .##
# ..* .* ..# .\ . . .. ...\...  #.*...**.# . .. .*. #.*.. .##* * \\..... ....  .*.#\.. .#..#..#.**.#
##. .. .*....\. ...\.* .#....*.\...#..*.\#.*. ..\ .......  ..... . ... ##...*... #....\..##.# ..#..#
# ..    .. ......*#.. .#..\*...*. ...*. . ... ...# ..*.*.... .##. #. ..   . #* .\...*#..*...**.....#
#.... ##  .\###..#..*.\**  .............#**.. ....... ...*  \ ..*#....*   .*  ....... *.. .... ...*#
#  *... . *# #.* .#. . ##* ..#.... ##.. .\..##..#*.*.#  .....*.*...*.. ..*..* ... .. ...#...  .....#
##.#.* ....#....* ..... **   .#. .. ...*\ *  ....# .. \.*....  .*..\.\#....*... **..\ .. .*...#.#..#
## .#. ....*#\# *.#*\#.#.. #*..#...*....#....  . *..**.. *...... #. *....\.* ...**. . ..\.\.*#...\.#
# .  .##..  ..........*#.. #.. ##.....*\ ....... ..*...*#....#..*.#.. *..\ .##.##. *....**.**#...*.#
#......* .... #*.*. .........*..........#.. ..**.. . .#. ... ..   #...# . .\..#*...##**.. ....*....#
#..... .*#...#*. .\.\.*.#.#.##.  ..  .. # ...*....  ..* . ..... .. ..*  *#.#**. #.....*  *..#..\# .#
#*.#...  ..# .# ....*.#.# *.* . #.*.... ..* ..#...* #..* .. \*.# .....# .\. .. ... .*.... #........#
#*  .\ *..............#.#. .#..* ....#*.. .  ......** ...# . ....#\.. #*.*..  .*....# ...** ..#..#.#
##..#\#..\*#....\#.*#. ... ..**# .##*...\   #*..\\..#..# #\.........# ..#. ..*..#.\. ...\..# #.. ###
#...\... . .*..#. **#..\#.. *.#*\. .##...*#....#.  \... # ...*.....#.  ..# ..   #..\.....  .....## #
#.. . ..#..... .#.*...\....... ....*....*.  .. .*#.#...   #.. *. ....*.#.#* **.....\\#...#\..  . ..#
#.* #... . #.. ..#..*##*\..#\..  \..#.\.*#....*..\..#. .. .#.*#  .. .  *.*. *.##.#.. .. ..**..# .  #
#*  #. ..\ #.....*\.* *.. *. ...#.\#..\...   \.#...... #.#.\.  .*. *. .  .... ...... ...*.*..\ ..#.#
# *..*. .....  #.  .*  ..#\ *... . . .*.. .###. .\...\#..#... ..*#..# \#...... ... .\...  ..#\*....#
#..... ... #... *...* #*.. .#* .....*.*#.\. ..\...* .....  .*..* #.. ..# .#*   * #. . . .  . #...  #
#*.#\..*. #**. .... . ... .... . #.**..*.*.   . .*. ......*  .. .**.. \.\....*.\# ..   #. . \##... #
#....##\. #..* . ....... * #.. .**##.. .* *..# .\... *.*.#. .. ..*.#. *.\......#.#\#*# ...*... .. .#
#..\.....*\......# ....#... \. ..\ .... *. *. .\.*.*. ... *......... ..*   \*.. .***.  ..*#. * ....#
#.*. ..  .\.** #... * ...*..#.. .* \.\.   ..*.. * #\. *....#.... ...## ..  .*. ...#..*......# .* ..#
#. ..  ..# *.. ....#*...... . ..\..#*.*...  . ..\ ....  .......... . . .#. ..... ........* .*......#
####################################################################################################