####################################################################################################
# .. .*....... ...#*............. .#.###...\ .\. .#. #*. # ...#*. .#  . ..#*.*#  .*.\#.. .\..\#\ #*#
#..#  .*... ..... \..*\.\..  ..#.  .. .......#  # .....  *#..   .*.*.#.# *. .....   .. .. *\#\....*#
#.  ..\*.... .\.* . .##*  . . .\... .. \. \  * .... ......\.  #..... * ...*......\.#...  .. .. ....#
#. ...*.## .*.\ .# ..*.....#.\ * ..  ....*...#.#. #...#..........# .. #.*#\...*.  .... *.... ..*.* #
#\##.#..#... .\..  *    ..#.. # *..\...\. ..\..#.# .. .......#*. \*....... .\. #.. .. * ..\ .*... ##
#..#... ... ....*#.* .. .\#. ...# .#... *.\ .. \\# ......\*. .#.   ...\#.... .....##.....\..#.  .#.#
#.. . #. # .....*...... .....##..#.#\.....#*.#\*... ..# . *.\#..\ *...*.* \.*... *\.....#.# * .#.*.#
## .#.\\#...\.. #*\.... .\.# .\.*\*.* .... . ...  .#.*\.  .#.*..\..*.*\ .. .**..#...*...* . . ...  #
#..* .#...  .......#.#.\ #.#.. *.  *. ..#.*  .. ........... ..  ....\....... \... ...#*##.*.* .*..\#
#.....# .*. ...*.# . \  #*..... . . ..##   ....#*.***#\......# ...*.#.#......*#..\#. ...\...  .... #
#* .\...##\ #.**.  .#..*. . .#.... ..#  . \..  * ... \* ..#...  .# *..  . ...*.# .#.\#. .. .*..#. .#
##* .. .. \   ... *#..*..*.#  \...... .#...*##***  ..#... #........   *#.. .#...**.. ..  ..*# ...\.#
#.*.   ..**  ...\#* \\.*.... .. ....*... .......  ..* . .*. *#*.#\.#.......... .*.#.**.....  .* ...#
#\.*\.  #.  #.\#.*.. .\   #\\....# \# ...*..... **.    ..##. *..*.... .  ......  ##. #.. \ ..  ....#
#* ..#..  .#........  #............#\..  ....#**...... .. .R* ...... .##.... ** ... .#..##.#  *#.  #
#..* \.*... .... \*#...\.. ..*. **........ ...\..\.   .##.. ..*\ ....#...   \.. .*.. ..#. *\ .... .#
#  .. ..* .....*\...  ..# .#....*.. #...*.* ...* *.\.#.. ##\.. .#....* ..#....#\ # .#.*.##.  .**# .#
##..**........* .\..*.  #. #. *.#....*..\.#..\*#..*. ..*..\.*. \.  ..*  #\#... .#\.. .. ...... ..###
#. ..  .. .\*..\\\ # #  .\##...... . .*..... . *.*  .#....#...  .. *...*.*..* .#.#*.....  ..... . ##
#\.*..#* . \........#...*.#*.. ..... *.#.#.**.. .**...\ . *.#\#.# * ..... ...** . .. *.. *. ..* ...#
# ...*.\....#.. .  *...* ... ....\ .#* ......*#..*.. #..#.*...  #.* # .....* .. *.# ..\....\  .*.. #
# . #...***. ... ..\.*...* .. #.#  **..  .... *  \ #..# .*...*  ....\. .............###*..*....... #
##.#.*#. ..#*\ ... ##.. .*.. #.** .#.. *...#... .. \..  ...#...\.*#.....*..# ...#* ..*#  ...#...\..#
# .* . # * ...#.....*. . .#* *. .\.. .  . .. ..*..*..#  #*\.......  \ .* \ .*. .*  #\ ..#\. *.... .#
#...* . #.*\.  \. ...#\\..# ..  .*.  .*   . ..#.....## *.# ...\.#\...*...  #.##*...*..*. ......... #
#...#  .. #...#. ..   **. ..  *.## ...*...# *.. \.*.*.... .....\  .  .  #*. .. .*#..*.*\  # \.\ ..##
#*  .*#. #... . .*\. #*# .\ ..... . .*. ... .. #..... ..\#*... #...#. # . ... * .. .#....*... ... .#
#*... .  \ .... *...\. \ .\ .*... .. .  # .  .#. .   .....*.....\#  .#*..*....\ ###.#. ..*\.  *.#. #
#..*#....#. . ...*.....#..#*.#.*..*  ...... ...... ...*.\.. .. *.... .  *.....*. ....#.#... #...*.\#
#.... \.*#....\\#. #*.*..* .#..#...#* ...\. *. ..##..... #.......# . ..  *...\...#.  ......#.* *. .#
#*\.# \  *...#*..*. ..*.... *. .#... ...* \..*   *...*... ...*#*.*....#.   .. ..#..\\. ...#.*..##\.#
#..#.*.\ .. \......  #..* .. *. .......#.* #.. .. #..#...   *.*. .*.*.\....# . ...*..... \ ...\  ..#
#. . . ....\.#.#.... *.#....#..*.##.#*. .*.... ... #.....\*.*.**.   ..#....#*.* .# ....   ....* \ .#
#*#..*\... #.....* .\  # *###  ..\..*.*.##  . #...... *..*. . ....\.... .....\#\ *..   ..\.*..#..#.#
#\#..#.  . * .#... ..\#  ..... .. .*...*.. . ....*....#*....#. #.#.. ..**.# ....  *. .....* \*.. .##
#.** #... . #. . .#... ...\##** . \ *.. #. .....*...#..\.#.. .  .  *\.  ..  * #..*# . *..*..#. \# .#
#........ .\.... *...#  .# .... ..  ....\.*.....*\ . # \#. .*.*. .#  ..  .*##*... .. .  #...\. ....#
# *. ..*...*.. \ .. . ....\. .#.. .#.#* ......* .....  ...#.. .. ...*\ #.....  ..#...*.#. ..#\ . #.#
#.*...   .*..   ......*.* #\.. *##....*.....  ....\\.*. ..........#...#...... .  ... *.*#*###......#
#....\*.  .. . ...*# \  ..* ..# \#.\.#\ \  . ..# .. .*.#.. *. ...*..  .\#.. ..# ..*   ... .*#.#....#
#.  ...  ..*\...**\#...... .\.#*. **#*#..*.* *.**\.#....*..*.#.#... ....  .\#... #.*.\.....** .*\ .#
L. .##  ....##..#. #.*#.... \#.....##... * .#..*.#.. #   .. ......  .. ..*.... .*....\ # ......**..#
#*.......*\.##...  ...\...*.* .*\*.#.* *.*.. . ..*...#.\  . .. ....*.....#  *.#.   . *... *...#\...#
#..* .... ...\.#....#..... ..# **#  *#.   .  ..........\.#\.*.*..*. ... \ . ...... .  . ... .* ..  #
#  \ ... . .... ....* .* ..#. ##. ..#.#.. *.. .  \.*......\\. ...#\...#*  ..* .. ..\* .#.. . . .* .#
#... ....#.......\*....\ ## .... . .... *... ....*.... # .. ** .#\ .* #..\ ... ...# #.. .. ..# \ ..#
#...# ....\\.. .  .*...**.#\#**  .. ....   . \. ..# #..*. ....\ ....* ... ..#  . *.. . ....... ...##
#*.. .#..*........ ....#  # *..*.. .#. .#.*.#.. ..#.*..  . . #...\.# .... ..#\.  .#.. #.*# * . \** #
#  ..  \#.*.# .#*..##. *. \...##..#...#  #.#**\.\* ... ##*....#*.#.*.. .# ...*..# .*.#*...\.... *  #
#***#.* .#***.. *.. \* *\..#. # .  ....... ...  ...#. .*.. . * **.*..* ..\\ ...\....#..#... . #....#
#.....\ \.**.**... ..#\....  ...#\##..  . #  .# ....* .# .  #.. ....***...#.#*. . .*..\*..... ..*..#
# .\#\. .*  *.. \.. .#.* . .\..##\. \....  **#...#....#*.. ..\..* ..**.*. #\....*....*..#*....\\.. #
#.......*.#*...#... ...\\#.#....\.   *.#. ...#.#.#.. *.. .*.    ..  #.*##..  .\\..... .#..... ... .#
#... .**.#......#.#. *...#.....\*.. . ....... * ##..\.   .#...  .....  .*.. ..#. ... . .#..#.\. *..#
#.#*.  ....* .*. *.... \. ....  *.. ..\...*........\.... ..*#....#*.*..#.. ... ... ..#*.#.. ..*\* ##
# .  .   ...#.. .\.....#. *.....* ... #. #. . . .. . .. ........... *...*. .*#....\#...\ ... ..#   #
#**.\#. ...*....# * *....#.#.#....#.....  #...... .*# #.* ......#..#..#   ...# ..... .#.  * * . \..#
#..\.# *## .\..*.. .\...#.***.#.*#*.....*\..\...... .*##.# \#. ##*....... ...#...... ... ...\#.....#
# #...*. ...*....#...#......#..... \. #...  ........ ...* #.*#.. .#..*  # .. ..  # # ...*  .....# .#
#* ..\ ..*.* *....... #.*. . * . .   ..#........*...#...**# \...... \#....#..# ...\##\..#..# ...*.##
##*. .....**.\.*... ....  #.*.......#. ....*\*..*..*. .\ #.**.***...... .#....*. ...\ . #.....#....#
#..\.. ...   ....\..\*.*\.  .*............#....#..\.   #.*#.. . . *.\..... .. .#.#\ ..\ ...... ....#
#    #..*..*....**...*## .....   .## . . .#....*\.. ... # .\..*# #.\ .*#.\.##.#.  #  \#. ..#.. ..#.#
##.\.... .............. ...*...  ..*#.#.. # ...* .# \ . ..*\...#..... ...#\..*.# .........*\. .* ..#
#..... . #. .......#.\ . .\\..*.. #\.*....... \.#..\. . . ...*.. ** #.... ..*..*.. .#... .  .**   .#
#.# # ......  ..#.... .##*..*.\*.....  ..# .....#....*. ... ... ....#.*... *.. *\ ... ..##*...\....#
#  . .\. \... .........##.*# . *. ...**.   .. #*..*. ...  .... .**..#..  . . *....**. . .** ... ...#
#*. .. . ..*.....#\ . *  .. *... #* .\*...... .\* ..#\ #*......... .#\ .. ..... ..#. .\.... ..*.#..#
# . .....   ........ . .**.  ......*#. .  .\\# ..#.*.. ..#..\ \.\ .#.**  # *...##.........\..#.  .*#
#.*..* ... ...#..#* ..# *....**...  .*....*.\. #...#. . #.. .*\.*.#.... \.. # \.#..  *..*. ..#..** #
#.*#*...*..##.\ . *\..##\\ *.\* *. # . .*##.....* .\. . ... * .\..*.*.. ..*..... ..... ..... .#....#
#..#*\  . . ...... # .#.. . .... .#\.....*....#   .....* .#. *. \#.*. ...\.** ....  \ .#.*...#.#. .#
# .##..* ..#\..  .*#.....  . .. .   #. #. \..*.*.*....#. ..*.... ..*.#*\.........**.#.....*.* .. ..#
#..#* ....*..*# ..\.* *\. *...*... . .*...* ..\#.* .. #.\  . \ . ...#...... ..\.#*# *.\*...*. \* . #
#....... *.\. ......   .......#...# .#..#... . *.#.*.*...# .. .. .*.. ... . #\ ..#.    .... ...#*.\#
#. \.......#.*  ..*#*#.*# #\..*. .....#.  ..  ... ... #  . ..##..*...\# *   \. ...* .*\\ .*...... .#
#.# *.. .#. # .*....#.# .....#\........##.* ....*... ...#.*... .......#.\..*...\*  . ... ... .*# ..#
#*...##.....#..*....*. . .\. **. *. .\  \*.... ***#  ......\. .. # * ..#.......... .*...\ \*#*..#..#
#*.. ...#. .  .*# . .*.*..*.. .* ..* ... ... #...**....# #....*# .*.*.. . ... .....#..... . \..\...#
# .#.. . **\#...#.  \.. * .# .# *. .\........ . . .....*.... ...#...*#.*....*. . \\\*.. .##.# *.* .#
##....#.#..  ##.\.##..*...**....\..*.. .....*#\...\\* ...*\.. .. * .  *.#.** .... ... **...*. .  ..#
##.*.*..#. \....* .*.#. ...* #..\#.*#   . .  . #......*.... # #...#.... .. ...*..  #...##. * .....##
#.\#.....* .##.\.#..\*#.\. ..#..\.......*....*.# ..#..... ....#.#...... . ..\*......... *. .....\. #
#\..\.#.... * .#. .*# *..*.... .\# ... ....*.#........ .. ...  ..\ .#..... *\ ........... #.* *\ *##
#.. ...**\... *  . .. .....\*. **.. ....##.#*#.* ...  ..... *.#*.*... .#.*\.....#...**.. ..*\#.*...#
#* .\..# **......* * .. .....** *. \.....*\. . ...#.  .*..*...* ... \.#.\ .. ....*#...\*...#.. ... #
#. ...... .. .# #... . #....... ...*...# ..#.\ * #..\ # *  .....  #...*.. ..*.#.\\.  .*.\\#...... *#
# *.#..# ##. ** .#.*... ...#.. . *..\ ..\..* ..*.#*.....\..\  .\.... *\.....   ..  .\..... ..*  ...#
#.#.. \*.#   .#......#..#.  .  #.* #.\. .. .# #\. #.\  # #* #. .*..*.. ..#.... #. .....\#\*.\.* .#.#
#.  .#. . *#...  . . *...*.##...\\.. .**...#.. .  *. .\. ....\ . .**.  .#.\\* # # *..\..*\* #.#.**.#
# ....#    ......... *.\..#......# *.  .#..*... *.#.#.  . * .**...**.. * .\#. ...... .\.*\#*..#..#*#
# *  . .*#\   ..#.. . \.  * ..##. *. . #* ....\# .  *..##\.  \## ..... .*.#*. \ **... .. ..*.. #...#
#.#......* .\.#\\*.#*.# ..... #..*... ...... ...... *..... # ...*  **... .  .# ..*.  #.*... \#.....#
#... . \ .#.*#* ...*..\.  ... *# ... ...\.# ...*.... .#. .#. #. #...#\...... .#....#...\*.. .   .* #
# ....*.# # .*#.........*..# . . ..  \.. #..  .. . .#.#...# .. .... ...**#*\\#...# #.*.*.**....## .#
##...*... * \...**. * .... . ..#** ..\... .  ........** . . .*..*..#. .... .. ...#..*.... #. .#... #
#\*#. \... \....*.  ....  ...*..... .. ..\  .*...   ..*...* ....#.........\.#\...#*. *#.. .#....*..#
#* .*. #.. .\ . .\#...#.##.#......#... #*..#...... .\...*.... ... .*.#\.**..#. .....#..  .. ..#....#
####################################################################################################