########################################################L###########################################
#.\#*.#*....# \..  # #.#...# #..* . *##.#*.... \... .*.*.\....*.*...... *# .  #. *.....\.......# ..#
#... ... \....#....*..* #....... .#**.   **. ...*.#****. ... .\.......#....\. * . ..\. . .#.... ...#
##.. . \... ... ......*# * \* #..* *....\ . ... ........*.#....#*.  ... #...*..* .  *.... * .\.* .*#
### *.....#*.#........ .***# .#*..#.*#.* * ...*..\ #..\. ..**#**....#.. . .  *#...  .#..***.    ...#
#..# .. .*# ... .#. .. ...\\ . \\ *.#.*#...\...*\. ..............#.*.*\ ..*#*.*\  ... .* . ..  #.  #
#....#.#. ..\*...#....\.*.* . ...   ...... .... ..... ..... ..**.... .\. ..*#.. . ..#*..* .  ..*.. #
#...\  \.\...\ .  ....**.  *\.  . ....\.#..#.*.*  ...  .. ... .# ####...... ...###\*. .#.\  .##..* #
#*# ...  ...... ..#..\\......*.  *.....*. ...*..*...*...*\.\\ ..\.. # \##*.\...# .#*.#.# .#\# .\ . #
#*..#...\..\.. ..*....  .*\*.... ..#..#\...#..\.*.*... ..*...*#.................\.*..\ ....... ...*#
#*. .###.. . ..... ...#  .\\*.\.#........ *##. ...... .....#.  #  .. #. ... .....*...#...... . ...##
#  .\#..* ....##. .. .. .#.*.. .* \.  ....... ...\ \.... *....  #... ...\ ..  ... \..* .. ..  \....#
#. ...\*.# * ..*  *. ...#*\..#..\*. \  ......... ..  #*..*\\#*... .. \.. .\# .. *#*....*...*  ..*#.#
#.*.#.\*. #.*..#   .#. \.*.*...*..#... .. .* .. #.  . .\\## ..... *. . .....# *.#. ...\.#. . *...#.#
#..#..# *#**# .\#.. . #*... ..## #*. ..## .\*..#\.*...*.#.# ..* . #*.*.. .....#.#... *......*......#
#. ..\..#  #\.\...  .#*\*....    #.....*#.#.*......# ....*.\  .. .. . ..\ .. #..*.*..*.... ..**.#* #
#\* ......#*..#*.*.........#.#..*.#.....\.*.. ... *.... .# .. .. . *... ..*#.......\..*.. *... ....#
#..# #..\ .*. * . #.#.*...... . ..* #*#.. ...... .  #*# .\*\\. .  ...#.....#.* .* # *\.......*. \ .#
#..**#..#...  ## ...\......\.......   .*#.. * .*# .\##...  .. . .#\...#.\\..*. #.  ..**.... . ....##
#.  .* . *..*#\..#........... . .#.*... ..\ \..*..#*...  .#*.\......  .#......*#.# ..  .*#......  *#
#.. ..** . #.....* ..*....*... .......#.\*\.... ..... ......\..  \.\ .... .  ....# .....*......*. .#
#\*.\#. ..... **. #.**\..##.... ....*.#...* *   .\ ##.# ... . #...#. ... . #. *#.*  *.#..... .*. **#
#*.*..#. * ..... .. .. .#..\ *.....\\. .... #. #.... #.*.*\...  **.#\....\.. .....*#.. # ..#..## ..#
#.#  .**.....  #.  . ..\ #....#..\*.. #. \*.  .*...\#   ... ...#  \## \ . .#..#....\.. *#.#. ... ..#
#.#.... ..#..\.....  *#.#\*.*#.#. .*...* ..\ .#.#....* . # ..  \. .. *..#......*#.  #. #.\.. #.   ##
#.\.  ..#\..#\# \#*\ ...*.*.... .... # ........#. .  . .#\ *....# **.   . *.#..... #....*.* #. #..\#
#... ..*... .*..#. \#.. .#...* ..*...#. #..... .\#.. ....# ....\.# .*....*##....##*.... ..#. .  . .#
#.  #\ ...*... # #\. .. *.*  ..*. .* *...\.. * #.\  .. . . ..\....\.... .*.... \#....*.*\*. *#\\.. #
#.. .....#....... *#.#...*.. ..   ..\.#... .. *. ... .\. ..   .. .....*##*..#..#.. .*...# . ..... .#
#...**..* . #*\ . ..\.\. *#.... .*.\*  . .#..*\ ....#... *.* \#...... ..*#.. .#\*..*..#. ...... ..*#
#.  .**..#*..\.# ...\ #.......... .#. . #..*.*.#.\...  . ****#*  ...#.\ ..*....*.......##...## .\. #
#.... .*....**.\#*.#\ . ..  **...*.... .. .. ....#. .#. ..*.........#. .......#........ ...*..#   .#
#\.. .\ # ..# ....#. * .*..#.** .#..#*#. .#.*\..# ..\. .*#**....#.  ..##*.....*  .*.....#*.\ . #..##
#. ...# #. *..... .. * # .*. **\.... ##. ..#.. . .. .#  \ \ .#.. . . #... \..........   ..#*....*..#
#....#..#..\#*..###..*#..#.. #.*.... .\.........*.# ...# ..#.\.   ..*.....#\   .*#.#..*...*....#...#
#.  .. \#\### .......  ...*. ..\...*.#......... .# #*....# \.*...... .  ......\*..#....*..#.\.#..#.#
#  ... . .. *.*..... ...#...*#.\. ..**.. .\..**.. .#.. ##..  . *. . ........##*# #*..#. .*. .##. *##
#. #.. .*  . ... ......\* ..**...#.. #*#..\#.....\#...... ## ..*#..... ..*.. ..*#....#...# .\  #..##
#.*.*.# *#. #.#*#..\.#..#....\ \. ..\. .....*..#..* .*.... ..#\.. ...  ...# #. . *....#.#\..*.*. ..#
#*..  ... \..... . . ...#  \#  ...**. ........ . .......*#. #**\. .\....*#.# ....* ....#... .#..*.##
#.*.#\.  . ...  #.. .*. #...  .....  ...# .............. # . \. .*.....#....... .. ..** .  ...#.*..#
#.. . ..   ... * # .\. ..*.*....\.. ....#. ... . \ .**..  *    .... .......#. ... .#...*. .........#
#..#..\.. * ..*.*..*. *...\ .. #.#.....#*  .  #.#...... ....\.... #\. ..\  ..... .\* .*.... *#.*#..#
#...    ...#*.. ..*...#.*. *#....#. .** ..#...... \.. ..* ....*  .  \. .*.\ . \ . * .* ......**.. .#
#*#....**... #. ....##..  .#  .....  . \##.\ #..# . .\..* .. . . .\  *.# . *  *.\.#.   ..  ....  .*#
#.\.... #. ..\ ..  #**..#...#...*. #. #...#...#.#.*...##... . .. *. #..*....#..*  .. ....... ..#...#
#. .*... #.....\* . .\....*... ...  #.... #.*\.  *..#.. .###.#....... .*.. . .*.. .*.\*... ..*.. #.#
#.. *.#..#.#.. .. ... ##.....  .....#.. #...\.. . ..#....\. \*\.\...*\\*. .*...... ..*. ..... .....#
#  *. . \. \\ *.#..*..*.*.#...*.... .. \.\**. # *...# .*\*...\ #... ..##...#....*....# . \.... ...*#
#*.* .. .\#. ... *  . #. .*. .\.#..*#* ... ..\.#... ****..... *. .. ...# .....  \*. ... .....\.. ..#
#*. .*. # ..*... *#..#. ...... \. ..*\*..   .   .... ...  ...#.... .#....## #..*# #. * . .........##
# #*#....# #... .*#...#....#  . ..*..\ #. . .. #.....*...###  .#. . #.#.** ..# ..*#. *.  \## ..#.. #
# .*#........ \. ... ....*.#\.#....\.#.*.##... ..\#.... .. .... .....*.#........ *##...*.. \.#. .#.#
#..\.  .....#.\*.  *#...... .*.... .*...# . ........* *.. .... ..*#... ..*  ... .**\*...#....*.. \*#
#...#.R.. #  .**..*.\*. ....*.. .# \....\ .#....*..#.\.. .*....  ......  ..*.\*#.. *.*....    .#..*#
#.....* .  .*#...# #**.#...#.....*#.\ .*#.  .* ..*. .#.**  # \.  . *....*..#. . ..#.. .\...#.*#...*#
# #..*..... . .....*\.# . \  ##... #....#. .# .#.* .. *... ... #....# ...* #*.**.\...#*.#..\... ...#
#.##....  . .......*..\. ... .#..... ...\.*.*. *....#...# . ..#...#.........*\#.**#\.....  .#.*..* #
#.\.#. . .*.# .*..... *..*.  ##...*.*....... .* . # #. .. ... *. . ..*#.*.....##.. ..*.**....... ..#
#..* ... \\....# .  .  ..... . .  .. .  .......##. *. ... .\.\.... . *...*  *.*\...\. *......#.#...#
#\.#.  . .... *..... .. .  ... ...#.. ..... . # . ...\.........#*..#... *. *#.......#.#.. .\. ...*.#
## *. *......... ..\## #.#...*.#..##..... #.#.#..*.......   \ .. *. *..#..*#..*.*#..*.\\..#\.* ....#
#.*.\.*......   #**.. *\.. ..\.#..\..**... ..  .***.*. .*#.. \..*...*...... .\.#  \..... ... .  .. #
#..#*...# .#\ .... ....*.*.\\ . .\... ##*. #\.. ..... #.*........#.. .......#. *  .. .#*....**. *..#
#. . ............ ....  .. .. \. ...\. #.#. . #. #*.\ \ ..#.... .* ........ ...... .*.#. . * .\# ..#
#  .. ...\...*......... *. ..\...*.......\.. ..... *....#.. *..... \.. .. *.\ .. ... ....\ .. **..##
#.  ......#...*.... .##..##. ##.... * ....\.  .*.... #.***####.*...##*# ..\\.*#.... . .  ..  .\*..\#
#. ..  ..#....*. .#  #.  \*... .......  ..*    .......\ ...#* .*.\*#* .* *#.  *\..#* \.. .#.... \..#
#.#**....\ #.*..\...#   ... ** ...# #*..#......... *. \..\*.*..\##... .#........... *...#*..#\.\.. #
#.*.\.....**... ... .......... #\#  ......*\..\ .....#..#...#.\\..# \....*..\*. . ..#.. .#....*..  #
#\.*#....  #. **\.*.....\#. **\*..#\. .*.# ....\ .#... ..*...# #...*.* *....*....*#.... .  ..  ....#
#.#... ......*  ...*....... . .......**.  .* #. .....\#.# .......  *.*.#....#.. .#.  #*. ... *.. .*#
#*# .  .\.....*.#.. ##.....\...  #.*...\ . *#... *#....#. . ..#...*.# * *.... .  . ..#.#.\ ...#.*.\#
#....# *......\ *...... ..... \.#.....* ..#*.... .....\  .\ .#.#. .*.##..#.\. ..*.#*\*.*..\ #... #\#
#.*#.  ....*  #.......#.*... ....##..\#.\.... . .. ...*#*.. ...  .* . .#.....\....#....#...#.. .## #
#.. .. .#.. \#\..*.*.\ . . *. #..*#.#*#.#.*.. ....#.... #*.#..*  ..#.* ..#...\... .***..# ..... *..#
# .....\.... ..  .. *..\.# ... \...#.\ ..# ..*.\ .*.... .....#..*.. ..\..*..# .*. .*.. . * ..## #..#
# #.. *.* ....\. *.... .....#* #.#......#.....  *  \...#.  #...*.. .*....\*.. ...#.. . \ . # . #.  #
#.* .#*.*#... .#.#.*. . ..#.... \..... **#.# .#.*...\..#\...*. ... ..#.\.. ....   \.\..**#..... . .#
## .#.....\ ... .##..   ....*.* ........... * .  * .. ##.\.*..\...\**.*#.*#... .#.#...... ...#...\.#
##\**..*..#.* .... \ .....#  .\... ..#.  #. *. *...... . #...  . *..*...... *....  ... #....\....  #
#.# #*.*# ..  .... *..*.....\......*. ..#.#..*#. .*.#\... ......**.. ..\  .. ... .. * #.. # . . .. #
#.*...#.*. .#.* ... #..\.... . ..*...#..* *#...*...*..  .# ...#..#.#*#*.....\#..#... .* ..*....*..##
#... #.. .. ......  ..***\.\  * ..*##. .. ..#. .\#.*. . ... .. . .\.*.*....*..#.#.*.. ..* .#*..* #.#
# ... .#...\#. ... \** .*.* *.\....  . ..*#.......#*..# \..#......\#.... *. #. .\..*  .  **#.\#  ..#
#.\ ... #**... .#*..## *. ....**...#. ..*...***.  # #. .\.... *..*.# ...*..*...*....\. .. .. *.## .#
#..\*..........* #.. . * *..# .... . ...........#.\ ..####.*. . .  *.#.. . ..#.* ..*.*.# ......    #
#  **..\...*...  * .# .*. . \. .\.....*..... . . ...   .*.\*#\\* #.. ..*.\..  .*\. .\. *.   ..* ...#
#* ..#.. * .*..  **\...#.. . ..... *. .#..* . #....**.*#*.#\..  .*#. .........#.  # # \ .\\*..*.\..#
#....   *.*.....*. ... *..*...\.....\. #..# .#...\.......*... .#  ..*.\.*.# ..\.#\ .....\. #..\ ...#
##. ... . ...#.#..*. *..#\.#*. .\#... *.#...#.....  ..#  .*.# .*... .#........ ..#.. *  ...# ...# *#
#..* .#...*...* \  *..#*. ** ...  .*##.#.. ...* .  ....#. #\. ..#.#**.......#....#*\ . .# .*..# .* #
#. #. \..*\# *  ..... . . .. ..\.\..... .. .. ... . .#\... .. ...##.. .. ....#.. *....  \**\..... .#
#  ...#. .....*.*...#....* . #. \*..*.##..#\ \.*..#.\.. ...... ... .. *... *.##.# ... #..#..**...#.#
#.* \#*..#. .....  #    .... #..   *...#..\. ..#*  . .*\\. .\..*.#. ....*. *..*. ...# .. ..#.....*##
# ..... *# . .*.....* *.#. ..... *..\#*. ....#..... .  # .#.\.* . .#\..... \ ..  *.... .....  \..**#
#  ..*.. ....* ....*.##..\##. ......\...\....... .. . .   ...\.. * * .**...... #.* *...... ..*# .*.#
#.#.....#.#...*.#.\\. ...#..... *...*......*.......  ...# ...#*..** ......... ......*..\ .**. *.   #
# .\#.. \.*.#.....#. *.....#.....\....##....**.#....\*  * ..##.* .#*. ..#*#....* ..**# . ..#.  **.##
####################################################################################################