####################################################################################################
#\... \*...*..# .. .....#...*.#.... ##........\#.#  ...* *.. *#.#.#*\*...#. .. . .#  .\. ....*.** .#
#. .*\. ... *......  ... .#. \...# \. .. ..*..#.*...\....  \. .\ . ....#. ##.. *.\ #...... \.*. .. #
#**..*....  .#. .#...* *... .#. ... . # .. # .# .. .**#.\##.....#.#\  #.  ...\. \....\# .... . ..*.#
#..*....*.. ...##  .  . .*... **.... *.# ....#. .*.. ..##..\...*. #. . . . ...#. .....#* \# #\ ....#
## .*.... . ... . .\*#..# \# ##  .\ ..   .#... #...*#**# ..\.*.#.. ...\.....*.#*  ... ...*... #*#\.#
#...  .# . *#. .*#.# .#.*. * ...  ...*  #  .. ...**.#. .  ..#. . ..* #...**.....# .. * *# *#* #.*..#
#. ...* ... . #..  . .. ...  .#. ..#...*.**.. . .*.# .. **. ...\.#.#.....##*. .\.... #\ ..*.*..\...#
#*.*  .#*..*......\**...*\*.* ..*..\.#. ...\...... ... ##  .\...*.... ... . .. ...##*..  .. . . *. #
#*.. .\.  .*..\*. ...\#.*.\.. .\... ......# #.* .  # *.* \...**.....*. . .....*. *.\ .  \. ...#.# .#
#.. . *.\.....#  .*...*. #...*. . # ....#.#*  .#........ .. ...#*\*\#. .#...* #....#..*.*#.. #...*.#
##..#*  \....*.\.. ...#. .*....*.* *.....*. * .#.. ...* ....... ... ........#\\ ...  \... .## ....\#
#...\ .....*.\...##.*.  .\ .. .#.*.*....\....#.** ..*.\. ..*......#.. *.. ..#..\.. .... ...  .. .#.#
#........*.#. ...*\.*#..  .... . ......#. ..\.  ...   ... ....*\...# ... .*. *..* ...#..**#  .... .#
#. .*.\## .*  ... ..... ... ...#*   #..\. ..#*#  .## \ .* #. *. . .#. .. .*.. \. .. ..# *..**##..*.#
##.#.. . \  *...\#....*.............*.*...*........  ..* *#*. #.*...#..**..#*.#...*.. . ..  \.*#*#*#
# ..\....\#.. ..\..##. * .. ..\\.......#*. *. ..\ **... .\* #.\....#. .###.. ... ....#.. ...\.#... #
# .. .*... ... ...#..*\........  .#*......*..*.** ..... . ... * .#*..... *\*.. .  . .*.\.*..*...#..#
#.........# .\. ##. . .*..* .#\ ..#.... #.*#...... *..\.*...  #.*.  \ .......   .\.. .. .  .# .. #.#
##. .#... #.............\\**.#.# . .* .. #.. .#.. *#. .#..   .. ..#\. #* ..*...# #....\.# *. ......#
#. #*\ .# ..#.  .#*.  *.. ..... .# .. .. . ..#.. ...*.#..*. . .... . .   . ......  ... * .... ..#..L
#..\...  . ....# .. ..#..*#. . .\. ....    # ....*.  . * .**. \.*** ##.\ ..* ...*....*#  ....*\*...#
## ...#\.#.#..*# ..*.....* * . .**.*...#...#..###. #.. ## ..*...*......R .\. ......\ \......#.. \..#
#. .\*.... . ..# .... . .#......*...... ..\..**.#*.... . ...* ....*... . .  #.  #*.. ... . ..*.  ..#
#.##\ #.* *.....  ...\ .\ *.##.. ...#\. ..#. .....*..*  .. .\..\#......\.  ....##*.#...#*.\.\#... .#
# . . #* # ....#..#..#...#...\ ..#. .#..*.  ..#*.......* .  .. .*\ #.\. ..  *...#..**..  .*#.. .. .#
#**#. .. .*.. . *.. # .. .*\#...* . ......*#...\#...\*..... ....#......\.#*. \ ..*.....*\ *.. . ..##
# .  \\..#  . * ..*... . ...\\...  ...\.....*. #..#..... .*. #\.\.\.....  . .#.. ....*.  . ... .* .#
#. .\...... *...#. * ..\*. ##.....  #*#*........#.. . **\. .... # . #...............\ *.*. *.*...#.#
#.. ...... #.. .....#*.*.........#  .......#.#.#..  \... .. ..#.# ...*.\ *.\.\...*  \..* *#.#.... .#
# .* ...*. . #. ..\ ...*.  * .... * #. #.. ..  ..#.......\\\..     .  \*  ..#....... ....   .......#
#*#\#.\ .....#.. ......**\...*.  \. . .....**.*. ..* .. #*##*#.*  .#... *.*...**. .##.# .. ..  *..##
#.*# . . \   ..#. .... *#*.. \ ... .. *..*..... . .......#. . ..   ........#.*.. \. \... .\.#*... .#
#*\..\.....#  . .*. #\..*.* .*  ....#.*.. .**...*..*. .#.....\** **#. ...  *...*..#\... .......*..*#
#*#.. \ .\*. ....*. ..*..\ ..\ .. ...# ....#. *...* . #. .*#... ...* *.. ...#......... . .. . #.*###
# . \.*. ........**......  #* .#...#...\..*.  \.\  .#\. .* ....#....\#.*.#...#...# \....#.........##
#.#* .. . .*.  .*...  ......#.\ ... ...\. .*....#. . .....\.... .. #...\ ..*#.. .  #**...*...\*..# #
#.*...** ..*#....\ #... .\..#..#.. #\#.*.#\ .# ..# *. . #......# . .. .\..*### ... *. ...* . #.....#
#...##....#.. .#. .#*.. .. #\*. ## #.....*#.## #*......\....#* #*## ........  ..**.# ....**...**...#
#\. .. ......*. .\....\. ...\.....\ ..*\ *.. ..## .........*  *.*......  *.# ...  .. **...#.... .#.#
# ...#\..* .\.** .........\.\... .. #.*....# . .... .....\..\# .  ** *.#.#* ...*.\ **##..#.##......#
# ....#...#.  ....*..##...\......\ .. .  *.....#*\. .  .*. ..#\ ...........\... .* ..#  .* ..\\*.*.#
#. .*. .\....*....   .\*..#.... ... .*#  ..# ...##.*#*.. .. .*.*\..##.. .#. ..#**.\  .*#  .....  ..#
#.*...*.. .. ....#*.**.\ #. * ... .*. *.*. ..# ..\..  .. \. . ..   .....*.#..*\....*..*. #.........#
#*  ...#. ..*..#\...#.*#.*....#..\. ...\.* . ..##\. . . .\ . ##.....#\.# #.....#...*...# #.... .. .#
# #. .. #.....  .......#. . ....# *#..  ##... .**\.#..\..\..#.#. #. *.#. *. .\..* ... .  ...... . .#
#.\..\..\ . ...*#. *#.#....#*   ......... ..#. ..\ *. ..  .. #... # ..   .*... .. #*. .*....##.*. .#
#   ...... ..*.*..*..*..#. *# ...*\\ . #..*. #.*.#.*.. .#.*.  .#..##\. *.....*.*.....#...#. *\..*\ #
#...... * ..#.   ..*# #.#... ..  # *.# #\.. *.\..\ ....*.#  .*.*.#...# ..*... ..\.\.. #\. .*\.... ##
#.   . ...  ......*.. ...* **.\*....#..  *..#.#  . ..* ... \ . .*. ......*.. .  \#*.* ...  .. .....#
#*. .*\...#*..* #. . #... *. *  .\... *. \ ...\..*...*\. . ..* .#* \ .#. .*#. # ..*... . .. .. .   #
#\ .....*..#*. ..*. .  ..#  #.....\..... . ..\#.#* ........ ..  #.* ..  \.. . **....* .. ...#* \ ..#
## ..\ ##.*...#..*\.#.. . ...... . \.....  \.\\# ..*...*.#..... *.*\*...\\....#\.* ..#.. * ... ...*#
#. ..*.... . . #.   ...*\   .*.. . *...#*......*..*. *#*.. #...#... .#\#....*. #.....#.\..*...#..*.#
#... #.  .* ..\.. .   .#. .#..#....\*#... #.*###* #.......#..... . .....*.#. ...\.......\.\. ...*\.#
#....##.#.# #* #. #.   ..#*. #.\ .  ....# .#*...\.. .# ..*# ... ..# #   ...##.... .. #**#.\...*** .#
#*.. \#..*.  .......#...... .#.\.\.#.. #...#. .##..* .. ..*...*# . .\.*..# ...* #.. .**....*.......#
##**..#\ .**.*....**..#..* .  \. .....\..  ..*.#*.. ..........**... .. .#** **...*  ...#.... ... ###
#....#..# .*\.#...*.....#........ .....# .. ## .....  .. ...#**...#   .. . . *.  .*\..  #.*\#*\.  .#
#...\ .#. *.. ..*... .#.......\..# .**... .**.  \.  #\\ ... .#*.*.#.........#.*.#.\... ... *.......#
#. ...... ......#  .. .\\...\......# .#*\ . . .\. ..\* *.#.. .#...#.. *..   #*..*.#.#... .. .......#
#........*...#**....  ... .*.   ........*..#.*.\ .  * .. ..#....* *\ .. *\* ..*.# *.*...#.\ ..  # ##
#.*. . ..#.. .....*. #.. ##..\# .*..#  ..\.. .#. .*..\**..# .*...#..# *..#*.*. . #. .#.*.\. **#***.#
# * ....# **....\ ..#.. .  *.#.. *.*.*... *.. \...*#.  . ..*...# ..#  #... * ...  ....... #..*...*##
#***.....\....* #.# #.. *..\ ..\...\ .. ...... .#...\. .*.....  .#.... ...... .  ... .\  ...* .  *.#
# *............. . .   .* ...#. .. ..  .. ..* ..*.\*. ...\**.*.  \..*........##.\.# \ .. .#.\... . #
#...*..\. \. .... . #.\#*.  ..*#...#.*.\.*...\  .* . *.\...# .\ .*...#*#...\.\..#....#... .*.. .#. #
# ..  ... .... ..#..***.... .##.. . .*..#...... .... .* . * .*.. #. .. *...*..... .  ...     ..*...#
# *..*.##.. ....**. ..#*#.. \.. *  .#..#..*. . ...\.\. **..... ..#... #... *....#...*..* \*.** . ..#
#....# ......#...#...#.# . ..#.. *.#*...\ .#  \ .*...\....... ..*.... ....#. ...*#\.\ . ...#. .....#
#....\ *#.... .# \.\.*.\.#**....\ #. *.#.. . .*. #......*.* .... ..  .#..# .\*......*..*. . *..#...#
#.. ..#  ..#.....#* \.#.# .#...* . # .* .#.#.. #.  . . .*. .*  #. .#..*.... . .\.# . . * #..*.\.. .#
#. ..\* .*.*.\...#..\.  #. .# .*..#...*...\.  ....... ...##.#..#. *..#.* ..*....*..*\  .*....*..*\ #
#.*...\...#..*. ...*...*....*.........  . #. #. . ....**...#\ #.  ...###....#*.*.......*....#..\..##
#.   \......#.*.  # .\#..*.*..**. # .#....  \...##....\ .... #.# ..##.....#*. ......\....\ .... ...#
#.*# # *#*  . *..\... # #.. ..**.....#.* ...*.....\..*##...#*...#.........*#.....  ## ......#.* ..\#
#*  ...*.. ..#...  .\.......#* *..... ........#..# .* .#......  #... .*#.  #..   *.... *.*.. . #.  #
#  .  ...#..*..* \..#   ... *# .*....*.*\.. #.. \. ....*.#\#* .\...#*.*....#..*.#.... ..*...*..*#..#
#. .** . .*#. *\.*#*#....*.*\  ## ..* .#..#...#....\..  \.#..##......#..\........ ...  .#. ###.. ..#
#..#.. .  .. ..#..#.. *##... ..... .. .* . ..... .*... ..#.#........\..*......*#.. .**.. .##.#. ...#
#. . \.\ *.\. \..* .# ..*..## ....* .  .......# ......#*..........*. ... .....#...*....\*...#  .  .#
#........ .. #  .#*......*..   ......#. .. * .. . ...#  .#.*. ...#**#*\...# ..\..\*. . .. ...  .   #
#\.. *..  .*\#\...\ . ##................ \\#...#*#......# .*......*.. .*..# .  **. .#\.#.# *....   #
##.\ . ....#*  *...# . . . ... \.  * *... . ....#..*... .*..#.\..\*..\......#.... #... .#*..\. .*.##
# . ..\. * ..# *.\ ... .#* .#.*... ....... ..#.#*. ...# ...*......*.*#. \* .... ...**... ..    \. .#
#. ... .  .#. \ ..\*. ...#.....**..\..........\... ..*.   .   *....*.\....\.## ..  ..#*....... ..#.#
#. . ...# ..## ...*#\ ...\..*. .*.#.. .. \# \.......*.\.......*..... . *  *....#. . .. #..##** ..*\#
#.. ... \#......#..\...  ...#..**#.\. .#*. *.\. \  *... \... .  ...  #...# .\..**...  *#.#. ..*\.###
# . .*.. *... .. .\..\\#. .#  \\.... .....**#.#.*. *   .\. ....*#.. .... .*... ..#*.\ ..** .#.*.. ##
#....\.#..*.* .  ..##.#....... .*.. \.. #....  .. ... **. \... #.#. .. *#. . *....*## .*.*.\.. .  .#
#.. \. *..\..  #.* ...... *  ..* *.# *....**...#\....#*.  . ..*. . *.. .*.* .#.  .. .#* *.**.#.. ..#
#. .#.........\...  ..*\.... *.*.*.....\....\..*... .*.#... ... ..##.....*.#.\..* .\.... .  .#.. .##
#.**.......... . ... #... .\ \....#.#......#.#**.. . .. .....#..*.. .#..........\. .....#.. .*   ..#
#. ..*...........# .*..* #.. # #..# #**..#.#*..#.\** . .*.* .  .... . #.*....**... ..\..\.#*.......#
#  ##..#....\.\*   *...*.. ...#..\..#.  .*.*....  *. .  ..*..\#. * .......*\.##.*.....# #  .   #..*#
#..*#. .# .... #........*......  ..   ...  *...  .  # .. * .. .# ....#  .. .  *..*. #  ... . .*.*#.#
#.....# .*.....#.  ..# ... .*\.#*.#\.... *....    \.*.#...#.  .....  *##  #..##..  ##. ..*.....*...#
#*..   . *.#*......  .  .#.##.*# .*. \... * .  ...*.\....#..#.  .......... **.#*#.*#* .. .........##
##....\ .* .. \..... .... *....... ..# \ . #\.*..*...\ .*. ..#.##*......... ..... *. .......... ..*#
####################################################################################################