####################################################################################################
#**... .*.#.. #... ..# # ..\*.....#...* ......... \#. . .#...**\ ..* .* . ...\ .  *# #. .\ ...##.*.#
## .##.. . .. ...#\#. .  .* ........ * .\#..... **.* ...#.*. .. * #... ##.. ..#.*. \..\ ... #...*#.#
#.\*# .. .##. .#.\ .*.# ...... .\***...*#.##.  .\. ..* . ....... * **. . #..\..*.. #. .  #.. ..#.#\#
#\..#*#...#.#.. .  ...\.. . .. ..  ... #....*.** #.\ #.\#..  # #.#.#.. #. .  **.... ...*..\..*#.. .#
#.\ \.. .# #. *. . *. #*. #.... .*. .....*.... ...#. #....  .# ....  .....# . *....  ....\.... #.*.#
#.\ \.  #.. # *.....*.. *.....\#.. \.#.*....*  *... #.*#...  ... . . .*.. ....... . .. *.. \. . ...#
# \ ..  *..\ ....**...  .. .. \..\.. *..  ......#*#    .*\. ....  *# .....*\ \ .. .\.. ..#.*.. .*\.#
#.#..#..# ..#..\.*. .\   ......  ... .\*.\.\..*. .#...# #\... .*.....*  .\ * .... ..#.\. ....   ..*#
# *..\. ... .......#..* . .\.# ....  .*#. \# * #.# *....  ..#\.*.\ *.#.  ...\#\....     . *\.. ##  #
###*  . . .*.#.#.#.. .# \.. ..  .\... . .. .*... ...#.. .... .. ..*....*\#.\. .##.#... #.#.......#.#
#.. *  . ...#.\.# \. \ #...\ .* .*. ..... ..*....* * #.  *#..# *.*.\ #..... # . .   .* ...*..*.#\ .#
#...***#\   #*...*\  *\.*.\.*....#\  ...\*.#.. ...#.  .#.**#...\*.  #.....#...#....#...  .....**\**#
#...**#.* #*\..  .. \.\ *...*...*#. **. #..  *..\.#.# ...*.*...*\....   .**\  *. ..# #. .#..*......#
#*.**....#* . ....  . #.. .*...#*. .. *.......#..#\  ...##......*.*. #....#  .\*\#.\.. # #.*.. . ..#
#...\.\. .. .. #. ..*#.#.... ....... *.# *. *.  . .#.....\#..*\.#.. ... * . .#  \....#.*.... ##.*..#
#....*#. .\ #..  ..#*#.  .... .* .\.. . * . ...... *\.. .. .\ #..**..#...* . ...# *#*\**.#..\.*... #
#....\  #.... *#.. . ##. .**#.*.#...*... .##  \....#.##*... \.#.......\.##..  .#...*...\\   *.#*.  #
#.. \..##.. . .. .. .\. .... *.## ...... * ..  ..*. .*. .... \. .  *\ ...\....#*....\.#.#* .*.  .#.#
#   ...*.. *.*. .... \.. .... \ ..**.....\.....  .\ #....*......  .*.\ .. #.. *... .....*#...#*.  .#
#..##..\.\.. #R. .. * *.*.*#...\.*\* *#...   ........*..# ..... *\.. ..#**  ....# ......\ ... .....#
#....*.. .....*  .. .. ..\ ..**#......... \.*.* *\......\ .....  .*.*.* .. ...**  .... * ....*..*..#
#.......#. ...#..#..*.# .#.. .#..... *..*. ..# .. ....#... .*.\#*.. .*  ......*...##\...\\.# \. *..#
#*.#*...  . ...\..#.#...*. \..  . .*.. . *..#.# .....#.\........##.....  . .... . ...  .. . .* . ..#
#..# .  \. ..*#..# .#.* ##\.#.* .... ...*.\. . .... . .    .\.\... ..#.....**#.  ...*...#... *#.#..#
## . .*.....*#... . #..\..  ... . ..\..\..# .#.#\  ..#.. #.. ..#...\#.*..**##.*..##   .... ........#
#. . ...*\  .##...* #. .#.#. \#.\##*  #..... \...**  *   ...*.#..#*.. ..... # .***. .#...*.#...*#..#
#*....*..## **#..#  . #\*..... . ...# #.. ..\ .....*............ . ...  ...*..*.. ....* .* .   .. ##
# *#*.. .\.. *......# *........ . ..**..\....\*   .#.*.. ...**...* #.....**. \  \.\...*.  .. # #. ##
#..*... .**..  .#... .... *......\.. ...#. *  .# ...*... .*#\*.#  * ## \.*.*#..\ \# .#  #*#. ...  ##
#..**........*.# *...*#..*. #.\. .  ..  . . ...#\ .#.#... ..*....*. . .....#*.*.. .\.... **..#. .# #
#... \. .#. ... #. .. .* .\...* *....\*.*#.....*.\* . ....#\..***..#....... ..#*..\....#  .\.*. . \#
#\.# ..... *...**.. ...#.*..# #.*.#..\.*..#*#...\...#...\..#.... ......*..#. #..# \.\.** *... *..**#
#\ . .. .#*\ \#...**#*.\.*   . #. #  #*..*  .... ..*#.##.#.*#  ......#..*.  ..\ \  ... ..#\#....*.##
# *.......  ...... ..#......... *.. . . . .. .....* #. .##.*#. .. .\##...#.. \.....*..\   .\ ..#* .#
#..**  ...*. ...*........#. .\.*....... .. \ .. ..\#*.**\#*.. .\*....#.. ........*.... .*.# .....  #
#...**.....#.   .*...  .\ *..\..#...* ..\ ..*... ..  .#.#\.#...#.## #.#* . .*  ..#...#*... \*.. ...#
#.. .#*....#..*.\\. ...  . ..*. #  ..#.. ..#.# \\\..\... *.# \........#.... ** # ..#  ....\  *.#...#
# ... .......   .*.... .*. *.\#. . . .\.#.\ * . .*#.. ...* ... \ .*\....#.#.\ ...  .##..... #...  .#
#. .*.*.#*.. .*....\.*#..*... ..#...# #.*.\.*\...##*\*   **\\.. .#... #  ..  \ ...#  .**..*#....\..#
#.......*.. . ..... ... .  # ... #. ..#**\\.#.*...*.....*...# *...\..#*.##.\..#.#. ..#... .#. #\.  #
#........*#   .\. #..... ...##. *.  * ...**...\.*. .# .*.. \.. .#.....\*....**.  .............#. #.#
#..#\#  .**...# . .. ..*.... ..#*.#.  *.. *\.*..# ##. . \\..*......  .#.. *.. * ...*..#.\ ..* .  \.#
# .*..\*....*.. ...\.*.... #.... #.*.. ...*.# .. .. \.*..\#*.#  .\..#  *.. ......... .  ..\  ...*.##
# ...#.* ..  *\..**.. .*.*.\..  . ... . *. *. . . .**\ ......*.....**..\...##..#. .** #..  ..\ . ..#
# *..#.... . ......*#.*. ....  ... . ... ...*#.  **.#...#.#* . .*#.... # ##.\.....*.#**. ...  .....#
#\. ..*. ..#..  .  \ .*... ......#..  ....#. .. ..#..#  ...*..*.. # #..\* .... ##... .. .. .#*. ...#
#\....# *..\ *........ * . .... ...  #. #*.* #.... ##..*.. **. ....\.*.  *..... .. ....*.....*. ...#
#*. ..\ \*#..  . .* ..#\ ....\ .... .#  ..*. ..*.....\\........#.\.*.....#  .... * .** ..  .*#.##\.#
#*...  .. # .**.. #.*  .. ..# . .\ *.... *.... #.....*  #.#*...\*.. *....*.*.....*..*.. . .....*...#
#.  . .\. ....#*#*.. #..#.. .....  .##*##..* \ . #...\.  ...*. #. ... . ...*#*. .\.# . . .  ..#.**.#
#...\# #.# .*..  . ... . .#*....*..\....... .*....  *#.\..#.......*#.#. ..#.#*.....*.\* ..#.**.....#
# *... #..\.#.. * ...\ . \..\... *......   .\.. #.. .. ... #*... *#... ... .  .*....\......*... ...#
#  #  #. ..  ..*.....   .#....#..#. * .*..#*. .*.*..#.......##\... .. . .\.. .. .... ..#... . .# . #
#..##  .....  . \. ...\... #*.*.\\.*.*.*#......\..*.#* ... .. ...*.* .##.#............\ .**.#.#.*.\#
# ..  ..*.....* .#\.#* .. ...#*  *... .#...*\.\#.....   ....\.....\..*.#...  ...##....#... .*.#.#..#
#. .\.\ \...... #..##*...#..*... ..... . ....* .. ***....   *. ...... ...*.#..#..\....*# \...*.. #.#
##...\.. ..*..\..# # #.*.... . .. .**.. \.. .*.\....*..\#.*#*. ...\.#..#*..#.  ....*...  .*...   . #
#......###* ..* \..\\. \.. \. .##*...# ..  .*...* .#.*.\.....*..*..#*..*.....#......\..#......#.#..#
##.. .#.....#.#..*... ....*.....# #.*. *#...*.**\...#.\... .  ..*..#.#\\..#....  #*.....\.#. *.#...#
##...\.........*..........* \  \..** *...#.\...\*..# ##.. #\.  \#....*...... \ . ...#.. ... #*.*.\\#
# ..*..*.........\...\# #  . .\.... ..\.#   ..#.*..*.* ....*...... ..# . . *.*..#  ..\ . .....# ...#
#...... . ..\ . . #....#. ..  #.*.#  .*#...##... ... .\......#*#  \.#\. ..  *.*.....  ...#* \.#. ..#
# #.*\..* ..........##..##.........\... * #.......... ..#\##.. .##..... ...\\*#.#**.##...#.*.  *#..#
#.  # . .#.... ...  .#... .*  *..#....* .. ....#..#**.....\#*.  ...... \... #.   .. .. ..*\ . *.* .#
#..#.#..#*#.*..\ . .\\..#  .....#....#....  .\ .* \.  ##.. .. .\. *.# .#. ...#  ..#. . .\..  ..#..##
##..*.....*.**..*.**.. *.....#* ...#** ... ...*.\.*#\ #.#..*....\**......*#..# . ...\...#\..*.*..\\#
##* .. ..*..\*.#..#\ ... #. .#.... \   *..\...*#..... . *...* * *\#.  ... #.... . *.*.. **.. .#* ..#
# .#.. .##.# . ..  #...  . *.. # .... #..#....\.\ .... . .. . ... .*....\ #. #.. .  . .*. ..\.# . *#
# ...*..#.# #......*.  .. . ....\......#.... .* ##  *.  ......*.. .. .#*....\......#.\#.#  ..*..*.##
# .#*  *.\\ . *.### .** #.\.. #.**. ..\#.... .*..\\ .... .** .  .\...*.....#. ...*.*.#.#.. .*. . \.#
#. #..#.# ....... #*#    ....  .##........ #.*..#. . .# . .  ..#.....*.   ## .. .#.#.#...*. ...... #
#. .##.#. .. #*# \.... # ..* ..#.....*  *#. .. **.# ..**... ..... **. ##\ . .. ..#.#.#*.  *..#  # ##
##.....* .\....*..*...  *....*.......\ ...\*. ..\ \**##..*.* ..  ..#.....#.....*.\*#.*\\..#**. \..*#
#.....#.\ ...*. ..#... ......#.  .  . \....##....\.*.# .\ ##  *.....**..  \.\#... .\.\......  # #**#
# # ..  \...# *... .*........ ..... .....\*# ......**  \. .\ ..#.*... .#*. *#...  .#... ..#..#.#* *#
#*.**...*.....   #..#*. ..... ..\.###.*#...*#. .. .\* #......... *.# .... .......  ..#. ...\  . #..#
#  ..   .#  .*.*.. . ... .. #. ...#.# .*..*.. ..\..  .. ......    *.. ..*#\.#* ....#...  *... ...#.#
##..\\#...#..# ...\..*#. .\*.#.. .\...#.. *.*#.*....*...*#\..**...  .*..  ..** #....#.  .....\ ..#.#
#  .\.*.... . ... . . #..#.. *.#* ......#  #..#.#   *\*.. #. *. ... *..** ...# . .........*...#.   #
#....\..... *.. ...... ..\*\ .. *..\...#. .* ...#*.# .\.**....* #\## .*.  .....\#* \ . *..*.*.. # .#
#... .**....\*  .. ...... . \   .*..  . .*...#. ... ... #.#. .. .....*#.......* . .#\. *\*.#.*\.#* #
# ..#...\ #.*....*.. ......*.#*.....*.. ....  ##..* *.##...\*....*. *... .. *# # .\   ..#.#\#. .. ##
#... ... . **.*....##*#  ...#* .# *.** .\#.. # *.. .#. .......## \. .....#.... #\#. .\..    .*.#...#
#. .. ..*.**.#*\... ...\....# ......##  .#*..  ....#. \.. .*...# ....#.\....*   . ....* ... ...#. *#
#. .**#.....\*#... .#. ..  ..\..#.\.#.#...*. .\.......#. ...\.\ .....#*..\#.\ .... . ..*...#... ## #
#**.. .#. ..*..## .*... ..  . .....*......*.... .*..#.... ... .\.##*.* .....#.. #...*.\. ..\ *..# .#
#.*.*. ..\.#... ..\ .*  ###\*........ #...##..\ #**....#.#.. .# .*.#..  ...... .##..*.\... .. *....#
#..*... ##..*. . .... *.*....\ ..   ..  ..#.\#.....* .#* . .*.##....*.*.##......*.....*. *.. ##..#.#
# ....\..\#. \\. .#..#...* . ...\. \. .**#.## .. #....*.. .* ..#\\ \.. .. .*... . . . *#....#*##...#
# \#*\.#..\.. *#*. #...\. .\*#*....#.. * ..*...*.  ...#....\............#......*.. ........  ..*..##
# .......... #\#\.. .. #...#..*.*..#\ .. ..  . ..*....\...... . .....#.... ...##.\\ #. ......\... .#
## \ *....*.* .*.. .\ ..... ..#.. #.*#..*..\\..**......*  ...*  .\ ..   .......*..#. *.*. .  ... . #
# . .. **..# #\#. . ..#.*.. #. #*.\. *.. .#. #.........# ..*..#..#. \... .* *. ..... * ...#.. #...*#
## ..* . ..*   . #. .*.\*... ....... ..##..**# ...*....#.......*. . ..#..  .\..* .* .\.....\#......#
#. . ..  *..\\.....# \. .*#..*   ....*...   ........ . ... *..#.\.#....#*.#.\...**\*. *\. ... .#..*#
#* \ .**\.  ....  *....** #.. *. .*. #..# #..#.#..# #*....... #...*...\\ ...\..#............... .#.#
# ..*..\. . #.  .\ \#.#...*#..... .  #.*# ..... * .... . #...*#..\\..*.#*......#. . .#..##*# ....#.#
# . ....\.**#.#. .*....#..... ....  ..\ *  ..*... .... .*#.. *.... *   ##\...  ....#..##..*..... ..#
######################################################################L#############################