####################################################################################################
#.*.*....  . \ *.*.*. ...*#.  . . *...\\*#.#...#.*#... *.......#.. . ... ......   . . ..#  #.. ..###
#. .#..... ...  .......#.....*.. ...  .#.  \*. . .*. .......*   . ..  ...  #. ..#  .*.    .. *#...*#
#.. .* ...# .... ....*. \.........\* .\.....#. ..#.... . #... .......*.. \. #\..#..... #**#..*#*. .#
#...**.......  *.#.... .... ..  .... .. \\.*.............. ..\# ...#.... ...  #. .##*......  .#....#
#* ....*...#\ .. .. **.*.\..*#... ..  # #\. *. .*.\ .\.*..#*....*......*.....\....#.....*...*...* .#
#..*.* .* \..*#\.\ ... *# * ..\..... #..\..... *......  \...*.#*...#. ..#..# ..#. .* \.\...*...#  .#
#  .....*# . .*##\. . . #. # ......*.*\.##.....*.... ..... ** \ *....  . ##*. ...** .... # .. #....#
#.#.\.\\.\ ..#. . ... \ # ......#...#.*\. . ....*.#*..\*. .. . .# ..# #... #  . .. .# ..\.#..*#....#
# .#\....*....\*..#.#\.  . .*\.#...**\#. ##.. ##.#*  \ \. ..*#.#* \..*..#....    *..*#.# ..*\. .#..#
# *.\# ..#......... .#  ..\..... . *#.  ... ..* ##.#*.#...#.. .\...#***   ..#* ..#...#. \.# . .\# *#
#..#. #.\. ....*\..  .# * .  . .*.*# ....# ... *# * .# .. *.\ .\*.*.#  ... \....... #.. ... ... *. #
#* .. .*..#... .#.* .... \ . ....*# .\ .. .#..  ... .....#..*#*...#. .\.   .... \**.\*...*\.#... ..#
##*#*#..... . *.. ..\......  .##.. ... . ... ..#.  ... ....*.# #....*.*\ .#* .#\.*.*# #\   .#...\..#
#*. ..#..\# ...#...#....*.**.....*.. ..#   .#\..  ...#. .#*.#.\..* ...#.#*#  #**.# *.... ... ..# . #
##.... ..#   .#. ..  #.#.  ..*.#.#..\. ....  * . ...  ...#.##. ...... ..*. ..##*. #*...   .  .. ...#
#..*#...**. . ...*\. .. \ * \R.. .#. \#*.. . ..\. ... . #\*.. **..##   ... ...    . . ... ...#... .#
##... ...  .\... ..## .. .  \.*.  ...* .\.#...\   ..*#.\..   .#..*.#... *  #.#... \    ....#..*.. .#
#. .*  # *  . ###....*. ...##...\...  * ... ..#... ..*.*.\.... . ##*....*... . ..*  ......#...#\ ..#
#*...*.......*.....  .\#.. .. . ... .. . ..  ..* . *.... . *..*... *.. * .*.....*#.**.*.....# *. ..#
##.  .   .. .....#.#..*..* .*.#..* ... .#*. .........##....#..*.##*.  *  #..#*.*.#  ....\...**## .\#
#.. .#..  ** ...\....... .#*..*#........*.*...\...# . ...*..*.#\ ..* .... . . ....#. .#*.   . #....#
## ..... .. ....  ..*.....#*#. \........*. ..*.*..\..*#**.\  .. . .#....# *.\.. .# .*.. ... . ..  .#
#  ...*.*#....\.#. .**  # .#..*.. \..#.* . .*.. * *..#..\...*.....*.#\*. \*...#   .  *....#. #.#*# #
#  ...\\ .\#.#\#.*... .. ... .\...*.#.*..... *.... ##...#..**. # .. .*#....#.. #... \..#*.*  ... * #
#..*...#.....*..  .#** ..\.#.. .......#  #. ...*..  ...#.. ...  #.*. . *#.*####....# .#  .....*   .#
# ....... .#  #...#.. *#\  .... #.....#*  #.#\  .......# *.\ .. #.... **.*...\**.. ... . \* ..#....#
# ....\.*.* .#*#... ....\. .....\ \ ...* #....##  .. ....  . #.....*.... *.....#.*..##. . ......**.#
#.#*.. . *...*....*    .. . *...#. ...  .. .*.... .....*.. ..... . ......*## ... .*   \ \   . .*\ .#
# ......*#.. #. .\........\... ..\ \......#\ .**.  \*.#...... ..\. .* ..#\ #* ..\*#. .. . .\# \*. .#
#..#... . *.** .... .. \#.   .#.  ....*......\###*...#*. .....#..#..*#..* * .\. .\ .\*...# *.\...#.#
#.....# ...#*. #. . .. .. . . *........*\#. *.... . .# ......\# ..* #.. . *\#. .##...\ .... ... . \#
#. *. ......\#.#..# ..#*. ...*... *.*\. *. ......  \.# #\.*.#.. ...  .#\ #...#*..# .##..# * .. . **#
##.#..*.. .\ . ........ ..# .. *# * # \.\*........   .. #  #..\* .....\# \ .\#* . **.#  #...*   ..*#
##.*........... .........#. .#*..#* .......... .# #...  ... ....  ...\# #\ .. \.\. .... *.#..*.#  ##
#*... ..# .##*...* .# *.\  *.\. .. *..... *..*.......##...\*.....\....\. #.. # *. ..**.\.*. ...#...#
#.\.*\*.. *  #.\ ...#**..... ..* .#....\.#.* \\..... . ...*.\##..  .*..... **. ..  . ..*\....  ....#
#..## .* .. ##... ......# ..**#. *..*#... . . ..*. ....##. ...* \. ..*#.......#.. .....##.. .\ # .\#
#.  ..\.......# * .* ..... .*.#... . ..  .\.. *.#. #.##\.. * *.......# ..*.....#..\*. #... #..# ...#
#*#. ..\*.....#..*.....  \...*.  .#. *#... .\. ....#..*#..#. #.# .##  ....   #*#. *..\...* . .... .#
#..#.*  # #.##....##. *. #. .* *.... .#.....*.....#*##.....\.........*. \..** ...\ ..\. . *. *.#* .#
#*  ..*. \........##*..\. ..  ....#. # ..*... .#\ ..*.#..#. ..\...\*. . **.* \ .....*......#..*. ###
#. #.... .......... .. #  *.*\ ..\*...*#... \..*.#..#.. .#...*...*  .*..#...#.**..###.* #. *#.\#...#
#.\#.. ..##.*\.  .*.*..# .#..*.... ....... .. . .*..# #.*. *# \.  .. .\...#*... . ...*..#.  * .....#
#.*.#..... . ..\....      #.*..*.....##. ..*# .....  *....#\..#.\.#....*.##. .  .. ..#\#* \..*#..*.#
##... \ .#. \.#. ......*...*. ...#... ..  ..**.#..   .....*.#. .\#.# . *..\..*.*.#.. . .\ .*..* ...#
#.***. . ...* ... *. . *\\ *#.#  . *. **#....#. .  .. *....#.#\.. ##. ...\.. .#*.\. *\...\ .\ .. ..#
#..  ...*  ... . \. ....... . # *.*#....\ ..\.\ *.*#\....*##. * ... . ...*......*.  .#*.. \...#* .*#
#*.# .*  .\...... ..\..... \..#\. #.....*\.\... \. ..*...*#. .... *   .. \. .......*##* ..  ...... #
# .. ..#..*\.# .#...#  \  . #..\  #. *..... .*# ...#...\ .# *..*.. ...*.*.. \.....#.# . # ..**.. #.#
#.*..*..*..*  \....*.***.*....# .\.#\.*.# #*.# .\ .....#. \..#.. . ....#...#.*... ....... . .. *...#
# . .*.... ...#..*......... .\ #.#.. .*. ..*#. \..  .## #.*. ...#*  *#  .#...... #** ...*. .*\.#...#
#.. #  ...*.#....#...\.*.*  #......#..#..\. *....#**.#.... ...#.*. *.....*..#. ### . . .*.. ...*..##
#.#   *.....#.. ...\.. ......   .\.*... .. **.*.. ...\\..*\ ..*.#*.......... ...# ... ...... \ ..#.#
# .##....\ *...#...#. ..**.... ##......*.. \ .\#...# ...  . .. ....\ .. #. *..#.   ......... # ....#
#..\.\.  ...#\................  . \.* ....#*\... *#.*#.   *....* . .. ..#...*.*#.*...#....*... \#..#
#........ ....\..*. ... . ..  ..**...##.\.*.. \ ..  ....*##.... * . .*.. . .. #..#\.... * *.. ..* .#
#.* .   ...*..#. ... ...#..*.##... #.. #.. ... *.* *.#*# .. . #... .**.. *.#...*... .#..** ...#\ . #
#.....*. ..** ##* ...... .... .*.##..* . * .......\.. . # ..#.*..# *.... .\ .**\  ..#....#  ..  .. #
#..*.*.. *...#.... ..**. *.# .#.. . . .\#..# ..  ..*.\..... ..#.....  ...#.* # *#.  .. .. \ ..#.*. #
###..#** ...*......... ..#.##. ..\ ..*...#*... # . ..#. #  ...#.\  ...... *..... ....**.... . ..#. #
#... ..... .. *#* ..*..*.*.* ...  ..... ..#.# *\..* ............ ....#..#..\..#.#..#..*. .**. ....*#
#..#.#.. .  .#.. .\. ... . .*.. .*.\ ... . ......  #....##. ...  ..  .. *..# .....*##\..... ... .. #
# #..  .  . .....*  .. ....\..\##..*#. .   #..#..### .........#....#.... .*#....* . .##.#.*.*...##.#
#\**.... .. ...* *  #...#\.*. ##...*.\..*. . ...#....*.... ..\\.*#. ..........#..  .  *...  ##\. #\#
##.\*# \.... .....#  ..  **\ .... ...#... #. .#.......#  *.#. ...   \*.... .... *. ...  ..\. *\ . ##
#\.............. #.#.. \.#  ..*. ..  ...#.   ... .# .....\.. .. ... \.###*.#.#.. *  ......\...\....#
#**.\** . .***.## .*. ..  .. .\.. ..*... . #.....#\.....*... ..  .........*...\. .\. ..*. *..\. ...#
## ..  *.#.. *...\   .#.. . #.*.*# ..*..*..*#. # . \*.**. #..... #. .# \ *.#..  ..\#...*\ \..###..\#
#*  # ..#**..*\...... #..*. # .# ..  *..#.##...#..# ........ \..  \* *... ..# ..#....... .....* *  #
#.... ... . *  .  .... ##.* .#\ ...#.\*\... #.....*...  ..*\#  .......#*# \. .*...#*. . .  \.*... .#
#....#.#..   *#....  ...##* .   ... *. . *....\. #. .... .#.    ... . * \.\. #  #*. .#...*.\.#. . .#
#.. *. * .  ....#..*.\ .* \#..*.#.... ..* *.* #.  #.*.. ....\.. ..*..**..#.....*. .. .....#*.   \ .#
#....#. . . ..  ..  \.\.....\ \.. .#*#...\.... .... ...#.\.. . .\.#.\. ..#....*....#.  #.. ......* #
#.#  ...  #.. ..*... ... . .  .....\.\... #..\# ..# . .... ........... ...  .#.. #.*. .#.*.. #..\  #
# ..#* .\..*. #....*..... .\.. ..**.\* \ . #......*...*...  .# .\   ...   # .  .#.#* ....#.* # ....#
#. ...... ** \ ....#.. ..\.#. .*\ *#.#. .. .\...*#.  *.* .... ....*..  # *\.*..*.* .**.....#..#. .*#
# ... #..# \\.*.#..##*..*.*\#.#.. **. ...#*.#* \. ..*..#\* ..#........\\#*. ... .. ##.#\ ###...\.. #
#..#.*.*.##...\ ..... .. ........*. \\  .#.*.*.. *#.. .#.#  ..\. .... .\....#\.*#. .\ ....# . ### .#
#.\ .\. .#*. ..*#.  .#.\ .*#...*#*  .*#.\\# #   ... ...\....*.. *..##.#**..  .#.#....\\#.#.#  #....#
#  #.*.. ....#.* .* * *.. . .*.. ..#.* #*.. .. #. .....#\.*.#.....  #..*..# ...#.*. ....... ..*.#. #
#.*#....  . .#. \.#.. ..#...\ *..#.*  \..#... # ..*    ...#.. .... ... **.#. ... .#*.. .... .......#
#.*#. .. #.#  ..... ..** *. ..*\#...... .. . . #..*.. .. #**...\.* .#.\.. * #..*.# ..    .#.....\\.#
#  .#.#.\.. ...  .*\\.........**. \#.#....*#...##..\....\\. .  ..... #...... *#. ..# . *. # .... #.#
#..... *\*  . ........*. #. .* # *.... .#*...... \* ...#.*.......\\.*..... \. ..... . \#.#.\. **...#
#. ..\*...   ..**......\..#\\... . #.\. .... ..*.. ..*.....*.......#*.*... ..  .\.*. . . ......*..*#
#  . * . .. ..... ..  ....\#. *#  .** \..#.* ..... .# * .....*..#  ...*#*....\  *.#.\.#..*.. ..**..#
#*...*.\. . . . ..\...##..... . .*.*. ..#.. . ..# #* #...#. *..... . ..  #.. .#...*# ... ... #... .#
###... \....*..* ....  #.# .*.#...#. .. ..##.#*.....##* .*...#. .. ....\*.* *.. #.##.. \...*.\  . .#
##*...*#........  .... . ............*.\..\.  #..  .  # .#. .\..#* ... .#\ ###.# .\.....#\....#  ..#
#... *. .#...*. .*.... .#...\* ... . *..*#..#. .... ..# . \.. ..*..#.. . ..  #.. ..*#*..\*.  ... #.#
#. #.*. \* #.# . . ..   .\..\....*..... ..*.. \.. #.. . .. \ .#....#. #\.# ...  .  ....*....... #\*#
#.\.\.# .....\.... #.... **.*.... *.#..*... . .....#. #.... * .....#.\ .......*. \* ..#  ....  ... #
#\ .. . #.\#......* . ....* *.\#... .\...\........##... .. . \.. .. ..**... *..... \ ... ....  ....#
#.... ...#.#.\#*#.\*..   ..... .#....*..#*... ...  .**  ..\.*..*...##.#.  ...*.......\..*.*..*...\ #
#.# ...###.*. .. . ..*.  ...  #.\. *.. ..**. *... .... ....  ..*.*  .. ........  # .  .#. .. # ..*.#
#*#. ..#.. ...*.. ....*.#..  .....*. . ..#*.......*#* ..*....*  .   #.#.#.. ....  \.. .  ..  *   * #
#.#.  #*. ...   ... .. #. # .... .......#. . .. ....*.#...# *#..\. .#...#..\.#... . * .*.. ...##.#.#
#.*#.#. .#. .. #.*.  ......#.....# #.. ..#.\..... .*\ ....\. ..#.. ........... *.* .#... ....  \. .#
#############################################L######################################################