####################################################################################################
#. #....**.. .*....*.#.##.*. ..##*......   \ .*.\#..#.##*.. ..\.#..\ ..*......\.*##.*..#.#.. .*....#
#.. .  . . . .# ... ... ...*.#...\ # ... .\. *..... * . \#.#... ... . .#.....#..#....... **.. .. \.#
##*#..  #.*.....\ #*...##\...  . **....#........ . #.\....\.*...*.*.....#.#.##...* ..#*. . .#.. .# #
#.#....##....*. .. #. .* \.\....... .. *...  ..#.##*.##.. ....#.....#....#....  .*  \#.....  #.#.* #
##*....*....*.....#.\#\ #* \... \. .#..* ..... #***.#\ # ..\.#*. . *..  . ......#.....\ . ..#*. ...#
#... \ .. *...... #.*.. ...  * . . \ ..*.\..#.\*.#.. #.*  . .#\......*..... . .. ...  ....#.. ...# #
#* ......#.*. *.*.#....* ......*. . #......*.......\......#....#. \# ..   * .\ ..# *..#.*...  ...*#L
#.#. ..\\...... ..*.. .#*..#.  .   ....  #. .*..#\ ...*. . ...#. #\...*\.# .... ...**.....  *. . . #
#....\..  \.** ....*.*........* ..# ..***...*.. .   .   .  ....#.... ...\. .. .*.\......*..#*.\.*..#
#*..*..*..**.\....*#.. \\.#....#*##\..*.#.\..\....#. ..    ..  #. ....\*. ...#. .  .......#... ...*#
#... .  \#.. \#.    #.*#..  \ ##.....#\.#..\.*..#\.\........\....#\.*.#*....... ..*#\...... ..... .#
#. ..   ....*. .   .# .#.#... ..**#.. *.... #*.   *..\...#... *...## ......\.. # .\ \\ . ..* #.#*. #
#.. .*.*..\..*#* .#. .\. ... . *..*..#*.....#....*...\..\   .#..#..*#.. ... .....  #.* .... ..#....#
#.\.#.\*.*\..*...  *.\.*#*. .. ... .# ..#. .*.*........  #...... .....*#....#.*\.\##.*. .#. ...*. *#
#.*.  **.\. ..... .* ...*....# . . . .  .#..   ..*.  #*..... .#..*\.#  \#..*..... . ..*.  ....*\...#
#\...#** .#.. ##.#.. .*.#.#\ ..*#*#. *...*  .* . ..    #  *...*. . ....  .....#... .. #....\*.* .* #
#..#..*#...#..#..*.  ..\*.#   . .. *..* . ..  ..*#...*..*. * # ..**.#..*  . ....\.#*#..\#.\*#*.#.#.#
#...*...* .*  #   .......*.\. .....  .#.  *......* *. ..*......# . . .....* . .....  \..#..#.#** \##
#..##.  .**..#....#. .\. ... *.#..*......   .....#.##.#*\......# ...**. . * .. .....# *. #...*.# ..#
#. *.*. ...  . #... . .*.. * .... .... ....\...*.##... #.**... ..#.. ..**....*.. .* *. .#.*...\... #
#.\# *...*.. .*. #.. #..  ..* \. *..**.*..  ..##.#.\. ..\ ..##.#..##*..  #. ....  .#. *....... .*.*#
#...*#.......#.**.*###.. .# \.*..*\....   .*#.#*. .....* #\\...*.\.....*.####.......  ... \.. ...\.#
#.*...##.# . . ......   ....\.\. ...#.. .. .. ..  .. # R \.#.    . \. .#.....* ....**... .  ....#*.#
#.. #...  ...*......# * .\.*#*#........ #*.#.     \#*.*...#. . ..\\..* ..#.##....\............\....#
# * .#....#*. *#.\ #...\\#*....   .  ..*.. ... .\..*. .. \ .............#..  .#  \.  *... ..*... ..#
# .....**\.    \.....*... . ..# \.. ........ *.. .   *.# .. . ... ...\#.... \.# ..*.....#\#.. .*.. #
#  ..#**..*.. ... . .  ..\...\..... .\.....# ...\. * # #.......#. # #. .. ...** . #.\#*....  ...*. #
#.#.*.....* # #..*#.\ . ..#..... \.. .*....*....\. . #.*.. #  ..#*\.  ....\..#..\*#.*..*. ...##.*. #
# \*. .. \ #.. **#. . ..#. .* ..*  .*..#...  .#*...##..\..  .*. .. \\..\ .* . ...\ ......* # ..*.  #
#*# .# *...*... ..##..#..\....\##..  .* #*..#*# *...*#.*.. ..*..*.#.... .#..\..*\.*#.  .#...... \*.#
#  **.#*. # .* \ *.. ..##*\ .... *..*\. . .#  .......#.*.*..\*#.*..* **....  ..  . #*.#.#.........*#
##* ...* ... .....**..\  #...  #...#. #.**.# \**# .#\...\.\. .**. ..*. ..#.\ ....... ...*  ..*...*.#
#..#......\...*..  .## .....  ... .  .\ ..*..#\.#\. .. .. *. ..*.#....... ***# *.. #...\#.* .* ..#.#
# ...# ...... * . *##...\\ #*. #\*...*. .*.. #...  ...#. .. .    ..#*..   . . *..**#... . *## \.   #
#.*.. *.*......#.......... ..*..*.. ....*....... \.. ..#\ *  *.\*# ..# #....*.....*. \   .\  .*  .*#
#.....*. #*.*.*.*#.....#  ....  \\#.  #..*. .*.* .  ....\.#. ..\*#...\.#.\. \.#.*......... \..  *. #
#\. \..**...\.... ... .* ....#. ##. ..*....\#  .. ....#......#.#..*...#* *......#... .*# .\.# . ..*#
# \. .*..  .\ .*#. *#**# *... *. #.... .\....     \##.\. .... ..\ ..*## *#.# .....###*.....*.  \..*#
#........  .......#.# ...*.. .* .  # \..\  *.   . .*#.. \..\.#.* *.. #... . \* * .*.....*#..**.* . #
#.#\  #.#\  ..*....\.*.....#  ...# . .\ . \...*..  \. .#....#.......  .*\#..\ .\*...#...*#..*#. .. #
#.......#.#. .. ## ..*..*........ ... ....* .......   ..#*.#....    .#.\ *..\... *... #..\ .*.  #\.#
#.* ......*....#* .....*..   ........#\ *...## .....*.....*.....\ ..* #.... .\...#.. ....  .*.#....#
##.. ..##  .*..#. .**..*.# .\ #.\#.  ...#..#*.. \# .#..#.....\#. .. . #......#.#......*#..  .... ..#
# . ......\#.**#. ....#\. **.*..## **.#.. *.. # .... .. *..*...* ..#. .......*... ....\.   ...\.\#.#
#\*   ..\..*\#.#. ... . ....  ... ..**...#.  ....*#........ . #.\.*#.#. ...\*.  .*..*.\......*... .#
#.###....**.. . . . .. .... *.#*.*..#.  . ... . \...  *... ..  .. # #.. #.*...**...*#\.  \*  #.....#
#.*.**. ...*. ...#.** ..*  *..#... .   #. .. ...*.\.. .. .....   ....*#.   ..* .....\*.. ..#......##
#.\.  ......* ... #\.. #.....* .*. *.... ....  .. .\*\ .*.*.#......*#\.... .\...#.*. #.*. .\\#....\#
#  ... * ..#\..# ..  #.\*.**\*##\.**...*\.#..\ # ... ...\#*.........  ...#\#.. *. . #. #*#...   ...#
# . . ...*.....  . .#. .#   ...# ...#\...**..*. ... \.\#. #. \.. * ..#.*..** * ...#...#..# ..# \..*#
# ... ...#.  ..** .. . .. .#.. \..*. \ #.\..\ **\\ ..  ..\...*.#.\ *.. ..#. *...  \ ....\. ........#
#\..# *.* ..*.\ *..*.....\. *...*.....\.*.#.\.\.. .. .   ..*. .# *...\ .....# .... ......*. #*. #*##
# *.#.........\# #.  \.# * .  .  \#... .  .  *...#..#....#*##*..*  ......  ..#....*. .#*.# .. *....#
#.... ..\. #*..\.*..\  # .  .\.*..#..#.  .*#...*.. ...*.  .#.**#.* . .. . . ...\.. #.*...*..#..* #.#
#*. .... .... ..#.. .\.#... ......#..\ .*.*.\.*.   **..*...**.. ......***... ..#....  ... .  ##* ..#
#.. .# ....   .#.\*####...#.\...#.. \.*.. .... . * .\ .... .#...*......#.. .# .  *## . ..... ..... #
# ..#.* .**.......*.#*.... .*.. .*.....  *....*.. #. \  . ..*.......  ..*.. .** .... . .. .....#.  #
#*#.. ..*....#  .*#.*. .\#.... *..**  * .. *.. ..\*..  . \..# ......\*..... #**. ...# .##..*. ...\.#
#.... ...# ..... .... *.....\... \#  .* #   \........... .....#...\ .#  ..........*.# #*#. *.......#
# .\ ..# #...*\..#. .. ..# . ..*  ..\...\...* \. . #*...#..\.**.#..*. ..*.. # ... ... \* #......\. #
#....*...#....\ * * * . ... ....#\  .. ...\#. .. ...*\ .*.#.#..... .#... ..\...* ....  .. .. ..*...#
#.#......  ..*#.. ..*. . *........ . #.. ... .. .*.... .*.* . ....* *.....*.#..#.#..# .. . .**\* ..#
# .*. ##..  #*....#.**.*\.. *..\......#.. ..#...##....# .....  * #  * .\\  .#..* .*.# \#.***. *.. .#
# ...*...#.  ## \  *. .#*.#  . ..  .....*..# ....#.\*.  .#. ...  \.\....# ..\....*.*......\*. #. *.#
#. ....#.... .#*# #. ... .*.# ..\.  *.......*...  .......*.  .. .. ..... ###. .# .#...*. # ##...#.##
# .. ...#..*..**.... ......*.... ...** . ....  .. ##..## . *.**.*...# .* ...#  .*#.... **.\ **** ..#
#.  .. ..#. ..#.*# . .*. ....... ... #..\..#.. ...\ * *...* .#... .*...\ . ..#* * ..*\... .. ..\*. #
#.. .. ....*.*...\.\*..#. ...... ..*...*..*......*#.#.. #\ #. ..... \  ..#.  ....####.#..  \##.*...#
#.  ..#*.##. .\ #..*.* .  ....*. . ..*\.##..*.*.*..#.#. #. . *##*#.. .. .\..**#*... . . .. ..#. .#.#
#.  \.* ##...#..\... . * # .\..#.. ..#*..*..*.....#.# ... ...\.*.......*..*.*. ..#..*.  *# \*...#\\#
#........... ###.\..#..... \.#*...  .. ...*.... #.....*\*.*....  #\..#. ........\#.#.\........  #  #
##*.**. #\.. #.  #.*.* .....##..\.. \..#..*. . #.#.. ..... .*\.*#** ...*#.\.*.....*....#...**.#.\\ #
#....#.  ....#....\...* .  #*.....  ..*..\..*. ..\ ..#  ..#....* #**.. #*#..*......#.\.. . .... \\.#
#..  *....    .*. ##..... .*....## ...... .  .....*.*. ....*. . .#. ....*......#..\  ...\ .*. *..* #
# ... *\ *. .  ..#. #\ .......* ..# .. ......##...\*..*.. \. *   *.* #...  \.. * ...##... .# .*# ..#
#\*....*. .##*##......**. ...#*. ..... .\..*.  *... ....#.  *\*. .... .*\  .  ... ..*...\*..# ##...#
#.. .#.. .* ** \...\*  \ ....*.... ... .#.. .....*. ..* ..* #*. ..*#.#**#.##. .....##. *.# . .#...*#
#\....* #. .. *.* #....\ .. .\#...#. .# .*#.. .. .# .# .. .***.* . .##\... *\...#...#. .*##..#.#\.\#
#.....*... .#.*....\..... .\##.  #.#......\..#.  ..\* . ..#* . .*...* #.*\..  *. ..* . ..# ..**....#
#.#*....#.*..\.#.. .#... ..#.*#. .. ...*#*\.*..#.....\. ....#.\. .\# ..##.\   #. .*..\#.*.*.*.....\#
#...*...#.\   . . *. . .#\ ...   .. # #....#.. *\#.#..  * *.. .#.. .... .#... ... * .. .#........\.#
###.......#.#.  #. \....\**..#....* #.... .#.# .*. .... \..**. .*...  .  ##...\....... .* .#...*#\*#
# ...# ...#. *#...* ...\  \........ .  ......  .  ... .*.\..**. ... . *.* ..  .. \..#.*.#..*....#.##
#..*..*. .. .# .. . .  *. .  ..#. ... ..... #*...#....# ..#... #*\**..\*...... .. #. .\.. **......*#
# \ .... #....#*...... ......# .##.......*###\ .........*\ \*   \   . \# **.\ .*..*.... #........* #
# #... ........  .....  .#*.. \. .#   #... .*.. *. .. ... .*..... .#..\ . .. \.  ...#..# ... .#.#*.#
#.*## \...#.. . \...##.. ... .*.... .. .*..** \. .##*  ....\#..  # .. .##...**..\.*.#..*..#* . #...#
#*.# . ** ...*.#.#......*\*  * ... ....... ......#.#..  .....*. # . ..# ..#......  . \...**... ... #
#.* ... . .\..#..#... *.# . ...  . .*..*.*.* ..*... *...*#.   . *...*...#.**\ ..#..** ... ..#......#
#.*.......* ..#.. ...*..*\*.  . .  #.    . . .. .....#.* ....   ..  .. .. . .*.**. .\..*.*.# ...*.\#
###*\. . . \ . # # .\.....   .. . * *  ...  ... . # .#.... .\.#. ...**.*.............#\. .\**...\ .#
#. #* .\*. ..* .\..  . ... .*.*.\..*..\ .#...##*....##... ..*# .**..\\.  ....##..# . .###*.*.... ..#
#### * ... #.   *..* . .. *. #.....*... *  .* .... ..** #. .....\.. .\###.#*.. .*.. ...*  #* ..#...#
#  \ \#. .. .. #. . .\. ..*.* \.##.....\. *\. .** .# . .  #...... ..#.\.  . *....  ........ ..... *#
#. .. .....\.* ...#.  .\...# . .... ..* \.*.*\....#.. . ....# * ....#.  #......... # *.# ... .. *..#
#..#.. .*\ .# .##*.###\#\..... .* *...   . ... .... ## \.  #... #..\*.... ....... ..#.  .** ..    .#
#.* .... *\.#. . ....* .. ...*.#. #.*.  ......\.. *. *#.. ..##.....*..*.  ..........*. *..... ... ##
#.  .*. ..  . ... #** .. . *..*... \..\ #..  \...... ***##..  . ...# * ..... ....#\ . *... . ..\. .#
####################################################################################################