#####L##############################################################################################
#.* . .*.* ... .\ .#..#.###*..#.. ... ....\* *.* .*.. ...#.*..* .#..*  .*.*....*.. *.\.......#**.\##
#.##.  ....*.#\ *..... . . . *.** ...... .  ..\\ .. .  .#... *..*.... ....**.\  ..\.#.*.*.. ..#\.\ #
#. *#..#..*.*.  ... * ...#..#..**.#..* *#..*..\....\.  .. ..#. .#.## .\  ......  .. .*..*.... #.*\.#
#.\....# .  ...* . \..*.. .. *#........ ...# .........\. \.#  .#...# . . *.#*....#.. ........ ..\ .#
#.. # ...* .#...# .*..    \#.#..  .\*#   . \ #..\*  * ......  \\.. .. # .#.*#.#*.**\*..*..*. *. #**#
#.\ *......*..... .*...... . *#..*. \..#.*...*# *\.*...... #  ...  . ..   .*\.\...\.... *#.#...#...#
## ..# ..*...*.\. ... ..... # .*.#* .....**\\.*.... . \..*.**... **#. *. .* \.... ...*.  . ...#.# .#
## ...\\....... ....#*..*. .# . ...*.. #..#.. ##.*.#.... ...*.\.. . .. . .. *.#. .#..# .. .*.*\*\.*#
#... . ..# *#......\*.......#.. .#.... ..#......\........#..*#.. ... *.\. ....#*.*.\...... . #.#.###
#...\....# #.  ..** . #. .#\#*..    ..  .  ..... .\.....*\* .*..\*#* * ....*......   ..... .. ..#..#
#..*.\..*.*.#.. ... ....*.....*....  ............*.* \.*... ..#......\ .. ...*... ......#. *#...# .#
#.  .\..*. #   . \........*... ... ..*.....*... .* .* . #*..#. \....#\.... *.. \.*...... .# * ....*#
#... \.*..#......##  . ..... ..##.* *.. #\ . .#......#**.... .*...  .....#. ... *\ \\##   \  ...*.*#
##......  *..... #*.. \. .#.. ..*.*#..*.. #*.*.#. #..#..* .. #. ..# #* ......#\\.*.#...##...# .. ..#
#.#..**\#.#. .*.*.***#...#..\...... ..#\\#.... #*.*. ... .#. ..\.#.. .*\\.....*.....#..#. \..\..#..#
#** * .. . **#....\.#.\..* ... .. .**.. .*###. * .... ... ....* .***..... *#.  . ....  . .\#.**....#
#..#.#..#.#...#.#.. #*....*..#... .#..*..\.......  \.. #... .#..*. ..  \** .#...   . .... *.  # *..#
# *..#.*... *\.*.......#**.# \ .*.# .. .*. \*  *.** #.* ..###*. ....#..** \ *.... ***##.... .. .#*.#
#. . .. . . .#...............  . .\.   .* ..   #. ....*........ .#.*\.\....\.#... ..   ...\. ..#.\.#
##. .\\.. * .* .\ * *.#.. \.*.....\    .. ..# .....## .\. ...*  .*  .\.  # . *.#..*\ ..... .....   #
# .\.* .. ...\...\.. .# \.. . .. .#\. .#\.*.....*#..\. .\ .  ...  *.....\\*..\# . ... ...... \* .*.#
#.. .. ..\.\.  .*...#  .* . .#. *...#..#....#....  #.#. ..# .. .\..*.\*....#\.#*.*#\.  \. #..*  #..#
#.*#*...... .# ##. ....*... . ..#.*.##\.** *.#  ..*....* .... *  ...#   #... . .# ..*.\ .... .. .#.#
#..##..* ..   .*.#   .* ..#\* * .*....# ..*  ..*...*  *.. .#..\#...* .#  ... .. .*#  .....* .*.. ..#
# #\*  ... #.\. \   ..* #... .#.......#*  .\. . ....\ .... .. . .. #. . \#.*. *..  *.... . ....  #.#
#..*..  .*\.\..*..\*... ...\*...  .....\*#*.  .#..**... .*..*. . ..\.\... .. .\.*.... . * ...## \..#
##.... . #....... *#. #... . .... ..... ... . \. #*...*..*... *.\.  ....\  #..#.........*.*.......*#
#* .  .\.* .  .... .\...  *  ...\.#.*#..\..*#.\.##* ......# .*.\*#**.#...  ...# * ..... * .........#
# .*.*.... ......\\.  ..#* ..*....# *.*....* .#.\.. * .* ..\... *..#. . .. .... .*....#.#...... #..#
#... *.......# .. ......\...#\ .*.. .#..... ..... \.. .*...\ \.*....\... ... ...*.#.#*  .......#*. #
#.#...#\.. .. .  *#.... .#...\#  ...\.#..\.. ..\..#. .. * ..#. *## #.... ... ....#*..*..  #  .*#...#
#..*..#.*.*#* # .. ...#...#.. .\\..\... ... #.*..\.*... ..*.......# .#\..   ... \#...  #.*... . ...#
#. \ .....#  .# ...##. * .\.* ..*.# \..*......  ...#.*. . . .. .\ .   #...*. . . .. . .*.\#*.*.....#
#....#...  #*...*.. .*...........*. .. .#   #....#.*...  ** ......#*#.\  . *. ..  .*.#. ....  ... .#
## #....\\... ..*** ......#..#..#*.\..# \...#*.. .# . .... . * # .. * *.***#  .... . ** .. #......##
###..  .##..# ....   ... . ....... ....  ......\..**.. # ....* * # .*#..*.*.... .*. .  . \...#..#..#
#....# .  #\.... ..**. ...\. ..  *..  .#....   .\ *... *.#.# ##.....#\ ....\  #  .........#.\ \....#
#* .#.*\..#*\....*#.. .. ..#.#*. ...* ... . .   ....\.. #..##  .... *..... . *...*\ .\\.. ....#*.. #
#...*\* ....*. .*\#*. #....#....... #..\ .......#... ..#\.# # .. ...#* . ##..*..#. .. .... #\..#...#
# .. ....*. ... ....# ..#*# ..#.#..##... .*#.#....## .... #* ... .**..**.##..#..  ..#.*... ..  *  ##
#.. ** *.#...\. .**.. **...  ....**#*\ .. #... .. ..\...  .*..** .#*.#..*...\ .#.#......  . **# .\.#
# .. .# .. ..#....\.##\  ... .  *...#.... ... *# *.#*..#.#..   *...   *# \....#.. . .**.\..........#
#...........##. .....# #....\*..... ....#... .\...*  **.#  ..... ..  ...*.... . *.......*. ...*. #.#
##. ..*.#.\ ...*.  #\*.*. \......\...\. *. .  . . #*. \. . #. ....\.*.\....* .* *.. .##.#. ...#*\.##
#..... ...# *.\..#. #.....**...*#. ..*#*. . . #** .. ##* .... . . #\#..*#.. \......#......  ...\ . #
#... ##. *#. ..*..*...*......*.# .\... ...........  . *......\\....... .* ....* ...*. . *. .*.*.#..#
#*# *#\#..*.......# .....*\ *... . ...*   .. ..  ...#. .#...\.*.* ##... ... . #.... .  .*. ..\ #. ##
#*...##..*. *. *. ... . .#...... #.##. .*#. ..#...*..#  ... \.#...\.*... .. .\#*....*\.*..*\.......#
#  #.. ....  .\....*...... #..  ....* .....#..#* .. .. ... .. .* #.  .#.... ...\....\. .*....#*** .#
#. *..*..*.. .#.#*  .*\.*.##* .*..\...* \..##..R .....\. .. ..#  ...  # ....#..... *#..#.*..    #..#
#...\..  . .... ..## ...\.... .. .#*.... # . .....#. . . . #**.*....*.. *.. \............. *\.  ...#
#. ...*.###*.  .#* .. ....*#..#. *#..*. #* ..  \#.##\. ..#*\.* \.\*.#.*.  .....* #\. . # #.. ..#*#.#
# .... *..*. .#** ..# ..*# . \..## #*\*... ..*..#.#.#....... \#..\# ..\ . .\.#*.. .#.*#... .   ..###
#....*.#...#..... ..#*#.\*.......**...\. ..  . ...# . ......  #..*.. . ... .. ..  #\\* \**.....\ \ #
# .. .*......*...#... .... # ##..*.*...* .## #. .. ...\*. .  ...# .... . #.# ..... \# *.***\.#...#.#
#.. .\ ..*.. #.. . *. #..#.*....  . \..* #\ . .. .\.#. .  ..  .  ..\.*.*#  #*\\ .* .#.#. .  #* ....#
# ....#.... # .* .... .#.#....... \   ... \... .  . ... \.*.. **... .. *....*... .*...#*\...*.. * \#
#. \.*. .. . *.*.*#*\#* ..  ...#*...\ #..** *....*.. .*#\ *.*... .#...#.....#.#. ...* .\...*. #..*.#
#**..\. . . ..#.....*... *..* ..*..  \ .*\ .* *..*.  ...\*  *. ....... . #. \ .*..... \. ..#...##. #
#..**.\..#.* \.....\.\\....# ....  #.... .*.....\ .#....*##.. ..\ .*#.. *.#.. ..*.#..*....##\.  . .#
#  ..#   .......\.##.#... *.\*#*. #..#...*.. . \...... #.*.*.... *.*..*  ....* ..... ..*....#.\. . #
#..*..  . ...   .. .  . .  .... .  #... .*..... .. .. #.*\\..\*.*.*.\#.. . *...#.  .  * ..... .....#
#.*...*.  .#.. ..\. .#*...\*...*. . ...\ .... .\.. # . .\.#. . ..  ..#....... .. ..*.. . # .\.. .. #
# #. .#\## ..*. *\#......*...#*. . .*. .*........  *...\*.....\.... ** *.\ ....\.. .. .*..  .#....*#
#\#.... .**#. #.. .. *.. .*.....\#.\ . \ ..*#....\ *...\  # .     . \  ...*#...\ *....   ##..* *.# #
#*.#. *..* #...  .. \.# .. #. .   ## ....#*...... * .. \ ....*.\. \## . ...#*  .#..*  .* . ........#
#. * .\ .\# ..... *...### #..# .*......*... ......  *** ..* .* ##.#**....  .........  *..*\*.\ # . #
#.... .. . . .\.*..* *.* #.\..*..##. . ..\\..   .#...#***.#....*   ..\. .*..... #. ..  ..  #  . *..#
#   .*  ..#. ###... #......*. #...**......* .*..*.\*. *..  . ..#........#... *.. ...  #. .*#.*#. #.#
# .. . . ...#....#. #......... ....#. #*. .#...#....##.#.*..\.*.# ...#*. .*.*.. . *.*...*#.. #.#...#
#.. .*..# ... *.*.*.... .#.. ##*.. *.. ..#\#\.\ \....# . .#.#\#... .  ..  #.......##*.*...#...#. ..#
#.#.... #.#..* ..*.  ..#\ #. .... .. *....# . .. .....*\* #.#. #..\.*. \..#..........#...#. ..*..*##
# \..\\...#. ..*.** .. . . ... *....   ......... .#*.......  .*. .... **\.*...........*#. *#.*.. .*#
#\*.\*.... ...\........  ...\. #. ....\....#.*....*.*\......  .#. .....#.. .#... ...#\..#*. .*. .. #
# .* ....#. ...  ..... ... *#..##\*\*..* ..\.   #.#.......*.#...*..  .  ... . #..* #.\.*.  .#. ....#
#.*# .*.#..... ....# .\. ....*..* ..  ....*\ . .....  .*\..##.\.\#.*....#..####. .* ......#........#
#.....  .  ......*.   ....*..*...*. ..   *...*.* #\* .#\.. *...  \\*...\ .. .\ .. .. . .\ .*.*.# ..#
#*#. .#..  .....  .*..... ......*. . ...#.\. ....#*........  *. .\.*.. .*# .. .\ . ....* .# \.  ...#
#  .\..# ..\#.. . . ...  ..* ..*......* ......\*.\.. ..\ * ......##.\..#. .#...  ..\....\ #..#....##
#*. .. . ... ...*..**...#*....# ..#.*.*\\...*..*...\.  .. . ..* ....#*#.  ...*...#...*..#.#.. .*...#
#. ... *\*..  .*.. .. . #...#\ .*.#. ... .... . \.\.. ..#.#.. *..* ..*.*.#.....#... ....\...#.#....#
#..##  .#\#.... . .#..##*..  ..# ...#...#. #....#.\.* ..... \.\*..\. ... ....#. *..*..#.# *.. .. **#
#.# ....#.. . #\..\ .*.  .*\##\......*..*\.....*.  .#*..#..*..... ...* .#\.....\. .\.  #....##....*#
#. ..*. *\ .... . * .... .  #.   #.  ... .*. .#...... . ....##... *  .*....... ...*..\........#....#
#....*.... .*.. #*. # ..   .*.\ .....\.\.....*. *..... ....\.....# \......*. ....\..*.\...# ......##
#*#..   ..\  . # .# .......\....... .  .*.* .#... .. ..  .   \. ...*...  .\. .. *..  \..* *.   ....#
#\ . . ....... # ..#.\... #* **. *.* .*.\...... .# .*. ....\*..# *... .. #\..... **....#......#....#
#.#.....#*. \..# .......#..#.... .*  *...##....\*.. #.#..... ... .* *.**.#*\.*. .   \*...# .\.....*#
#..*##.  #..*.\..*# #. .*# ..\*.. . . \**#  ........  #..*....*.#**...\.#..\.#..\.*..#..  .. #.\#..#
#  \.   *.* #..#...\....##.... ..#....#...# . .*..\**#.. ........#. . #*..#.. \*. *. *...#.... .. ##
# .... *. .. . . .. . .\#.   \ ... .. *..#.*.\ .#*#..*..\......# .. .... .#.. ... *....*.... ##.##.#
### .#.*.. . .\..... \ \.*. * .. **...# ... .... ... . ..*.. #..#.....*.\ .\.....*.# .*  \\.... .###
#.*.*  .#. \.* .. ..#. . \* .\....#.# . ..#. .. .#.*.. ..* .#.  .#.*.*..#\.. \.\....*.#.*.* *.\.# .#
#.. #...* ** #.  .*. .*.  .. ...  * ..#...*... .. *.....\ ...#......#..   . #... ..#*.\...*......*.#
#. *.*..#... ..#.*...** *.. #. ...*. ..# ... #.#  #.#...*.\ .*. # \ **..*... *. *.####.. ..# ..*..*#
#*  .* \#.#..*.. .. #*.... \.#.#....   #* *.. ..... . .#. *.\..\* ... ##* ........#*\.#..#.   ...  #
#.. .. .*.*... ..*.#. *..*.... . .. ... ..#. .*  ..*...... \. *.#.....#.. .... . ..\...*..**.*# *..#
#...#... .  ... #............ .....#.*\#....*....\..\*.....* ... .#....... .#. *... *\* *.....*# ..#
####################################################################################################