########################################L###########################################################
#*.* .. .#.  ..  ..#..  *. ....#...\* ..*..\ #...*..*. ....  *   \..*... . #.*#*   ..... ...\. *.  #
#......#......#.#..#.*\* \.#...*.... #.. #.... ... #. .# ..*...#. *#.* *.....#\..........   **. ##.#
# \#... ..* ......#\*.*  . ....*.....# ..\.\.\.. ..  .#...# \.......#*\*...*# .\# .*. ......... #\\#
#... ... .#. ..R**.. ...#....**........* **...*..*.**....*\......  #.#..  *.*.*.# . *.#*.#..*..#.. #
#*. ..#....\. ..... ..\... ...\...\ ..... \...\. .#...\ ..\.... \..#.*..\*...* .**. *. . .#....\.* #
#. .#..\....# .#.*.*\.\\#..\......* .* ....\. .*...*...*. \.  #..*#...#.*  *.. ......#*..\ \...*...#
# ..* ...*. .. ..#....*. * \ #.*  ..# ....\*.... .#.*. ......*.....#..\.\.\\ .....## ...*# ....*. .#
#....... .***#..#..... ..#\#* #*\. .*##..   ....\#*. ..*. ...##   .. ....... ..  . ..\.. .. .#... .#
#*# .**.   ... .....#\ .. ........  .... .. #. ..  ..# ... . .#.#*.#....* ...\.*... .............. #
# *.. .   .  *.\...... ...\  \#. ...# .#......#.....#...#.....\.   ....#..*  .. #.. .... ..*.. ....#
#*\..... ...#.\ ...#.. #.* * #........*...*. ...\...*.* *... \. #. .......#...*. ...# .. ......#. .#
#.#.*#.*......## .* .#.\....\..  ......#.#.. ##... ....  \..... .. *....*#\ .. .\..*..... ..#......#
#\..*........# *##. ...**. ###......\  .* . . ..*....... #.... ..\... ..*.\....* .*. . . .....*.#. #
#....*. .#. *.. #...*\...#. ....*.. .#..# .*\ ...\ *.......# #...#  *..#\. ...\\...#.. .*.......* .#
#.. .. .\ . #...# #\##..#.#..*. . ..*#.... ...#. # . .  ..#. # . ..\ *#.* ..#\*..*. #.... # ..* \ *#
#.. *  .....#. .. ..\. #....#\. . .  .... ......\.  ..#..#....** ..  **... . *... # * \*... ....\..#
#.. ......\*.... .***....  .  .#..  \ .#...*.*.. .  .*\......*#  ... ...  #...\#.. ..#\.. ........ #
#.#... ... ..# # ..#.*#.... ..#.. ...#. ..#....#.. ..  \*.#*.. *..#..  ..#..# .***\..# . . .* .**.\#
##... .##.\#.....###..\..\... .* #...  ....# .......#.#.  .. #. *\\\.... ...    ...#\.#. . ..**  ..#
# .*.... ..\*.\#..\#... .#.# ...***\....* ..... ... ..#  .# . . .\.. ..#..... .*.#..\ *. *.\ *.\...#
#\..\*.*..   .. ..* .#*#.*.*. ......*.*. .. .. ..*. ..   ...#..*......... ..  **.\ ...##.*........ #
###\....##*  .....   * ... ...... ... * ..*   #...... . # . .. . #**..#.... .#. .\.#....#..*  #.*..#
##....*#...\.. .#*.*.  * .#.....*.#.#....... .. ##...#... #....*.....**..\. ## .  #..*. .#*..* .#**#
#.*...... .#......\# .##  .. ...... ...#.#...  .\..\  ..#.*.\##.#**. ...  #.. . *  .  ... .**..* ..#
# .... *..#.*..\. ...\..\#\... #.* . *.#... ... ...  .....#\#.. *.##.*\..#... ........  * .  ###.\.#
# *...  ....#\..\#* \*.... *\*.  *....  .*......\  ...............   # #\\*\. ..\.....# .*....##   #
# #...\ .. .. .... *.....* ....  .*#.\\.... .. ...#..# # ..#. .. .....*.  .. ..*#.**  ... ..*# ....#
#..*. .*..*#...\* \.   ....  *.#.#. # ...... ...# .#.    .. \...*#..\..*.. .. # ......** #...*.*##.#
#....#....#....... .. #.*.. \. ...  ..#......### .\.# ...\ *.. . ....\\#.. ...........\..\.. .  #..#
#*  .\..#... \*.*...\...*\... . ..#*#  ... \*..  # .... .#. ..   ....\.##\  .. . ..*.*##.*#.. ##...#
#*. .#*.##  . ... * ...*.# .  #... .#*\ ...   #.. .\....... ##...  * .. .*.... * #.......*.*.##....#
# .*    ... ...#...... #* ..#......# .  #..* \  ......\..*# ....#..  ..#.#. #\ ....\ ......\..... .#
#..# ..... *.*.. ....*..* .....#.\** ...*.. \#.*..#.* #. . .....#... *....#**..*.**..* .#.#..... \ #
#.\... # ..#.#.. \ .#* # *...... . .   .. . ... \ . \   . .*. \.......#\.....*...\ .*.  .#....... .#
#.. ... *#.. # #  #*.. #....*.. ...\.  .\.\##*.## .. .*.*#.. ....#......#..# ...#.*.....# .*. \. *.#
#.\..#...# .... . . ..#.#..\ .\. .. \ .... .#.* ...*.#. .\\ . ... *\. ...#. ..*... ..\#..   ..#.. *#
##. ..*.## . .#....#.##...*. ..#.**.... . .## ..# .*..#..* ...* *\# ..   # ... .  ..#.*...*..#..#. #
#...*.* ... ..*... *... . *. ..*.*....  ..*....#*.. . .#*.##. \.*.\.*.#   ...*..#. \*.#\.......... #
#*. .  .#.* .#. .* . .\..#... . #.*. .......*\.\*.....*\.\#*..\\\ . **.*.\. ... .  .. ...*\ .*...#.#
#.. ...# ....\ ..*..*.... ..* ...# . ...\#..#.*...... ....#.*. . .. #. ###..* *.#..\... .*......*..#
#*.*.....*... \.*..\.#  .  . .#... *.....  ..... ..#*\ *...#..*    *#.*. ..*... ....*..*\* .  **.#.#
#*. . ..#\\...*..#.*.. ..*#.\.*..*\..##..* # . *. . .  .*...... ..*...* ......\#. ..#. * *.... #..*#
#*#\.* ..#*.*\\#....*.#.....*... ... .   ...*.. .. #.........#.... ..*#*...*  .. .*...#. #... \.. ##
# ... .....# . ...\#....  ..\..*##\....\... ......#... ##..##.\.*#..  .*\. \.# \  ... ..*..#.*.....#
#. *.#*.. .\. .  .\...*..... #.. \.#\..\.  .. #......\ #*#*.*#...*..#..  .\##. .. ##... .*.. ##*.* #
# ....\. # #..  #.  \........#... *.#..\.... ..*..*\#..\......**....#.\*... \*.*....#*   ....\.*# *#
####.*... .. .. ...*...#.. #..  . \#.... .\..# . ....**   ..... #..##.. \... ...# .. . . #.#.....* #
#.\\...#..##...\  .#\** *.. .\. ....*...*#.#.*...##.. . ..*... ... #..*. #.\. #* .\*\.  *..  ..\. .#
#*..*... . *#..#....\.. #* *\* .*. .. \. .. #\ #.... \....* .. ..#.\ .#......*....*.#. *...# ..#.\.#
#  ... ..#...***..##*\#* .*... #\  ...#.\. *..* ..*....*..#  .##.#*.#.#..#.\.....  \#...\.......**.#
#  * . . ..\##.#... ..#\....#...*..## ...\. * \*# .#  ..*\... .......*..   *\.**.........#..# ...\.#
#*.....###*..... ..*......# # #.. .. #\. .*.\.. . ##. .. .... . .... ..***.  .**.. **..*. .. ..**..#
#.#.... .##. . .*#\.# .......\.  *.*..*.\....**# ##.... ...*.....\......*#.. #.. * . *..\  ...... .#
#.... ..     ....\. .. ##...\... .. ..#.... *#*# #. #........\  .\.....#\. ..*. ...\..\\. .\ \...# #
#*.....\*. .#*\...***..* .#...\*...#...* \....\#\.\. ..* .#\*.  . . .#. \...  .. ..  .#.\..**..... #
#.*...\*#.#....... ..........* ....... ..*\.  .. ...\\.# ..*##. .*... *#.*...# ....*...#...\*  ...*#
## . ** . ..*  ...*...  #.\. ..  #..#.*.. .....\. * ... .......  ..#..#.#\#...#. *...\.* ..\.*. .# #
#.*..#*. .\...* . \ .. .....* ....*** ... ## #   .....*. .# .. ...#.... .#.###  ..\...\\*...*.#.#..#
# . ...  . ..\.......\ . .#.  #.\..#.. ...... . .. \. #.........\#*.\.\ ...**. .*.##*#..#\..\##....#
#..\ \......  ... #. ..#..\#*....\  .......\..#..* .\.*   *#...# *.\#.  .**.. . .##. ........#.  . #
##...#.. #.. ....#  ... .# *...*...# \.. ... #..#.... ..#\# ....*#.. ..*.#.. .*.. ...#\. .... . ..##
#.....#. ...# \.....\ ..##.\...\. .. ... .#....*.......\.... ... ..**#.. ... .*.#   .#.....#.......#
# .#.  .#.*..  .. *....\#....*.. .*.* ...* \.#\ ......*\. * \...*#.... .\.\.\*#.  ..##.* .. *#. .* #
#... ..#* . .. .\....\ .\ . .*... #.....#....#...#.#.*. * .# ..\.#..... .. ....*... .*.## . #...\..#
#......  ...   .... .*. #. .. ..*.. \....* \ .....#\....#\.... \ .. # ......... #*. ...##.....*\...#
# .*.\.**.\. ..\... ....#...*#.#*....*\..\\.*..*#*#..**. .*#...  ..*..#.  . ..\.*#*** . \*.... ....#
##... ...#* ..#.# .#..#.*...\ ....*.# .. . ..#.\.....#...\...*#.#.  ..\...#..* .* .*........ . .*. #
##... #. ..*#...\ #*.##*..**...#  *.#. #*.*.*.   .# . . ...**#*. . ....#.  .. *...#..*....  ..*#...#
#........#. *#.##*#..\.......# .. .**.... # . *.  .....  .*. .....#\.. .\...\  . .........*.##*.. .#
#...*..\....  .  .*  ..........*. .....*....#... ....  ..\#.. . .\\. # *.*.#*. .. .*\\........* . .#
#.. \. .... *  \...*...........# .....##* .....#... #* ...\. ... *. .#*..\.#.. . *.....*# **.# ..**#
#.#.**....  . *..*..#.*.*.. *....\......*  .  . *#...\.#*.....#.* .. ..*.#....*#....##.....* #...#.#
#.. *... .##.  .....\*..... #*  . .* ..\.....* . \.  .##   ...*.. .. ..##..#.**..#\..*#..#.* #.#  ##
#. ...*# .*.#.... . * #.*.#....*.....  ..... .**.  .#.....#*.*.* *#....*  . .** * . * # \......*.. #
# .... ..#..# #..* .#*....*.. . .\ *..  #\....\.... *\.\...**.. . ............#..  ****...##.#. ..##
# #... ..*..  .... . . *.#..\...  .  ..**.* ....#....*. *  *.#....\..\.  . .#\##..\**. #.\...*. ..\#
##.*....*.. ..*...#.....#. ..#.*.#.. ..\. .\....#** *#*. . ##...... * ...... #.\..#........*... .*##
#...#..\. .  *. **.#.*. ..##...... .... \..# .\##. .*.*..# . ...\ ..* \*.###. *.... .... .   .#.*..#
#.#*.\. ..\* ..  # .*  .#.... ......   . # . ..  ....... *\.. . ... ...*.# ... ..*..  .##**... . #.#
#*....#.#......\ ...##*.. *..#\..*## .........#  .. ..# \* *....*#..* \. . ..* *.......*..\.. *....#
#...##\#.# \\..* ... ..#.  . .#. .*##.*.....#.#.#. . \. .\. ....*.##  . ...#..... .......  ..#*.\ .#
# .#\..  . ....*.. ...... .*.#. .....#.#\....##... ..  .. .*..* ... ... ........\* *.....#.\\.....##
#...#. ...\ . .....\... .\.\#.. .......*  . ...... . . ...#.... *... .. ..#..#\. ...*.#...*... .  .#
#.. . *.....*\..  .......**..*. . . #. \###....##..# #..  ... . .. . ....#.*.** .*....##.......#. .#
#\..*..* #..  *....**. .\\.*.. ..... . .... .......  . ...*. . .## #  ...... ....*......\ .. #.....#
# ...... .. \ #. .. .. ............*.#\# #..#  ...* #.##...  #.  ....#..# ...#. ##....*#.  . .. ..##
#..  .##... . ..* .#.   *.#. ... ..#.\#. .#..* ##\.#**...\.\ .  .*..* #.... .. .... *.#**... .#....#
#..#  .*..... . #..*.. .. .\....** ..# .*...... ...#* ..\ * *#....*.. . . \ .# .\** ..\ ... ..#*# *#
#..*...#  ...*.... .#\.#..## ..\...#....*............. **..#  ......# ..*..**.*. ...  * .  ...* #\.#
#. ..*...#....*.  #.. . ...# .# ...*. * ... ....##\. ........ .#*\ .. .. .\. . . .*.*. #... .... ..#
#  ........ . ...*  #.....\  ..##... **...*....** ....# ..\. . ##.*. ...*.#*  .....# ..  .# ..  ...#
#..\ #... ..\.... . .... #... #... .\\....#.  .#..*...* ..#  *..\*.*.....*..\......\*... .#*..  .**#
# #.. *.... ...#...#....**##*#..*. ##.. ..  .#.\. *..**. . #.\..*. *..\..*..#...* .\..\. .. .......#
#...#*....\#..\.*.*\.*..* * #\.  .\ #.. .   .\ .. ....*....#  .... .*.#*. .#..# ..#. *... #*\..#.#.#
#\.....*...*. ...\*.. *...* .. .... ....... #...#....#.* ..*.....# *. ...\.\.##.# \..#.......... ..#
#. .  #*.*..##... . . . ...... ......#.....**\##  . #..\ .#.\.. ..***. ..#.*.. ... * .\..\.. ...* \#
#..*.#...#. ...\\ ..  * ....#..*# *..#. .. \ ...... .* .*...\ .......# ..#.*.... .\....   ...*...# #
#...  .#.  .#..#... ..\.......\*\. \.*... * ..*.  *.*.. .#.**.......... \\#*. .# .. ... *  ..# *. .#
####################################################################################################