#################################################################################################L##
##.#... #.. .#.\*#*.*.....* .*#....#..   .......  . .**..\*..\*. .... ....#.*. .\* . ..*........* .#
#..\.......\.#   #..... .. ..... ...  ## #\  #..\#* .\ . *..*.... \##\..#* ..**.* ... .... . .... \#
# ..*.....*..*........ #.*#.. \... .*\....#.......\  .##...\**..   .*\ .. .......  . ...*..*.#*#. *#
#...#...\... . #. #*. . . .. ...*.\...*...   .. ..# #..... ...**..*.#. .#..   ..\...#. ..##..* #.  #
#*....*#........*. \*.\.\.\\ . * .. \..*.... ....* .. .*.... *. .##..*...*. ..#..#.. *.\#...#   **.#
#.... ...*..*.#.. # ..* \*#*..\. #.. . ... ##   .. *#.#........ * .. .  . ..\...\. ...#.*...* .*  .#
#. .\.....**.. ....\..... .##.*.\ *. .#.*\.....#.*\........#... \ #.\. *........ ..**  ....\. .....#
#... .*. ..  .#..  ..\......\...*....... *\.. ..*.. .**..#\..\.. *.....\\.. *.#*. .....*...# ....*.#
#.#..*. . ..#.#.# .* .*..*  . ...\. .....#..*...#..*.# .... ... . ..*... . #   .    \..*. ..# .#.*##
# . ..#.#.##  #..**..  . ....\.. .#...#..... . *.\#.#.*...*. #.. .......  **\ *#...\..*..\#. ..#.#.#
#....\......*#.. .#...#.* .....#.##.#..#....  .\.. *..#. *.*#...#\\   .........**... ... .*\#.#...*#
# .#.**.. *. .#......... .**.... . \ .#.\ ......#..##**.#....# ...........*...\ .*...*.# . *....# *#
# .. ..*  .#..#.  ..*.....\..*... . .##. ...# .#. .#......*.. ..\  .  .. .. . .*.#.*.. * ..# .* .. #
#.. #......... ..#* .\. ... .#... #.## #\\.... ....*....  . .......  . ..\ .**\...#..#. ..  ... ..*#
#   #.........* #...# ..#..#..... . #.#\....#.. ...* \.. . .\#...*...#.\.#** ...# .\**...## #......#
#.#. . ....... \#  * *.#   #..  ..*..*   .  . .\\ *..#.#.*\.*  * . .*...*.*..#* .......\#. .#.\#\*.#
#.#*#...#..\.. ##*# .*.... *** .* .#.\ ...#*.  *...  .....  ....#*. .* .  #.. #... \ .... .  .. .*.#
#..#. . .*...   ....... *....#..# * .  #....##. ....  . ..\.#  ..\  # ... .# .* . #..* *#* .. ...\ #
# .  ...#* .\.*\# . . .......\. ... \....*#..*. . \.* .. #.*..*#  .***  .... .* \...#.*...#.......##
#..\ .#..... #*  #*  *.#. .#*....\*.*.#\.. *... . * *. ....  ...*.\ ... ..... .#.... #* .. ....  #*#
##* ....##\... \.\*. .\...# .... ..... . ....\..*..#... ##.*#*... **  *.*.  . ...  #...*..\**.   ..#
# \........... .*. *..# ...#....\#\.... ...\. .*.. #.#.. . ....## ......*#.#\**.  #.. .##*# ....#..#
# \#*. # ...*..#.. ... ....*.. ..\*#..\.# . . .#*..... #....*...*. *. *.*  ....*..* *... .... ..\..#
#.. \..###...*. \.#.. ..  .. ... ..*\... . . #..*....\  ....  .  ...  ..*\..\ ##..#. #.......  ...*#
#...*.*..... . . .  . #. .. ......** .*. * ..*.#. *#.#..#* \.* # ...  .#.. #.\.....* *..**. .......#
#... .#\.*.\\... ..  ..  # .  .*..*.  *. .... ....#  \#.\.#. ..\ ...... .#......*.*. .   . ..* ..*##
#.. #.. .#...** ..*... ....  .# ...##..#*....#* .*.\....... .*.#.  ..... \.#.......*#...\......*.\.#
#.#.*..*......... ..... *.#  .....\......... .   .. ..#  .. #.... .. .....   \ . . #...*. ..#.#. ..#
## ....#*   .   .. .. * \\*... **.#.. .. *.  *. #. .##..*  *....\. \ *.*.#.*. #.....*  . .*.\.. *..#
#.*#. .. ...*.\... ..  . *#.* \ \\ ....#.   ..#.  . .\ .. #. #.. .\....\ .## .# #.\*.#*. \...    ..#
#. #.... # ...* .  .*. .#....# .#..#..*........#..#.*.  ..*... #.#...##. .#  #..........#* .#... ..#
##...##.. * .##... .*...*...*. . ...#..* *.\..#...###  #*.. .......***. ....*.  . ....\......\  .*\#
#. #. #.   .*... . ....* *... . *\*#...... ...... . \.#\....#..#...   . ....*#.#.  *. .*.... .*..*.#
#  #.*. . .... .....#. ..* # .. *.... #.. #..*.. ... . ** . \\.....#.... ..#   ..... .. .#.**#\\.# #
#.. ...# ....... #\#.\  ..*..*.. \...*...#* .   #... .#. .* .*  ..**  ...*#\\... ..\....*...*... \.#
#\*... \. # #. ..* . \ *......*. *. ..\ ...*..*.   #  *.. ..\.. ....*..#.*\.*... .. ..# .. ...*..*.#
#.* .**....*. ......  *. #..\  *....*\*. . ..... ... *\## ....*......\.  \#...#*. . ..# .*. **. ***#
#...#..*.#.......# ..\#......*.........#. .#.*# .#.*....\ # ..*...*.....*#.#    . \.\  . *.*..*....#
# .\ ... ..\..#..*....  \..... *.  ** .*...#..  \...# *....\*. .*  \*\.... ...#..*.#*.\.. ...... . #
#.#.#..\ .. .*. . ..  .\.*..\* .##... #....*.*...* .# .*#... ...#...*\...#..#.\ .  \*    . .. .....#
#.##\.#.* ...  ..*.. *. \...*.\\..... # ....**#\...  .#... . .  #  ...\ .*.#**.* *.* # . ....*.#...#
#....*. ...*#.. ...... . ....  #..*#..* ......**. .   .*   ..... .*.##...*.\...\.. \ ... ...#**.. .#
#.# .#.#*#....**. ...#*\\..*.*. .  ...#*.....#.. .  ..# .. ..  .*..##...** .\.. .. # . ..#. *. **..#
#.## .*\...\#....*\. .#.\.*...*#.....*..  #....#\*\. .  #... .. #.##*. **#.*.*...*. .....**..* ....#
#....# .\.*. *\#. ......*.*  .......  ..#**.#.*..... ..#.*..* ..  ..#  ..#\.. .. .# .*....*.\..   *#
#.*... .*\....\\. . .. .......  #..... *..**..##...*#..\*. .\....\....* .# ##..* *.*.\ .....#.\*. .#
#\. ...# ..#. .\.. #. ..\........**.* \ ..... . .......\...#.\..# #.* ...# .... .*. . .   *.#*.# .\#
#.# ...  # .... # ..#\....*.# .# ....\ *... ..... ..*. .... \.\ .....* ...  .......... ...\.*.. . .#
#..... . #.    .. #####\...\ .*...\\.*#. ..#.* .\ .\#.#.....#\ ... *..  ... . ..#\*.. ... . . \..###
#.....*  ..##. ......*......  \# # . .*.. .*#..... .. ... \*..##.. .. #.#.*..*\........ .#\. #\ .#\#
#....# .\*.....**....  ##  *..  .#..#.. ## *   ....#. ....*.. ..\.*.# . \#. .\   #. .....*  ...*..\#
#..*. . #.#*.....#. ....\..*... . .....* ... . ..*##... .\.\..*.  . *..\..**  .*.    ......** .....#
#. ... .# \#   .  \..... .  .\.## ....* ... . .  * .... ..##  ..  \.... .\.. #..  . ..\.**..... ...#
#....*.# #   ..#*. # #.\#..**..\#.*. . ..... .* ...*#.\..#. \.... * .#... ..* .\#... .....*.\.*..* #
#..# ...  ...## .....\ #    *#.*... ....#. .# #. .*.. ..  .#..* .. ..  \.....*.. ..# ..............#
#*. * .. ...\*...**.*.*.\......  .......... *#........ . ....*......*.....*\\..# ....#*#.* ...# . .#
#.. ...* * **..\..#.#...... \. # ..   ....# #...\..* .## ... *.  . . . . ...#.. ... *..* \.\.......#
# ...#...\*..\ ...# #*.* ..\.##..\.*\..*.. .#..#...#.*#.... . . .*#.*. ...*#.# *..... \  ..  \..*..#
# \ .. . .#. .. .. ..#..\.\.#...*.* .*..*...#**...#.. .* .*\.. ..  .*#*...#...... . *.  . .#. *## .#
#....*.. .*...*.  ..*. # #\..\. .\ .. ...#**...#\\#.   .\* **.*#. #.#..# \.. ... ..  ... .#.  . \*.#
#  *.#\.... \ .. #.* . .  . .. ..  *.....*\. #.#.  .* . ... ..#*..*..#..**\*.  * . \. .#..*.*..*.#.#
#..... #....\...\*#...... ..* *..* *. .*....##. **...*.#.*..*# *.## #. .*..\..  ..*. . ... ..\.. . #
#*..#..*..\.. . ....#.    .*.#.  .....  . .#*.# ... ....# . ..\* .#*... . .*..*......   . . ..#**..#
# .#..#... .. *.. . ..*. ...* ..  ... .*.... ..\.#   *. .#  .*...*.\...\..... \..\....*...#  #\....#
#..... # .#....**.......  \#. .. . \.#. .. .. .. * *\..#.#*. . . .# #.. \.## ... * ...#.#. ...*..#.#
#.\*#*#*#.*.....  *.. ...*.  .. .# .*.. ..# \. ..#.\   ..    .. *.#..*.*... ..*. ...###.... ... .* #
#.\\.... . ...  .*#* ... *#.....#. #.*##.. . .. *.  ...\.#..\ *...#\.\....  ..# .##..........#... ##
#.. .....  .**#.... ........  * .......  .#..#.. ..#*#..#.. *..\.*#...  \..\.  ..\*..*  ###.*.. .# #
#.***.\.. *..\.#......*...*.  *.* ....\.* .#. .#. **...#.*..... #*# #.\*.. *...... #  . ... ....*..#
##\*#*. .#  \..**..\.. .*. .* #* ..\. \. .#..*..# .....\#.... ...#.#. .*....#.......#..#.   #...*. #
#.. .\#**  ... .....* #....#.#\# .. .##. #. .\.. ..*. * .. .  .  .. .*\..... .. ... .. .# ..\.*...##
#.#  ..*...*  *##.....\.# ... ..#.\....##....  .  .. .#* #. .  .. .**..#*..... ..* .. .#.*.# \*#.\.#
#....\...... .*.*\...* #..# . ... \. .# ..*..\.. #\*.###..*... .  ... .*\..* ..#*\  .\.. ...#.#\...#
#.......*..*#*.*  . .# ....*......#. . *.\  .\. .*#. ... .  \.* ...\#.. ... #*..  ... .#.... *....\#
# \..................*.\.#...... .  #. .\##..#...  ...... .. . .. .....  \ .. # ##*..## \. .\.# ..##
#..  .... ...* ...#  .. ..* . .#.#.# *.. .# ..*.#..#.*.  * . .#*. .. *  ...*.....*....#......#*\...#
#. ...#*. .*..\.\.\.*...#..  ..# .... .\.##....\....**.   .\. ...... .. **..   . .... .#.\..*......#
##   ..# ... #.* . *# ..*.**.. # . ...##\ .........#. ..*.  .. .* ..... .\\..*.....\.#...*#\.#. #*.#
#.......# ...#..*... * *.  .. .###..... .......#.\. . *. \. ##..*..*. *.\.*##*...#..*##.. \. \#*...#
#. ***.\........*.#.* . *..*\ ..\ ...*.... ......... ...#.*.*.....* .....#*...  .  ..*  ...  ....*.#
#... ..\#*..##\. ...*\.  .. .#... * .. .#*. .. *... .* . ...*#.*#....... .*...#.#*.* ..  *.. ..\# .#
##..#......*.. ......*..\.\.**# .. #....#.*..  ....#..#.**....*\...*\.....  . . ..   ....* .  .....#
##*....... *##*.#* *.....*... ...... ...*#.#...* *...*...#.. ..  .\#*..#. . .#..#**\# . ..*... .\.##
##..#.....\#...*.. #..\ . #. . ... \..###.\  #. ... *.##..*##..** .  ..  ....*  . ...# ...*.  .... #
#.*.. #  . *....*#. ...# ..#. .*. ....*\.#...   .\.#.. .\ .\*.**...*.. ....\*..  *... ....#. #. ...#
# ... . .## . .. .#. ..###. ........#...#..  .*#.*#\.... #\.....*# \* .* .*.#*. .**\.*.##....*... \#
# \. *... \.\  .* .*\ ..  .. .. .. ... .. . **. # .  *. #....*...#......  ...* *.*.*.... .... .. . #
#. .  ..... .. .. ..\  . .... .*.\....#..** ..  ... *  *..* . .#. .  ##..##.. ... ... . #..#.* ....#
#.#.. *#... ..#......\.#...*.**#*#... ..#  ....*#. #.*#*. \... \ ..## #. ....####*\ ..\...\*... .. #
#...#\.*... .. .* ...\.....#* .. ... . .  .*...* ....... \ .....*...  .#..*.***# *...*#... . . .\..#
# .. ....*.   .. \.*.. R. *.#. .#.##..*.. ..  \....#......*.\... ..* .  * ...\.#*... .#.. \..#..\  #
#..#*...# # ..\*.#  *\ \#..... .. ..*. \##.*. .. *..\...# .*. ..\#. *. ..... .  .#*. ....#..#. ...##
#.#*..*. ... . #. .. . *...*..\#.   .*...  #.... ..\. ##**...*.....#....** . # ..#.*.. * #..... .# #
#*\##.\# .* ...  ....    . ...#. . . ..#.. .. #. ..  .... .....\  #\# **...*#...\#. *  .#..\.* ....#
#...\.\\* ..#\..* ......... ..  . ..*.  ....*...  . . \.. ##.  .  *\  ...*.*... \. ..\....#. .*. .*#
#.*\\ . .. #.. ... # .#..\.\.....\..*......\.*.... * .# *.#*...**. \\...... *.#*##. *#.....**......#
#*.\. ....*.#..#.*.*.. .* .#.*....#.* # # \. ...\...\** .**\ .. \. . *. \.#.*.... \...# . .....##..#
#... .**.  #... *# #.. *\....*  #....*. *. ... *\..... *.#..\.#. ........#. #*. \# .... .\..# *#..##
####################################################################################################