#################################################################################L##################
#.*.# ...**......\ #*..#.#*....#* .#..****L.**..\*......\#.* .\..#.*#.*..*.... *  ... **# .**.#..  #
#...\#. .....\.... . *. \..* #..\.. ...\.*.*..#..\...*.\\**# . ...#.L.....#.....##\...#. *...*.....#
#*.*..#.*#\.*L\...#..L.......**.#.*.*\#*.#\* ..#.\..........# . #..#L\.*..# .*#.# *..*. ....... ...#
#....*...#*#..\# .#.....#\.#.. .\..\......*#.*# .#  . .# *##...  ...*#......##....#.....*# #..#..\.#
#\\ ..\#.. .#.*..#.. .#.... .#  . *..**....\#..  #.****#.\.. .*...**...\..**.*.#... .*.\...#..\...\#
#.\.. ....* *# \.**\..# # * .*... ....  ...#*..#..... ..#.#*#.*............  \..#.#*... .#..*...*.\#
## .*#\ *.\.#...\.#. ..*#\.....\#.*#*# #\#.*#. ..#..*\#L## ...#...#...#..# #** ...  *.....#* \.....#
#.#\ .#*# ... \.  ##*..#*#. .\# .*..\ . ...*\.. \ .*..  .#.# #..# .*##.##...L#..#.... .#..... *....#
#...#. ..\*.*.... ......##...#....*\...\.# #...... ..\. ...**.#..*..#.L*.# ...........  .... .*#.\ #
##...   \\. ....* ....*.*.\.* ....  .*#*#*..#* #.**. .. .*\#.\....* *###.#.*.. *#L*...*#.. #.*..\*.#
#*#.\\*#.#...*.\...##..#.*.\..**\. *..#*#.#..** . . #....\.*. **..*. \#*#*##.....#**.#.*\..\\\ ....#
##\ ..*.. #.\. ..# ....\..*..\.#L.\L*..##.#... ...##.\. ......##.*#.##*\#L ...L...#....\.... #..#..#
#*.#*...*.* \..*\..*... #.*.... ..*.#...L...#..* * ....#\.#\. ###.. ....\#.* .. # *** \..*. .\*\\..#
#\** ....*...\# **..**.. .*...\..* *. \*.*#* ..**\ ..\***.. ...  #..#..#...#\. ...#.....*.#.\...*.\#
#.*#...*.\....# #\#....... ##.*.#...*. #L\\.#.##. #  ... . * . ..  ...#**.....#.L*L.*#...........#.#
##....*. ...\.*\ # ....#.. *.... .\. ..*\.... .......  *.#.\*. ......  #.#...... .*..\#....\...**.##
#..#*.... .. ....#.\ #.*........#. #**. .#\  ##*#*..#...*....  #.... . #.#.*L..\**.#.#.#.\... .*.\.#
#.#...# .*...\ * .*\..*..  ..*... L*. ...\ ...\.. ..#. * .# *.........# .*.# ..\ .. ..#..\*..#....*#
#...*# #......#..*.. ..  ...\.L#...##.*.....*.* .*#. *.\ .#...#..#.\..*## .. *..#.#.....#\.. # ..#.#
#.#...#..*\# .#.....*....*..*... *.**#*.#*. .#.*....... .**.#*\..\ .. *.#.#....#.*###... #...*. ...#
#\*.**.... ..... ..\#.. .\ .**...\.....# #.....##.*\\. .\.. .. *#..#  .*.\.. ... .**#.# \*#.*..** *#
# #.  L..#..*#\.\*## .\.. **...\L.*#.*.....*#*.\.*..*.###....*..#..... * .#.... .# *..*.*\..\.# .L*#
#*#L*.. ..#.*..*... ...*. ...   # ...#.*#.#......# **..## .* **.L\.*.*..# \#.#..\.\\...#..**... .* #
##\#.*.#.##L##.......*##*\.*..**. \..#.*. .# ..*. .. .\# * *.. ..#. .  #.* ..**  ...#.*.*...*..#  .#
#.#.... L#...#. .#.......#..##.#*.*. *...*..#....#.\.*\#. . *.*. ...*.# #***#..*.#*....*  . *\.\#..#
#.*...*... ##.. *#L.*\. ..\.*#. .... .... .**.#.**.#. #......##*.# .\.\. ... .. .#.*..\..  \.*..#.##
#.*.*..*. .*...\#. *.##... .\#.....*..\.## ...**.#**.*.. *.* ## # . *..##\ .\# *.. .*.\ \.....*...##
## .#  \.\...\.....*#.*..#  .\.*\\*.*\#*.\.#.. . *..L**. ###*... .*.#..L..#.\* #..#* ###.\.\.#.....#
#.  .* ...\.*..**. *#\... .*.*#**.#. .......#.*. # ..**...#.#.*.*...  ..*\..*.#.  .**.....*#.*  #.*#
#. #. \...#....*..##  #. \ .\...\*#*#..\*. *...\.#..\. #..\.......#*....##.....\*. .#. *.\#...#.#\L#
#.....# ..#... .*\ ## *.#..*.*  .\\\...* . #\.# .. #\  *.\\*.\\..*\.#..*........\#..#*.. ..* .\... #
##** ..\..**.*\...#\.#..#.. .. ..# * .**..#...*.  .##...**..   .#.#....*...\.# ... **...*.*\.*#..\.#
#**. *..#.\.. . * ... ......#   . . .*.*#\ *#.L..* * #.. .#L....#.....#\. .\.*L.. *.#...*..  ......#
#.#*..#.*...#..*##*#..\ . ** *\...\...\#.....* ..**.*...##*\*..###.* .#*...*  ..#..*....#\ \ #.. #.#
#..\*..#.##.*...# .. ...  * ..*.#.##....\..*** *..*..*#. #*#.... ..\#L\..#.* ...#*...*. ....\## *###
#\*#... #.....*.*#*...** #.*.***##.\ #*..*.....#*..*.# .*\*.#.\ . \*#......*.##* .#.*\*...\.. .....#
#.#..*.#.....#*##.*. ** \\.. .. ... \##*....#..\.**..#. .*##*. .#.*\...\ ... #. .*...... **. ...*..#
##.*....   *\...#*..#.....\###. *.#\.....*..#.*. ...\.#.\.\#.# ....*  ..*.  .#.#.\#.**.#.*...*.#.L.#
#.. ..#*#...\*..#. . *#*.# L  **..*.. ..*..#\..#.#*....*.###.....*.. * . #...*. \ .#.#..L.. \.*.*\##
##*.. \.\\...  ... .#.L.#.\##....*. .#.*.*........#..  \.....#..###.  ...#.*. ..*#.##\. ..*# ......#
##\.... .....*.#...##.. ...\.*.. *##*\#\\.\ #***.*#. #. .#.#.*#.*# ...........L# ***.....# ..\L....#
#. ...\........   *.*..*..## **# .. \.#.\.. .\#*#.##..\..\..*  ...#.L.*#L. \ #L..#.**..\.#...# . ..#
#. ##. . .##L...\\....*...*#.. .##*.\..#\*\\.**#*... ... *#* ... #\*  ....*.\#...##. .*..\ .# \**.*#
##*##.#..*.#.* .....L.#*# #..#\...\#*.*.*.\..... ..#. #. *.\. .\**..#.*#*# * .L . .#**..*. ... ..#.#
#. *..*.#**#L.... .....  #.# .....**...... ...*#..\....#.*.#*. \\..##.#\#.*#.*\*. .#*.\. *. *..\...#
#\ #*.. . **...\.  #*...\\#\.. * *\# ..\ *..#....*#..# ..* * *.....*..\*..#..*... .... *#*.*..\ .#.#
#..#\.#..**\. ...##.*....*..\.#..*...##.***....#..*#..# ...# \ \ *.#. #.#..#..#...#*.# .#. .L\ # . #
#\\\ .  ....\.#\##\* .\\..*..*.*..*.##.. .\.\.......*\###\.*#*..#... *#*..# #*...* #. * ....\   #.##
#*.\\.. *#..\**...\ \.*#\ **.*..#..... #...* ##..*...*  .#... .*. ..*.**. ..*.L\ ..#.*. .##. *.\\.##
# ..*.# *#*.. *.**...# # .*.\\ *.*##*.#  L *\#.. .....\. ....#...\...... #.#...*..# .... ..#.*.....#
# ...#*. .....#.\.##. *.#.*  .. ...*...*##...#* .#. \...##.#*. ...**.*\ ...*# .#....* ...... . ....#
#. *. ..... .*..#** .## ..*...##.\\*\....#.*..##\..... # .#\\#* *# \.\  *.. *. ..*\.#....\#*\#.*. .#
#.#.*.#. #*#.  . \\#.*.. *...\ .....# *\..\.#.....#.*....#*#.##....*. ..\*. ....*..*#*L.*.. *..* .\#
#*. ....  #.\..#**\\*.#..##*.**.. ...**##...L\L.##L.#*.#.  *..\*....*.#. ..#.. . #.*.  ..... .#..\*#
#* **# *.L* .#*#... . *..... .#\*\  ..\.  ....#.....*  **..\. *...*....  .   .\*..*.\.#. .. .#.*..##
#.#...#.**\#......*. . .#. #.#.#.... ..\** #.#  \. .. .... *#\..\.#..#... . ##\..*..\.......#*.\.#*#
#*.#* #\ #*..***.. .*#.......*.*  ##.* ..\#*.#.*** #*  \....*.*#.##.\... ...*#*.\\..#. . ....#\ #.##
#.....#.#.#..*...#.#* .. .#.... .. .\....*#\*. .#**...\ #  #\*.. *.....*#..*..*##.L...#* . ....*. .#
#* # . . .*....# #..*....#..#....* .*#....#.*#....#.# .. ...*..#........\..* .# .*.###.##.##..*.#.##
#L#...#*\ ..#.... .  ... ...#..***\**.\\*..\..#.#.......*.#...*...* .#.... .\*#\*... *.\. .. ...\  #
#.. .# .\...#*.. . .*..#*L.##..**#.* L.....*.L\\ #..*#  ..\.*#...#.* #..\*. ..##...#..*L.. #**..# ##
#  * ..*# .*..*... .. *.. .*#..##. *## . *## .#...#..*  *..*  \. ... ##. \**.. .#....  *. .\...#*.*#
###*..\L#....**.....\..*..#*... #.*.# .##.#... \..#..L.\.... ....# ...#....#.#\.#..*. .#\.#. \##\..#
#... ..*...\.* #.. . \\. ..\.##.#.\.*.* .\ ..#.#..\*#.#.\*... #....** #.*#* .. .. L. ....*\ . *L.#.#
#  *.#.....#..*.\ .*.\.\*.....##***...#.\ #..**\ \...**   #*\..#..**....*.. ...\*..... L ....*..  .#
#*#\.\...  ##*.*... .**..# \** ##*\*.\  ........#.. .#.*... .... #....*\\#....### *#.# ....#*#*...*#
#.\ ..*..#.* #. *..... #..* .*****.#\\ ...*......  ...\ . .#.**#*........... .....#.#**. L ..*. .#.#
#**#. \..... \\.. . ..*...#... ..# # . # \. *..\ ..#\..*.#.. *.#..\**#*.\* *.#..*.#\.* . ....\....\#
# \.*..#.*##\ ..#... *#...#....*.*\* .. * ...  #* ....#.#.*.\*##.* \...  **#. *. ....\.* .#.*.#....#
#..*.**\**...\.*..*.#..*#.....#.# .\. . #.#\#..*..*.*. # *..*##\.*#.#.*.*.##...* **# .......##..*. #
#.*.#...........#..\.\..\..#**L*..#....# #**..#\  .*.  .*\*.....# *\..*#.#*\\ *.. *.. * .*...#..*.*#
##.\  .# ......#L.. .. .*.  .*.  ..\ \........#..##...**\.....#**#\.#......#.#.*...#.*# #***.# #*.*#
#.\\..\.*.**. .* .L #.#..*\*..*.....# . ....*..*.#.#.***...\.*...#.* ##\.* ..#\ .## # \*.*.. #...# #
#\ .....*...#.*..\ #*..#.*.#*\#*#\ \.\.\.. #....\..*. .*\..*#.. .***.#.  #\.* .#.*..#..* #\#..#\...#
# .......* ..#..#.. ##. *... \##*\ *...#.*.L . \ L .\\.**..#\\....*.*.#*.*.\*.#**.*.. *#*#.#. ....\#
#* # #....* ..\.*\....* .**.**.**..\...*\.*... *#*...**. .*.# ... #....* ...\.....  .. ...#........#
#.###\..#..   # .*.* .....*.* #. *#*\. ..#..... #.#. \. .\*#. ... *.\...  ..\. ..... *.#\.# #.. ..L#
#\\.. # .##L ... ...*..## . #..#*....L.....*#***....*.#..\.*..##.***.*\..\.##...*. *.*#.#\\.#\#*...#
##.##...#..... #..***....*.#.*#.. ......*#.*##..#.. . *. #.#*.# \#*..*##.#*.# L. .#.#*..### *##.#..#
#.# #*.\#. .* .##.*..#. ##\..*.. . #.L..*##.#\#..\....*## ...#**.*#\..* #..*.#* # ....#.  ...*#.. .#
# #* *\*..#. ##. ..*.#*...* ...... ..#..#... #L##.# *..\#...\.  .##.. . ..  *#. .# ..* *#...#. . .*#
#* .. #.L.#.. .*L.#\.*#.###..*.\..\..#*#...  .L...*..##.#...#\.#*. . .*..##. #.*.#.. . * ......\ * #
##* #..\......#####....*....\L.. .\.  .#.. .#.\...L*. ...#.# ##. #...\#.#.... ....# #...*.\#.*.  .*#
#...*.... .\. ...#.*..L..#\\.*...*\\  ... ..... #. .##....*#...#.*...##...  \*.** . ##...\.#* .*  .#
## # ....*. ###\. \#.## ..* ..#*..*.\....#\\#..*.. . #L#*.. *# . ..##..#L.#.### *....#......*. .#..#
# **......\. ..*.\..#.#*.*..L.L..\..#..\#* * *...#..* *..*.**\#...*##...#...#..#.#.*..**#. #. ..# *#
#* #..... ***... #... ..*\ .\..#*....#.  ...#*#...*.\ .*\..\ ...***. ...##...# ...#..* .* * #...*  #
#.*##\..L#..#.\.##*\...\... .. \# ..#.## .... . . .*..**#....*.....# #.\..# .L. #  .*. ..#**....\.\#
#..\*..#*.\.\#.... *..*.. \\.  ..#** L.. ..... ..\.##* .L.... ... .#...* *#\\....#..*.  \# .#*.....#
#..#.* .... #* *.## ..... *\**.#..## \.. #*#.. #...#.*.. * #  ..#\#  #....* \*.....\.. #. ***#.*.**#
#......#  .L..#\.\\...#\#\.... .....# ... #\*..#..*.** *.#...#.#*..**#.#.#...#.* .*...\#.. ....#.*##
#.. ..  #.*..#.#.R##.*.*..* ..  \..*..\*. ...#.**..*...##.*\. \.#...#....#*.. #.... *. ..# * *L.#*.#
#*....# *.....#...#....\.## ..# ..#...#..*..# *. .....###.*L#.*......#..\ ..*...*.***...#\....\.*..#
###..#...## #*#.#*\*.**## #.# .##......***.......#.. ..... . ..#..#.\\* ...\..\#. . . # .#...  ##..#
## ....**.#. . ...#..*# #... ...... ..*....  . .. ...#L.*... .#\*\.#  ...*  . .............. ... #\#
#* ....#**.#..#.#*\.....*.#..*#.... .*. . ..#\.**# ..\...*\*.. .\...*... *...\.....\ .*...  .*..\\.#
#.....##..*##.*#   . .#*#.#\..\\...\L\ ..*. \*..#. ##....* .*##*.*.#*# *... \*#*#..\*..#..#....... #
##.**...# ....* ##\.#....#\\..*#.\#** ..**....# ....#. ...*. ##*..\....*...## ..#.... *#*.#.#.#**#\#
####################################################################################################