####################################################################################################
#....  ...* ....#*  ..#. #.. *.\.... ..#..... *#* .#....  \*\*...\#.. . \.*#\  .#... ....\.. \.....#
##. *..\... .#*#. #\ * \*#....### # .#\.*#..*.\..#.... *..* ..#. .* .##.\.. ........ \.... *.......#
#..#.*.#.*.. . ... .....\ #..#.*\..\# #..#*\... .#*..*..*##***.*..#.#.....#...**...*..  ...*. *... #
#L.\\  #.. ... .#..\*..  *.* .*.\...*. \*. .*. ......*#.\. .#*#.##...L..#*.. ..\  L.#..*#..*.#.... #
##...* ...* *.**#.#.#.. #.#*  ... *\.# #. #..# ....#.#* # ....\.. ...**..#.. *##. \. #.* L#...#.\.*#
#.*.**#.....* .. .. .#*## **#...L.L#... #.*...#.*....#\.#.#.. ...\\...#.... ..#...*...#..#.#...**..#
##*.*. #.L*.. #..#\....**...#\ #...# . .\**..*\...*#....# # ......#.##.L .##.. .##*.*...*..#*.#..# #
#* .\ *.  ..# #.# #...... ..##*.#. .**..*....  ....\ *.# #.# .*.....*#.# ..\. \.\L*..#.. **... *#..#
#.#... .*.  ...*.\.. .#. ..\*.\*.# ..##.#*.... \#.#....# *. ....#. ...*. ####.L*.#.##*.#..# * \*...#
#**\..#* ..\.#.....\.*  L *....*\\\#..* #.***..#..#.# ........ #* .....#L.\.*..#...#.  .#\***. #*..#
#.#.\*#.*.L.\ .......# .. *. *.#. .*.#. . .  ...#.# ......*.#.. .  ..*.#..# #.**.#.#. #.#*#*.#..#*.#
##.  . .L.......*# #... . *.*. .. ...#L.....#....\\.*.##... *L###....##.\........*.# ......## . .#.#
#.#.\ .....*.# .*.* ..*.... . ...#........#\\*.# \.#......#*# ..#.\.\\.#. #... #... .....#.*....#.##
#*...#...*......#. . .*.#\#.....\.\....*..... L *##*.#L.\..\\. \#\.....##..# \.\.... #..**.*. . .#\#
#... .*.\..\ *#*...*..... .#.\*#**.\*.. . *..**...#...*.##....*#..*.# #*.**....\..**.#..... ..\.\. #
#. ..#.#.*.*\. ..*#\*.\*#.......\*.#.*.*.\..#.*.##\.*.... .......*.*.#..*....#..#..#...*.*..\. *.. #
#..#...   #.*.#*...**..##. ..*.#..*. ....*.LL## *...... **\* # *.#..*.... #...*..**.\.\.*...#......#
#.#*##..* \#*#..\ \*.*. .*..# ...* ..\.* * ....#..  *.*. *.. .. *.##..#.#*.  *.# .. .#.# \.*.* .*.*#
# #\. . . #\#..#  \L...*\  ....\*.*\*. #*...** . #.#.*# ...\L..  #.*.*. ...\ .* .....L .....***#* *#
#*\#....*#...**.*.#..**. ..*.. .. ...#..... ..* ..*.#....L.** . \#..# \.*. #L .. .*#..*\*. .#.*.*#*#
# .*.  ..#**# ##.*\ #.... *#.\L.**##..   #...#  .#\# *#.. .*# .*#.*.*.*\...##*..* \..****.. \*  .*.#
## ** *\* \.#.#.*..\.\.#....#*##.#\\... ....#..# . ..# ...#..\.**...... #.#.. .#......#.\# ..#....*#
#.*# \#........*..  ..*  . ..##. .#*\..\*\......*# ....*  #.*..# .  ..*.\ ... *#\#. .#.*.***. ....*#
##..# ...#...#\\\\#.... ...**...***..#..#*. \**\#. ..#... *.\\.# .#. *..\..###...*. # *..#.#..#*..##
#.# # *.##... *..#.  .\. ..*\ .* \.*L#.*#** # ..#  .**.#*.##.#**#* . *......  .*.. ..\..#*....*.\..#
#...* . #   \#\\\*...... .. # .##..#.#...... .#.**.*#*..  . ...**...*\## ..#.. \* .**.**\...*...*..#
#..#.##.\..  .##..\# #...*.....#.#*.. .#*#...**.\\\#*. ...*..#*#.\#.#*..# \*  .  . #**. \\ ##..#..\#
#..#..*#...**..  ..\...\* #*#..#*##....#*.#....\* .*.*\.   \..\##...\.\.   #...#\### ..# \##. . *.##
#**.. *.*.\..*. ..#..# .#\L*.*#.\...#*\.. **.#...\*..* .#\ .*. # .*#.#..##.....  ..*#*..* .*.#. *..#
##...#\... .\*#*...**#\...#.\*..#... \ \ *\. ........#L..#.\..L..****.\. ...L.*.. ..  ** \##... ...#
#...*.# .# *.##. #.#.#..\ ##  .*.*. #.. *. .#. ..   .#..\*....#.. ..... #*#.*...***#.#. .#* ..L L ##
##.#.\.. \\..#.\#.#.#\  ......*....*.*# *\ .\. \\\...*.##* #*#....\ .L#*#...* ....*#*. ..#...**##*##
#*#*#. ..#\ ..L.*\*.#..... *.#..*.#  .*. .#.*.#..\.#*.....\.*\.L ..*...***  ..##. ..\.#. #.. ..\.. #
#.\..\*..*.   #*#.\.\ \. ... * .*..*.*\.. .**. . ..  #.*#.#..*\*.\...*. *###.#.*.*...#..*.#...L#.* #
# ..L.#..*#..  *. .#. .\.*.\#*\.......*.#* #\.*..#\.. ..* *# ..L#.#\... *\#. .\ .# #*..*## ..*.*  .#
#.*# ..*.*.\#.#\.. #.* #L#.... *\#...# ....* ......*.. .\.#\.*.#.*#*L.*.##.... .  ...*. ## # ..#.#.#
# .* ..\.**#...#...***#..*...*. ..*.#.# .... . *#. #****.. L.\..# #. \...*.**. ...*..#L..###.#.**..#
##.  ##..\* #...\...*..#\# \*.. ...#.#.***....#. #...*.*\..*...# .*.#..*.*...*.... #..#\.\#*.**.. .#
#..#....#.* ##L.. ...# #..#\. .##. L. ...#*. #*..#*\...\..*\*# ... #...*.#. .. .#* .\... ....L. .. #
#..#.  .#\.\.\\.#....* .. ..###LL#.\. *\..  ..*......\...*#.#\.*.#.. #...#\   .#*..#**#...* #*.\#\ #
#.**..*. \..#*#*.**.... .. **#.... .*. ....#*.##.# .#.\  #.#*..\#..#.*..  .*..\..#*..\L##*....*.#..#
#..* . .\.*.#*.  *..#..##.....\........#\..\ # .*\..\*#... * .#\.......**..\*.*...L...#. ...#*...*.#
#\#....\.* .#..#...#\...\*\L.*..#..*..#*.*\\.#*#   . ..\.#*#L\.*..\* \.*....#....#.##.... #*.. *...#
#..* ..**.** .#*#..*\\.\#.* . .....\...##.. .**. ........L....###*#..\.*..*. ##.#.* ..  .#\..#.* ..#
#*.... ..***  ##..L.#*. .*..*.#.*.##. **L* .*.#* .#... . # .  .##..*.#*.# .... . .*..\.... **..\..*#
#*...*.....##*..\.. # ..\ ......#.. \...## #*.. ....*..  ....#.#..  ..#.**#.. . ...#\.*  ..*. \#.# #
#\ .#*.#.\\\..*# *..##*..  ..#....\.*....\ *\..*..**.\...*. ..\..\#..#..  .. . \..#.*. #\*.........#
#. *#*....##\\.*.#..** **.# **.*..* ..#.*..#**.**.* .#..*#.#.##.***#.\\*.\*.\\...*.*\. . #*... .*. #
##  .*.\\. .##.. \\..#.*... .\   **. .\*\..\#..*.. #.** .. #. ..###...\\#\*... \#. *#.#. #*.*#.... #
#.L.*#.##.    .#.\#..#*#\*.##.*. .\....###* .#.#.....#.#*L... .\....*...*. .#*#. .* #....*#...\*  .#
#..*...*..\*..\.....* ....#.. . .. .*#.#.... .# \*#.  .*..#.....*   *..*.\.\ #... .* #.. #.#.#\.*#.#
#.#..... ..*...... ... .\*#.#.#\#..#..#..* .  *##\*.#.#.*#.*\\.. L....**   #*...*.....#.... ..## ..#
#*.**.#..\*...#.#..*#.. ... ...\##*.*L.\*.......\*** .....*.#.L*#*.*....**. . #.....*.#.. \*....#..#
#..L.#. #..*L*..#. ........*\\#\ \.#.. ..#..#*.. . #..#.# ..... . ...##..#.*# #.*. \. #. ....\\ ...#
#...##.. .**  .*  ....*### ...*... ..#......*#.......#... .#. # ...#\..#*..* **#*.*...*..*.*.#*# ..#
#.*.*. .#..\.. * .. ## ..#.*#..###**  ...**...\.\..\. **#.\ ......\#..*.\ * #* ..* .# ...\#..\.. #.#
##.\*.## .*...**..... .#...#.##.*.....#..\ .# .\......#\.*.. \.   \#.#.*.#. \..#...##...#.. .*\.L .#
#...#*.##... *#.\#\\#**.* #. #..*...#.*#***........*# .\.##..* ..*.*..#.....\.. *\.*L..*\.*#. #*#*.#
#*...\  ..\\.##. # **. .\##.##... .#*..L# #.\.*.*..... **....**.# #.*.... *...#....#.\ ....L.\.#.\.#
##.***.*.* .##... #.#...#*...*. .... \.#.  \. #..*... .......* **..\*.*.. \.##.*..*. .\\.* .....\#.#
#....*.*. .. ..\.*. *.##  .... .*.# ##. \*#*.#...#. ..\..*.. . ... .** .....   #...L. ..#..#**.. *.#
#.#\...#..#.\.#\ \*...\# ...* #\.. * *.#...*..\.*\..#......*#.#*.*#..##*#.\ #  * **#\.\# .##.....* #
#..* ..#.*##...*.#..#.\.## ..##.*.*.\#.*..#*.*. .....*.#*#*.**..*.\.*..L.*. ###.#. . .\..*#..**.***#
#..##*..\..##...*#\.\.*..# *\ ..*.\ ....* ...*..* ..#. .*. ..* .##..#.. ... ... .\..*#...*#.#...L#*#
#*. .*....*##.#*.. *  #\ ....* *# . .##\.*.\#..##\..\ .L..*L*..........# ........#* #..\..#.\..\**.#
#L.#..#.***..# ..*...*.. *... #* .#.  \..... .. #.... ... .*.. \\#*\.....#.... \*.*#.#\.. .... *.#\#
#.\\..#.#*......* .. ..\  ... \*. ... ...##..L..*...\* #.L  ...#.....*.* . ....**..\.*...\**#. .#.\#
#..** .*# .  ..... ...#\*.. ..#.*.#..*#***   ..*.#.*.*.#...#.#..#\*...*.. ...*.#.#....  . . * .. . #
#.... *#. . .  #.#  ..*.#\ *.*. #L**L..*.....\..#....##..#...\.#..... .##*.. .. L..**L..\...#.....##
#. ..*  *.. ....* *\* . #.*...#.. \.#.#.. #.*....*...**#...# .#.#\#..#.#..** . .....# ##L....  ...*#
# #.* ..*#..\##.**....\####. .*.....#.\...##*..#.*......* ...#.*..#.\.** *#\.**...** ..... **..*# \#
# ...#.... .#.\.**. . .. # .*....#.. \..**\#.\.*.#.\  *.\..*.#.. #. \*. .....#.*.\ #\......\#... *\#
## *\\ *# #...\.*.#....*...* ..\\*...*#. *.*. ..L.***. **#...\  .#.*.......#... *\ ..*. .# #*  .** #
#...*...#. #...*..#. ..* .. * .L.****#..*.* ..##  ... .**. *. .*.\*..# .#. *.*...L ..*#\....*...*#.#
#..\.*..#.*#*.  *#.\.......# * ....#..# .*#...#.....L.**L..\L# ##.*.......  ....*.. *##..*..#.\..#.#
#\ ..*.# .  \..... .\* ..... .\.\*\#.* \.L\#..#.# .\ *.\.*\.*. . #...#L..\..... ...# .#..... .L. * #
#.#*.##.\..#\.#.* #*#.  \.*  .#.#.  .\#*#..\ *.# #...**.  ..*..*.#*.#\.#.......* .*.....*\ \L.#* . #
#.. ....**.# ... . #.*  .# *..\...#...## #...#.#. .#*#... .\.\#....#..*. ..L*.*.**#.#\#\..L..#.\.#.#
#.....*.**.**.##.# ..* ..*.  *#.#.##**### \...# .**.. #.#. .*.*...#\.*\ #. ***  .*#.\...#   #..#..##
#.\.* . .\.\.... #*.#..# #.... L..L....*.**###.#.#**.*## #  *.#*#.##. .*..*\.L.L.* \ L #.**\# .*#..#
#.#.#..#*#.........*.. \.. . .#..#.##.#*....   *\..**\..##. \..#.... \. ..##*\#...*.# ..*#*.#  . .*#
# .#*..L . #.*#.*...## .... .. ..*#*... ...##..**.....*...#*.##*.*.. .\* *#*#\.##............ *.\.\#
#....*  .#....*# . ...  ..\.*#..**.\.\.*\...\.*....# ...#* *..#**.#.##* #. .\..*...#\ #... ....\# .#
## .*......#*..#\*\*.\.. .  #* .###.*..# . . .#...#...#.*... ...*\. ....#.****\.# .....\. ....#....#
#.#L #...#....*. .....#*..*.*.. \..\ ..#*.##*..## . .#.#. .### .*.#*. #  ....\.L#.#....*#* ..*#. #.#
#L*. *.RL#.\...** #...  *.. #.. \*.*..... .#.....\#.\ .\. .*\. ..#....##....##. .*\..***.#...*... \#
#*.\.....*..*....** .  .# . .* .L.\..... ..*..*.  #... . .#..\ .L...#.....#**......*. #\*#....#. ..#
#\##.\....#\#*..#.#.##.. *. ..\#.... ..\*.**. ..\....  #*\#\.*. .##\# #. .#. ..****.. * #..#..\....#
#.. ....#. .*. ...#.. ..*.#*L*L*...\* .. .*#..\#.*....#....#  L..\.\\.*#*\..... *.* .**.#*...* *..##
#..# \L....## .. .. .........\.. . .**.# . *.* #\..#..#....#....*.**\.\*.. #.*.\..#.#*# .#..\ \. #.#
##. *.*  *.\#..\*#..# ... . .*...## *.**#\****...#**... ..   #..\*. ..*.**\.###.....*  . *#.  ##.\ #
# *.##.\.**#* \L. #..#* #*.. #*\#.##..*.##.....*.#.**\... * *.. .* \ *.*    *#..*.*.\\.*..*.# *.*.*#
#*.\*.#.*....#\.\.\..*.. \.#.##. *# ..#*  ..\## ......**###  .##...L...\... ...... ..\#...# .###\ ##
##\.......#*....*.\.  .##.*.. *.#  ....\ ...\.#.#.*..**#*#.*.. \...*.\.#.\.###.#....**.........#...#
#.\..*..#.*\.*......#..#*.*..*#\.*.\ *.\*....L. . *\*..# . #..#....*.#...\.*.*\*.##.#\#..#.#\*\....#
#..*\. ....\ * #*... .*. *. * ####*#. ...L.....#.*#.  . ..*\  *..#... \L ..*#.*...#..#**.*.# .#....#
#\..#*...... .. .#*. ...\....*. .#...#... #\. ..\ . #..*.*...#.**.....#..\ ...\#.## #.#.*#**#.*##\*#
#\. .*#*#.* \.*..**. .*\.*#..  .#....##*..*..*..# . .\*. #. .. ... ... *..L....\#.. \..\.#..* *. .#L
####################################################################################################