####################################################################################################
# .*. #. .*..*.**...... #.. *.. .......## ..*..#.#** . ...... *...** ..* ....*. ..... ..*# .#  *.. #
###** ..#.... ..#....*.* ....... **#.###.#...*\.. ..... .#. .\...\#*. .........*... ##.*...*.#*..#.#
#  *\#* ..... .*.*\.# .*...* .. .\ .  \##  .. .#.... .....* ..*. . *\ .... .*.. ...   .*...\*... ..#
#... \.. ..* . \. .#..#*. .#..** .*#   .* .#*..#....*. ...\  .* .\.\.  # *. . . .#...\..#...*.# .*##
# . .\.*....\. ..* \. ...# \. ..# \. ..\#.......\ .*   #..#*.*...*#*...#\#*.....    .*...\* *.*.\.\#
##....*  . #... ..\...\*....#. ...... *...#.. .*...#.#.. *..*.......*. *. .* *.#.  .*.#...... ... ##
#...#...*..# .   .#.*..*.#****.#...# ** .#...*.#......#.......*  \.. #.\\#.# ..#..  .  ... * ......#
# .  *. #...*. ..... \#. .*....\..  #*.#..*..*....   ...*.* . . . ...#.## ... *. ..*.. *. *  .. .. #
#..\.  ...  .\.. .* #..  . \*..*\.## *..\..  *. #.*. *.\. ... ..........#.*. .. ...*....\.... ..  .#
## ........ .#*  *#.*.. ... \. ..#. \...*.\\....#... ..* . ..#...**\. *.#* ..*... .......*. . **.. #
#.*\*..\\##.*. ...*##  ...#\. .  ....#.*#.... . ..#.* ....  ....*.....# *..*..*\.*. *.*..*\......#.#
# *..##..#.\.\.*.##....*  .#*. .. ....#* .....* .   ...*##. ..\  ...\\*.* \..  ... #  .*..  ...* . #
# .*#. . ..* ....... *.. .  ..# ### . ...\.. ...  *....   *.** .\..*.\#.#.....*  .#...... .*#.\.. .#
#. *....  ...##. .   ........* ...* . ...\.* * * ....... ...   * .*.\... .#.# . *..\....\..#..#...##
#...  .## . ..#. . ..# ..#** * ..... #. .... ...\#. .\  ..*...*. ....# *. .*.\ ..... # ...#*.#*. .##
##...... . .#.\#\*  ....#...**# . ......  . ...*. .* . \\*.#*#....#..  .....\##.... *..*#.  . .*...#
#..... ..#.#..#.... #........##....#.*#.#... #.\.\ *. .*\.......  .. .\.#.. \.... .*  *#.. ... **.*#
#.*..*..#** .. .*#... . **.... .*...\#..\ .#.. . #..  *... #.. ....# *..*#  .. ....*.#.. .*..#.. ..L
# .\ \. *..... **\..* #....   *. .\#.**. . #. ...\*.# .*.*....#...  .. \ .. . **##.. .#..* . . #.  #
#..#.. .. . .. \. . . ...*..  ... . . ..\.#*..#.*...#\.*.. #\.#..#. .\ *. .*\..\*. ...*\#..#. ... .#
##.....  . .   .**..  ...\ \.... ... #.**. ...  .\. ..#\.. .  . .#*...  ....\.# ..  ...# ..... *...#
#...*....## ..\.  ..*\ ..\.*.\.**...#**.*...#.....*#*.*...#*.*...## ...   .. .. .. .#.. *  # ......#
#  .#* .#.##..##.\ . \  ..  #.. ... ..*  . ...*  ....*.. ** * . .....  *..#\. .#.. #.. *........#.##
#..  . \. ..   ... ....... .#....\.........*\.#* ......\...##  .*# .  .  \.......#. \#...#.*. . .#.#
#..# ........... . ........\.. .\ .#* ..*...* #  ....*.\......## .. ... *.*....#...*.#... ..**..   #
#*....##.##*.#. .##.. *.*........ .# ..*...**..... . * #.#.....  *.... \ ..#.* .###...#..#.. .#.*..#
#.#....* . .\ ... ...  # . . #.*.... #... * .  ..   .....   . # . ....... .#... . #* ...#.*..  ..*##
# \.\  . \#.#.. ... .\*#.*.  #. \. *.......\..*\.##...* #..... .....#.##  ...*.... .. ....# .# ....#
##.... .*.......* ..#.. *.. ...#.\.. ..\. ...*\...... ... . #*.... ....##.*...... ....#  .. . #.*#.#
#.\ #  . #. .#**..#.*.#..\...**. ....##. .##..#.\..\.#..........\. \ .  .#*.#*  *.. . . ..*# .#.  .#
#.. .#.*#..#. .\... . ....  ..*. .....*..\.. * .. #.\..\#..\..*. . \  .#     .......*#*.... ...#.* #
#.*...# . *.*..*.#  *. #.*.#. # \.#...\.#...\#.. .#\..... ***.#*.   ... \. . .*. *.. .*# *.*...  .\#
#.\ *.# . .*\... .*. .. . ...#.. #.##.*..... *...#. ..* * \#.#. .... ...* . .....## *#...  ..##..\.#
#.    ... ... ...  ** .. .#..#.  .#\.. .. *#.*..\.....*.. .**..*. #* #  *..#.. .** ..##..   ...*\###
#..*.#.. . .....#*....*... ... #.. . \... .#.*...\..\*...\. . ..  \ ...* ##.#*  . .. ...\.   *#. #.#
##.*.* ...*.*.  . \.* ... ......*... . .# .....#..\##.#  #\*. .  #. .*... .*\  ...#**..# *. ...*#..#
# .#.#...#.**..#  #**.*..... \##  ..*.. ..# .  ..** ...*   .*. .* . .#......#  *.#... \*. .....  . #
##.. ..#. ...\*.....* .. .**..  ..... .*.*\*... ..\.  .. .....#..*\..#..... .*.*.... ...\..#... ...#
#\.*..##.*\  . .. ...#..* *\ ..**...  *\....... . .. ... ...... ** * .#. . .**.*............# . ...#
# .. .. #....*\ . .*..\.  . #\... . ....# ...  \#. ..**...*#..  ..\ *..*. .#.*....# ***\..*... ....#
#*.#. .. #..#.....\#... *... .#. *. *##...\ * #  .. ... \ .*.....**..... ..*.\..   .\.... #. #.#. .#
#..#..\.  .##*..#*.... *..*\.# . *......*....# ...* # **## #....#*......#.*... .. .**... .\..\\..*##
#..*  * *..#*... . ...... ...  .. .\... *\\*.*.*\..*#.  ...   ..#. .\ # .* ...  \.... .......##....#
#.*..##.  .....\ .....  . .* .\..  *..*...*   ...   ..  #.#. .* #.....*..# #.#**.. .. .. ... # . ..#
# ....*\  . .... #..# .. *.. ..... # .. *...\ ...  ..\.\  .* .. .*.# #\#...* . ...#\....*\    **.*.#
# ... *.# .*\  #... . . #\*.   .\......#.....*.  # .......**........ \ * \ #... ..#.  *  *....# .  #
#*.*.# *  *...#  .\ #\. *.#.....  \#......*.\. ....*... \. ..#.\...#*.....*..*...#. .*....#*\......#
#... .*.. #.*.*... ..#  . .. . ..*#...*\ .##...    *.#.... * . .*..*  .  . .*. .#.\ \.. # ##.....  #
# *.. .. ... ...#.* ..*##. ..\.*....*. . **..##. ....#...*.. * .**#*. .....#... # ......#..*\.\*...#
# ......## ..* .. ........*#. ...*.#.  . ... . *... ......#.. .\. . \#.\... ..#  *..##    ..\....*.#
#   ...*.. \.#.. .\#. ....\.*   ..  .*...##.#..*.. . \###  *...*..... #.*#. #.*..**.##.....  .#*...#
#.. ...*..#... ...\.\ ...*.#.  .*.. .##..*. ...*...........#\#...... ...\* . ... \*.... ..#  * #...#
#.. .* .......#..##....#...* . *.\#.\ .#..*.*#..# ........ .. #.*#..**. .. .  ........*. ... ... ..#
# . #.\*..#....  \#.. . .. . .**\.. .. \..## #. #\##..*......# . ......#....*  ...... * .....* \ ..#
#  ..##..*##...**. .# ... *..*.....\ #. . .. #........ .*...*...\. . .R\.. *#  ..\.... .#. ......#.#
#..*  .  *   .*. .#.. .*..... . . # .\  ...# .\.\#....*....*.. ...#* . .\* ...\.... . . ... .......#
#*..##*.. *. *.*....*...*    . . .#.# *    ..#.**  .. ... *. #.. . .#*.. .# ..#*  \ ...* ... #.....#
# ..\*... ..*# . ##*. .\......#. ...\. .\ *. .#.........*\**.  . ..#.. .**..\.\#..*  \....*..#.. ..#
#.*.. ..... *. ... .. .. .*  . .  . #. ... #.*.\.   *.##..  .##.  ..*...*#.\*..*.....*.##.\\ . *#..#
#...*........\\....##..*.  .* ..\....\ . #  #\.#*.   ....#... ..  * ..# ..*\ # . . ..# # #... \ .**#
#.*  ...\ ....... . ....... .*..*.#....\ \.....*...**.# .... *\..# .*...#...*.* ..*.\.. # .#   .* .#
# .  .*..\#.#..#.**. .   ** .    .. ..#... #.  ...... ....   #... ..#\..   .....##...#.*...#*.#. ..#
##.# . #\##...*.\*..\. .. .** #.  .\....... #........\*..*.*.  *.#..*   \...#  .....*.#..#.#.  .. .#
#..\#... *.*.........#.##.\. \.... .*..##.  ... # ....*.*.*  *..  *# *...*#.  .#...   \\.*#.*#\*...#
#... .\ *.#.....#. .##..  .  ....\ .  .. #..  .........\... #\*...........*. ....    ..... *.....* #
#..#........\...*.#..\....   # \......#....*.#* .\ \.#.* .*.....#... . .*   \*.. ..  ..#\..#.*.....#
# \..... ..*. .....##.\*....*.#.. # ....#*.   ......\ *.# # *.. ...\. .....#..*. . ..*. .#.. *..*\.#
#.*.\.#.... **.* ..........*...#* ..\*..\# .* \. .\*#...#* .. ...   . ........\..*  ...\*.*.\.#. .*#
#.   . .. #... .\*... *. #  ...\.. ..#.*...*..#. .#  ..\.#.#.*....  .....* .\#..\\..*. \#*. .\ .* ##
###..#.*. . ..    .* * .....*#....\ .\.\.#.......## .\.*..#........*..\** .\..... ..*.. . .*  ....*#
#  ..#.#. #..  .\ .......  ..#.\.\.  ... ..#...\**#.#   \**\....##.#... *.   ..\...\.... ..*...*...#
# . ....  . ...#. ... .\*.... ...*..\ ...#.. ......  .*.##..#..*...* .. *...   .  ..\ .. ...# .#..*#
# .#......#*#.*.....*..**#. #.# ....*.\.**..  ... \... *...........  ... .\.....#.... . *..\* ....*#
# .*.* .*.. ..\. .* #..  .. ...#..#**  .*.# ...\.. .. *. ....\.#...  \.. .. .. . \*#..#..#...\*.. *#
# . ........ *.*......  .#...#.. .##....... .. ...*..#..#\#....... ...  *. ...  .. #*## *. .. . ..*#
##*#\. ..*..   . ....\.. *\.. ...\.*#*..\#\... *..## .   ..#*  ... .*  ..  ..#...\..# ... ..#..\.#.#
#* .......*..#.. #\*.*..# .* .#\.. .*... . ...#. ....\*.. ... ... \**..*...#*.* . .....##....#.....#
#.*.... ..... ..# .\ ... .  #.  .* .  #....**..#.\  .  .* .#. .#.*  \. .#*# .# .  ..* \\ .   .\... #
# ## .  .\....**..*... #.....*.. ..  .... . .*.. ..# \... ..##.##...#.\.. ... \...\#**..*#\..*..* .#
#.  *.# #*..*..#**. . ...#. .. .* ..#.#  #..#.#.#..#*.\.  ..# .......\ .#.\...\..\...#.*. ..*. .\# #
# ... .. ...*..#*........#...* #. * ...#....\...# *#.*\..........* ....# .....* . *..*.*.. #\ *...##
#\ . .\. ...*..#...*.. # . .#**..\. . ...*.\  . *. .....##\. ....\.*.* . ... ...#. .# ..#...\ . * \#
#. .*.#...*.\ .#.. *... #\......###..#.*\*.. ...\...* .*#\*..*. ..\\.#......#\#.. *. ...#.#.. . ...#
##*.*..#. ***#..#.. *.#...#.*. ..  ...#. ..#*.\....\ \   . *. #.**. *. ....... ... . ..# * . . .*.\#
#....* .....#.. \#*.  \#.. . .. *...*\. ...#* ..#...*** \.\.. .#..  ** * ...\. ..* . . ..*.\*..#.* #
#.*#  *...*.\.... ...*. .. *. ...# .... #. #. #.\#.#..*....#.   ..*...*......# ...# .. .... ..*....#
#...... . .. ...*.* ....... .\*. ##......*...\.. \*...#.. .. ##*..*..#... . *...\\....  ..... . .. #
#..\#*..\. \*. ... #....#\.#. \.*.##..#...**..#.... ...#..... .... ..##......   .# ......*.  .##\. #
#... *.# # .\...\ ..  ...#..\....... *.*.##....\...**.\\.*..#.....##.#.\............  .* #. . \. ..#
#\..\# .. # ..  *..* #.  . . .#  . . .. .. .#. .#.....*....*. * ........ #.* .... ..   #   *.......#
# .. *#\.  \.# .. \ .... .....#......#.\* **.....  *. ..... . .....# \ #. .  . .#.... *...* .\\ ...#
# \\..*#*..#.\ . .... ........\. .  * .#.#.  .*. .  ........#*   . \...*....  #   *#....#  ..... .##
#.*..\   .*........#*   * *.\.#.\\#... .... # #*.. .  .. ........#*#  ... ...  ..*..... . ..#..\ #.#
# . ..\*. #..... #.# .#*..#  *.* #\.. .. . .# .....##.. .  .*#.\..   .#.#.\.*.#...\\. ...*.. # ....#
##.......*....\. . .*..**. . .   #... .  \....  ..*  ..*  \  . ........ . .*  .\. *\.........* ..  #
#...* . . *\..#.#.#.*. ## .# # ..... ..#.*... ....\.  ..##..#\...#\#. *..  ..\. ..#  ...\..#....**.#
#....\. .*.# *#\...# ..  #.*\ . ##. ...*.  ...\ .#*.*.*. ..#... *....... .***.*...#.*..... .#....\.#
##..\#.....#*. *\.. *#. #......* #.....*.  .#... .. .. .  *\.*..*. .#....#.. .. ...*. .#.... .  ..*#
####################################################################################################