####################################################################################################
#.. ...... .\........*..*...#..*....#. .#..#..#... ..\..* .. ..#.. \... .*.*...*.....\*# .*.   .*. #
#* *...... ..#*. .* ...   *... .   \ ... ....# . ..#....#  #..*#  *...\\#..\ \ #.. .#....*...* ....#
#..  .. ..... ..# ..*....*\ **.#.... \. ........ .*...##. .. .\  .*..#...*.... .* .#. *.. .#..#. .##
#.. *... *......\.#..... .... .. *  #*.......#*.#.##...*..#..#.*..**.... . .#.    ...# #...*.**... #
#*.#. *#.##.#. *.#\... . ..#*....#.* .# .. * . *. ..# . #.#.. ...\** .\.... * ... . *# .....*. \ ..#
# *\...**. * .\#........\... *...  .. . *#.....#.*\. ....\. .. * . \...#... .. ... ....*  .  .  ..*#
#. \. . *....**..#.  # ....*..  ..*.......* .*.\  ...#..#. .  . ..* *#...*#...\*. #*... \ .*#*.. . #
#....#.  *.#....*. ...... * **.*\#  \..*.\  ..*.*.*. .. .. .##......\*.# . *. ...*\##*... .....#.*.#
#...   #\ ..*.. ..   ...  \.#.# . ....##. ..... ##....*\... .....*..#.#..  ....  #*.\# \..... ..  .#
# .......#*....  *.. .#\.. *\.*\ # \ #\. \.... .......# ..#.\ *...*..## ..# .\.\. #.. *. .... ..** #
#\*.. . ..    #..... #.....#....*.#*...  .\\........\..*..#*#*#.###..\*...**.....  .. *# #....*#..*#
##... .#..**.*#. ..*..#.#.#...#*...... . # .. . **.. # . #  ........\...\.. . . ..* .**...*....* ..#
#..*. ...*. #  . # \..#.*..*.*.#*...\ .....  *.#.**..\ .  . #.*...#*....  ...... . . ..# .##..\ .###
# .#. .# * ..#.#... .\*.*...#.  #. .\.\... .....*. ...\* . #*#.#.#  . .....* . \..... #  .\*.*\..*.#
###. . *. \.*....\. . . .#.....  ..# .##\.#...  .. ... .. ...*..*.. *.#...#\. . .# .   ....#. .  .\#
#..  ... ..*..*.. .##. *#...\... \ .  .....*..\..*.#\...#. .. *...*....##.#.. . .. ....#.*..#.. \..#
#*.. #. *#...... .... #.. *. . .# .  ..*..\..... .\...... #.#..# ...* .........*\...  .   .#....\. #
#....... \ .. . ..\.... ..#....#* *...*.*#... . ..*.\#*.# ..*.......*..*  * . ... . .   ....#...  .#
#..*. .*.\*\......#..\#.....\..   .*.#....#   #**..*..#........  .  ... .#...#..#.* ..  .* ... #...#
#.\\*.\. ..\* .*... .**#....  .\*.. .*.#........*...\\.  .#.#..*.  .#......\ #..*. . #...#\...*##..#
#..#.. ..  *\.*..*.#*...# ...**.\*.#.. .\. ..#\.. # ..   #.........\... .. ...... .* ..\...#.*\.. ##
#.  ....# *..  #..*.#.\* ...... #.... \ * .\... ... .#*..* ...#. * #...\....*.... ...#....\.......\#
#. ..# * . ......*..\..#.. ...*# .....**.*.\*...#*...  ...\ *..\\ . *.....#\..... . .*.#.*.*.... #*#
## *...... .*.... ..#...\#\.. \.. #. # ....#  \..# . . ..*............**....##.#.#  .\#..#.. *.#...#
# ....... *#  ......\..\ .\. . *..*. # ..*#..#.\.... #*..#*..*.. ... * ....#...... . #..#....\.*.* #
#.*... .....  ... ...#.*. .....  ..#.#.....##.... .##.*  \*  \. *.\*.##.. .#....#.** ... ..*.. #.. #
#....#* ... *. ..#....**#..#.#.\   ..#...  * .# .. *. ....* .#.## *....*. . .\. * . #. # \*......#.#
#... ...\.#.*..\ . ...  .#...\ *#..*\.....*.* ..#.#.. ..... ...*** ..*..#.**.\ *. ..*....  *#. #.\ #
#*. . ...#. .#.  # ..*..  . .#. .*#..* \.#....#.#..\.\.....  .*  ..*... . *.#.. ......#.#.**#. ....#
#.  #..# .  .#.*#. #*.#**#...#. *. ** . . .# ..*.. .\....\ *...  . ... \  ..#......#.*..#..*  . .*.#
# .*#. .#.**...#...#..*.. #*#.*.*.* .  .  ... .. .*..*...#..  * .\# ..  . *. . ... .#.....#  # .. .#
#. * * ..  .*\*.   .*. .##..... .##.. **.*....*.. ..\\..#*........*.# ##\*.*. *.#\* . #. ... #\ *..#
#..# .  \.......#*... . .*\.#.\ ... ... .......\.\. ....*.* ** \*.  ..#..  .# .. . ...\#.*..* .#.*.#
#**.....\...*.\..   ..*#.... .. *. # ** .\\ .\..    .......#.\.#*  # \....#. . ....##...\##*.....*.#
# .\..\. .. .... # * . # .\... .# ..*..\.. .*...* .. .....   \.\. . #... .  . *.#*....**....*.*. ..#
L#..#.. ........#...# .\...*\.*... .**.*#............*. .#  .##.# .* ..#*...# .#*.*#..#. ..* ......#
#....\ \  .**.*.....#.*.*..\. .\ \ *.  . . ..**..... * ......*. ..* * \#**.* #*.*...#**.#....#\...##
#.....#...... ......\.*  #..#...#...  #.*...  #...# \.. .....#.  ........... * ......**...*....  ..#
#..#.#  ..... ......*.*. ..........\...#\.. # # \.#.#......\   . \...........*#.. .. \.#..##. ..#**#
#.. ... .....#* .. .#....#..  . .*#*..*.. ... *...\* ... ..#.#...#..  .. # ....#.*#*.#\...  #... #\#
#  #.*  .*.\\#**..**.#. ... # #. *.# ..#.#*.\.# .. *. .....#.*. .#.\.  .. #   .\  ......*.   * * ###
## .*.\ .... ...*..\ #.*. ..... .. #.*...  #.. #*...*..#... .  .#*.*.#...##.. ... . .....   *.#. #.#
#... ...# .\  ..*.#..# *..*...#. ...\.. ..*..... . .\.* *...#. .*.. ..#....\* .\ #  ...*. ...* . #.#
#* * . .*.. ..\. ..#.  * ..\.**\.#*.....\.#*\. . .  .*  .# #..... . . .. ... \...  .  #.*\. ...##. #
#  .. #.  ...**.#\..... .#... *.#. ..*# . .#* .#.. .. *  \..#.\ \.... . ....  ..*.#..#. *.##.#.. *.#
#..#..  *...*.*.\...*.#.# \**. . ... *. #.**. #. #.#  .#.#..\.# ... ..... \#......\#........ ..#.**#
# ......   * #..#.# .**  ........ ..... .#.* #\..*......#.  ...## .#*  ...*   # *...  *.. . #.. #..#
#.... . ...#..#.*.*.\.. ....\\....*\**. . ...#.\*.# *  ....  . ...*.......#...#* \..*# . .#. *... .#
#.. .*  .*...**  # .. ..... #.  . \..*#*.. #\.. .. #. .... .*# . ...*...#..*. *. .**.\#.......\*...#
#.. . \ *. ### ##.#...\..*......*.#.......#.... ..  ..#....#.......**.*... # .* .....\...... ..\ # #
#.*...#\..#..# *.  ##.. *...#.#.....#....#.*. ....\#... #.... . .* .*...#.  ..*.. *\#. . #... . . ##
#*.\...# *# *.  ..  ... .  \. . ....... .....*  ...#..  .#. #....* ..\...*  ....* *. ..\ .. ..... .#
#*....## .. . .....*.. . # .\....\.#*... ..#.\.#. *..  . ***.#.\....** ... ..*..#. # \ .#*.\ ...*.##
#. #.... ....##. . .. ........ ........\ . ..\\#.....*.#.......#... .#*#.*...\.\#.#\.......#*......#
####.  ......\...#....#. ##.  #*  *#..\. . *#....# .*.* .# ..##.. .....\. .#  ....* ....##.......#.#
#...#...*.   ..# .##.... .# .#\.#..\....*...*\..\#.... . #..... . .*  . ..##... ..*...*.... #.\.*..#
#..*. \ . ..*#.#.. .#* ....##.*. * .## .......  .. .......*.# . .. .\.#...#...#.....#.**.....#*.*..#
#*   \.#.. .....***.  ....... ..#.\. ... .. .#.. ... #\\.. ..#*  *.\.#.#........  * .*......  .....#
#\... #*.... .  .. .# ** ... \*..... ... # *..... .  \. #  ... #...*.....*. ....*#* ......**..\ .. #
#...#.   ....\ ...#...#.*.# . ......... .......... . .. ...... #.# .. ...\.. .. \.*..... . \.**...\#
#.. # .#.#.*.##.*... \*... ..\*##...##.** .** . ...*##**  . .*.. .........*.. ... ... ..*....  *. .#
#.   ..  ...#......*\  #.... .*..*. ... ..*...........  #. * * ...#... *...*# ...\. .#.... .\.. *.##
#.#.*..*..*.\... .# ...... \.......... #. ..#\  .  . ...* ....  ....\.*.\ ...\ .. *... #. *..  ..\.#
#*.##.. ....... .*#..  ..  . ##.....*...#......#\*...*... . #.. *.. .* *#* ... \..\..\..*....*\ *#*#
#*\#.\#\..**...*#.. ......*.*##.##\ ..*#. .*..... .**.  .*. ..*\ ... *.. .. *.. ..*.\....*#...*#...#
#..  ..... .. ....* ..  #*...#..  ... .\#... ...   .... . *. ..... .#\ ... . . *. .... .  # . . ...#
#...# . * .*.  . *#.. ...*.\#..#........*..*. #.\ *.\..* .#.#..**  .#\  .*...\ *\... .*....* ...* .#
#..*......*.#....*.*. ..* *.*\ ... .... ..... #* .... . .  .*..#.  *.... ...\.#* ... . .##.. *#.. .#
#. ....#....#..  ......##.\ ..#*.\## #.......... ...#. ....*.* .... \. ..##*.#..\.......# .....\.. #
#. . ..*.. ..#* . *... ..*. \\#* *... . .## *..#...##....\ ....#*. .. ..\.  .. . . # ...  .. ....###
#.. . .....#*...*.\.*.*...  #.*...#*... . ... .. ...*  .... ..... ... . ...* ..*... .**.. .# #. ..*#
#.# .\. .*.... #. .*#... #...... .*## .\..*........##.*.. ..#\*..* ..  .. .. ..* ..\  *#.*..#\. *#.#
#..*\**#  ....*.. . *.....#** ..\........... *....* *.. ...*..  ..#...... .\#.\.**.  ..**\*.. . #.*#
#** .. #.....*.\#*.*#.*..*..... ##. # #. \ . .#*... #.. ..*\.\.... ..#..#..* \......  ...*\.*#.....#
# .. ..\.. * .#.#..#.   #..... .......  ..*...\#. *. ....... . ....\. #.  .##.......#.... . . .. ..#
#*. . . *..#..  ... *..#.#.....*. .#*#.......*R#...\. #\* ..... ......# .**\#.....#*.**.*..*. ...# #
#.....\..# #..*. ..*#. *\..#..    ..# ....# .. *..\. . .  ...\...  . .....#\#........ ##.... *..# .#
# ...#.  ..\ #* ...# ..\*\..#.....  *..# ....#   .*.. ....#*.*..*\...#*.....  .. ...... . *.\....#.#
#...... *.**.....**.# #...*..##. .*..... . ...\.#... *#... * #.*#. . ..*\\ .*..# .\#. .\.*. #... .*#
#.. # .*#*.#....#...... ## * . ... .. \. ..  * ......*... . ..... *.*..#  *. .* . ..#. . ...*. \...#
#.. .  .. ......# ...\... .#*... .. .*.\.. .* .*# #........*  .*..*#  .##. #.#* * .  #... . .* .#.*#
# ...\.\...# ...  . .... .#... ..*\..... .... ##. *....# **# *....\.**.  \..  **...#\..*.. .\# *..\#
#..###\.# .*\ *.#.##*##*.# ..*.  # * .. ...*.. . ..#*...*.#.. ..... . . .** #.*....#..## . ...  .*##
#..#.. #.... .# .#*  . *....\..#.... . ..*..#...#.....#.*. #... ..... . #...#*.*. ..*. .\ ... *...\#
#...... ..*.##.\ ....# .* *..#..*.**.*..#.... #.. ....  ..*#\...\.*.... #... *.\\  .##*.# #.*....#.#
## ..#\...............  .\.#  # ..\...*.. .... .\. . *.....* *....#  .#.#.*.    ## .#..#.#.  . \...#
#.#.#*.# *\#..*... ... ... ...*.....\.. #\..*  .....*.. \.. .##* . #\.\*..*.... ..#\ #... . ..# \..#
#....... *#*... * .\. ...  ..  \....\ .    .#.#.*.. .. . ..#........ . ....* #.#*..# \.*........ #.#
#*.*.** .. * *#.......##*#..\  \.. #.. ...\.. . .*#.\. \..*..* ##.\....#. #..** .....#... * .#.....#
#.#...*........ # .*\ *#....#..#..*....# . #.# . . .  .. .. ...*...  .....\..\ . * ... .*.\\ .. ..*#
#.*#... .. .....#....#. #. ........#....  ..# ...\ *  ..... ...#.\.*\  #. .. .*.. ....*..#.#....*..#
# ....*.*...#.# #.**#*.* .*#.\...#.*  .....\.**.*. ...* . ..*.  * ....**.....*.#. ..\... . .#*# *###
#..  .. ... .\.#. ... .. *# * .....#....  \*. #.. #.. ........*\...# *.  . \.  . ..*#...#..*.*\.***#
#.*.#.*\.#\. . . ..* .##....#* .  .#*..   .\.  ..\.#. #  .*.. *...\ \.\. ........*\.*...#....#..\.##
#*..# .\.....*. ..*....   #. ...#....#.*#####*..#.\ ........##...*...# .*..... *..**..\##*#. ..*\*##
# ..# .#\*.. *... .#  .#.. ...*..*\.. *..#... #\ . . ..\ .**......\....*.#\.#.*. ....#....* #. .*..#
# \.. .**.. #   ..*.......   #  .#...\##. #..  .*  ..   ...... .....*........#..\  . \.##. ...  \ *#
#. .*..*.*.*.  ...   ........# .......*.... \.......  ........ .\. *... ..*..  *. .#. .....#. .....#
####################################################################################################