####################################################################################################
#.. ..#.#*   .\....# .*.#. ...##. *.#..*. **..#*..........#.......\. ..... ..#.#...** .*\..##......#
#.\.*.**\\...* \. ..\#\R.#*#..#.*L. .* *...*..*\..#... ..*  #*.#...*..*.*#.\.#. ...#. .*.\.* ......#
# .. \..* #.*.*..#... ..#.#\.  *....*....#.. #... L*\...#*...*.*.*#....*.. ..   ...\. . .\..#\**.*##
#*..\... ..*..#.##.#**..#..#........ . **..*....#.#\ *.*.##\...  .#.#.. .*#.  *#*....\**...*#...##.#
#. ..#... #*##..*.*..#.......\##   ...... #\# .....\*..##.\..*# . ...  ..#. .\\.\*.# .#\...#*....*\#
#..\.. ... ..\.# *#.# ....#...\\ ...*. ###... *.#\* ##....*. ..*.. . ...*\*.* .\.  ... ...##.#...*.#
#.*#.*.  * ..#.##\. *..#. *.#....*...#*#\.#*..* *...*\. .*..  ...*\*L.#..# *\#..#..*# *.# ... #.\#\#
#*.\#.. \..  ..\.* ..\.#*....  .#L.*\..*# \*....\.* ...#.#*#.#. *.\\\.*##\...*# #....##**#**.#...*.#
#.\.\ # \L....#.#..*\... . ....#. ..* \#....  ...# ..*\.#*. #.#\  *.#**#.. ..*..\ ...  .*. #* .L...#
#.#**\.*\#...L..\ . ......L##.#.##... \... ..... ..#..L*.....#. ..##..........*......#.#*#.. \  ...#
# ...#..\\.. #. .* #..#**##...\.\.. .#*##..* .#... ##.#*.*#### .....\*#.##.*\...*....*....\..\\ #*.#
#..#...#L**#....*.#\*#\.... .\.#\.#**\#.# . ...#. ... ##.....\ ...#* ........ .** .\.#...* *  \ .###
#... \...#** #*.\** ..*\#\..\.\.  #*.#.\.## .#.* .. #.  .\.*...#.\ ..\.. ...# .#.* .L ..*## * . .#.#
#..#.\#\\#.#.* ##.. #...#. ... ..\\#*###*...\\*.#\*...*.... # ....*\###....*.#.*#..#. ..*...\..#..##
#.... .. ##...*# #... ...\#..*# * ..* .#..##..   .#.. #.#.. .#...## \.....#.L..\#........ .#*#..##.#
#*.\. ...*..# *..... ...\..* ....#\. .* *.#.**...#..\...#. #*.#..... .*.... *..# \ \ \\...  \. ..\*#
#......*.#\##*.**..# . ......*.\#.\..*.##*.*. .. .# .\.#  \.* ..*.\##*.\.** . *.. ...#....L#*..*.#.#
#*\.##.L.* \....**  ..... ..##*.*.. .**.\*.\# .* ..#.#.\#..\.** \ **\#.*.........# . .*.L. \*.#*.#.#
#..#*\ .*..##....*... *.*\..... ...**#.#\.*..\..*...L#.........*..L*.....*.#.  .*   *#.#*#.\*.# \.##
#.#..  . ..\..\ . .  .\.*.\.\.## ..*#..*.*.\.. #*.#.#.  #  *...\#\....\#.*.\.#...*...#.#.#..#*..#..#
#....#.#...#*..#..#.#.#.#  ...\..#..* *... ...*#.#.. .#.... **L\. #.*.*..#...#....##*. ......*....##
#....#....\*..*. ....*.* #..  #. .#.. ... ***  .  .*.... ****..#.*  *#...\..*. *\* .. #\.. .#.. *..#
#....#.\. ......\\... ........ .......  * ..#.*\#...**L* #* ****....*.. *.*..#\..* .*#\...## ..\..##
#*.#..*\*..L. #..\.**#....*.* ...**\*..#*.*# L. .#.#.. ...*\.....#..#..#.. *.# \..\\.   .....\. ...#
#....#.#\*...# ..*#*\ *#.*.##..*.#...\* \\\..L.#..  \....#*\.\.*..#.#*.## .\.*L .## .#...#.#*.*..  #
# \***#.. .***\##.\..#.... ##.*.##*.#*...*\* .**..# *..\.\*.#...\.*.#.## # ***.# ..\##.##. \###...*#
#...#*.......##..\... ..#*.. . *.*..*#L#...\.##...\.... .\.. *#.. .* .***   #... .**.#. .#.......*\#
#.\ ...*.*.. \ .#..#..\..\ .. #.. ..* #.#.....*...\.#.#....\. \ .\*#.*..#*.*#\  . ....#.L# *....*..#
#..... .*...\*##. .. ..#*.##....* \ .#....*L...#.. *. \##.*#\.* L.*. . .\..L .*#...\... ..#. #L #. #
# ##.*** *#  ..#.....#  ...*.*. ..\*##..##.# \..*.. .*L.#*..*\..**.#\..*##\#.... ..#. # .# \.......#
# . #. .. ..#.*...\ #..\.#*..# .  ...*.. *.....##.#..# .#.*...#\.#...\ .. ..#.#.\*...\#*\....  .. *#
#..*..#...#. .*...#  .* *#\.#\\.\.# .*.*.*** *..#..*.*.L...#*..*....*#***.#......#. ##.\**\..\*..#.#
#..\.\*.\**..# ... .L.#.....#*#.\\\ .*... \..*....*..#..#..# .*.\.*.* ....  * ...\###. ....*..\.*..#
#.#...#..*....#.*\...#*.**. ... . **#. #*...*..*#... .\.....\...\*. #....*.*.... .\*\.#....###.....#
#...# #\.....#.#.\... .#* .\#.**.\#*#..\.....\**#*..*. .. .. ...*\\#.. * \ ....*#*.....##*..* .....#
#..\..****.#.#....**. ..# ...*L*\* ##*  ....*..* . #...*.\*\*##\.#*.*..L.\.... *..*\.*###..#.\.. . #
#* #*.\ #..#.......\.*.**#..#.... #.#.##.#.... \..* #  .*.... .. #.**#....*...#*.\.#..*...# ... \#.#
#..#.*#... * #.*.... \. ....*. #*..  *. * #.#..*..*... * .\ #......**. #. ..#..## .\. .#\.#*....#..#
##.\.L*\*...\\... \..*\  *..*. .#.#..#...#*......#.# ..#\# . ....* L..##.*.. .#..#..*.\.*.. .. ....#
##*..*.#. ....\L#..##...\..*..*.\#*\.\\ \\.##*.*.* \ .*##   ....#*...\. \.. ...*# ......\. * ... \.#
#..#.#..#..\*#..# ..#..*# ###*.\**..##* .....#\..*###*#.\....*#. .... *.*#...*..#\*.\.\...  #. .*. #
#..**##.*..#* .* # L. \#.. #*\. ***...#.#.*# ...*.\.\..#. #.\..*......**..*#..L....\*\#.*..  ..\\#*#
#* ....# .*\*## .*..\.....*..#... *.. \* *#.. ...\###... #*  #. .* # ..#.*..\..*#.\......L....*\#.*#
#.#.....\\.  .... *..\..#*#\#*.. #.\#..#....#...#.*.*.. ..#.*.*......\#*.* ..#... .** *#... \# *.*##
#* ...# ... .#.#*...#**.......#.\...* #.*\ .....*. \..  ......*.#.# . #*.#\...L..\.. ##......*.#\.\#
#....#.#*##.***...#. \..###..... .. ... . .  ..\..#.#.*.##.. ......*....#... .*\# . .*.*\##.\#*\..\#
#.*.*..#.#*#.# *.* ..*.. #..#.##*.* .....#..*\.# *... #......#..#. \.*. ....*\.*#.... ....\.... ...#
# .# ...... *#.. #.*.. *#...#. . .#\.#.. ...#*.#*.#...##\.....L.\#*...* # ..\#*.L.#.**..*.*#*.. ..##
##..#...*.#.#......L..*#.\.\**#\ #. .\....\..  #*.#.#....*. .##..\\ ...*.* .#** .\... . .*# .*#\L .#
#..#   .....*#.*.#....#.\..\.\ .#....#    #.L..#.#...*##.*..#\.. ***..*##\.*......*.## ....\#... ..#
##...#..*\  .. ..*..*..*....** \.\#....**.. #*...#*. #\*.  \. .#...**..#.\..#.#.... .*..*#..#\.#...#
#*.*....#....*. .*.*..# ..\.*.. .# ...#.#\# .L#*#..**\ #........*#...*.#.\.\ ..*. .**  ..#... #\* ##
#.....* #*\*#.# ..#...#..* ...*#.#.. . \*..\#.. #. *.*.....*#*. .#.... \...* ... #*..*..\##*.  ..*.#
#.....#.* .*#\# ...** ..\#* *.*.... *L\ . #.#....# ..*...#...\##....* *#..#....*.##*.* #.*\# L...\ #
#.*.. ##* *## \ .#... .**** \ .*.......... .* .....*#.#*# .** .*# \**.##*..#*.#......\*.\..*..*.. \#
# \....... . #*.#*.**\ *.*  #.## .#. .\..# ......*..\.* \*.#*.*#\*.#*#. \*##..#. ..\..L* *#. ...  *#
#.##..#.* .*.##...\..#. .. ..# ..** .. ......#\.* L##.\.\ .....\# .\ ....#.. L*.##.....L.. #..#\ #.#
#. .#\\\.\** .*.#.L. * \.#\#.* #...**.. .#\**\.#\...*#.. #...*.. .##.**##*...*  \\...#\#*. # *...\ #
#.*.. .#*#.#.#.. #....## .  *.#...\ *.\.\..\\*#..* .*\..#.. ##*....#*.#.*#. .**.*#*.L.#.... #.  L..#
#..#*#*.....#.*.  .# .#.#..... .. ....#.#\..*..*.#. \*.*#..#..#....# ..*.\ \##*..*\#. .*\ #. ...\..#
#... ****#.  ..* #*..\ \... .  .#.... ..#.*#.*...*#....#.*\..* .\..#  **\#.* .\ ..** ..L...*\......#
#  *...# .**#*..#... .# \* #**....*.. .\.\.. #L ......#... ##** ....\*.*..#.*.## .*.... ... ##. ..*#
#*.* #*\...#..\......**\.##.#..#..* .L#. L..#*.. ..#. ....* #..#. .# #L .#.  # ..\ ..#......*\.. .*#
#*.###\..*#* .. .*..#. \*.*.**.#.....  . #.*.*....#..# .... .*..\..\##*#\.#  . . .# # *L#.....*..*.#
#.#.*.....\.##\.. L*L..*.....\ *.*....##.*.*..\...*..* #. .## .##.*.\..# #.\ ...*#.#**....*\.L. \ ##
#...\*.#\#.\.\*. \\#.*# ... #  ..\# #\.# ...*L..*.....*#\*..##*. ...*\....#.  ..\# ..*...# .*#.\.#.#
#..*#.* .... ...\*L*...#.##.#\.##..#....**\*. . #*.. .. .#...#.*...#..*\\*\.  . L...#\# .. .\ .....#
#. .* .\.* .#\. .*. # *#.*...*.\...*.  *...#..#* #.....#. .*.# #... *..\.L. #*.\...*.#...  . ** .*.#
#.*.#..#*L#..\..\.*#.. ....  ..\...*.*. ...#*#...*\..#.\.#. *\*.#....*\.#.*#*.*.# ..#\. . .#..*..#.#
#...\......#..**.... .#... * #. ...#.*. ...\. ...\#\#*..# ..#...\.*#. #.  *#.#.#  * ...\..*.## #...#
## ..*. ..*..#*\... .\ .\\#.\#..#.#  \.\\# ...*..#* .... ...*. ..**.. **.#\..#..\..# ..*....*....*##
# .L..#.#*......... .....#...*.*#..#*....# .#...#.#.. .*....*. ..\##*...## .#..... .**...\# ....*#.#
#*.*##.\##..\..\.. .... .**..*# #.*.\.*. ......#.#*L.*#*\...#*. *##.... \..L*.\L ... . ..#.#..*\.\*#
#.....*. .... .*.  .\#..#.. \.\..*.*#\.. ..**.#*#*\\* #.##.  .#.......* .  .#...*..* *... . ... .. #
#* .\.#*\#..*. ..\*\. .# #. \ ..#..*..#.. ...*.# ..... .# \.*.\#.*...*.##...#.*# ....\...**....L...#
# #..#.*..... ..*\** #..\.  ..#.*...*\##..\.***\.#.*.*..*.#......\.#..*. .  . *## ...#. . \ #.\#..*#
#.#* \...\ # ....*.#\....#.***. *. *. *. # * .##.##.#*\. *#.  \.\....#.\# \** \..***.. ......*##..##
#*. \..  *# .##.*#*#..*..#*  #.*...#....... .#. .....*#\....\ ....*..\...*\**.... ..#.\\.  .* .* .*#
#*. .. ##.. .\** ...*L.L.**#  *** .. .. * *..*. .#. .....\.##\... *..#.*.\.#.*.*.#.#...# .... .. . #
#*. .#.\.#. *.... .# # ...**.*..*  #  .#.*.....L# .#*..*#\*...#\#.....\ .*#.  ..##.#. .. #.. \ ..#.#
#....* #*.. . ..**#.*\.*.## ......*...*#  .L*.#....*.\#\..# .*#...*\.*.#.#..#  # ....**....  ..*#\##
#..* ..*. ...*.#.  . ........  ..*...#.*.....#....# * L*\..# .*.. L*....*.# #...... # \.* .....*.#.#
#\...#. . .\** ..#*.\\.. .*......*\ ...###.#..*.#..#\ .*#.\\.*. .*.#  .*.#..... ....#*.**#.\#*.. L##
##...\#.. .* .*.* #*\\..#..*.......... # # #.......##.# .# ..## .. #**#  *  .#*#***...#... .*.#....#
#.#.. ...\.. #...*\\. ..#.*#...#.....*.*.#* #\. ..\ #..\#.#\..\..* ...L. ..*.#.#.\.*  ## .\\.*.\ ..#
#\..\.*..#...##\*#.*..** .#*#.L*..\.. ..*...\..*.   ***#*.#\*.#.....*..* \...#....\...*..\....\#...#
#\. \.\...* \. #\..*. *.*..#.* #....* ......*.\....*....##.........*# #.*#.*#.#**#....*#  ###..*####
#.......  #\...*. * #...*\.*#*..*.#*...##* .... ## ..\..... #.#...\..****#.#.*.. #..*...#\#*.#\.*\##
#..  *..*#.#.  #\ .*\....*\.#..#.....#..#.. # .#**##. **.#..*. \. ...*.**... . #.#* .#.#. .. .. . .#
##\ *. # .....*\   .*#.\ #* . . .. .......... *.\#.....\.*L..\*\*#*####.*.#\\*..*..#.\.. . #.. * .##
#...*..**#.*......#*..*L.....*.. *..*.....\.*##\......**.* . .. # ... *... #..#...\#.\#...#....*..\#
#.*...#*.. #*.*... \ ....# ...*.....*#.#.\. *. **.... *....##.......\\..#.*..\...*.* .....#........#
#*.#.**.....*..*#.*...##..# #.#\.....*.\#.\.**.#  .*## ... *.L.#. .....*.. *.*\....\ .*#*#........*#
#.##. .# . ... ##*...# . \.*... #.\\#....\\* ...... .# \.#.......\.*.*#...\..#. #\.. ..*...#.#*.##*#
#.\..*** ...*.\#. .*#..... \.\#..**.....*.*#.#.#*\ * # # *  ..*..# . ..#*#.#..#..\.# .. ###**....# #
#*.#.. ..#**#.#*\. ..##.....#...# .*...# . *#.... #...\.\*........*..*\**.##.\.#..#..#..*.. ..\....#
#.##.#**  .#*...#*\.\... .... *\.\#..#. ...*....#\. #*##\ \\ #  *#* L.\.#*.#.. \..# .#\L*.\\\ *.\.##
##..*\.....\\.*##... ##.....* *.. *....* ..#  #* # *\. ...*.*  .\. ..\ #*\*.\*\#.*.## #.# ..*#...*\#
##################################################L#################################################