####################################################################################################
#..\....* ..*...  .........### \*#. .... ..#......... \.. ..\....#\.*#. #***... . #.* ....#. *.*...#
#*## *.\. # *.... # .......   # *.  .. . #\.....\.*.....#...\... .\. .\. .* .##  * . # .#.. ....##.#
#.*....*.#.\\. *... .** #.#.. ...**... \.  * ...#.*.. *#  #... #*.. .* .#.#*#.. ##...##..... ..... #
##.#.# . #.#*....* ... ...*.#.  ..#. #..\. ...  #*.. #... .#* .*.#.* ... \ # ... ..## ...#*....# ..#
##..# .   ..*. #*# *... #..  ...*.......##.. .....#...##. #..## *.*##. .  #... #.\ ....*##...#.....#
#...*. . ..*...#...# *\**.. #.#* ....*.. . .\ **#..*. ..*..**..  ....*..#. #  \..*.*..* #*.\. . ...#
#.# .........*. \**... . ..   .... .* #...* . #.*..*..#*... #.\.. * \.*..* . ...*.#... . # . .#.. .#
#. ...\*.\....*.. ....# ..#....\.#\ \  ##.. ...... .* ...... . *  ..... .*..\....#\  #\... . .\..#.#
# ..\. ..*.*.....  ...... . .#*..\.# \.*...\ . . . #..* .*.#..*.\....  .*#.#...**.# ... .....#...**#
#\.#.\.#. #..##.# *# .\ ..** ** *# ..... . . ...  ....*.\.....##*.\*  .* ....*...*. ....*... .. .#.#
#.. .... ... . ..\#*\ \.#... #   . *......\.. .... .....  .\. ...\#*.#.. .... ...\# .. . ........#.#
#   *.*.. #.  #**\...*..... . .#*. ....*... .. *. . .# .# #. ...... *.#..\.    .**.. *...#..*..\..##
#.\...  \   .. .*.#.. . ...** ..* \ *..*..# #*.. . *..\#*.... ..  ...#..*\.... .  ..*.\\**. . .*..##
##. ..... .*.#.#\...... . #..#......# #.#... *..*..\.........\ #.... \###*\.#..... \..... ..**\ .#.#
# ... ..# ... ..*.\...\.* ......\.... # ... *# .** .\ ....\.#. #. \*..........#. \ .. **...#  .....#
##\#   \. . ##\.#*....#..  .. \...*..#. ..*.*.....#*.....*...... ... #*###\#.#..\#  ..... . .. *. ##
#*  ......# ....*.. ..#..#..\#.\\ .... # ....*.  ..........*. .*.#.* ....*.. ... .\.. .... \#.*\...#
# ....   .. ..#. ...  . .#* .\ .  .*#. ..... ...**\....#\..#. .*... ..*##\   ...* .# ..#. .\...*. .#
# *.......#.. \\#...# .. .*.\ ..#\... ..# ....#. ......#...  #.# . . ...... ... #. \..##*..... *...#
#..*......# ..* .#*..*.  .*. \.*. ...#...  .#.# .. .* ..... ....  . ... .*....#.\ ## . .. *#*.*.##.#
# #.**. .\..#*\ ..#*.**..*.* .*#.\..  . #.*... .........# .. .*#   ..... ....   .*   .. ...#. .... #
#\..* .\.#  . .#. . ....#. .\...#.\. * \.* .......** .... #.\*.*.##.#. ...#..**#..#.  ............ #
#..\ ..  \.#.  .  ......*##. #*. . .**\ .*..#\....##  . .... .*\#... \. ..\#.#*...*.*\#......*\\\..#
#. .  .\*.\ .\  .... ...*# *.*# . ... . \...#... **.... ##...* \ .....## ..*...... ......*... .....#
#....#.* ...#*#. ..#  . .*..*...# .. .#...* .#.. ..# ......#.  ...###..#..\ .\.......#..... .* #...#
# .# . .\.#..*. *#\ *....*..**....#.....#. ..# *#*...\#.*........ *  ..  # . #   ..#.\..# .... ...\#
#.# ..... \....*.#..*.. .........*.  .# #.... * .........*... ......\.. \. *.* * . .....#.#.. .* *##
# #.#...  *.. . ....#   ... .\..*...*.. .*.*\#\ ..  . ##.#*\..  \#...*. #..#...*....\.. .... ..#\###
#*   .*. .... ...\. .* ..*. . ......##.#*\# . ...... .#....\. .. ....#..#.......*#...*  * .. .#.\. L
#.......*#.#. #.#. \..*.#. ..# ..###... #.. ...*.. #. .* ..#*#\.. . ..** .* . *..*..##*....# ....* #
# .*.   ... #. ...\. *...#...#....#.#..... #*.#..*.... ..#*...#..#. . ....*. ..* .*.....*....\.... #
#*.*# .#.*.\ .. ..**.. ..\..#  #..\. .\... .*. \* .#..*...##........*...*#..#.  #.  ..*#.\...  ...*#
#.# .. *. *. .*.*. ..*.. .*  *......#.*.\.....#....*# .\.\... \..**#....*....* .#.....#.. .. ..#*\ #
#. *#.. .\.*....*.  \..#..#.* *... .#..#...\.# .\. .*.*....... #. *\  \. ..** ..\.*\..#*.\..\# ..\.#
# * ..  ....*\*#... * *#... . .* ..*.. ..#...*...*.. .....**#. #..\*..... ..  ..#..  ....\.....\...#
#\ .#...** *\*.... .  #..#...#.*...\#.\ ... ....#\#.........\.#. \. .. #. .#. .   .## \ ##.  .*....#
#*..  ..... ...\##....\.\.#....*.  ... .* . . * .. ..\..  .. .*  ..*.* ...*.. *.*..#.\.##... #.###.#
#*..##.. \.#...* .\.........**... . .\.. ..#*........# ...*  .#.. .  ..... ...**...... .... *... **#
#. . . ..# .....\\ ...*.\ *.*\*..##.. .\#.*.. .*..*.*#.\**. ....*..*..  .   ... . *..\. * ........ #
#...    ....#*... ...........#.\#**.##.\.\.*.***.*..#... #..\*.##.*. .*  *#\......\.*....*\..*.*...#
#.*.. .....#*..# ..... . ....*.#...*.. *. .#.#. .#.# . . *. #..#\ ....*...#...\#.#...... ...... ...#
##.....\\ .***#\...*  .. #.... ..###\***..\\............ ... ..\....... .*  ..# *... . #. .. ....###
#.# #..*# . ..#.....#\..   .  ..\.#\# . *.\..#...# ......#.....#..#* . ...\...*.*#... .. ...  ... *#
# ..\.#. .  #... * ....\ . ......#.*... .* ... *.  \... .\\......#. . . *..\. ... #....#*...*##....#
#.. ..* #........#....#... ......# *#.. ...* . .\ .. .  ...\# \..##.  .#*#  #..*\.# \#..#*#\... .  #
# .*##. ...#  ...#*.*..# #*.*.# ...... *.  .\.#.\*\#..* ..*.#*. .   .....##  ..\.... ...........*..#
#. .  # ..#  # .\..#...... ..*..###* \.\.#.\*#.#...*.##.**.# . .* \..*. .*.** ** .*#..#. ...... #..#
##*.\.  .*.*.. #*#  .... . *#.# .* # ..*..# *..#...  ...*.#.#*..*.#..  . ***\ . #  .#...*....... ..#
#\. .#.## . ##\. ..\..... *....*..*\..##* #..*# ... ..*.*.......#\*.. \ #\..... ..* ...*.. ...*.#..#
# *.#..*.#.*..# ..*..\ .. *. . \.....\*#.. . *....#..*.. . ...... .. #\.. \. .. *.....**.# *.....  #
#.*\ ..# . ..\..... .*...\..  \.\ .. \...*# . .... .#.....*\** ..*\.\#.#*\...\.##......#. ..*....*.#
#. .*.*..#..... ... . . .#.. ##*... .\ .....   .*#.. *\#.\.*\...#..#. ..*.....*.. #*..  ..*.*...# .#
#.. *  .* .. .# .\ ..* # ...*........ ..*\.......  ....\ ..*.#... **\**. ... ..#..#  \.\... .. ....#
#.. .. ..*...*...  ...#..#\ \ .......# \..*  #.#..\*. ..**.......\.....*. ... #..# # ...# ...##.#.*#
#...*.*.. **. .*. .. *.# . \. ..#.  *.**#..#.*   . .\..\..**..#......  ...# #.*. .  . ..\#. \ *....#
#..#....\#..# .  #.. .... ...* .* .\.# ...\.*..*..* .*.*. ..\ #.. .....# *##*..#*......#.#* \.* ...#
#..#.....\ ......# . \ .\#... ..# . ..\\\*** .#.*... #.... .. .#   \... .\.*.** ....***##....#. #. #
#.#..*. \ . *..* .*\. .*... .. #.* . ...\* ....*.*.. ..... .# . ....#...#..\..   *.##....#.....    #
#.\#... ....\#. *  ...* *...\#.*....\ #**...* .#. #. .#. \.#.#.*........*......#...\.....*  * #.##*#
# .*#.*.*# .. .# ........\.... .*.  ....*... ..  .#..**#. .*..#  ..*.##. ...#*..#  . ... **...#..* #
#* . ...\*....*.....#.. ..##.. *.*....\##.* .... .*..... .  .\*.*.  #.\.  \.*.#....  #.# . .......\#
#.*...#*.. ..* * ...*.*...  *..\\# . #. .  . . ##.#.. * ..#.*....#*  ...*\ .. ... .*#.. . . #*.*##.#
#. ....   .. *. .*.. . . \ #* ... ..*. #.* ..   ..#..*...*.* . ...* ........##... **##.....\*  .  .#
#..*. \.. .   .....**..*..*... ..  .....  .*...  *.\. *..*..*  \..#\.. ...  #...\.....*. \##.....  #
##.* . .....\. .\..*\.....#... .##...  .. #.. ...  ........#*.#.... ...... .##\....*.\..  ..#\..*. #
#..* *.\..\*##.... .*.. . #. \... ... ..#..# .#..\ .*#\*. * ....#.....*#....... .*. .... ... .... .#
#..\.... ....**. ##.......\ .. **.*.## # ** .......* .\  .##..*..#.. \*#.. .\. **..#.#...\.*.*.  ..#
#.... #. .  ..#.*.# \#.   .. .. .# *. ... #. .. . ..... ..#.\..... .#...#. ....#  ...........#. ...#
#..  .\\.  *.....*.\.*# *.# ..\*# ....#.....  .. ....#**. .. \#.*.*. .# ..... ... * .... .**# . *..#
#...... .#...... .* .*....\..... ..\\*\ .#... ..\ .....#.. . . . .##..  .*#  .#*. #* \ .\.#....* . #
#*......... **. .# ... .#. ...#.# ...... # ......#..\.*.* ..\  . ....... ....#.  \.##..*. *..# ....#
#\ . ....\ \..*..*..#..\. .... .. . ..*.#..#\..... *..#...\. ...*.. * ..*.... *.\ *... \..\#  ...#.#
#.*..#. ....\....*..* . \ #..*.\. ..*  . .. ..  ...#.. ... ** ... .. .\.......\.*....  #. .....##*.#
#...  ... .... ......\#.#.... *.**.# ..* ...*.... ..\#. #....  #  .#. .........#\ ... .#.* ....* ..#
#  ...*. .\.**..  . *..*#.#*... ....\ *.. ... .  .#  ........#.#.#.  .#  *...  .... ...#*....**.*..#
##  .*     #. .# . ... . \.\...*#\... .. .*.*..*\.... ...*\.. #...*. .  # .. ...... \.  ..\#..\ *.##
# .#\#.  *# \\#..#..* #.*. #*.#..... . #.....** # .   \ .. ..#.... .. *    ...## ..#. . *.. .#...#.#
## .. ..\..\*. ###\\ ......  .* .*#. ..*...* .... #.\ .**#. .\.##\... * ....*.* ...*...* #.. .*\...#
#..*..*...   \.** . *.*####.# ...#........ ..# ..* ....## \....#.\. ...#...*# .... #.#......\.. .#.#
#.#..*.. #..   .#. .  ...   .... *... .\ ..\.*\. .......##\..... .*\#* *....... ...# .* ..# .  #.\.#
# \   .*...\\. .. .....# .* ... .* ......#..*. .*#. .. \. ....#.  *# .##.*# . \.. ... .\.# . ...* *#
#.#\ ..**.# *.. ......#.# .#..*.....*\*..  .*. .. *. ..#.#.*.\ ..... .# \...#.. ..*... ...... #. \.#
#.... .....#. .. . .  .......# #*..*.\.......... .# *.\.#.\...... *...#. ... .........#.  *\.. . . #
#..# ...\.#.. .# #. . .\......# *... . ..\  .. ...*  *   . .*. ..\.#....#* . *..  ..\.# ..##*#... .#
##...**....\... .*..R*#.#.##. ...#.. * *..#.\. . *#....*.\*#.... ... .*.*..* . .. .**#.. \*\.\ .. ##
#   .  ...#.*. ..  *#...*##** *..\.. . .  ..*..* *.... ....... ...**.. .#.* .*# .*..#*...\ # # \...#
#...#.# #..##\..#... ....*.* .... . ... . .*  . ...*#  ....#..\..**\ #.. ..#....*\**.\*.* . *  \.###
#..#.# \. *. *   . *... ..  ... *\ .##..  .. .#\. ... ...* .........#  ...... .  ..**..#.....#*.  *#
## ## ...... #*.\.. .. . . #.*.. * *.....#*.. ..##. \.....*......#*..#\..\... #...# *....#\.*... .*#
#....#.. . .  #.....\.. ..\#\*.#.#.....*.**.....*  #......#...  #*.*#.\  . ..#.... ... \#\.....*. .#
#*  ..#*#.. \*.  ##.. # \.*............#*... . *\.... .*\ #....*.#..##.#. \\*.....\ *...#....*  \.\#
#....   .  .#.... #*\... ...  . . ........ **..  .\##... .#..* . .....*.#*. . ...*....#. .#..*. *\.#
# ..#.  ... *#.\# ...... *.*....... .*.*.. \..*#\ .  # .\..#.......  . #..# . #*.*...#. .\...  .*..#
#.# *...#\  **..*\...*.........\... *# ...#.##...  #.   .\..\..\ #...* .#.... \.\... * ...\.*.*....#
#.###\\... ****\..\.#..*   .*.*   .**..*..\........\. # \.. .*.*#.*...*.#...*.\\. # .*.*..*. ..  *.#
#..*.   ..* ..*...  #..##...#**.#..*. ....#*.. . . ..##......... #. #.##... *...........*.#.\ ..\. #
#* \.\\\#*#........ .....  .*.... *.... .....*.... .* .. ......# ..*...  ..#. . ....  **..\. .   ..#
#*#.\.. . #...*.... ...*.#.* ...\\ ... ....   \\**..  . .#.## . ..##   ..#. * # .. ...*..   # #.*  #
####################################################################################################