####################################################################################################
#..#*.*\ \..... ... \.\#..... . ...#\.*\.# .. .**##.... #. *..#.. ..  ...\.#*.*R\...#.\..  ...* ...#
#..\#..#    ..... ....#....* . \....*#.. *. .. ...##.#.  .**..  .#\#..  ..*#..#...\.#. .  .** * .. #
#*.#..*.* ..... # #.. . #  *. ... .  ..#...  ....#\.# #..#.. *#.# ..... ...#..#.. ... * ..\. .. .\ #
#* .\*#*.... .\... ... ........ ...\. .... .* .\..   * ... \ ..      * #*..* .\..\.. *...*# .\\.. .#
#**.*. * # .. . .. #\..*.#..#.....  *..*.*.#.... *.*.# *. . .\....\ . .. .#. .......* ... . .#.... #
#..... ..*..**.. *..*.....  ... ... .# *. . ..* * ..\.......  * .. ....#\...#. .#\.*.....*#*  .\..##
#...*..*..\*... ... \ ...#..*.#. #... # #.......\\\#...*..##*.   .......#  .\*....#*# .#. ..#......#
#.. #..\.\..*  ...## ...  ...... \#.*. . *#. ..*\.. ...#* *.#..*\*.. *.. .#...##*.  *#...*.  #\*.\.#
#.. .  .. #... ..  #...# ..#. .........\......#*.*.\. . ... ..*.#.. *... *..# .. .. ..# ..*...*..*.#
#  .. \... *. #............ .. *. #.\##.  .... .#\..  . .*. ...\...## *.  .*.#..*...... . .. ...#\.#
# ...  #.  \.*..##..#...\\.*.* ....* .. .*..\....  .. \.*\......#........  .......  .#**.. ...# ...#
#.# . #....*.# .*...##.. \.\. #..... ... .# * . ....*.*\*#. .. #...*...**..#. ...#\.......# ..... *#
# ..*. ... ....*.#..*....*.*. .#....*# .*.. ##. ..*#.#..... ..... .....  ..........  *\. ... .  ...#
# .#....... ...*...\.....\###....*\. #*...... .*.....#.*..*.\.\  * .\.\. .....\.#.\.#.\*\..\\..... #
#*... #*   ....\ .\*. ##.*.. . ..\. .\ #*.\ ..\## ... ..** .*...... ..  * ...\  .. ...*..#. ... ...#
#*....*.....*..##.*......#..#* ...*... *## ..*.**..#.* .#. *.#.*..* . .... .. #  ...*.. ..\.*....  #
#... #.... .....# #. .. . ..*.*.. .    *..... *# .....\.. *.. #.#....*\. .......*.\...\.. ..\..#.#.#
#. .# .. \.*.... .    .. .*.\#*#. #*..*.  ..#*. ....*.##*   ..#  ..##. #.... . ... . .*\..*. .. ..##
#.\ #\\.. *.... ..  ....#.\ ......*..*.*\ ... ##*# .. . ..*.\.#*...#...\. ... \ . . ... .  *.   .  #
#\. ..... *.. ....#.. .*.*...#.. \..*....   ..#* ## *\.\.. .. ....\.#\... #\#.  *..#*.\... .#.  \\ #
#..# ..*\.....* .... . .#\...*#  #........ .#...\.#.#.\  ..#...  \.*. *.#....*..*.*#.. . .#  ..... #
#*..*.. ..*#....#.\*.* .. .\#. \\#.*#.  . . .... ...\ .... .  .\..#... \.. ..# ..#..\ * ..*..#.... #
#.....#..  #. #*.\  ...*.. * ..\.... \.*...\.#  .......*....#... *. .#.. ..  .. . . **\..#.  *.*.*\#
#....*.# .....  ..#\.#...#.\ *..*. .*.\.*#.#.*....  ...  #.. #..#..#......\.....*#... .#. *.#.  .#.#
# .* ....  **.. .*.. ... ......# .\.... ...*.#.\. *#.    #.\..... ... .#..\ .. .. . .* ... . ..*\* #
# . .#. . #.  *.#.......\.#... *.#.*#....  .\.#..   #...* .. * ..* .# \\**.* ##.# ..\..* .    ..\..#
# .#  .\*#*...\ ......#.. ..*...#...  . .... ...  .....#.#..##. *. ..\.  #. . ##. \.# ..*#. #\..# .#
# *.#.* **...... ..*.  #.# ....\.. ..*..#..#*.#.*..**... . .......\*...##.# \.... . .*\......#*.#..#
#  .  ... .#...# .\*............. ...# ....# .. \ .#...##*# .*.*. ...\ ..*#..\...#*..*.. *##...... #
#...#.#.#  #.. *#.  .....#*# .  ..\. .\ . .. #...  .*....... ..#.*.  ....#...*..\# ..\..*.  # . .#.#
#..... ....... .  . .*.   . * ...# . *\ ..... .....#.......# .#*.\......... * .*......#.....# .\..##
#**..#. ..#..... *.#..\ .....#.#\* *\\ .**.#..  .* .....#.#. #*\ \... #...\  ... .... . \.#*\.#.#.*#
# #..#.. .. .. *.. .......... ** . .....*. #. ..... ..  .**...... . #. \* * ...#.\....  *#... ..*..#
#...........# . ..*..\#..##....#.....**\...*.* .\...\. ......*. **.*#**...\...... . .......#. . *..#
#\. ....*... ...# . *#.#* ....*#..\.\*. ..#**.#.\.##  .. . .  ..#...* ..*.. ...*.#.. .#...... ..*. #
#... #*\ ..##.  ...#*... ..#.#..*...*. ....#.\ #..*\..#.#....*.*#.#.... ##. .#. .. .........* .*.*##
#. ...\...#..#\ . #*.....*.#.....#*. ..#  .#..**.. ..#..\. ...*.*.  ..#.. ..*..  .  . .##*. ## #.*.#
#.. *\#..\ .#.# *.#\... .  #......#*..#.. ..*#. ##.#... *.......*  .**\ *..\\. .....*\##...###..*..#
#.....  .\...\.. .\...*.\. ##.... *\.*...\....* .  #.\. ... ..#. .#. ..* ..* ..# #. .  *..\  ..*#..#
#...*..\..*#... . .\...#.\*.*.\#. \... .... . \ . .. ..#.\... \.#*.*.#.....#...**.. .***\  .##* ...#
# . .. ....#.*.*....#.. # . *.\. ....#..  .... ...\##...*.\.. ..* . .*.*. *...*... .# ........... .#
#\.\.*# .. \.#. ....  . .  ...#..*..##.\\.#..##.*#.. #. *\.  #..  ..* ....#. ..\*.##.#...  ...# *..#
# .... ...#....\## *\\#**#\ .......  .#*....#   # . . .#\*#\. ##...# . ..........#.. #*  .. . .....#
# . .\.  #..#.**\.  *   * ...  ..#*.\#.###....\* *.*..... # #.*. .*#. .. .....*.#\ .#  .*......  #\#
#..##.\. .  .. . #.. .\.#...#  ..*.... #..   ...#...\ .*#*..*...... . .....##.. ... ... ...*.. #..##
#*.#..\  ....\#...  #.\#.\.* *........ ....* \*. *# ... . ..\... .*.....   .. .. . #.. . *.....  \ #
#.*.  .\ ..... .#....#*.#.......*... ...  \.\\.\  *#....\....  .... .*#.....#.  * * ..  * ....#..\.#
# .*.. \*.  ....#. .\.#.....\\.*.... *..#. \.#\. *... . ..*.. .. #. \.. .....## .* ..*.... .   #.\ #
#.  .\\# ... *.#.#\ ..**..... .*... .####.......*. *.*.# #........*. \..*.*... \*..#..#. .\*#...#.*#
#.. .#..* \ . .. * .*..... ..*.\....... #.\.#  *..#... . .......#.*..* \...\*\.........  *...#*....#
#..\.. ..#*  *\... *... .. *  .#..... .*\...#. .. .\ ... . .... * ... . . ... #.\.*.. .. *..#  . ..#
# ...*# .# . .  ........# .... .#..#.....* \.#... .*...*.*..###.#.... ....*.. .. ......*\.*.\#...# #
# *....#.. #*. *...# \........*..*.......*. #... .##..#. .#..*.* .*. .**.*...  ... . ... . #...... #
#  .\*...#.* ... .#*\.* *.#....... ... .\.. ..* .. . ......... . ....*..  ##*.  *.\  ...####****.* #
#.    . .... .  ...#..#.\###* \#. *. .  .#. . ...**.....*...*..*.. \  *... . .\#\\..* .\ \ * .# ...#
#.#... ..  . . .* #....# . \*.. #.  .....\. .....\.#...#*..# .......#. ....  . .   .*..#....# .#.#.#
#..*#.*..\ \.**# ...  \...* . \..\ \*.\..**.*\.... \ ..*.  ***.#...#\#*. .*..# .. ... .#.#..# .....#
##.#..#..#.\ #.....\ \*\....  ... \.... .*. .. #**...  .....  .\#.... .. #*.#.*#.#... # .*..*# ***.#
##..# #.****.....  *. .  .#... ....\.........*.. . ....*.... ... .    ....#. .##..# *... .*  .\  ..#
#. . . #.#\.\#* ..#.  #...*. *. #*.* # . . \\.....\......  ...#*.....***..... \ . #...*#\. #.......#
#..*#.*#....* . ..# ..\..\.. .. \*. . .. *#. .#.  .\*.*.*. ..  #.. .........   .*..\  ...* #\ ..\.\#
#... \. ..*.*..... ..*.. #..#..*.. *.. ... # ..\  .  .**...  *\.#. .....\....#...#....   .. ..# .#.#
#..\.. #*\...\.  . ..*.#.....#.  #..... *.*#  #.  ..#\.  *... . .#*. .. #.#.....\*.\.. ..###....  ##
#.. .\.....*.. #.*.*\..#.**..#*..#*...* . * . # ...*. ...*.. .\.*#. *...*. .. *...\. ...#*..  .. *.#
#.# .#.. ..#. .#..  \.* #. ... \\. # .. ....... ... *.  #.....*.*.\. ..*.* ...  .\....\..*.  ... * #
#\....*.  ##....*.\**.. ....*# .#.*.. . ..*.......#.  ..... \.\#..\.......*... # #. .\* .... .# #. #
## ..#.*.* # ..# #... *\.* ...**. .... .#.**.*. .. ....\   #.....  .#\* . . . . \*#. ...#...*#\.. ##
# #.*#.... . #. .##.....#.  ..\#.#...  *..... ...#\.*#....#. ........*.  ...## *... ...*...........#
#  .#.*. #\ ..... ..  .*.. .*  .#  ..... \ ..#.  . ..* ....###...##.\#.#. *  .....#. ...*. \   .** #
#..... ...*.#\\* .. #.. .\...##. . #....*.*.. .*..#... ..#...\. ..#*..*#*#..\  .*.\.#\...*.. .\....#
#....#.. #.   *...#.##.. .. . . ...* . ....*.... \...#\.   .  **. . .....  .. ........# .. **...*. #
# \ ..\...#.. #.\.#........ ..# ..... .  ..*......##*.. \#. \ .. #. #....\...*. .... .\.. *..#. #..#
#.......* ..\.  ...# .. .*.. #.   *. #..*.. ..*\ . \...*.*.# * ..#.#.. .. \. #..... ..\...# .* ....#
#.*. .  ** .....#    .\.. ...  ..*. ...*... .#...  ..........#..*.#... . * #.* .\..\ ...   .*. ...*#
#. ..*  .*. **. .. .... .... ... \..#..... ... . .#.. .*. . .*.. # ...\ .\ ..*. ... #.#... ....*..##
#...     .... .  #......* .*..*..* .*... .*.  .# *#...... ....* . .. ... ..\#......# ....*..#*.#...#
#.*. . .  .#.#*..* ....*  #*\....# ....\.. .#*. #.*.##...*..*.. ...* .\ .*..*#.*\.*.**.... *..#.**.#
#*..*. #  ...#.# #*.*.*......  .#. ..\#\..*\ .#\.#\ .* . ........#. \.....##... \*..*. *. # ...*. .#
#*#\ .#*..\ .*\.\.....**.. ......\ .\..... \..*###\\ ... .  .#.... .......  .. .  ... ..* .* \ #.. #
#.....  ..#.*...#\..*.# #.#\.# ...#.  #..# #.. ..#... ...\......#.#.. .. #\ #*..*  ..#.. . *\......#
#.\*\.. *...*.... . ...# . . .## ..*..... .*.* .\.# .##.* #..\. #. \..... # ... ..  \...*.**.\... .#
#.......*. .....*. .. ..**.## ................ *...... ....... . * ...#.*.#.. ... .*.# \    #..*...#
#.*#*.**..# .. . ..*. .......#.. *  #... *......#\.##......#... \ .#. #.. .*.#... .... ..*..* ..#..#
# *...#*.. .  .. #*. .**.#**.\#..#\......   ...*.* #...*...  **#. ...\.#.  ..#\.*.. ..*. .... *...*#
# \#  ...*.*.# .\\\.  \....*..\  *. .# ..... ..*..# .*.  .. ... ... ..*##.. \..# .\...  ...*\##. ..#
#. *#*  ..#.... .#. .#  \...* . ........#*.#.*..  \.*#. .  .  .* .....*...\.*.. ..#.........\..* ..#
# .#. .  . .\..* #.* .*.. .#.\ . #.\....* #. .\.\....#...#*.....*##.#*  ** .\. . . .*.. .  ...... .#
# ......*.....#.... ....# \ . .. * #. *.... .#**.......\.*. .*......# #* ..##. .#*\#. .. ........#.#
#.\.**.... *.#..*..#..........* ..*.\ ... ...  .  .. .* *. #... ... ... . *\ .* ..*..*...... .*..*.#
# #..... ..*#..##   ....*#...   . *  *..... ... \....\   ...* .#.##.  \*...# .# .\.. .#.#..   . .*\#
#..*. ..  . \.#. ........*.\*.......*.#.... ...  . . . . .#..... .*....  . #\..#.* \.... ..*... .#.#
#.. .  ....\... . \...* \\\ #.*...\.*.#*.\.#.. ....#.. .. .*#*.\. #.*..#*.. .*..*.**. ##..#*..#...*#
# #.*#*.\ .  *..##*..*.. #........*\*. .\*.*. ....*.#\.*   *.# .. .#... . ...  ..* #.* *#.\ ...#.. #
#...*.##.\*...... ......*....*#.. .*..  \ ..# \... .\.. .\..*#.# ...# #**.#.#.\. # .... ...*. .....#
# .#.....\ ###.... *#.#. ...*.  . \........ ..  \# . ..\#... .... ....**\* .*. .....  #.. *##..*  \#
#.\..# #.*..*..\ . .. #.*.*...# ..\.\ ..#..* .#.* # #. .**\*##. .. ...*# ..  .#.#....#..#.* #...*..#
#.# .* *. .....#.  .... .*    #...\. .#...#  *. ..* ..\*.*\#\...#.\.\ *..... .  . # #*..#.  \. .\..#
#*..#.#.*..# . \...  ..  ... .....#.. .........\\ \ .*..... .\#... .. \.#.......## *.....*. *\.# ..#
##########################################################################L#########################