####################################################################################################
#  ...#* .\* .* ........*............#... .......##  ...\#..  *...# .#. \.. ## ..... *  ..*..  .. \#
# .. .#..#...#. \ .#*... .*  ....*.  ..*......#.\  *  # ... #.. ..# ..*.*#..... # . #..*...#... .*.#
#..* * .\#\ #.*.*  #..#.** .* ....... .\.*  \..#. ....\..#.#...#..#...#. \....\.... #. ..#.....##\.#
#...* .. \. ....... *\.#..*..*.........####\.....\.... .*. .. . ..** ...#.. . . \ ..... ...*... *..#
#.......... ...*.##.#. ....*# ...# .*.*#.. *.*  .. .....*...*....* ..... * ....... ..*.....\ .#... #
#*...#... . ##\ .*.  #.....    *#\......  *..#..*.#... ...#\.*#.*#\**..#*.#. .*.  .# . ..* ....*##.#
#... .#  ## . #*#..\#*#.. . .\ . . .*. ....#*.... .##. .*..*...*.#.\. .\..\  ....*# ....... ..*\...#
# *..  .....#. ..#  .. *.. . ....... ..\....# ..#. ..\#. *.#*..#.*......... .. \* #* . .**.. ....*##
# .. .....#. ..# *...#\.....*... .\..........*.\....... .#......#*..   ..  . .  .... \#.. *#**. \* #
#  ... ..\. ##*...... ..\.*.* . ** ..*** ..  . ......#  . \#..*..   .*. .  \ .#.. .....*.*.# **... #
# ..  ..#..#... .... . # . #.*#\..# .\. # . # #.... ..\*. .  ...#.#**## ...#...* .......* \ .... ..#
#*.#\. ... ... #..\...*.#*...** .....  .. *.  ..\#..#*# .  . #.. \\* .... ......* ..  *.....**. ...#
#..*. \. #.............\\*  *#..# *\..  . .*#.* ..#.. * ..*.. ....# \...\..*  .....*#*.*... *.*..###
#  .*#*..*....*.*..* .#...# .. . ..#....#.##*#.  ......#..    *.*..*... ..*#..\..... ...*.... . ..\#
# .......#.## ......  .*\..*... ...... ..  .. ..    ..*#.... \..#.   ...*. *.*....*. *.*.****..   .#
#.*. .*. .....#.# ... . .   .\\.... .. .#.... ..... .*.  .#.#.*.. ..*...#.....*.\. .. #..... .\  ..#
# .. ...#. * ... ..........\. *.\.* #..*...#.\.*. ....# # ...*#....\.*# ... #*.#.#. **...#...*.  .\#
#.*. ##... .*.*#.*.#. . .#\\ .#.# #.\ .  # #..\... \.....   ...*.#\#....*...* .#.. #*# .*#.\*.#. ..#
#.......#... . .....\.   .. ..\ *..#.. ..#.. ..*  .\ \ ...\ . ...\# #........#\\ ....\. .. *.#.*. .#
###...##.....#.*. ..#....*#. .... \ *#.\ # .  .* ..** \... ... ...*# ... .... ...\#   . .#..##...**#
#.#. ..#.##..#.*#\   .  #... \... ............*.*#..##. .. *#..*.  \ . .####.. #...*...#.### .\ . .#
#..*.....**.. \.*\..........  . ... ...#.\. ... .*  .# .* *\.\.... .....*...\*. *. # .#.#....*.*...#
##..*....*. ..\ .\......  ..  \#  ...* .\#. ...#..#. .....  .*.........*...*.*.. *  .*#.* ...#.#. .#
#***.. ...# .  ...#. .#. .*...\..#.... .  ....#... .  ....# ..###..* .. *#....#.. ... . ... ...#...#
#.... ..... .#..# \...\.\.* ....#. ...  .........#..*.#.. ... .. .*  ..#.  .*#... ...*.*.....  . ..#
##..#.# ............#. .. . ... ......*....\*..\.*...*...*.   . ..\.## ....... ..*... ##..  #...##*#
#.. .... .  ..#.\ #.. . #  #... .... ..#*.*.#*. ..###...  ..#.*##..*.... . \*..##...#.\..  ... \.\.#
#. ...# ##* *...\ \ ..*.. # ... ....  .. ....#. .*....#.*. .. *.. . #.*  *.\.  ..\.* ..... ..#.\...#
#.* .#..*#\. \.# ..  ....*   .. ...*.*.*#..* #.*\.#..*. .#. ..##.\ #. .. .*... \ ..##   .......#...#
#..  ..  #.\.\.# . ...#.. .. # ...*. *..**....*.... .** .#.  ...#... \\.... .* \...\..*#.. *.....\.#
#...**...*. . ##.*. .#*.#..\ .\. .. . ..  ... ..*..#.#.... *#  * ...*...#. ....#..\#.*\ .#*.\...#..#
# ......* .... #.. .*..*....#. .  \...... ..  *...** .. . .  ..*....  \  ...*....  .. . **...  ..*.#
# .##*.*.   .##  . ....#*#....*...#...\ ...*.... .****.....*...*....#....\...* \\.**.*.......*.. . #
#.  . ..#*\.* .. ..*...*# .##..... . . ... *..*.\..... #..\... .*.#**. ... .*... .  .. .\..  .....##
#.. *.**...\. .. ..# *#\*......#. *.  ...#..... . . \ . # ... .*\#. *  \..**..*.#. \*.....*....# . #
#..*. #....#.* ##\...**#.... . *...*#\..*.  .....*. .#... .##..#..*. *...# ..* ..*#.......#.  \*..*#
#....... . .....*\.. #..*#* .... ..\..#...  .# ..* *. #  .**##...*.\..\... ..*. *..  ....*.*. .. ###
# .\.###..  ..#..*\  *#..*.\...#.*..*...*.\. .*.*.*.. ... * . .#\....*.#.....*#\. ... .   ..*..*#. #
#.....#* ..... .....#\.... #....*.* * ..#.#\ \##... ## .#.*.###.#.. #.. ...#**.#.\.\. .*... *\. . .#
#\*..* ..*. ....# . . \..**. .. *#.\**.... ..*#*# .* ...#. . ....\.....# ..*.\*#.#. ..*..#****.. ..#
#. ...*. ... #* ......*#.. . .....***.. #*\   ... .* *.##* .##\.. . #... .... . #*#. #..*  *  .. ..#
#.#... ...\..............#. ...  ..... . . ....*  .#\.. ..#* *.. ..# ..# * .\...\.......#... ... ..#
# ##.. .. #\..# ........*# .........*..\ ..*.***.*.#. . ....# #..*.....  .. #.....#. *...\*. .#..*.#
#....#....*..... .*.. ... ....\.....\#.* .. ......*.........*.*#. .... *.. .  .#..*........*... .\.#
#...  .. *...... ..*# ...*..* #. ...#.. ...#....\#* . #.\.....*...*...  .... *. *\**\. ..\*  .#...*#
#.. . *.... #. .  ...\...... #....\.#.*#*  .*# #.. ...*\ ..*#.*.....\.*  #.. .#*#.#*\*. ... . ..*..#
#....... .#*.* # *. .  \... \... ... .#.\...    ......#*...\.#. ..* ..  *. *.\  . ........ *.. ..  #
#..\.*... ..#.... ...#. *.*    .. *#\..#.**#..#..... *.\..#.#* .. ..#  *#....\. ...  . .. * \... ..#
# . .*.   . . \ #\.#..  .. ...* .#.... .#.*.  .\..   *#.. .  ***..  .#. . ..........* #*.## .... *##
#....##.##..\..*.#..#.#.#..........*   . #.   . . *....** ...* .\.. #*........#..  .*..*.##*.*.*. .#
#....#. ......*..  .. *#..#..... . . . .#\ #.**.... *\\# \..*. .##*#.  *#.. *. ....  ..#\ *#*.*..\##
#..* ..  *.\... ....\..#   ..#.*........ .  ........\. *#. #.. *.*. *.  #....# ...*...*... ..\. ...#
#... # ..  .#* #...*..*.#. ... .\..#... .. .#... #..#*.\# ... .. * \... ..#*...  .\#.#..*... .....*#
#.# ... . \.....  ... ...*#....#.\.....#...*.  .*... ..##\#... . .. .\..#.. ##.*..  . *..  #...*#..#
#.\  \. .. *....* ... ..\#..\ ..... .#  ##.... . ## #....*.*\ .. .* \...*.#*#. ....*.. .*#*..#...#*#
#.*...\..... ...*.\ ***.  ...#. ..... #...#.# . . *. # .# .  #....*. *.\...... .#.*.\..##.# . *.*..#
# *.**..  . *..   ..#\#. .  .. .#..* .*.. .# ..* . #.#.\ .  * ...*#.  *.#..\.*  ..\..... .#. ....#\#
#..........**......#.. . ....\*..#  .....#.....*. #.\... *. .#....*.#...**.#.* . . #\... .##...#. .#
#. .*..# * ..# ....\ ......#*#..... \*...#..*. #..\ . .#.\ ....\.*... ....#..*.. *.........# # **.##
#  ..*..**..  ..* ..  .. #.  .*..    .##. ..... ..#  .....#...#. ..# * .   . ..#..... #\# . .#.... #
#.... # . #.  #\...*. . * ##.* .**...*#............ *#.#..#.* ...   .. *...#.#...*.. ...##.#*\. #\.#
#*.. .#.*.. .##. .* #.   ..... #.. .. . *\. .....\...#.#\.........\..*. ...\. #  *..**... ..... .#.#
#* ..*.  . #.    .#  # #*... .. ...*..\*......#.# ......*. ....*..  .  .\# . ..#.......# ..*#.  #. #
#.#.*\*\#. .. #....*.. ...**.. ....*. ...  .* ..... ..#..*#.# *....#   .\.*.. ...#.** #*\..* .*....#
#\ ... *.#..\.. \\.....* . . #. . . *.  .. ...* ....\ . ..#\. ....  ###* ..........*.*.....#....\..#
#..#.#... ...** .  .............  # *..\ .#.  ..\..#.*...*.#......#....\ .. *.# . . .... ..# *. ...#
#.#*.# * #. . .. * .  .#....\ .#  *..# . ..#..#. ...##  ..#..... ... .*.#.#. \.#*.#\..# * ..*....*##
# ..\.*..# ...\*...  .. . .\*.*...*..\... .... .. #.. # ##.. .*.*\.  *   .*..*... ......***\....  .#
#. .#.*.. #*.*#..#  .#\....\..**.........#*. .*.. .. .*...#  .. . ..*.......#\.\\*.....*##. ...\.. #
#..\\#  #.##. .*.. ...*.*. . #...... \...#..#\... ... ....* #......#. .* ..#\*.....  # .....\.#.. ##
## \.#.. #..#. .  ... ..#.*...\... # ...*. *.#\*..#..*  . . . .\## .*.*.*....* * .  .*..# .... ...\#
# .  **... ...... * ...*. ..... .*..#.*.... *..*\.\........ ...* ..\  ..#.  * .......*  \...  ..*\ #
# *.\ #\.. *.  # ..\.. ..#. .  .# . .....\ *# .\. .  . *.....**# # ....... *  ..# ....**\.\.\ *. .##
#..  . ..#.#.##\...#.#..\ .\..  # ..#...# ...  . *...\.*\**.. . .#. ...\ ..#. ....  ............*###
# . \.......*..#... .#.*  .\\  .*.#..* ..*.\ .# #\...#. #.#... ...\.\.#.... ....#..#... ....# ... .#
# ... *#. ....*.##..*  #*. ..*.\\.\... ..... * *.....* .* . .#....* #*..#. #..*. .. . ...*#\#. .*..#
#. .*.#.........*.... .. .\ #*.\.\  *#.... .. ...   .*...*. # ....## ..\* ....   ...\...#...*#..#..#
#.\.*#\#.  ..   ..\#*......... .*...... . ... #.#.*#. *.#..*.. .#.#. . .\. .. ..#...#.....#.*..##..#
# ..#.\..\  ..*....**.#... ##*..## ...#  .*....  #...  *. .#. ..*. *##  . .*.. .*# .#\....#. \ .####
#  # .. . ...   ........ . . ## .* # ...#...  ...\ ..  #. *..\.*. . .#.. . ..#*.. *..*  #*.*.. *#  #
#*.*. \.\.. ......*.......# #*......*.* ...*.#.*####*. .... . # #.  #...#... *.#*.* ..**... . #.#\.#
##.. #...*.#  ... #.*.*.. .. .......# .. #...#.#.. ....*.##.... * .#*#.. .. .*.....*.. ....  .# .. #
#.**....#\ .  ...# # ....#*..#\.\ #... #...\... #* . . .#..\...  .   .  .\*...... .. ...#..... ....#
# .    ..#.\\#. .   .#.#\. #.#.* .*    .....*...**\# ...  . .* .*.  . .*. ..##..#. ..# .# ..#.....\#
#.. ... ...\.*...# *...  ....#.#....  .*\*... .. .* * .....# ..##..# .* ..* ........\. ##\....*... #
#.\...# #. .....* ..*..\*.. .  .*....**...*... #..*#*\#* ...#..*#. #   .. *#..*. ....  .. ...#  #..#
#.*# **   . .. ..# * .. .#.# .. .#...\ ....\. .\...\. ....  \* .......#. ...#*........... \ .... . #
###\\.* #\.***.  * .. ... #. .. #.*. . #*.* .  ... ....*. #  .. \\ .... ..**\.. *..*.*...#\. *. #**#
# .....*.\*. ... *#.*.\ .\... # ... .##  .#..#.# .\#.# . .... ..*. \.*....#..... #*.. ...*....#. .\#
# #*.#.#....#.*..#... ..#.......#\..\... ###*..*.  *.*...*...*#.. ..\.   .# .*....#.. .#\...\..#..##
#...* . ..\ ...#..\# .# .*.* .#.  .............\...........#.# .#. **...  \.*.. #.. *.....*....#.. #
#.  .  * .... .*...\.. *.#.#. \.*.. ...**#.......  ...R.#.... * #.#..* .*#.  # .....#.\ .*.  \ **. #
#*... \*.*..\*.\ ..*#.*.*#...*..  .. #* .# . ....#*..#\#..     \ .*. ....# . ....# .. .#.*.*#.*. .*#
#...###..#..#*.*....** .. .. .#   . .  .... ...  .*...*..#.#..*.\.# \..## .. *.*# ... ... ...... ..#
#.\..*   . *..*\ .#...# #..#. .\. .... ......#. *....... .\\#.*...*..**.**\... .. #.....**   .... .#
#.#. .\#... ... ..# . . ... .*#... .*...  *. .*## #.\#* .....\. .#...*..# \#\.... *.   . ...** **.\#
#...... .# *.  ... # .\\.#..\...... *....\.\. #.... ..#.**.  \ \..*.*.#..... *.... ...#..*..##. \*.#
#*  .*#... .. .\\*... .. .*\#... \.#. ..*  \. ..  ....\#.#.#...\#...\.*..*. .##...##.......... *..*#
#############L######################################################################################