######################################################L#############################################
#..# ... ...\ ..#.... ....*.#*\.#.........  ..\* .......*..#*# *\*.. #.  .*\.....#.#\........*.*   #
#*# . ..* . .* #.*.*.#*..*..* .......*.#...\.\.. \  . *  .\...\..... ... . ..  #.*.. ....*...#.#.. #
#... \. ###. . #. .  .\... .. .# *.*\# .*#*  . .. .......# ..** ....* *... ..#***. *. .  .. .* ... #
#\...    #.... ..#.. ....  .....#... ...... ..*.* . . . .. .* .* #.\# #.#....#. *.#*.. ..#.....  #.#
#.*.#.. #*.. . .#..... . ..\... .#..\.   .... * ...  #....*.. . ...* *  . .... ..*.. . ..* .....# .#
# .#*\. ........ \  ..... ..\. ...\#.\*...# *. .  ..*... ....  ##.. .. .....\.# \.... .##.  ..... ##
#..*.#\# *....**\.#.. *...\. .*#....#.** ..*.**.....##\ .. *.....*... .**......#..*.#. .*...*.. #..#
# \. #... .#.#.* ... #.#....\.#\..... .*...*.#.*......... . ... \ .  .#.#*. * #..#.... . #.**. .   #
#  *#. .*.# .. ..*#..**.*...* .  * #  ... ....\......\...#.. . ..\.  ....##  .#.*...#.#**  .\.# . .#
##....\ \#..#.*. *.. ..#. \*.#  *.#.....  * .*.  .#.\.*.......#... #.......\.. \. .#.  ... *.*..##.#
#....   ...\.#....  ..**.#* #... ....\.\  ...#.** .. .#.#\#\  .. . . #*..* . ...*. .#.#..#..*. ..*\#
#\ ... ......#\..# . .. .. ....   #.. .#. #. .#. *.*...# . ....\ .#. \...  ..* .*.. *##... ....*..##
#.. ....\\. ... * #. \..# \*... ..#..\.........*..*.*.#..... * .. . #****. ..*..  #.  .#.**.... .* #
#*........*...*\.. .*\.* ... ..#*....\. .... \.\#. #... \. . ....\...*.#.#* *. . .. *....** *. ...##
#\#..\. .......**..# ....\. \. .  .#**\*..# .*\.#**.... ...#.*....# * . .  ..*. ...*..  #.#.   **..#
#.#*.. . ...*..###.#. ..#.....#.. .*. \.*\#.. ..* ..#.... ..*.... ......*. *.   ... #\#*. .#..\..*.#
#... #*......\..*....#.#.#.   # .. ..\..\*##.. ...*.  . . .. ...#.*. . .. . . ##.... #.# ....#*...##
#. .#  ... .#...*...#*#. . ...#.   .. * ...**.. ## **..#..   ....* .#.  #... #. ..#.. . .  #.*..\.##
#....  ..\..# ... \.....#... ....*.#. \......** #....\#...\ \  .\# *..*....*.#. .*    ...\.* #.*#..#
#*#..*.*..#... .#*# . #... \..*... ....... .... \.*.. .........# . #...*.*.**.\   ...*..  #.*.... .#
# ..*.* \. ....#. ..# *  .. ..*. .... * ..*...*.*#*..*.  #..*...\\......## ... . ... ..*..##.\.. \##
# ...*#  . *..*....##.......#.\*    . #\...*..*.....*\..# ..##.......#...#.* .#. ..*.. .#..*..#  #.#
#.\*.*.*#*..***  .. ..... ..#*..   ..**.. ......* ...\\..#* *..... .#..\ ..  #.\  ....  ..#..... . #
##. \....#.*...*...  **##. ... . #  ... ..*.    . ...\*.\.  * .  .........*... . ..........\.#.##..#
#.#....#... **..#...*..\ ....  #\.#.*..#*#..*.# #  ..*.  ....*.*.*#.*....#* .*.# ..#.  *#.# *.\*.. #
#... .* .. # \ *.. .... ..*..#* .....\... .#.  .*# ... .  . *.....#. ....*...\### ..*. . # ..# \ \ #
# .. .*.*.# \  *.*..#. *...#* .**.##*.. .#*..\ ...... \..*.*. .. ... ..... .#  *.#*..# \.\*\..##...#
#.#. . \.\..... .* ..*...#.#.... ... . .... *. ##..  .#..#...#.  ..  .*.# * .# .#.* .. *..\... ...##
#..**#. ##.* .\ ...*.....#* \.. ....* .  #\*.. *.##*.# ..#.#.*.. *.*..... \. ..\....#*.....**..\...#
###  . ..*.. .#.#**.. .\ **.#.\... *..*........ .... .\\..\........\..\ #...*..* .. \....* ..... ###
## .\ .*.#*....*. ... . .. ......... .\ *.*#.... \ .*.* .....* # ..\.  #.#*.. .  ..\.*..*.*\.  ...*#
#.... #.#...#.. .....\. .\*.#.#....* .*... .*.#..... # \  #. ..........\*..\.  .*\*.. #.... * .#...#
#... ...*\ ...\   . .  .#..#. .... . .. \.*.* **.*.* #* .#....#..\....*.##.#.  . ..\*##\#\ ...  . .#
#*.#....*...  .. #....\. #.... .*....* .#\* ..*......\  #*.\* ##....* ....... #**.. #..#\#..*. ...*#
# #.#*#.. . \.  **# #***.. ........ ...*.*#.. .#.#..  *#  #... ...#.*.**. ........ ...#. \.. .... .#
###..\..#.........#   *#.....*.# \..#*  ..#*.... .*#..  #*. . \. ......*#* **...\.*. .... * .*... .#
#.#..*..#... . . .. .#**....#* ....#......\.*..* .. . ..... .. ........ ...... ....*. ...*...#...* #
##.* .....\ ..*.  . .* .... .#.*   ...  ......\  .\.....#\.\. ... *#.. #..*\..... .*##*.  .*.... .\#
#..***...#..\#.*   ..**..#.*. ...... \. #.#...   ... ...*#. # ..*...##.*.....**\.#.**....*...#\ ...#
#  .....*..\  . *...\..#...#** .... .#.. ...#.\...*#. ..*. *..\.#..*\#.* **#..*. .#.......#.... ..*#
#......#*..#........*.. .... .. . ..\  #  \ .*#.#..  \. \#. .#. #*\.... ...* .. .. #.#.....#.** .. #
#..##*\...  *...... # .** **.......#.... \  .#.*. ..  *..*. . .\....*. #...   . \* .. ...\..#...*.##
# .#..# ....\*#....# # #*..# .... ..*... * \#*....\#..*..... .. .... .\\ *.....#...\.. ..**  ....*.#
#.. ..#.....#.*.. ... ... *. #.... .#**... ......*\...# . ..##..* # \  .. #..#.**..\ \#.**.*.#*....#
# .\ .#...**... .. *.. ... .#. .. .... .**..*. ...\.#.*#.\...... #*\#*\.\\... ....#.......\\...*. \#
##... .\.\. ..#\.. \. ..... .* ..\. .#..## .\..\.\..\. \##\ ...... .. ... ...#... ... .. ...... ...#
#. .#...# .# ...\... # \. ..... .......... ... ..#*. ..\ *.....*.......#.*.. # ...  .# .... .*. ..*#
#..#*.... ...  . ..# . .... . **#.*.. *#.........**..# ...#*....#..*...#\  .....**. *.. \#.. \..\\.#
#....*.* ** *..#..\# ..## # .*..*...*.#..#...........\.*.#.. .#  .\#...\#.. .*.  .*.# ...* . *..##.#
#.*   #.  ....#...* \.#\..*.....*.*.# .*.\.. .. .*#.#.#.#.**...*.\ .#\**..\#. ....  ..# *#.... #...#
# \. \.. . ..*..# #...# ..*\.*. #*.  #... ..*.. *...#.*...#. . #..  *...#..* *.*.... \ *. .....#..*#
#*............*........#.... #......*..* ...* ..##.....#....**..  *. .....\*.. \# #.. .#\......*...#
#*......*.# ##****  # . .  .... .#.\ ..* ....*.* .#.*...  .. #.. \.  . #  .. ....\  .* .#.\\... # .#
#..  ..#..##.. \..#.*#.... .# ..*#*. \*#  .#...#   .#\.#. .# * \* .*..*.*.... ....#\..... #\#  .# .#
#...  .*. .#\....#..\#... *...*... ..#...#.. #...##.#..   .. ..\.##... .#.#..* ...*...*....# #.#.# #
# ...\ .... *.*.......** ......*.... .. .. .#... *.# . *..*... ....\.  ....* \..#.... .\.*..  . ...#
#  # ..*.#.* . . .. . ..#*#.# \ . ** #.*.  ......#..  #..*.....*. ... .#*. ##\ #......* ...*.#.. ..#
# .**.**..*.. ..  #*.**.* ##......\ ...\..... .\....  *\.......#. # .**.#....#... .#.. \..#  *..   #
# ## .. #*.. \..\#* *\.... \. #....\* .#... #....\ . ....*..#\***##*...... . .....#... . ..#  *  * #
#  .. .*#..*..#*. *. .. .... **. .. ... ....#.*..#* \...*.#*.. #\.. ..  .........\........ ....# ..#
#*#.. . *#*. .#. \...# . ..*..... \ .  .. ...\#*.*...... .  # .. ...**\.#\.*#. .\#*..#.# .\..# # ..#
# .#.......# .. .\#.#  .#*#.. #.. ..*#..# ...#.... *.#    .*.*..#...#.. .... . ..#* .*...\.  #.....#
#.#.\*.... .. ... .\.*.\...\.##........\\.  ... ........# \* ..*#........**....... #.\*.*.... . * .#
# #..#. #..*  ..\  #.. ........ . .... ..... .\      ..  ..\.*.  ...#....*.**..  *.\.# # ..* ..*.\ #
#.   .... \.\\.#..\.. ...*.\.*#.... ..#......*#...........*.*. *..*.##*.** .*\ ..... * . .#.....\..#
#.... . .  *... *.. . . .*....#* ..... ....#...  .. .#.....#.... \  #..##. ...*... .#.....#*... #..#
##*...# ...*#....  #..##.\.  ..\.#...  . .... ..#\.. . .. *. ... **..*. # ..... .#. ...#..##.. ...*#
#.**# .. \*. #..#. . #.#.\. #.#......*.. . \\\* .. .*. .#.  *.\*....   .  * ..*..  ..... # .*.. *\.#
#.... . .#  ## .... . ... .#.. *..#\.  \**....*.# ......\**.#*. . .....* .\.. * * ...#   ... * .. .#
##....  ....# **..# #\..*. \#*...... .  #. .. *....# #.*.. ... *  #*#.... . ...#. .........#\.... .#
#.. \*.\ ... ...**.....  .#.*#.#...\ # .. ......*.... *.*....*... ..\ . .....*.\.*.. .#..\.#..*....#
#.. *\ .##..*..#.... #.\...#..\....* ..* ... #.*\#.....  *#. ..  .**....**# ... . #.*  .... .. . . #
# .*..#*.* ..  .  \..*.*..* .....#....*..*# .....#.# . \# *  *\* ..*.*\..\..*  .#.......#. . ..... #
#..  ..## \.#**. ..\ .. ..#.*\ * *....\  .  .##.  .  .*.. \#.* ... .. #.... ...*. .\**.#..\**  #. .#
# ..*.\.#.#*.# .. . ..\..  ... *.#..#.#.  . ....* .... *....\.. ...#.. .# ...  .. # . ...*. *...\#*#
# .... .. \.\. .\.# ... . *.*.*....\#.  .. ..*.###.... ..... .... .#.    ......  .. .##.**....*..#.#
#. . #....... ..*#*.... .*. ...\  * .. ... \. ...\.**..\ .... ..*  *..* .* ** ..#.. .*..*.. *  .. .#
#.*...#*\\...#.. \...##  ..#.#.. ...\ *...* .#... ..*#.....\  ..*\. .. \...  \..* ..\. ..... .... .#
#..#.\. .\ * ..  ...... ...#..*. .... .*.#. .**.#.....\#*..*...# ....... #...\.\#. ... . . ..#...\##
#**...... .  . *.#*.\*..R. *#. ...#. ..   .#.#**   ..    .##..*## #.#*.#.#.  ......  . .\..*. *  ..#
#.#*#\\ .\....*.. ..*...*..#*..*... . ##.....##*...*\.#*..  ...*\..  . .#.#... ...  *.*# #....   ..#
#..**\ ...* ..*..## . #. .. .#.*.*#...... #. ..........  ...*.. .#..*...*.#*.. ..*.\ .#..#. .#. . .#
#....#*.\** *...# .*..#... ..    * ....#...  .*... .... *#...# # *#..*.. .... .. .. *.\*.#. **    .#
#. ...\....#\.....* .\##.   .**.... .  . *..\*.#.*  .. ...##..  #*.*. *\ . .#. #....*.\..* ... .* ##
#.. \#..#. .#. *.. .  *.......#.#.*.... ..* .......* .\... . . ..# .**#. . .* .. .*.\...#...*.\\.\##
#* ##... **.   .  ..... ..#... \*....   *. **..  .*.  ..*#....*\ \#.*\...... #\*#.... . . **.......#
###.. * ....*...\.*.*..  * ..\.*. #. ..#.. .#.#*.....#... *.. \\ # ....#.. .. \. .*...\. ... *. #..#
#\ ......#. .  #  *...  .*. . ........*#..*....... \.**....\..#.*.* \.. .  #....*.*.* ....*... *...#
#  .#...#*....\.....#. #\# .#* . #.....#.*.\# .* ..# .\.*.  . .. .\..... #...# .. .*.\...*. . . *..#
#...*....\ ..\.#...# .  . .. \..#  ...*\... ...... .*   .*.. #....*. #... . #. . ..# .\...#..\*. #*#
#........* ..# ..  .* #.#*.. *...*#...#. ...  ... ...#.#.#.#.#*.#.*#\.  ..#..#..*\.. ..### **  . ..#
#. .*.\...\...#. .*.* \..#.  . .  \ *.#.#.\#.*. .\ . *.##...#. \. # .....\ #. *#.# ...****.... ..#.#
#.#.\...*...\. . #*\.  ...#.*\.# ..# .# ..*.#... .... *. ....*\.. ..*........ #.# \  ..........\#. #
#.*. .......  .##.... #\##.. .*. #..**#.... #.\# *....*. ..# ...\. ....\.\.. # ...#..\. ..#. \ .*..#
#...... .. .#.... ..*. . # .*\.\.  ...\....#.# ..*.. .#. ...#.* \ ..#...\.*\ .....\# ........*.....#
# ...*\.#\. \.** ##..*.\. ....  ..*....... .# ...   .  \. . .# ..*...... .*   #\. ....*\ .# *. .. .#
#....## *.. ..#.....#  #....*...... .** #......... .....##... #.#....#...#..  ###*.#. .#.\...\.....#
#.*...#**#\...\*##.#**.#.....  .*#.. .... \.... .*. . .......#* .*##\.#.  #....\  * *.....* .#. #..#
####################################################################################################