##################################L#################################################################
#.*\.. .# * \..\..* ** .. . # .*...  .# ..  .*.....* .  *..  .......  ...#... .*#. . \..#* #.*.*...#
##.*.*  *. \... ....* .* ***# .#...#......... \*.#.....\ ..*.*..# #* \\  ##..#..\..*.*. ... ..... .#
#.#*..\........# ....\.  ..... *..\....*.. .. .. ....   ....  . .. *..  .*.  #....#. ..   *.*.  *..#
#.*..\.#*.... ..*.#*\. ..\. #.  ....*# .\.\.\*\. ..  ..*..* .# ....#\# .##..*.\.\. ...#..* .. \..#*#
# ......*. .## ....    #  *. * .........#.....*...  .*....#*##.\...... ..*. *  #.** .##*....#\*.\\.#
## ... ... *..# ...# *..... #*#.#.*..\... ... .. ..\ ..\\ #... \ #....#  ... .. .#. * .. #..#\#\\..#
# .##*.\. ...*...#. #.* ... .... .##... *   ... . \..... * .. **........#  .*. .. \.* ..**.....  ..#
#\.#.....#. ##.#.\.* .#.#.###.*.  .#.    ..*...#  .....  .**. . ..# .. ..  ....... .....\... ...*#.#
# .#.* ....*.* # . ...# . .  \.* ... ##\.... .... ..   .....#\. ....#... ..*..\......*....\ ... ...#
# ....#..#   ## ..## ..*.#  #.  ... . .......#..\ #  .*     #....##\. #.#.. .. .......\..** *......#
#..\#     .. . ........#.. #..... \... ... .. ..*  \.... # .. ##... \\ .. ... ..* *..*#.#  * .#.. ##
#.****..*#....#.**#....  \*.*... ....\ . .  \.. *......**... ......\#.....\.**..#.. .  ....*....#. #
#.\.#\.* . ... .. #. .#.\.#. # ....# .#.... #.#... #.. .. .*......#*...**... ..*\ ......... \.#  ..#
#....* ..........*....*..#.. ........\.*.. ............ . #.. *.#...*##......... ..*..... . .......#
# ..#.###.  ...R.*. .. ....##. . * #. \. ...... *.  ...  ..\..*.\*..*.\. ..\....#  . *..\ .\*. .#*##
## ...**.......\.....*#. #...*....  ..#... .*. .*.# #\.*. # .*..#.#. ...\. *.#\\.#.....\.. .....  .#
#*... \. .  .*.... .*... ... .. #...\ . .  # .*. # .*.#\.. *.##* .#\..#.#.. *..# ... ..#.*.#.#...#.#
# .* .*.* *.#.#.*....#*. \.\.*. .#. . . .*..**...**.#.*. .#.. \# ...#\ .#\\*....*.....\ .. *\ .....#
#.....*..\.. #..#. ...  . .*.\.. .*. **..  ..# ...#\.. .#..*\...#..   . .*...#.* ..*..#*#\*. . ..*.#
# \ ....\.*.*.... ..#  ..  .   ... .... ..* ..\*... . .. *.  .#  . .*. .....*....#  *#.. ...#... ..#
#.. ....#*.....*# #...****.....#*#*#  .....\.## .... ..\*. **.# ... \........  . .... \#\#...* *. .#
#.*.. ....#..\\ ..#...#.#...* .... ..*. \ * .....*...*.*  .....*.*.   .#.##...#.*.  \ .. .#....* ..#
#*. ...#.. .#...*\  .#.... *.* ... . #.. .  .*.. ..#..  #. * ...# #*.\..*.. \*\*# ..## *.# .\. .. .#
#...#\.....#....*..\....#.......*. \... .#..##\.#*#*# \..* ... #.... .....#...  ** ...   #... ..## #
#..\..  .....*..* ...*.. **\. .\. .\#.* . \  #*#. .* . . .#\ .....\..\**. *.#.. .. *.#. #*.. . .\\.#
#...#*...#*... .. .....\#. ... *#......##*\..*\..* .#.. ### ..\ ..... *#  .#...... ..   ..\..\ #.###
#.. ....#. *..*....#.. . *.. .. ..**.. . ..#.\#....#.* .# .*.... *.#.**..  ..* ##  *... ..... \.# .#
#  ..   ..# *  #. .  ....# .#. . .# .. ..*.*..## ... ..*...... . .. #\ .*. ##  .. ..*\....# \.*....#
#.#.. **. .. .\.....\#......#. #.#..#..#..##..#.**\. ##*.... #... . . #..#..# .....#..#......*.#...#
#.... ... ..*. .# * ..#... .#\. \..*.#..*...##...#.. \. ...\.. . ..#.....*#  .#\.#. *# ..#..*..  *.#
#. .....   .#.  . .\ # ..*.* ......#..#.*....*. .....#........\.#...*. *. . .#.* . ...#*# .*#.. .#.#
# ..*.  . . *.. . #.. .#  #*....*... ..*\..\...*.*.#. .*. .##..  ..**#.\.#... ... .#* .... .*\*  ..#
#..# . ..# # .*....... .\.*.\#.#.#. .. ..#..###.. #*#..*\ ...#\...\. ....  *##..  .*...** *.. #*...#
# ..#....*. \.\#... .#... .#..... #.\........#. .... .. . .\..... .. .. .# *.  .*\.  .. ......#.# .#
#.... *#..* ..*.*. # * *\#.  . ...#\... *.\.\. ...# .#...#*. ..\##.*.# ..#.. .... #...*  .*... ....#
#.#...# *....#....#** . .\. * ...*. ...  ....*. ...#*. ... .  . .. * # *...* *.....\... . .  ... . #
# .#.#.#.# .........#.##. .. ..#..**#..** *....... #..  ..# ..\....* .... .#..  *....\*\...  ......#
#. \..\.. .\...\...\.. ..#. ..##..#*#*.... ......*#  . .*..*... . .....\... ....... .*#....#.#.* ..#
#*. .. #.... .*.\\\.###........ .#...  *...... \#..\ .. ......  . .. #.#.  \. **#   ...... .##. ..##
# .# **... #. \*.\ .. *  #... .. .*#....... ..*#. ....  .#. ..*#.......... ..#  .*......\. .. .  ..#
#.... ... .# .*.... .* \  ..#.... ...  .##...\\....#* \..\  ***.\ ...*....\* . . ...**#..\....*.*..#
#.  #. . *... ..* ....** * .\.. ............... ..\\.....#.... . ..  ..... .* *\.# ......#... ##.. #
##... . ..\\..* . ...............*   .#.#  ...  .. .#\. * \*.\..  . .#. ...*.....#.*# ..  .  # .# ##
# ..*.  \. .*#. ..*..##. .**...#  .#.*#.......*.. #.  ***. . . * *.. .. ..*.   *.... .....\. ... ..#
#\.* ....*...#..#\ .  #.. #.. . ... .#*. ... ..# .#.*# ... ..*.. #.....  *    *..\.\.#*#.  .. * ..##
#..... ..#.* ..**.*. #..\... *.#*.. .\*#.\*. ...*  *..... * ...... .. ..**.....#.... ....#. .......#
#* ***  ..#* .\... \...  .....*..#   .#... . ..**#... #*.#.*.. .#..*...##.. #... \.. #.**.  .. * .##
#. ..*.**... #..    *.* *.#* .. . .  .#* #..    ..  ..#. \\...*.#... \.   \   ... \.....   ....  ..#
#*..... .*.*\. \.  ......\ ...## ..\ .\. . ..#......... ...*.\....#.. .  *.....  . * #..* . . .. *.#
#  *.* . *......\.#.. . #    # .*    *.*.* .# .#*..........*.* *...   .\ .\\..... ..*\*#.#..#. .. ##
#.*.*....... *..#...# *. ....... .*....... \. .\  #....*.\\... .......*  .* #...*..# ...*.  .. .*  #
#.*.#. *...##*..# #.#..  \  ....  .. .**.. .   .. *.# #..**..\*.*.*#.##.*.*...\...*.... .  .\. .\\.#
#......*#......#....#.#*...#*. \.. #...... .# .*..#..... *. .. .\.... .#...#..   *...# .###*.. #...#
#.\. .\..** * ..  ..# ...**##.. \....*..  .......#\#.**...\#. ... ....  *....\..   ........\* .\.. #
#. ....\ .. ..   .\  .\\...*#.. *..##.. . .*. #... ..**..#..#\.....*....* *... #.* ..  #. .. ... \ #
#*.#..*.......*# \#.#.#*..# .. .# ...... ..... #. #.......  ...*... \..*#*.. **..# * *.#. ..#* . .##
#**.\ ..*.*..*..\#.* #. .....\... #.  .*.**#  ... \**.*.. .... .... ... .  *. .#. .*.  #*... ...#..#
#.\..   ...#.. # ... .*.#*. . . ..*##.*...*.#... ....  .. *...*...#..... #.# \ ..# *.*.. #.  .#. ..#
# #\ .#.*.  . .\...#. * ..  ..*....\    .. \..#.. .. *#..\.#.#\ ..*.#. . . . \*#\....#.* *.#..*#.. #
# ......*...*.*..  . ......#.#. . .*#*.#...\* ..\ . ....... .#*... ..*#*. ....\.***# ..*. .\... . .#
##.   #..*  ...#\  .... \.. ..... .. . * ..#. ...#.#....*#\. .*.... \# ....  . ..........\.# .# .# #
#...\. *..#...\ .#.\..##\.. .  * . \# .#. ..*\... .#\..\. #. .#. \.*#.. #..\ *..#..\#. .*.... *\.#.#
#...*##.#. ...  ....*.#...  # . *#.#.* #  .  *. .*.. ..* ## . ...#*....... #.. #.....*\..\.*#*. .\.#
#..*...*..#.#.....**. . . #.#*#.*.*...\# ..... .....** .*..# ..\. *..*. ...*. ...#*\...#.. .*  \ ..#
#.   #\..#..\.. ...... ..#  .. . ..*#.  .*. ..#.*...# \.* #*.\...*.....#*#.\. ...*#....#.\##***\.\ #
# * #.#.*..#....#. ....*...*. #   ....  .*#  ..#... #\#..* ... .. .. .. .....  . ..*   *. . .*...*##
#...\... ... .#...**..  .#....\.........\....  .....#..... .# .... ... ....# .  *.# . .. .#.. ..#  #
# *. .#.....###. #.#.*.......*# ....... . ..#. .\ #.. .\ ..\. ....#....... \#..#..*. .\*. ..#.#. .##
#* #.*...#.. ...*...#   ....**.....* #* . #..# **... .*# ..# ..\ *. .\.# *.#... *\#..##..* #. . .. #
#..*...* ......*\..#  . ...*.* .*\ *... #. *#..\ ....#...\..  ...... . .#.. *.*\. .\..*.  . ..... *#
#.# . .#  ..**.\.... \.#* ..... #*. .* \ . #..#.*.... ...  #......\#\..  ****.. *. ........\*.\..#.#
#....*....#.... .\.  # . .##\... . .\*\.. ...\ .. . \..**..*#....*#.*.*.......#...\.*.. . ..#. \.. #
#*..  ..##\\. #... .\......*.## ...\ #.... .#..\ ....*....\. *.#.#. .. *.* ..\#.*..... # .#.\.*.#. #
#...*. .* .\.#..\  #..\ .. \ ..  ... . ..#.#\.. ....\ .\. .. .\  . . \.#*.*....\  .. ..#....#...\. #
#.#*.\.  ....... ......#..*..\.*# *#. .... *. #.....  \.*. . .. ...*\.. .... .\....**   #. * .*   .#
#.. #... *....*...** .. ..... ..........# ........ . ..#.#..*.  ... * . ........  \.  *.\ *#....  .#
#.*..\. # ...#. ..*# .\**...#.* \*  .*. .  . .* \.. .   ... .. #.....*.#... .*.#  . *..**.\#..  .*.#
#.*** \** # *.#..##  ..  . ..* # ... #\. .. .. ....  .##.#... *...... #... . ....#\.**..\.*. ..   ##
# \.#.. .. #.* .\.. .. .*..* . ... .\..* ...  ..*..* *...... ... #.\. .#..\ *..#\ ..#.#** \. .\*..\#
# .#.. ..* #..*.#*........*.## ......**\...* . .\.#.....# ...\ ..#  . .*#.......*#*#.\ #.... .#..*.#
#.. ... ... .\ .#..#.#..........*# .. ......\. **..\.. .. .....#..\ .....##. #......#...#*.*#. ....#
##. .*...  #........ .#*.. *... .#*.*..#....#.#. ... .... ...*.. **\...#.* #  **. .\*.*..#. \* ....#
#* *.... .#..#* .*.#*....... ... .# **#..#.....*. . ......#... * .#*.#... \#..* ...#.....#  ...... #
##..**.. .\..#. ...\..#..*.*....*..... ..*..#**..# .. .. .*#.*.#.#*.##*. .. ..## .  ... .#.\ .....##
#...#...#....   ....#.....# . ...#...#.. ....*  ..... .#. . \ ..  ......#...\. ...#... ..\ .* . ..*#
#*#..#*..# \...*......*.*\..\.. **... *.*.*.. ....\. .....*..\ ...  ....   *.*... \. ..*...#..... \#
# .#..* .#.....#..   #*.* ..  #*... \.*. .....#..... ..\**......... *.#...\.#. .. ...#. ...#..\*\ .#
#.#* ..* .......* .##. ..#....\.. .*. .# .....* ....# * *..***.  ..\..#..#.*......*. ..\#.#.*... \##
#*.....*.....*.. ...*.#..* ....*#  ........#*..#.# *# *....\.. ....\**#..*.... .\....\ .\* #....  .#
#.# ...\\.. .......  ..*..##.  .#...##.  .*..# #*###* ......\... .*.## . ...*.. . ....#  . .*. ... #
#*.\.#. ...#..*     .*... \##. #....... .. .*..#* *.. *.*. .*..\*. .....*..\. .###..*#.   #.... ...#
#.#.  *.#.. ...*...*.# *. . *...##. #. ...#...*..... *...#*#\ *...*##..  ......... . \.#..#. . **.##
#\  .. # .#**  ... * . #... .......#* .....    ...* . ..... ..# . #\..   .* .*#. . .\.. *.\*. \. ..#
##......#\ *..... .. *  ...# . ..... \.#.......\ ...\  ..#.. ..   ..... ..##*.## ..##........# .. .#
#... #......#* .#... ..# . . **#..#...... .. #..*. . .##.#. #*. \...#.  .* #. . . . # \..#.. *.. ..#
#..* #..\ ... .**#..*. **.*..#* .#... ..#* ..\  \.*.  ..\ .  \..\#\\ .. * # *#*.....#.\ ##.. *  * .#
#.. ##... * .*.. # .## . *................* ... *.\ .. .#....#  #. \.. .#..# .*.. .*.. .#*. .. ....#
#.  ...\ \.  ..#\..\.... *#..#. .. .*. \* .#\.*.# \#.. *  . .........   ...*.#*.\......#. ...  ....#
####################################################################################################