##############################################################L#####################################
#..#..#. .*.\\... \#. .. ......###.# \.....*..... .#....* .# #.....#..#...#....#....# .\ .. .....* #
#\*...*.#.#*..*.... .\...#\. ...*. ... ..\.* *...#..#*.  .#. .. .* .#.*. .....* .... ..... .#......#
#*#.\*........ *. .............. *#... *##.#...* *# . * .#.....\......   .#.#... ##.\....#** #...  #
#. .\.\...  ........\.. \. .. .. \. *.#. *.* ..\ .\*. .. ..\..#.#*.  . ..\.......*... .*# ......#. #
#. ..#.#.. *# \ .....#..... ...\..... *....#....*.* . \...# . .  ..\ .*#. .. #.  . .. ... . .# \\ .#
#.#*....* ..  . #\ # ... .#.#..\..\  #.  * . *.\.# . *..... .... .. ......*##.*....#.  .\..#.*...  #
#.... .  .*..*..*..*... ....#. #...\..*. ...#*... ......*.#. ...#..*# ..*.. #.*....# #*... . .....##
#*#.# .#....... #..... . ... *# \   . *...#\#... . ... #\ .#\. #\. .  .  .. *.\.\ .\..*....... . . #
#.....* .\  * .. .# .. *....*...*.......\ .*.#......#.  .. ..#..  .#. \ # ..*...*. * . .\##\.....  #
##..#.* .*.*## ... *..#...... ..*...*##.## #.  #.   .*#.*...... .  ......**... . #* .\*.  . # ....*#
#... \  .#...*.. .# *\....... ...# ...# ....... . . #.. .... . .\ *..*.\... .  *.#\\..**.........  #
#. \.....#..*..\..\ #    .  .. * # * ...#...#. *....... ...\#.*. . ....*#   .....*# ....#..\#.. #..#
#..# . .. . .....#... \ \...#.......### \.....#... ....#......#.* #.** # .  . **. ..#...# ..# *... #
#.* ...#. #. . . ....*...... ....\# ......#.*.. #.*.#.# ...#.*..  .*.#...**.*#...... #.*..#.   .\..#
# .....#...#.*.\.#.#..* #... .... #\ * . .#.. ..*\ #..##....#.#..*.\ ..  ... .  . ... \ #....#.#.* #
## #.\...#*...\.  .#..#..  ...#.  . \. .#*\    # .*...\* ..#\#* .*\..... . *.#.*.#..\... ..#. ..  ##
#.*.. .# .#.. .. *#.... *.....   \\\*...#. . ..  ..*.*\.#....#..... #. ... ..*\ #.* ....... ..*..  #
#...... .   .\.*.  ... ##..*.. ..\ .  ... *....  *. ... .*......\..*...  .*..*..\*\...* #.*..# ....#
#\*#.\..  .## .# ..*...  .\ .*#.\..#.\#*  .*.* # \..\..#... .......* .. .... \... ......... \#..   #
#.  . ..*\ ... .#.#  . .\\....... * ...**.  #.#\.....*..\...\..#. *. \...*...   #*..\.#...*..#*. *.#
#...  #.*.............\* .. ........#*. .. ........*#.#*  .*..*..*#.. .\..*.......#* .*#......#  *.#
#.... .*..... ..#..#\ .*. *#..\ .   * .. **.. .* *.. ....*..... *##.  . #.# .. ...*.#*... *..  *.. #
#.*.*... * *#.....# *.\#..\...## ... .  ....**  .#.*## ....*...   .* ..... #..# .\ **......... .#..#
#. . #.* .#.*#... ..*...\..\. . * .........#.... .\.*....*. .. . #...... \*\ .* . ..##.#   ..\.*...#
#* .  ..\..*......\ .....\.. ..#* ..\.....\* .......  *  .. . \*#. .\..\  .. .. .......*.. *..\##..#
#.* .\.*..........#   # ... ..*.*..##...#.*\.##.. #. .... *  .#... #.*.\ ....#.#.. .*..  . *...##\.#
#\*..*.   ** ..#. ..#.. ....# R ..... .........*.. .... ...\..*.........#...\..\.. .  *.#.#.*#.#*..#
#..  ..   #.... . .#....#...#\ #. \*.*. ......**..*. . ...\*#* ....... #.. . #... .\..  .  \ \.. #.#
#. *#..*.###   #.. .#.#\\ #.**.#.#.#.*\   . .# . **.*... ...#.. ....\ \.....**.\..*.  #*...*.. . . #
# .....\... #...  \#\.#.*..... .\\*# ..*#.*...   ..**. \#..\. .  . . . ....* *... .  . ... .#* .# .#
#... ..*# ..\#.#.*.#.. ..#....*#*  \  .  .\  ##.*.*..#. .. ..#.\ ##*\. ..###...  ..* #.\.....#* ...#
# .\ ... * #*#\..  .  ....# \. ....*\  . \.#.... . #.. ...# . ....#...#.......#..... .*..\*.*...##.#
#.* \....  . .\....*.* .. \. # #..  .... ..* .. #*.*\ ....**.# .. .  .. #.*..\..# ..#. .  .... #.  #
# .*\.# ..........\**\*#. .... *.\ .*....*.#.#*#.. . .#. ..\..#.#.#  # . # .. .. .#..#..... *\...* #
# . .\ ....##.*. .#..* .  . \#\..*..*....* .\.\.*\ ..*. .*.. *#..*...... ..*  ..... . ... .#...*#.##
##.# . .\*.. . .......# .\..*. ..*   ..#...#... .*.\. .    .. . .#  .. . \#...  *... ...   .\.*....#
#\  * #..*. ...#  ..##..... .  .#..#.#....  ... ..#.  .. # ..\#........#. ..#.* . .....#...*. ... .#
#...#. ....*......#\. . .#.  .##.#.#*. #.. #\ *.*...#.**.. .*.. #..... *\.........#..... ...*..  ..#
# . .....*.. #*..*  .. .*..* *. .#\#\.*#  #...\..\* .#......\. . .*#*#... \....*.. . . . ...\*#....#
#. ...* #..*#\*.# ... ***..\. .. #. ....#.#.#... #..#*....#..*.#.  ...**....*.... \*.#... .\#.....##
#. ....*.... \...*......#\.... .#  .... ...... *\.  #\..\ .........\# #..*..\..  ...  \..   . .*.. #
##..#\*. .. .*.*.. . .#..#\ .#.....  ........#**....  ... . .# ##.  .. *\\...#*....### #.** #.. ...#
# ......#\* .  .# .... # #. .  ........* .\ *#. *.....* \...*  ...* .\...*  \.*.  .*............ . #
#. *..#..\ ...*...........* *.#...*....* * .. . .* ...#. ##. .  *.*#. ..* ..  *.. ..\**....#..\*  .#
#..#..\#.#...#.. \..#.* ..\.. . .#.##.. .... .\.# ..\\.*...\\*...* * #.#. .. .. ..\* .#.*# .\.#\. ##
# #.*.*.. ##.... .*.*. #........#...... .###.*#.  ..*.*. .. .... .#..... .  * .. .#...*....#*\.* .*#
#  ..........  ... ...#..... \*.     .*.#..  #.*.....*.*# #\*.. ...# \.. #..... .# *.... *...... ..#
#... .###....\#..... .###.. #..*.#..\*.*...\ . #.*.  ..#.#..*.. .....#.........#.. *.*..*.#* .*....#
#. .#\.......\...#......#   ..*.. ......... #......#..*. #.## ......#* ...*.... \.\ .# .#* \*.  #. #
#.\\.....#.....*  ...... .....# ..#..*#**. . ..#.**# ....... *\..#* ....\..*  . *..# .#. . .*# # .##
#. .\#...*... ....*...  ..\.......# . ....#..   ...#. .\#  ...... *.. .*. *......**.\ . ....... ...#
#  .#. *. . ..  *.* .. . . .  .   *........ .............* # #.* #... .*#..#\#..#..  ..  \.. ... \.#
# .  .. ...... \... .*..*.. .. #  ....#* ......*.*#.. .*.... .......*.\......  .  ....  *\\*.. #.. #
#* ..\.\. .\. .....*##.  ..\..#.....#.#..#...*...#. . ..# ... ...*......#.# .....* . ...... .......#
#*.. . .....#..*.  ..#........ \.. . ..##..  ##.\.*. ...**#..  .\. ..\ .......*.*.#  . ..#. ..*\*\.#
#.. ..# .  .#.... *#\ .. #...  #. ... .#. ......#...... .. ..  . ...#..\\... . ..##. ... ..*.....\.#
#............#..* . #... ...##.. ....... \.*..  .......*..*#.  #. . *... ..#.   .. ... **..........#
#. .. \.#.#.. *.#.. \..... *... \.... ..#.*...\. \#*#..\ . .......#... \ *##.. \. ... ......... ...#
# ..* .*\. ..... ..*...\ .. ...#*.*##..\*.*.....*. ... # . ..## .\..... ... . ...*.. .... ...... .*#
#   **. .  *# . *... \ . .\*......\. ... #. * #...  ..#  .#...#..* * *. .#.\\.\\.. ..\..  .\.  # ###
#*... ...#.... .......\...*.*..#.. ..#.*... ......# ..\...#..   * .*.# ...\....*...  ..*#  ..\##.. #
#*.# .... **#* #..#... .#......\#.\#.#...... ...#..\..*.*.#. .*...#..*. .#.##.#.. *........ *. . * #
#.  .  .#... ..#.*........#.  \#* .....\....*\... ..... . ... ..## ...# ... . . .\..  #.   ##\.*. ##
#  ....*#..... *....\..*. ..#....\....\#..* \...#......*.. .* .. *...... ...... . ....\.. # .... ..#
#   ..*. . *.....*.*..... ..* ....*.. ..*.#. **.*..# .*..# *.  ..*.  .........*#* ..  .........*.. #
#..  . \.. .. .. .. ..   .. .. ....  .\..  . .*.#..  \. *.#. . .#..*. ... . \.. **#...#. . * .  ...#
#\. ....#.#....... ......#...#.. .* .# **..*  .. #...**\# #.#... ....#..#.#..* ..*.#*# . ..... .*.##
#. .#... .\\.* . ##......\#*.*..*.# ...*.... ..*......\\...   .. \...# ........ *... ... ##....\ *.#
#.... *.#....*.* .... . .* #...\.*..*. #.*#. ......  .. #. .#...*.. ..*....#.  ... .  .......*.*...#
# * #* ...*.....* .#.\. .*#. ...#.#.*...*......# . * ....... # .*#.#.#*...#....*.. ...*......\....*#
#.*. .. #. .  #..#..\*..#. ##* .*..\.  ..\. . ....\.. .....* ..\*.\ . * ##.\#....*.\\*..  .#....*# #
#.... ......*\. **#..\# ...#.. ..    #\*....#.*.  ....\......#.....  .. #.\* ...** .*#..#.\...*..\ #
# . .... #*. .  .#\  .. . .\*.... ..*  *........\ * #.*.*..##  ..*....#. . ...#*....# ...\.\ ##\#..#
# #*...... *. ..* . . ... \.......#\..*\  ..   .. . *................  ....\.*...# .  ....*\ ..#...#
#\#.. #.. . .\.# ....\ ##* ..*. . .#.. .#. .#\..# .#...#....\*...  . ....... *##...#.......#.  .. .#
# ......*.........*... .# \# ..*#*..*.*  .. .*.#. ..#. .*. #. .* .. . *.*##. .\..*.. ......#....*.##
#. ..##..#...* . .\. #. ## ..... \.....  *\....# ...#.*  *.. ..*  .##.. .. ......\**. ..\\.*.....\ #
#.....\..\.#.***.  *.... ......\.#. . *. ..   ...# .#........#.#...# ##... ..... .\*#.*....\.. .#..#
#.. . ##..\#.. *..\.. \*....#\. ..* ....  .  #*.. .#... .\.*  ..*#...****.#. . .. ##.#... #.#..## .#
#..*. ..... ..#.  .\... .**##. . . .\...*...** *..\ .... ..* *...*.#..\.. *# ..\.... ...... . \.#.##
###...\..*#..#..#..*..... ... .## .. ...\. #... ..  .. ..#. ..*#. . .. .#  .##. *. ... ..#....#..  #
#*  ** .# ... \.. .**......* ** . ..  #..*.. .. ..*.  ... ...*. \* ..........\.... ....\# . .. . ..#
#*...#.  ...*.* \.*.#...#.....   \. .*.#... .. *\ ... ..*.\*...##\.. ...\...#.** . ..... .*.#. #. .#
#.... *.#. . ...*..*...#.#  ..\.#..  ....  \.....#.*  . ..*#*...*# ..#....* #.....##....*.  .  ..  #
##.....*#***.*.## . ..#... .. ..\... .. . #. **.. . *. ....#.#....\*.*.#... .. ..#. ...  .. #. .  ##
#. ...\. *..*\....#....#\.. *.*..... .. ..... .##..#.#* .... .....*....*\...  #..#\ ##..*... ...#..#
#.. ...... .. .*#.#*##... ... ..* .....#..## .  .. .. .#. .# ...\* .##..#...#    ...\..#*.  ..\ *..#
#. ..*. ..*.. . ... .. #... **  .... *... #..*. ....\.#. .*....#.*. #..*.#. . *. \. ...** .**......#
# .  #... .#  ..# *.\.... ..*.#.... \...  #.\...*.....*#...*#.... \\..#.. *** . ... ..... ..\ ....##
#... .\#.\.\.*..\..#. *. .#.  # .\... #\.#......#\ ...## #. \\ .. #.. .#  #. *#.#..... #..*.#  ...\#
#.*....  *.#* ..   . .* *. .  \ *. ...#. ..  .. ..*.  ...\.  .  #..* *..\.\. .*.*..*#.. . .*...#.*.#
#......*..\.\.. *..  *.*.  *..#  .*. .....**..#... ..***. ##. . * ...\##.. ......... ... \...*.#.*.#
##*. \........ ... ......*. *.. .#.#.....#....#.\.\.... #. .# ....\....\  .\.*..*.#...\\ ..... ...*#
#. **#....\.. .\ ..\... .......*#* . ..*.**......# .#*# ... #\** ....\. #.\.* . #..*.. .* #....#. .#
#...*# ..* .#...#\ . .#.. ..........# \. .*..\ \\. .. .. .**# *..  .# .#.......#... .#*.#.  .....*.#
#....#... *.**\*  \..  ....\#.. .. ...# ..*# ..\\.#**......*..##\. .#... #. ..*\#\ ... ....** .....#
#..*  ....## \.........#\..*#. .\... #.*..\   .. . #\ .. .. ..#..\...  .\.*.*. . .#.*..\\ \.....**.#
# ..... . ... .#. \ . .#*.# .#. .#.#....*\..*.. .........#. ..*. ..*.  \ ........#...\.#.*...#\#...#
####################################################################################################