####################################################################################################
##...  *.. ...#..  . # *......**.. . .\. . *...##. ....\....*  ........*...* .*\.# .. ..... ..\ \.\#
# # .. . .#..*.  #..#....\\ #... .#*.  #...\*.. ..#.#. .  ...#...... .*##....#.    #.   .\ .\.#..# #
#..* *.... ... *..... \.*.*..#..*#*.* . .*.   # ..##...###.#..*  ..#\.* . ##.** . .... ...*. ..\ . #
#\... . ..*....* .\*..#. .\.....\. . .... ..  #*.*# *............ *#.....* . . *.##..... .* . .*.* #
#.*#...#*........\ \.#.*...... #  ...##...\.\#........... # ..#.* .*\.. ..* ..##*. \*. .. .##.....##
#..\ ....\  #. #.*.* .*#  *. .* ... ..#** # ..... * ...... #*. *.. . # . .*......# ...  \. ...#.\#.#
#..* .*#   *. .  . . *.\.....*. ..#.*... *  ...#....*...*...#.....* .*..#  ....... .#  \...#. ..\\.#
#.\\..... **.*.. ..  .*...\. #. \...#.*.. # ##.....\. .#*...... .* #...*...#.* *...\..*.*..... .#. #
#.*\. ....... . .*\............\.....#\.#..... ..  ..\.*\#.... . .#.*. .\. *........# #.. .....*##.#
#.*. ..*..#\............#. .........*#.... .*.. .. . ...***....*.#. \..*.#.. . **#....#...  #.. #..#
#  ..#. ##...# .........##..#***.  *\. ....\*# .. . .*..  #..  * ...##.*. ....* . .  .... #. .#...*#
#....*..#\...#*# .*... # #.*#.....# *.*.\#..#.....* #.. .*..#. . .. #. ...... . *.*# #  #*#..*..   #
#.*  #..\.#.#\..#.... ..  ..* ............ *... ..\#. .  .  .....*.\.. * #.....#..... .  ..#..## ..#
#\. ....... *....   .. #. ..#. *....# ...* .#.\ ..... ...#\.. \.*..*.... . #.##.. .*. .. .\\. .  ..#
#... ... .# . ..*.**..\....*.*.#. ..  ..#\...*  . \. \.#... ..* .#*#... .*.#\*.*# ...*#.........\ *#
# \#.*#...# #*..  **.#.......\.#.. ...... .##.  ....\ *.. .\..#.... . #...*.....#. \   .* .#..#*  \#
#.....#  * . \#. .  . . .... . * .*.* \. .....*#.**..*...\.#..... .## .# *..#..*.\ # \.  ....*...#.#
##. .#.#.#....\.. . . \#.\*...  .#.. .......*.*.*.####..*....*..#*#.....  *.\  *. **.#....#.*  *# *#
#..#..#\#*#..* \.#........\......... .. ##.*....... .... .....   .... .#**#..*..*.#...*.*..#. ##*..#
#... . *\..*...#.....*#.#....*.##\...**....# ... . .\#..\*.*. ..... .# ...#...#.....  .# ...**... .#
# ..... # ..\.*....*.*. \ ..\#.. *#*#....  ..##...#.\ * . \.*.....*# .......\.* .#....\. #  .# ....#
#.#*#* .....*. \.....*#*....#  .\...#.. ..#...*.. .\.... .*\..##. \\.. . .......\. ..... ..*... .\.#
#...\...#   #*.*.. \..#.. .*.#..#*.#    .*.. *. *..\*\...#.\.....#..... . ...\.#  \#...#.\....*  #.#
#.*#*. ##..##.*. *...*\.... .. *..##\.*.  ...*  .\ ...*.\*..*. .. ..\...\. #......\#\....  .. .  \.#
#.*... *\.** *#*..# ..\#.##*.   . .#.# \.*# .....###.  * ...... *...*..\.. ...#..# # . \. ..##..  .#
#*. . . ...... .#. .. . ... .*.. #..... .#\   .. . ..  . .#..# .\...\.. ##*.*\.... .  ....##*  ....#
#  .#.... \ ...  *. \.\ #.##. ....#..#.\  .#. #**\.. ..* ...**#.#......#.... ##.*.. . . .*#.. #... #
#*...\.  ..... ..#... ..*......... . #...   *\ #...*#.. .*#..  *..... .. ...... ..#...# ....\...\ .#
#\ #..#.....#.*.  #.*\*#... *.\.**..*  .. *..#.... ....* \ \#.*# #  . ...*.....#..... .#..** *.**.##
#...*...*.*.. ...\#.... ......... .* ....  ..*...##.. ..*.#..#..#. .# \##. . ..*.*\...   ..#.*.  ..#
#.\..***. .*.#.#...#.. *.#..*. ....# ...#...\ #..#*. .#. \. ...#.#.\*.#. . .. ..... \.. ... *..... #
##... . #.\......... ... ...*....#.***#.#*.\*......  ..#  .  .... .#*..... .........**\... #...##\.#
#.*  .....#  .. .*. .*...#... ... . *. #.... \#. .......\ ..... . ###.** .. ... .**..\..\\. ..##.. #
##   .* .. . ...  .   .** .* .*.\\.\ ...\#.... # .  .....# ..*. .   #..  . ***....*...*. #....*....#
#.*..#..  . .. #.*.. .#.##....... ..#.... .....**.....#.\*. ...*.....# \ .* .## ......*. *.#  *.\. #
# *. . # ....*\............#  ....#.*..*.......  .#.**. .*...#.....  . ..#.\.... *.#*\.\ ...**\...*#
#.*#\.... \ .  ...*....  **...  ..  # ..*#**...\....#  ..#..#..##\..  *.   .............*.. .*..*..#
#.*   \.* *..# *#.....  #.....#.*.... .  .  *## .*\..........*  . #.* .*...#.. . .. . .*. .. * #...#
#* # ..... . .#* .....*.\#.**......*#.......... ... ..*. .....**......  #.. #.... #.. . #.*...   ..#
#. #\..#.  ..  . ............. * . ...... .#..# .*.\# \..*.#*.#    .#.......\.......... ...#*...*. #
L.\\*\........#\...*... * .#.. ..*.\\.\....\..#..*.* ....   #.*....#*.  .# **.. .. ...... ..**#.*..#
# ..... *.. . *.#. .  ## *..**.....\. .\.\..*. ..*......*. ... .*.*   *.... . ..***..**..#..*\ ....#
#....   ....#. ...*. *   ....... . \*...#.***.... ..* .\...*.......#  .\ .***...\.#..#  \. ..# ###\#
#.#\#\. . .. ...  *.... #...#. .. .. \  ..* . . #.#..*..#.. ...* .*  *..#..*.. .\..#.. ..#...#.... #
#\.#..  ...#..*....*.\.*.\*.*...#    **.# .....  .#.. **. ..* ...... ..... .#**..*... . .. .. . ...#
#.#.\....\.*...#* ..#.... . *#\\...\# .*... ..*   ##..*  . .#...*...#*..\. \ *... ....#. #.*.  .* .#
## ..**......#....\.  ..#....#.* . ..  ..*.. #.. ....\*...  . ...*#..*** . *.  * ..  #...*.. .*....#
#*. .* * ..*##  .#\...*#.*.. ....  \...... ..\..*. .* .....* ........# \..*... #.. .\.#.... . #. ..#
#...#\. ..... *# #.........  .*....  * ..*.. #\ **.....#.# ...*...*... *.....*#\..*.*..*#*.#* *....#
#. \..* .#.#* ..# *#  .... #... \.......\..... #.#.#*.. .##*.. .# *.....#.....*. . .*.\....*.....#.#
#.. ...  .\\. #.*\*... #..\.....#. ......  ... .\.\.#*#*..........#..*. ..#\. *.\. * .\. #...... ..#
#*....  .*. .. .#... ..  . .... ..*.. ..... .#.#\.*.\#. ..... * ..#. * ..*. . ....*..*.. \* #.* . .#
#.....\.....\ ##.# . .. *## ... . *..  **... ..#....##..\. \.*.... *# .....*....*#  .#..*.. .* #\\.#
#....  ...... .#.\#..*.*. ..*.. .# *\.. ....\..*#.... .  ..*#..*..*. .. . # **.*..#..\. . .*..#*. ##
#..* . .#.\#... ...*.#..* ..  .#  .#..*.*. ...*.*..\##.......#..   . *\.  ....\#\ # .*...   . #...##
#..**.....*. * *# .*.\...# ... ..... ...#..*.#\#...... #.**\..#  .*#\... ...  ..#..*.. ..#. .. . . #
#.*....  ..#.... \ ........#.... .... **. ##.* .. . *. ...#\ \* .. .\*..... .# .  \..... \ **.#  #.#
#\  .... .#.... \....  .....\....*......*.  .#..  .# .....#.**.. .*#.... #.... ..*#. .. .  .....#..#
#.. ....* ..#..\...\......... .\#...\\ ...\*  #. *...##....#..*.# .......#*  *....\\..\.. ..* \. .*#
##.* .........#  *. . ...... ##.* * . ..  ..  .# .#..*. ..#........\...*\...  ..* .#... .*  ..*   *#
#..##*.... . ... \ \*. ... .*..  *..*....*. .......*. ##... #...* ......# \ .*...#*.. .##.... .. .*#
#. .* #..#.  .\.#... *.* .....# .. \.#.... . **.\.\..... .##....\*...#... .. ..\.\ .#.#...... .*...#
#...#. .#.*.\\ .. . \ ..#*...#. ..#. .\...# * .....\. *.* #..\....\..\ . .\# .   .*#.#*.*. .#.. . ##
#. .*... \#.  ..... ..#\...*...*.. #\. .#..#.##.  ##..#R*...#.. .......... ..#.#.*.  \#. .* *.\ ..##
#*.\.*#.#. ..  .*..... .... .#.#.**\.... .. . ......\*#.. *..*..*# *. .... .. .  *.\..\ .#.......\.#
#.*. # . .# .\ ...  *.. *.. ... . . \. .... .....*.#.#.....#*   .# ..\..... *\ .#...*.##\. .... ...#
#\... ..#. ..*.. \... . .. . . ..  *......... .... \.\ ...#.*.  ..#\ ...*... .   . *.. .. ..*  #* \#
#\\ . .*... ...  *..#..... \..#.......#* ..\ .*........  ....**. ..# . #* *#* \ .. \*..#.. .... #..#
#\\.. ..\ #..##. ......\...*..  ... ..# ..\...   #   .#.#...*## .#...  \..#. ......#  # ...*\.   *.#
#..#....\.. . *#...*..#*#...  ..*#*.*..#... .\.. ..... #.#.#..\..## .*..#.....  #..#  .  ...  .  ..#
#.#.. .\ * .#. .. .......* .. . . \....\\. * .#.\.... #.. . ..*. #........ .\. .....**.... ... *.*.#
#.....##* .#*...# *#.#.\.... ....#\.....*....#.#.\ **..*... ..*....... ..*..... .\ ..*.  ..  .. ...#
### \..\ *.*....\#.. #.#. .**.. #..# .  .*..  .. .*  .. ...##. * .#.#. ..... .....*... .* . ...* ..#
## #\##...#..\..... . \..#. .#..* .. * . .#. .\ ....*.*..... .#*\ ..#*# .  *.*. ..*.\  . .*.......##
##*... .\..*#*.. *. ..*. . ....* ...* .*.*...#. ##. *.. .*\.** *  ..#.. ..... ..**...  .**.#.\.....#
# . #. \*.  .*..... .# .....  ###..*....  . *..... . # ....#*.\#..#...* #.  ......#.. ..*#.......*.#
#.#..#.. . *.. ...**..##... ... ... .#*. \ \.#...#* .. *...... *. ....* .# .\..... #\..*\.....*.*. #
#.*.  .* .**...... ..#.*#\*.*..#* .# .*. .......  *. .#\#......*.#  .... . .. .**.. .  . .#*\*..#.*#
#... **...##   #*...#... .. ...#* . ....#.............. ***#...*...\... \. #. #. ...*\.. . .\.... .#
#  .  ..*..*.. . ** .. * . #.*....*.*.# #  #.... ...#.#......\ .\\. .\   ** .#.*..*\  *.#.#.**... .#
#......*#...#. .. .. ......*.* ..#... ..** .\ ..# .\\...... .*..#.*....#.*...# ..*.... ....... # *.#
#.*. \ .*...  *..# .. ..*\.*..... .  .  .#..\*.. ..* .. *.#.\#.   . . .\ .#... .# **.\...*.#\#..##.#
#.. . ..#*....\. .\.*.....# * .*.. ...... .... #.....#  # ...# ..\..\..*.... #.#.     \.....##* \ .#
#...#..**.. *...*  \ .\*.   *....** .....*#..*...... **.* ..  .*.*#... .#  . .*.. ..*# ..*  ....* .#
#........\.. ....#. .#. ...*........  ..  ...\  # . .. ...... #**..\.. .#*#* ...*#....... * ......##
#. . .#.... #.. ..*..  .\.*.#. .#.  \.##... .* ....#\.. *.. # ..\. . ... ....#**.#. .......#..*.*. #
#.#*......#..*..*..  ...*... ....*...\...\.....#\.#.\......*\*...#..*#. ..#.. .*.... ##.. *# . ....#
#.\.#...#.##.. .. ... .#.. #... .. ... .*.*.*...#..#.*..*# .*.  ..** . ..\...* #\*##..\...    .*..##
#.#..   #  *. .  .* \.   .... ......*.. .....#. *#.*..##*....   *. .* **... ... * .*\.....#.  .    #
#. .    . * .. . *. . .. .\. .#*#  .  .....#...#* ..*  .#*\#....... ..#..*.... ....*.*.....** .. ###
#* .* *#**#..* *  \ .#.*#.## * ....*# ...\....#....*....\  .*....... ..*.....* ........*....\ .\#..#
#...#.*..##.... ..... \.......  ..* \.....\\.#  .#  ....\  ..*. .....*#*###.... #  .#.\ .. ...... ##
#.#*..#..# . .#... .   *..   .. .#*.. .# #.*.*.\.*.. *. # ..#......*\..\.#..  #...# #.#....... . . #
#* ... ##.. .#..##*# \\.\..*. .........  ...\...#\  ..... .*... #  *..*....#. ....*. .*#*. .. #.#*.#
#.*......*.#. ..#.  ...\. ... # ...\##  *..... . .....#  .#. ...# .\. \ ...*#.\*......*# ####\.. ..#
#..# .....*.*......#... ...#.. ...*.*..   *... *.. ... ...\*##.....#......... \\.... .*#. ..##..#. #
# . . *#...*.\\ .#  .     #...\.*..#..#\#...* .\. .\.... . .**..#.\* .\#...*. ..#*.\ ....#...\#.#.*#
#. .... .#...*...#*..*.*...* ....* .. \...  . #.#.. ...... #..*..#...\....\..  .#*.. # .#*. ...# ..#
####################################################################################################