####################################################################################################
## . . .*...*.# .*.. .. ..... .**..*\ .... .#.  .\....*. . #.###. #.*.......\#..#... .   *... .. #*#
#.. .*....*..*....##.. ..  ##.#*\.. .*... .....# ..#* ...*#.*...*....\...#. .. .  .#...*. .   ..*.\#
#......*  ..\ . ...... \\#....#.....\*. .*..#* .. #*#*........ ....# .\.  *#.. .*#  .#...*#\ ....*.#
#.\.. ...#..#.. #.*..  .\ ..\#\ ........#...... ......\.  .#......... ..... ....# . ....  . .*. # *#
# .*. ....**..  ..*.#  ......***##*. .#.# *..   .  . ..##... ..\\ ##... #. .....* ..#..*.# # ...#..#
#.#*.  . * . #.  ....\#.*. .. ..\... ..*\ #...# #..#.\ ..#   # .# .. *#  ...* .....* .## .  ..# ...#
# . .....##.*. ..  *.#...* . * * ..*\...##......*. . ....#\#*.#\..\. ##. .. .#..\\...  . .. .#..#..#
#.. \.\#.*# \.*....\...  . #   ........#.# ...*#. *.* .#.* ...... *#... ..\....\..#.....  .  # .# \#
#..\.  ..# #* .\... . . .\  . ...#..**\....* ...  ..# . . ..\.  ... .\.\. .#...#..#. ..... . .....##
#.... ....\ .. .... *. .# \ .**. \..\. .##.. .#......* ..*# #.* .*. .#......  ..#*.. *..\......*.#.#
#..*..# ...\... ... \.## ... ..#... . ....#. ..\.  .*  .. .\..\..... .  .. #.##...*##.\.#. ...**#..#
#. **........... \.*  .*.#.....  * . . *.#*.* .\ .*#..*.#... #*.\# .*. #.. . *. ..*.#  \*...#.*. ..#
#\.#..\. .#. .*# ..  ...##.\*.. ** #.. * .  ...*..#... ...*.#.. ..#..\..# ..\..  .\...#*## **... ..#
#.#*#.....*.... ...#. ..* *....\# ...#*. .. ...  *........ . .#. .. #..\* *##\. # .\ .\....  . ....#
#..#. . .. . *.#.*.*. ..*.#.* #.\  #..  ..*. ..#..\*.* ....  *..*....\... ..\#... .#....#..\. ..#. #
#.  .. #...\ .*.#... #. .#.*..  ...\... ..  *..* *.# .#...*..  .\ *. * . . .  *. ........\.. ..*..*#
#....*. ... . #.  .#.* .##. .#.*...# .* .... ...\ .*#. .*#.##..\.. ..  .. #..*. \. .. .#.....* ..###
##. . ...... .. ..\..  *. ..\.\ ###*...\   *..#..# ...* .. #. ..\ \..*...*  \.......*. .....* ** ..#
#...*. .. ....\* .\...  .. .#\..... *..... *\. #.. ..*..    .\.... . * ....... *.#.. # .  ..#.\....#
# ..  .\.#.*.#.\..*.....\.#* \.. *.#....... **. .. #..*\. **#..\....  .......#*.   .....*... * #   #
#.  \.*..\. .\  ... .#  .. .. ....... #...#..*\...\. ..*.\\.. # . ... ..*.*#.. ... .*# .\\ .\...* *#
#.#. . .....\\#.*..\#... .#........ *....... #..*.....\...**....... #.\. *.. \ .\.*.. ..\. #..*  .*#
#....*...*............#.   ... \.\ ..* ...  ......* *. #.. ..\ ##.   ..# ... .*#* . .#.... *\ .#.# #
#  ..*.#*..# ...\. .*.... .  #....#.. ..  ..#*#. ..\...#  .# ....# \.. #. .#.. . .. \....  #.##*. ##
##.*.*. ....**.* ..*. .\.#...*.#**...\#.#   \##... ..... \... .  ..........*##..... ..#\.#\.#... ..#
#.... .   .... #...... .. \.#  .... \*#* . .\.* #.*.. #...*#.\#.*  *. * ..#   ......*.. .\...*#\. .#
#.*   #\....\* ....#...*. .\ ..\ ..*#.. *.... ..# ...  ....#.  ...#...  .... . .\.\*# \ .*.\.  ..#.#
#   . . . .. .....\ ..\.*..#.  .... ......*.. *. . #..* ..#  \*....* .. # ......   #. #.  .\.\*\.*.#
#..*\.. .. ..*...# #..  . **. ..#..  . . \  *. .... .#.. . . ... ##...#..*#......#.. ..#. .#. . ...#
#..#.\.... . .# .... ..  *  .  ...\..\.  .* #*#*.#*..*  #..* #..    ......#*... \ \\.... . .. \ *###
# ....  .. #.   .*...*  # # .. ... #.#.\....#..*.#. . ... *.. **#..... #.# #. *.*.....* .  ...##..*#
#.*.... .###. ..... .  ...# . ...#*\.# *...* * \ ...*.#.*. *... . ..... ...*#*....  .....\.\...   ##
#....*..* .# ...*.... \.#.. # .*..* *.##...*.# ..*. #..*. *..\#*#..#...#...#.#.# #. . ...#.\.#.....#
###...*..#.. .#..*.. *.*..\ *. *. # ..*.# * * .*..... ..*\*...*...# ..\....*.. ....\.**.*.##. ... \#
# . . #... . \# ..#..#. .\.\ ...#..*.. *...#\... #*... *.# \ *. #... ...... ..\.... .*  .#..###*...#
#.*   ..*...*.#.... ...*...#  .*.\#  ...\.*  #......*# # ... *. ...#** #.#..* .*... #....#...*.* .*#
#.  #.....#* ...\**.#*.....*#. \..*#.\. ...*.## .*#\...*......* \.# .#.* .*\ ....  .*  ...... .\. .#
#. #.*.*   \.. .*... .*.... *. . .. .. .... ......... .\ *\ #..#\.** #..*... ...  * ..\*...\\..  .\#
#. .  *. ...\....#* \ . .* ..* ..... . .#*##\*\.......#.\ ... ..*\.. \.. .. ...# ..  \..*\.*.  .*.*#
#.......*...#.*... ....#\..\ .. *..#...# . .#. *..#.#.....  .*\ ..*. .*..#.... ..*.  . #.#.\ .*. .*#
#..\ #.##..#* #\. *....*\. . ....#... ....*......#. ..\...**..\..* .## \.... # ...* .#  ..#.. ..# *#
#.. ..#\..... .*.*#..\.#. . ..  .   #  .#. #..\#..# ....*.. .. ...... .. .#...... ... .. .#\...#.\.#
#.#. ..##*....# \...... ..\ .* ... ..#\.# .\  .. #. *..*...#... ..# .\. . ..\  ...*. \..* ..**.. .##
#*   ...*..#*.....# .. .......*\*........ #*. ..#..*## ..*\**... #...#*# .. \.  . **..#.\.#\ . *.*.#
#*.. .. ... #.##. . .#...* #.. ....# *...## .\\..* ....*\.*. *..\#..#.....#..  ..#...*...*..#...\. #
#........ .... ... # ...\.*.....\..  *. . .. *...*  .  . #.*..... . *.#\. ...##.  .. .# .. .#. #  .#
# ...#. *.  ..... ...#*.#.**  #..##...\.#\.#..#.*# .#*.\\ . #.. ..... *......* .*  ..*#*#\  *..*..##
#....#. ..##\..#\.*.. *.  ...* *..... . .*.\.. #. ..*.##. ... . .\  .#.#\.*.. * ...#. .. ......\**.#
# ......\*\...\.. .#. ......... *# ..  # **.#* .. .#.#.\..#\. .\* *.*#  .  .. .. .. ......* #.. ...#
#.... . *.. . .\*   ..#**..*\.*.. #* .*..\..    \.#..**.. ..*#*...\   ...#....#...#...*..#. ..... .#
#.. ....  ..*..##.. ## *....# . ...#.*   \  .#...#..*..#  . #.*\.   ... ... ......##.\ ... ........#
## . \. . .... #..*.**... .* ..##**..\#*. .**...#*.. #\\\*... .... . \.#.#. #*. .. ........*\. .#*.#
##*.. *#* *...... *\  .* ....*##....... .**... .... ....   * . ......*....  .. .# .......... *.. ..#
#*..\\ .*\   .......*.*# ..# .*. ..# . . #. .\ *.#.**..#\ .#\.  .. ##   *. ... .....#...\ *...\*.. #
##.#.....*..*.*.#. .. \..#....#\...\*.. .#  ... . ...#  .......  . .. .*.*......# .....* .# ##*.* ##
#.\.\ ...\*. #..**#*.*. .*....*  *.#.*.*......... .....*.* .... .# #........\.  ....... . ......*#.#
##.... .\...*.\... # #.  ..  ..\*\#.##.*  ...\..* ....\...*..## .  . * .\... *. .*.#...#. #**.\ * .#
## \. # *.*.. * .........#*.###..*\*.... ..*..#\..  ..#.  .\.....   \.\.. \\...*.... .#.\... ..#*..#
##* ..*...*......#...*..##.*## ...*.*.*.*...*..*...## \.... .*. *........\\ . ....\. . .. *.*\....*#
# #\. #* #.#.. .. .#.. ..\ *.. ......  \. . #.##...* #....**.#. .... .. \.. # .. . ..*...... .... \#
#  ........ . ...... .#. ... .\....# #....* #* ..... ..* ....**. .#*#... #.  . #. .*#.#\.#* ...#.. #
# .. *.*.... .. .*. ...*..*.... ....\. *# .. . .*  . .   ...#... .... .#..   \..\...#...... #*.... #
#\..*.. ... *. \\..#\# .*. ..\.#* ..*.#.. ..... .*. .......\#... *#..\ #. .. .. ...# .#*##. ..* \  #
#.. .#. ..#.*. ... . . .  .. . ..*.... ...\*... .*#..*##.*..  ......*...#. * \#. ..*......*.  \. . #
# .. .......  ..*#........ ......#\.#. ***... **....\....*#.......... .. .  #  . .#..#.*  .* *#\   #
#**.... ..... **... *.  \..#\#*.  *.. .*.\..*.*..#.#   ....#...# #.... ...*... ... .. .#. ..\.... .#
#..#.#* ... *#...........#... .*..   . .....**..\. . \#.#.... ...*#.#.# *.......... .*#.#. \.. #.#.#
#..#.. #..# .**.#..*. .. . .....*....#..   *..#. ....*..*#*.*.#..*. .#.*#. ......#.\.. . . #...... #
#.* .... .**. ...   ..#.....*..#.\# .##*..\ .*#... .. ....#..\\.\*.*..... ....#  .##\...#. ....\*..#
##. .*. .\.#* *  ...  .\.......#....#........* * .. . # .. \.##... *.... ..... \* .#...*....... . .#
# ...\....... ..#...** .#. .......\*.....#...*...\.\ ... ..*.. #.*#.# . .#.*...*.#..*..*.... *R*  .#
#..  *..* ..#..#..# ....#.. .#.# ##. *.. \*. .  #....# ..*...\ \  .\..# .*#\#.*## *#. ...*....#.#*##
# #...**..#.. ...*...#. ....  .*.\\#\.\...........   ... . . ..... ..* ......# ......*.#. .... . ..#
#.\. .   ...#. .##*. #...  ....#. .#.. *.. .....  . ..... .#.*.#........ ..*.. #... * ##.*.\ ..#. .#
#..#. .. *#..  * .*.*..*.. #** . \ # ...........\.. #...*...... ..  .. .#*.....#.......#..   .... .#
# . .#.\.......... ..  .*.*.\  ...**.. ..... ...*...... .#. ..  *..*.. *......#*#..\*\#. .#\.......#
#.. .... ...#   ... \..#...... ... .#\.\...... .# . .....# .#*..\...#.. .# ...  #. .* .  .......*. #
#* ..\ .#...... .  ....*  ..*....\.... #....#..*...#.*..#..#\#*.#. . . ..#...#.#.  ..\ .#....... ..#
#........#.#. #. *..... .  *.. . *.... #.##..\ ... ..... \ .......#.*\...... #..  .. *..... .#....\#
#....#  ..#  #..*#.....*# . ..**...#...##.##.\##.* . .#.** ....... .. **\.. . *.\.\. #...* .#. .. .#
L......#....... ...**......\.....*..* .#... ....   \.  .#. .*..#... .*.......# ...* ...*..... .. \.#
# # .#..  ..#*.#......#.*...*. #..# ....  .. .........#.. . .......* #*** ..\.. ...... .\. \ ....#.#
#.*. \ ..#*.. .#**#..... # ...\.## #... #.  # .\\** \*.\...*.......##. # .*.. # ....... . ... .** .#
# . ....*...*#.. *#*...*.##.*. .\**............. .  .*...  *  .*.*..*# ....# ........ . .#.\. #....#
#**. ....#  *.#  # \..# .. .... ... .. . ....# #**..# \..#**.*.\ .\..........* ..  .**\#...*  ...#.#
##.##.... ... ......#..*. ..#*....#. . . ...\\ ...#.. .*\. .... ....#  . #.*\. *. ...#*.#\. . #*...#
# . *.*..** ..\##. .#. . .   ..#.#. ..**... .*. .  ..*... ...#*....##..\#*.. ...\#.\ ....  *..  .* #
#.... ##.. ..*# ##*..\. *.*## ..*..   ....**.\..#...*.*..#. .. ........\#\.. .. .\....* .#....#.# .#
#.. ..*. .....\## ..*.  .*...#\. .  ..  ..... # . .. ..... ...*#.*..**\. .....  . ....#.....#.*.# .#
#.. ..*.#.* ##. ..... .... ... .. ...   ....\ \.#  ..* . * .*...# ... .. #..#.**.... ##*. .....#*..#
#  . .. . .# .... .* *. ...... #..\ ..*....\....\.   .*.\  .*. .*... #..  *.*.*#.\.. *..*... . ...\#
#.  .*.. ..*\...  *...* \. ........ . ..... . . . ..*# ........ .......##*\. .......*...##.* ... .*#
##........  #. \ . .. ...*. #  \.#.  ..*  .#.# \.#.\#. #*.  * *....\**.. . .#.....*.\ ....  ..    .#
## . ..*\###........ ...# . . \ . *.. ..... .##.\# . .* .  \.. ...  ...  . ....* .  #.....*.  #  .\#
#.#* ..\  ......... .....##...#..  . \.#.\.*#.#\# .#.... .*..#.....\ **.*. .**. ..# \..... ...... .#
#.#*.  . .. ..  #.*#.\....#.....#.# ....#. .# \.**  \ ..#*.  ** ..\.# *. ...#. *.#*.. .  .....\...*#
#.# **..#..* .....*. ..*\. #.    ...**.\*. \.... ..*.*\ *. #. .. #. \*...##. \#..\....#. .*..*..#\##
###  .* .##.*.*\... #**# \*.  #. ##  ..    ## .. *....  *\.*......\.. .. .. .... .... .  .*\**.#.  #
####################################################################################################