####################################################################################################
#. **.*.... .\.  #. . .. .#...*\*#.#.#* ..* *...  #.#\........## ....#.*...#..... .. #..*...*\ ...\#
# .. .*.\ ......# \.* ..## .#.... . \. .\  ....\...*.#..*.. .. .\ #...\ .#. ...  ......* ... .\*. .#
#.*.. . .... #\....\ .\...  .#  \#.#.....##\.#**. .. #. # .. # . ... .#. ...* *...#. .#.  ....*..**#
#.... \# #\ *#..... .#... . . . .# .*...\..##.. ..*. .#.... #.* ....** ...*. .  .  ##... ..*....*..#
#.\#*# ...*... ...  *#.*.....\... ..#.*.\.. #**#*...# ...#.   .. \.  ## #\ #..#*\. . ... . ....*. ##
#..*.# *#* #* * .. #.....**...# *.. . .#..  . .#.**... ..  #  *...  ... * .*.#. #.#*. .#* . #.  ...#
#...\..*.*.. \# ....\. .*##.....#.#.\... .** .. #.*. . ..**.*...#.. .#.  ... .. .  ..# . ... *... .#
# .* . . ..  ..*##... .. . ... ....*...\.  ## ... ......\... .#.\..*.. *.*\*...**\......*..*#.  *.*#
#. #.#... .\  . \.* .*..... . .*.....**...\ *.* #  . *.# #...... ...\. ..\.*.#\... .*\..*.  .\. ..*#
#.*...# ..#*.*..#....# *...#. .#\*\*#... .. ........#.  *#.#.... # . .*...# .*...*.  #.....\.* . ..#
#\.... ##. ...\  ... \\#........ ... ....... *... ..#. * .*.....* *.*....*. .#... ..\.*....\  *#..##
#.#. ..  ... .... ..\..#.. ..* ..#......*.. .\.*.. **.#....\....*.*.#. .. \.  .*.##...\.*..... \...#
#. ....  #**..#... *..* .*. ... #...\*.... ...   ...  .\.. .#...... . ....  ..#*.\*... .#.*........#
#.*..##**..* #.. .. .\ ..*. .. .#. . .* .# *. \ ##.  #*#.. .\..#   *#... ... ..... ...  *. ##\.*. .#
#*#*#*.\  .. . ..*...#.*#..**..#...*.# .*#* *..  ........*...*.*.............*....#\...*  \ . ..#.##
# ...#.\... ..#.... ... ..###. .#....\.# *\. ...** \.. .* .*#.......\\.. .. * .##..\.. ..#\....\.. #
#..#...*..*.\.*. .  . ..*\* .....*#. * ... . ..... **.*..*......*#.  ........\*..#... ... ...*. .. #
#.# .. #.  . .. ..\.   ....... \  .*.#  ...*.\..* ......#*.# ....#.. \#. *..*. . .## .\. #.........#
#...... .* #.\....# #...*.. *# .\#.. ..   ..#. .#* ..#. ..# .. *. . #.#.**\\.............# ...#. .##
L..#.. .... * ...  ...... .   . . .... . .*..#.*... ..#.. . .. .. #. ..... ..*  .*#.  .#.. #. \*# .#
#...*\*....  #*....*... *.. \.## ***.\ .**. * .  .*.... #    .... .\. . .#*..#.. .. #.... .  ...\..#
#..\ ..#......\ \...... .\. R......*...*.. ## ..# .###..#...#...*.**. . * *.....*.. #*..#.#.\#... ##
#..  .*.. . ... ..*#  .#  . . ...*.... *... . ....*#.**..\.. ......*......#. . .... #.. . ....*\. .#
#. ...#\.\.*#...#.*##....  .\......#\..\. ..  *..*..... .#.. .\#... ..##.* \. \...  .....* *.# \##.#
#. .. ..#*.  ..**..#...*  .. .\.# \*. ..  . *.......*#..  .*..#. .#.. \...#...#..#..#.... # *# . . #
##.. . ..* \*.....*.. \ .*#.\......#.... .....*\...#\...#*...... . *...#\*. .. # ..* . ..*. .. .#**#
#. *. ... .  .*.... ..#. .  .....\.\.\# .*. .....#..# .*.....\...  ...\\... . ...*.. * .  #..\\  . #
#.#...*.* .*.* \...............# . # .... .\** . ..#........*#*#  .....## .*\.. * .#...* ......\. .#
#. ....#.#* *..\  *...\.\.* \.*... #.#.. .. ...\  ..#.#.#.......  #.........*.*#..... ..# ...... ..#
#.......   .... .......#..  *\  .     ..\\\.......#..  .. ..# .# * .... *  .*... \.. .# . .*... *. #
##..*  .. .. #.##. .**...*.* ...#.  *.#*##*# .. *.. .*.**..... . .\  .*...\**...... ..#..... \.#\#*#
#. ...*#.\. ...\ .\ ..*.#........   .. . .#....... . .....*..* .. ... \ ..*#* .... .#..   \ . . #*.#
#*..*....... ...\#..*...*  ... .#** **\.....#. .*..*...**. ..*.#....  *. *.*..\# .*. .  #.....\..\*#
###*.# . .. . .........#... ..* *... ...#*. .# . *...* .#.... #... .. \.. \..*.. .*.... .*\. \ ..#*#
##.........#....\ #...#...#.*.#\....#.... *. .\#.  \.\  .*..\...#...#. *#  ......**........ .*.\ . #
# #..*\...*...**#  . ..#*.. \...# .. ....\..... . .#....*. .\... ... \.#......  ...*.  .*. . .. *#.#
#.....# . *... .* ... ###*..\. .. . #......# . .* #.. #. \#.*.#\# ..#..#..\. ...# \....#*.. **...*.#
#...**...**.... #.**..  ........ ##*# *#....\......*# ##.#*.....# ## .*\# .. ..*#. .#. ..#....##...#
#.#. ....#...** ..  ... #.*  ......*.*  *......... ##.. ..* \*.. \.....\... .\....\. .*...... .. .\#
#......##.#..##** \.*... *#.#.* **  . #\..\..... .... . #....*.# .. ...\.\......... **.\. *..\#... #
#.*.*\\.. *.  #.. *. ...\........... \#.. .*.  . .\*#.....*  . .. \......\...##..*....  .#...#.... #
#..  .....  #*.  \.**#.. .#. ..##..\*.*. .. ..*#*.##... #..  #*. ... ....#..*\.   ....*....\. .*. .#
#.........# .*..*....\*..#.*.....   .. . .\ ..  ..\.. #.. .*.* .*. ... * .# \.**.*#.... .. ..*...*.#
#. .. ....# #...*...#.....# #.\#.....## . \. . . .\##.. . *.\... .\..#....*.#*.#...\#..*.. .#...  *#
#. . ......  . ... *..\. .* .#.* .# .#.#..\..\..#.\**. ...##  ..#* #.... . .#.......  .....# .. .# #
#. .*.##....*. .*# .. ...*.   .. # ...# ..  .. .* \.. .#.. .........   *#....#.#* .#*... . \..\..\.#
# \*..\* .#...#.....*.*.....* .\##..#.  .*.#. ..*.#.*.# .*..# . \\*... #* .#..*..*..*.*.. ......   #
## ....\*. .\# ..\.\.. ...*.. #...#.*.*.  #.*.... \..\.* ..\# #.* #  .. ...#.# #*..   .#.. * ......#
#..... ..  ... *.*#\  . ..*...... .*. . \ ... *.. .  #.#..*  ..#....*\.** *... ..*......  ... .   .#
#   . .. .. . ...*.. # .#*. .#. \ *#. *.. . .\*...*..\... \ .* ...\.  * .* ...# . .# *..*#...\*. .*#
#.. \ *#... .. *....** . ..\  .. *.#  .. ........ *#.#\.. . .....\.....#  #..  . .*.. .*#..*..... \#
#*... ... * ..#.. *.\#....\\...*\*.* .....#.*...*.. #\\.\  .....\ . ...... . ..#.\*..#...*.## \.. ##
#.*..#...*..\.#.....# .*....#\#. ...#...# ..*#* .*..*......*#...* . ..*.   \*...   .# . . ....*.. .#
#.\*... .\.\.......\... .#.*..... . .....#.......# *###*.# ...#*\....#..#. .#.   . ..\.. *.  .# ...#
#. ***...\.#**# .. ....##...   # #.. ... #*.. #. ..\...*#. #....  . \.# .*#..   .# .# *# #.#.##....#
#.......*....**. ..# *... #..*.\. . #*...*.. .. *..##. .#...# ..#.\.\.#. ......#.......  .*..#\ ..*#
### ... ....#...  *...** **#. .. ...**.......... ..*#.*..  ..\..... .\  . *..#..**....*.**. \#..**##
#.  .\*#\*.#  ..\*.  .* . . ..   #...**#... ..  ..... ## .. #..... ........#.....*...#.\*. #..#....#
#.......* ... ...\.#.*.#.........#.*.*#. ... \\#  .\  .**. ...**. #..\.......#. ...*.. ..* .#. \...#
#....... .. ...#.#.*..*#   ..* ..#...#. ..#.* *\.. .\. . . \*#. #......\...\\. ..  #...... ...... .#
## #  .. \.#...*.* #.*.. *\* .. \* *....#.. .. *  . \.*.#..*........   .*. ...  ....**#...*........#
#.***#** .\.*.#. .# . .*.*#..* #..#...*. #..**\..*. .#. ..\..  #..*. #\..## ..# .*..... ..#.. . .*.#
##*...*..# .......  ... * ...#  #.. #...*.. .  .#*...\ ..* ...*.*.* ..#.*  . ..#.. \....** #.... * #
#.*  . *...  \. ...  . ...... ....#.  .....*. .\...#. ...... .. \...\.. \..* ..# #.# *....\.....***#
# . ...\.#. .. \ #.\.##........*..\  .*.**\... .*\.*.. *.. ..  .. .. .#... *.   . . .............* #
# .#. ..*. ...#....#..\.\...#*#...*. \. #...\.* . *.  \...*.\.*.#...#*..  .*#\.# . .... .\ .\..*...#
#...*..     ...  . .....*...* .. .# ..*. * . *. .... ......#..*. . ..##. ....***..#.. .... ...  .. #
#.. . **.*\ *..*...#....* ...# ...#.. .....** .\.\... . .*..#..#.  * ..\ ..#*#.. .**.... ..##.*..* #
#..... .#... . \.\#*... .#.... ....*.. .......\...*. \  #. \...*#.* ..#.. . #.#...#...#...... #....#
#...#..* . .*..*......*\. #..#.  .. .... *.*......# .*. . ..#.* .# \....**#.\.*.\.\ #. ....#* \....#
#. ..\.*..# * . . #.\. . ....*..#. .#  *. .*. . .  .# ..#.#. *. # . *...#. #.#.\ *#.....#..  #.. ..#
# \*..*....*.  \*..*....*.. *.#..* .#..#.##... .......  .\...*...#..*. #. .#  .\..#...\.*.*. *\.. .#
##..\..#....*.......*.*#....###...  .# \#...**.... . .# .# .  .........*....*...*... .*..#...\...*.#
#... .... \....\...... .*#.....##.. #.# .... \....##...\  ....#. # .**..*.*..#\. #  .*.#......\   .#
#\.. *.#...... ##  .....#*.........#...*#...##*..\.....*... *.#.....**.. ..# # ...\..* .  *#* # #*.#
#  .# . ..*.* ....*   ..#  .#*. ...#  ......#. *. #..#........ .....* *#.......\.  ...#.. ..*...  *#
#..#*..*...*.. ....#.*..#....*.*#...\. *#\#.*.... .\ ..# ..\*.*....*. #* ...   #..\ *..*..#...  .  #
#.. ..### .#.  ... ........\..#......##..#.\  ..\....#...#..#. *.. ##  \*.*....#*#*.\* .#*. . **. .#
#... .#.##. ..**. ..#*......*..\........#.#.. ...*. ..... . *. .. ..... ...##* ..#..#.. ..  . ..#..#
#.  .  #...*\....*...#..... ... .*..........*#...... #.......  . *.... ##..*.. #. *..\ .\.* \.\ . .#
#   .  ... .. . .*\..\.. #...\*#**#... .*.#.  #... . .. * .. .#......   ..*......*#.  # .. ........#
#   ....* #.#.\#. .**  . #..*. ..*......*. #......#*#...#\\ ................## . \...\#\*.  ..* ..\#
##.*. .\..*#. ...# ....#......\..*\..\.#..*. ...*..#.... . ...* *  .\ ... . . . #...*  *#.... . \.##
#. .\    .. ...**... .... *\ .#*.*......*... #... .*#.#.. ....... ...*.#. *#. ... \.* #.. * .\.. . #
#.#.. .......*#..  .. ##.\....\.*....*   .   .*.. ...\..........\..**.....#... .*\.. \ .#.  . ... .#
#\*.. **##..# .. . .#....*  * . .....*.......\.*.......\ #\ .. ..#.*. .*..\... \#*... ##.. #... . .#
###.\*.. .#.#*  ...**..\. #...#  ...  . ...\ ...*  \ .\.* .*#. .\.#**..#...  ...\..#......#\ ... ..#
## ..*.#. **.. \.*#.. ...*. .... ..#*.... .\.   * .*.#.#**..... ....\\  #. .#\\..\. .. ...* ..*. . #
#.  . ..\.*.*. ##*....* . .#* .. .#.# ...\ .** ... ..  ....# ..\ ..*. .......#.##..  . *.*..#.\....#
#.. ..#.**.* *#. ..  .#. *.*. ..* . .*.. .  .*#....\#...**....* #.* *..  * ...... *.#  ..\..* .\ ..#
##. ..#.  . ....\. *..\.#.*.....##.. ... ...#.*. ...*..\....\.....*.*.* ....\*..  ...\.........#. .#
#..   *. ..#..... .\..........#. ..*..#..... .. . ..**#.#......#.#....\ \. ...# ... . ..........**.#
#.......*#.\..\.. ...**....*.# . ....  . *.*. . **\.#..*#.#..**# #..# # ..# *..*. #...........*.. .#
#*..#   .  # #.....*.##.\*....... * .#\..*..  . .*  ....*.*.  .#..\..#... ..*...*   *\.\....#..##  #
#.#*.*. . ...  # .*..*  . ..  #.... #. .. * .. #  .  ...*  ...   ..  ......*........# .... #. .#*..#
#...*.....*.. .##  ..##..#  ##*  .....  .#...#.*.\    ....* ....\#.*#.\*. ... #..  .#.....*. #.....#
##......... .. *#*.#*#.** ..........  .#..#....\.*...  . * ...\ .*. #*.##.#.  .  ......*#.* .   ..*#
#*.. .......... .* ..... .........*##.#.. .*. \...*..*.\# . \ #.. .......* .... .....\ .. *. \....##
####################################################################################################