####################################################################################################
#.... #..*..... .\ . #. ..\.*.. . ..\... .  #  *..\.#.\.. .......*.  *#.\..*........\ ..   .*..... #
#.#..\.....#...*.... .*.. .  .*  ... .#..\*#* ..  \*. . ..#.#.. .. .#. ....##.#.*... .. .  *. .*...#
#. ..*.. ## .....*. #. *... ........#*.. ..#...*..**\   ..*..\ .  **....*......... . . *...# #.#...#
#...\.\.#.......#.#..**....  .... *#\ .#.*....*#...##*.# #..* #* .  #.*.  .# ... *..#* .* **.. .. .#
#....  .*. . .......#.\ \ . .. #....#...\.#*\. .. . . .\. ..........*.## #.  *. #. .....*.# *...  .#
#*..  #..* *  . ..## ....#*.*. ......*...#. . . \\##...\    #* . .. **.. .........*... *....  .  .\#
#...\ * ...# .\..#. \ . .   .**..# ..* ... . *#..**. \.. .* ....*.*.##  ....#*...*. .**. # ....*.# #
#.. ....\#*.... .*#.. \\... #.. .#..#\ ##.#. ....*.#.. ..\... # .# ... \ #..#.  .... ...# ..\*.#. ##
##....\\.  ..*.*# * ..*.## .#.. ..*#.\.. \.. \...*.##.....** . *.........#. .. ...\   ... ..\... ..#
#.* ...#* # .  *..*. .#\.... ..... #.#\. ##\. .. .... *..\.#..  ......#...*......\..##... ... . ..*#
#. ...*## .* *..*  ..*#....  . .....  .# .... *.....#..**#.    # *.\\.. *..#..\# *..... .. ..*.. ..#
#* ..*...##.. .#...... ......\ .... .. #.*..**.# .*..*....* **...#.#..#.... .. . #.#.*# *...#. ...\#
# \#   ........*. *.  . ... ....#.#  .*... ..#\.#.#.. ..#.#..\.\..##..#.#.*..*#..####.#.\#.. .*.. .#
#.. * *...#...  ..   *.. . .*.#... .#.\..* #. * *# ... . ..   .  \..***.\.#.. \. .#....*..*.....\..#
#......\   . #...\#.  ...*#\# ...*\#.. #. .  ...*#. .#....\ .. ... ... ..\*....*\.....#..    .... .#
##   .. ...*..\......   ....*.... . ... ..\... ..# .  ..*.\..\.... . \#...\ ...\#..*...... \...*.. #
# ... .. ..#..... *.**.......**..#. .... . ...\...#. .* .  * #. #..**.\*.. # .. ....*.\. \. .. \#..#
##....*\..... ....*.\..*...####.* ...*.\.  ...#. #. **..  #.. #...#.*#......  ....* *  *#... #. .. #
#.... . . \...#..#* ..#*#. .........#...#.#. .#..#....*.#.. ... .. ..... * *  .*..# ....*..  ....\\#
#.. *.. .. #...#. .\ \. ... ....  \..*. * . .... .....#. \...# .* *\\.... ... #.*. ..*\...\..\.*. \#
#.\\  ..* ...\ #  \. #... .. ..\ \ . #* ..\.#. # .*.#.....*.#. *\ .#... . ..#.... . \\....#\.* ....#
#.. #..\.\.*#...  ..#.......#    *.*...#. ..........\ .*..*.*. ....\ . ... *.#....#.#.  . *.##\.*  #
#... ..**. ...........*...  *.# \.#..**..*. .* \.\\. .......*.. ..* * .... .\.#..\.#.. . *.*  .*..##
#  . .\..\\  #... *. .\#.... *..* .. \\*  .. .. ...#*......# #.... ... .*... .. ... .#\ .  ..*. # .#
#.... . .*#... .....#.##.\\#.#.... ..*\  .#..  ........#......*# .. .\. # .#  .*..  .# .#.. .*... .#
#...*#*\ \. ..## #  #.... .. ..###.#.. .  ..**..... .. .# \... .\. .  .......**....#* \ . ..  ..#. #
#...*# . #.#.# .#. #...\... #...#.* #...#..... . ...*.  ...#.*\. .#*. .# *#*#.*..\   #... .#.. .*# #
#.. ...## .\.. .... #.*.#.. .*#...#*.... ..#. ..   .\*..*.**  .... ...*#.\... ..... ..*#* * ..   ..#
##* . .   . .#... ........# #..... #.. .... \*.**..*. . \... ....* *.. #\ . ....#..\.*...*.*.....\.#
#. .   *#.\    .\\\ ..*.\...*.# . . .*.\#\. *.... .. . .#...#  #......... ..\. .#.*##  . *..... .*.#
#  .\ . . #* ..**..........\...#  *. \.. ...\ **...*..*.... . #. .... ..#..  ..*.*.\ *#\ ..\##.... #
#.* #..* . .. *..#.......#.. ..\ .#...# .. .*. ..    . \#\..*.....*........ ...\... ..*.#..  .....*#
#...*\\. .....# .*....  *.# .......  .#. ...#.# .\#..*.......*. .\.....  .....#* . .##. ..\\.....\ #
# *.*.. ..........#...\ ..*.. .*.\....##.  \.\\..*.. ...............#   ..\* #.*.. # ......*.#* . .#
#.#..*\.... . .\.  . ..  .. .#*..... ##.... .*... .  .\..  ...  ...*\ #* **..\ ... . .#.\..*..#....#
##*....\# . .. .*...#  *...* .# .#.**.*# .*.**. ...*..#....#  \#.#.. **\..**. # \..    #..... .*. .#
#. .#.*..   .*# #.*. *.##*. *..# \ #.#. *.*...#....  ....#....\ * .#*. .# .\*.*\...*.* ......* . *.#
# ...#... .* .... . *.....# \.#...#.*.#   .......\.......**..#....#*.\.*..  .#.#*.#. ... #. \#....\#
#. .#...#.*. .. \.....\..  *.. . # . *. # .*  .****.#.\..#. .#.  ..*.. ...  \. ...... .... ...\ .. #
#\\.. #..\.\\#....#. ... ..#\  ....*.. *.....*  ....#  ...*.*...*..* .##*.#.# * #.#... *...*\..  #.#
#...* *\.*.\. #. .. ..... ##. *  .#.* ...* ...  #.#*......#.\#. ..##........*. ..*. . *..# .... .* #
##..\. .... *.. .#... *. ......... .. *\.  ..\.. .# \.. *. ..#...  \. ......# .....# . .\..\.....*.#
#.\.* .  ..#....* ...\.##..* ......  ..# ...*.#.\.. ... \....## ..\ ..#.\..... .... *#.*..*.  ...  #
#......   #.*## ....*....#...\.\.# .  \..## . \. ..*.*.\.....*...\ ..\.. \ .. . .*.\.\.......... .*#
# # . ..... *. .......   ..##. .#..\#.*.* . .....#*. ..  .# # .#\\#......#  \*..\#.*\.* ###... #...#
#.  #.#. ..*#.*.##*. # #.*\  ..*.. . ..*.*. ##.*.\\*.#. ##.#.*#.... . ..# . \ ... #  .*.......\.  .#
#..#. .*... . ....* ....... .#..  ....\... ......*  #..... ....#.  .*. ....#\#\ .  .#*.\... * *..* #
L#.\.  ## . #   . .#.\....*.. ... #..*..\.*.\  #..*.#... ... ##.*..#.  ...*...# .\ #.*...\....#....#
#  ..# ....*.#.*. .#*. ##\.#. ..\##\\*. ...  ....# .#.. .......#...\ ..*#\..... .. . \.#.... .*\...#
#\ .. ..#   ...#\... . ..#.  .#... *###.*#... ... *. .\..\#..*.. ... . #*...\ **.... # #*.. \. .  .#
#...\. #...#.....#..#.....#.. .#. .# .#*\. ##. ..#...#..#\.. ...###. .\....#. .. \.. ... ...#.#  *.#
#*  #...#. *.. ....#  #. \ *.... ..#  .... .. ......#  ..#.......# *  #.....*\ ... . *#....#... .. #
#* .....* . #.* *...*... ...\....*..#.. ...#..............\# . .\.  .. ...  .... ...  #\ ..#.# .#  #
#  ...*\ ...#.\#. #  #**... #...# #.\.\ .. . .  ..\.#*..#\..*.  \ \ .\... .*. ... .. ...*  .. .... #
###.# *..##*.*. ....*...  ...... .##.*. # *.* ... .R... .#*\..#. .**.*#. .#...\... .\\ ..*..# . * *#
# ... ....\#....\   ... ..*\... .... .#*.#.** ...#..**...\.*..* .*.* .* #.\ \...* \.**...*.#.. ....#
#.#* . . .#.... **... ..  .*....*.....*... .. ...# .\..\ *  ...*\# *. .#.. #*#.*..#..... *..#*.  ..#
##.. ......*..#... .**#..* ....  .#...*#.# .*. ...... ..* ......#. ..\#. ....#... .#..*.. . ..#...*#
# ..#\*#...*.. *.... ..  . ...  #. .*. .*.#.#....*.\\.. #.......\*. #* #....... . *...... .#...  *##
#*..#....\**\\.# ...*. .*....#.*. .* .  *.#......*...#...# .#  .##**#....##. ...\.  ...*.. . *\\#..#
# .#..#..#  .\. ...*.. .#..  *.\ # *##..#. ..# # ....#......#. .#  .*.#. .*.* ##*...... .#. .#*. . #
#. .\..*.  .  .#.*#.* \.. **. ....#....*..#....*# \ .....* ..   . *#. ...#..  ..#\...\#*.\.. . . ..#
#. #. ..*.....  .. \..* *##.... ....   #*.  ..  ...# ..........  ....* .....  ....#*\.# ...# #**...#
# . #.   #* * ..  * . ......\ *  \. ........\ ..* # .. .  . ... ....*.. ..\.. *.* .*...*  * ..*\.# #
#..   ..\*......** ......  . *..  ..#\..#.. . \.*# . ...###.. ..#..** .\ #.. ....#.*..\#..*# *.....#
#.....\.......\..#*. #.# **. *. .*...##.\.##.***.. ..*... .#.#..  .* *..  ..... ..#. ... ....  ....#
#. .*  . ... #**......**# #.#..........#..#. .\.  *##....#.*.*\.\.*  # **# . . *   .... ....*. .. .#
#... *..*.#  .*\..*.**...#.\..#..#\.#.#.........*.#*...  .... #*#. . ....#**..   ....*. .... ..\..##
#.# *.*##. ............  ... #.*#.  ..........#..... ..\*#..   .#..*  *.  .   ....... .....\.......#
#..#.##...#.#*. .*..  \.\.. #\\  ..  ..... **.*.  . *..#..\..\ . .. .....*.*. #..#*. ..\......#..#.#
#\...*.#*#.. .\.  .   *.##. ........*.*  .*....*...\..*...####..*.# ... ...* .*#.*#   .   \##......#
#..#.  ..*.#...... *\.* . . . \..**#..*# .*.#   .*. ...#.#*# .*.*..\ .....\  ..*...\... ..\#.# ...\#
#.*...*......... #....*## * .#*.*.... .  .*.... .. . #....\..#..... ...*  . ..*\\#* ........... ##.#
# \ .*#. ....\ *\..*.*...  \.*\..## ..#.*..*. .. .#.*..\. .*..*\..*..*.#.  .*.  \..... #.\.........#
#\..#..##  . .#...............#*. #*.#*...#...* #\.\..  .......# ...* .....  . *\   ..# .# .# #. ..#
#. ..*....\..#.*.* .  ..\ #........#* .\\.\#..... . .. *..#.#*. #...  ...*.. .. . *#..    .##..#..*#
#..\. **.... #. #\.*.#  *. ...#.. .*. . *.##...... *.....  *. .  . ...  \...*#.. #.#.  .#.. .. .  .#
#..**.\#  *... .. ..... .*.*. ... ...# *....#.*.. *.\. ...#\..#*.*.# ... #...\\  ..  .*#.. .*.   \\#
#....     ....**... .. .*. ...* ....*...........*.. #.*....  . #*. * .\.    .. .. .\.#....#*#... ..#
# . ...*....*... *. .\ . .*.*. .........#... .... ..\.. ........ ...\..*##.##........### ... ...**.#
#..  ...  ..\ . ##.*.*\ ... .. .*.\.. #. #... *##...  #.#. *...*.*. ..\.*...#\..\...*.\\. ...... .*#
#. ..#\\\\.\..  ....* .*..*.*. ..\ *... ..*\*.# #.*\#.......#.#.*...# *...** .......*.......#* .. .#
# #.. .. \*# ...\. #. .. .*..###*.  ... *#.# \*..**#*..*.\ .* ...#. *..#........\**...#......  .*. #
#..#\. .#.*# \.....* .# ....*.. .....\*..  .*. ..... ...... ..*.#**......... .*...* *  ..*.#... ...#
#.\..#..#.........*... .  .#*. .. .#*. .......\ ...#.#..*...  *\. #...\...#*.\..#. ..# .. #. ...#..#
#....#\#.......  \..#.  ....... *...\....#*\ . ...#. ..* \*#\.....## .*. ..* . .\#...#* *....# ....#
#...... .**. ... ...\*#. *.. #... .#*.*.*..#\.#*. ..#...\\\.#. #..# \...**#. \...    ...#........*.#
#\..#.. .. ...\..#. ...........#.*. ..* ..\*.\...#. .** \. #\*.......# .#.... * ..\ #..\ # ..\.....#
#* ....*. .  #..#......   *.*.*###..\#..**..#.. *\. ##.#....*....*\.#* . **....*...#..##.*\.* #* **#
#.** . .\....\.\.*...\..\. ...    ... ...\#...... .\.\ \#.#...*...*.#... ....#.... *.. .#..** .#. .#
##.#.... **..###.   \*#  .*..... .*. **\#....\ ..#........  .....*#.*\.#... ... .......#*.\.*...  .#
#.... ....\.....#.  ##..  .... ..**. #   \.*...*.  .*.* * #.... ...#.... ... \.\..#..... ..#..#  ..#
#** .      ....  #.*..#*.*. .. ..#..#...*.#...... .\... . ...* #.\. #. ...# .*...   ...\..*....#. .#
#.*.. ...# \.. ...#.\.###.*...  ....* ....##.  .#* .. ...*\  \\**...\ *.. #.# *..#...* . *.###*#*..#
#.*.\.****......\... *.*.\.* .......*.# \ *.* #..\.* .......\##... * ...  *. .*.\ ..\#.... .*..\ ..#
# .#... ... #.. .**\...* . ..#*. ...#.. .#.. ...\.#..*.#.. .*.*..*... . ... \. .##.#..*.\#.  .. . .#
#...#.*#...#. ..*...#...*.. . .\.#**.. .#.. .*. ..#.#. .....  \\ . .....  #...###*..\  .....*. ... #
#...\#\ ... \ ...... .#..#.#\ ....  ..*.# \...#.##\.*.. . . . #.....#.\\...  *..* * #.. ..*..  .#* #
####################################################################################################