####################################################################################################
# *#... .#... .#..* ....   ...........###..  . .... ..  \...*#\.* .\.  .....*.*... #.*  .*.#. *##*##
#\.* # .. ..  .. .**..#.\.....*  . *..\....#.....*#........ # ..  .*.#....#.#*\..\............. ...#
#*.#.  \ ..*..\..*...\* .. *.\.... #\  #..*.. ##\. *.#. *.. *.... .  . .\ .  ... .##.#....#\  . ..##
#....*... .....  ..... *.#\*.....*. *. ..*.......*\.\.*.# .. #. ..**.# .* \.....#....**  \.. ....*.#
#\\ \.. .. . .   ....  .....#..*..\# . *..#. .\...\..# ..*.\..... .# #.....#......#.  .*.....\# .*##
# .\*... .** # .\. ....  . .. ... *.   .  ..#*... ... .**. ...#.\  .#.....#..#..*#.# ... *.. ..*...#
#..*. . . \*..* ...* ..   ..* ...\ ..\.....  ....... ...# ...*# .. ..... . .. .   .. ... .*...... *#
# ...#...*. .#..#....# .   .... #. ..#...#...\ ...#...... .#..#\. .\ ...#...... .\*..... * ...#\.. #
##.... ... #..*##.#...# #*... . ...  .* ...# \ . . *..\ ... .##..... ..  .............. . . ..*\.. #
#*....#..\#\.\#.....#..\.\  \.#...  .*  #...*...*. .. #.. \* ....##.....#.. .#..  . ........ *#....#
#*.. .. .* #.. .*. .. ...*.. \. #   *..# .*#.* ...#.  *...*.... .#.#. *#..  ##....  ...#.# ... . #.#
#*.#*.*...##.......... .##*.  \*...\\.#.\.#.. .. #... #.\. * . #.*. ...*... ....# .. ..  .. .#.. .##
#*.*..\.\*...\........ ..*#.#...**..* .\.. \*....#*...... ....\.#...\..*....#... . . ...  \. ....\*#
#...#.\..   .#..... *... ..... ..\#... ...\ * .\..... #..*.......... .. ..#.#.#...#.#... *. # . .. #
#. ...#.. .. . ....\.... \  \ ..#...*#..\.\. \.  * * ..  ..#* #. ..... ...\.. ..\. #.... .. *..*...#
#   ..#. *.#  ..   *.#...*...*#... ..*. ...\#......\ ...  . ..# ..\... ##*..*. .#*.*.... .\..  ..*.#
#.... *....*.. **#. .  *.. ..  . .... .. .*#.# . \.#.#...*.*.. *.# .\\#...*.##..*#. ... * .. * ..**#
# . *...\ ##\*  *.... .   \ .*#. . * .*. ......\# .. . .*. ..*.. ... \. . **\...#.  *. . .*#..... .#
#.. ....\.. . \.*#.. .*....*.#*...#.  ..*.#.###  .  ..  .# *\#..*#.. . #. . ....\.... \. *   .. *. #
#  *\*.* .  .  ....... .\.#.# . .\*#* \# ..\.## ..#  . *.....#...#....\.....*. ......... *...... . #
#.  ..#....##.#..  . #..*..#.......  #.... *. * ..\.....* . .. *  ....\.....##*.#..\..... . .# ..\.#
#**.#.  . ........ .. .\.... .. . . ..#.#.#...*...  #  \. ...###....... .#.. ......\#. . . ....*..##
# #.*..\..... .   ..*. **#....#. #\ .\...  ..#...\  .. . .#\. *#* .... ..#.... ##..*#.*. . \ .. .. #
# ..#. ... \.\ # # * . *...*#.**. ...#..*#..**.*.\....**.*..#....\ .\.   .  .. .#. ...#..... *. #..#
# .... .. ....\...... . . ..\. ... # #.. ..  .... \......*\  #.. .....#..#........#.**..\.* ......*#
#.#......\.\....#. #... ...#... ...** ...\ . .  #. .. .\ . .**. .  ..\\..\. .#.# \ ....   . .. ... #
#*# . ** .. ..*.#.* ..  .#. * ... \.\..*#.. ...# ....\. .**.. ..# . . ...\..*. ..... * .   .#.*.* ##
#.  #. ... .  ...  .... .#.. \ ... ...........*..#....#   ** \#... \.*#*... #.*...*. .*..#.*.*\  * #
#..#  ...#...##.*..\\ . .##  .**..*\.* ..#.... .\ * *\.... .....#... .**\#.# .**...**.\.\ . .. .. .#
#*.. .*... .**. *......... \.\..*. ... *\ ..#..\.#. \ ...#* .#...#..\...#...\.\ .\. . *..*#. **..#.#
#  ... .#*..\..* ....... .  ..*.*. .*........ ### . ...  .. . .*... .. . *.... # ... ....*...\....\#
#..#.\....\*. .  ...#*. .\. ....  .#...*   ..  ..#.\...... ...#.*. ...  #*. *#..... . .. ....# # ..#
#\..*.. ..*......*...*.*..  .#\*\ .  ..*.... #...*.\ .*..#*........ .*.   ...* ... . *. ....   ...*#
#*..#  #........ .* ... #..  .*....\.......#  ... ..*...#.#.# *#.*. . .*.. .  .##.\. ..#..* .*... .#
#... \\** ......... *\*...*. ..*..#. ....*. .*... *..  .\. #.. ...*..*...*..# . ..  ..\# *.*\...#. #
#......## ...\#.*..*  ..... .. ..*. ... * ..#. ....*.#. \...#*.#....* .*...* .... \ #.#..... .#.# ##
#..\...# .#. \\\...... . .\...*.  # ...#\.\.##... *.. ... \# .* .   .. .#. . ..*....*.##*. # .*.##\#
#*\. #. \... .......#... .# \..\*.... ..*....\.* \.\....... **... ..... ..... *.#  .*.** ......#...#
#.*....\. ...#...... ...*...* .. . ..*#....... ..*... .#*..#..\.... ...*.*.....* ...*.* *.....* ...#
##.. *.... .... .... \ #\*.* ....## ...*.....  . .  \   # **..*..#...#*# .#.\.\\...#  . **... ... .#
#. #... ..*.. .....#.. ... ...#.\.*#...# # .*#. . .. .*# ..\.#\..*.... . ..... \#...*. #\ #\#......#
##. . .\**..*...*. *...**. \ ....\....  ## ... ...\.....#... . ..  \..*....*.#  ....\\....  .#. #.##
#..#..\..... *.*....#.*...#.......* .....#. . ##....#..*.  *.. ..\.# #... ..*. * ...#..*. # \  .*..#
#.. ... *. . .#....##. . .*# \..# ... ...#.....*. .....\. # *  ..* #.\.#....*. .#. \*. ....\..... .#
#. ... .. .*........  .#. .*###* . . ..*. ..*....  ..  \* \.  \*..#*  .  .* . .#*.. #..*#. .#.*.*..#
#\ ......\\.. *.... *.... ..  #.. . ..... * . * . ......*..... \.*. . .*...  .#....*.....  .. .*..*#
#.\* .*\.. .#*\\.    \*.#.\.. . \..*..... ...\\* . *.\.*  .....#.*.*......#  *\..... .....**... \. #
#... .\.... . **#* ..*.\....\* ... ....* # ..#... #   \  .#.. ..*..#* \..... ..... ...   ..* #..*. #
#... .*#...#.#\.....*.*..*. .. .......#. .... *# . .*.\ #.   .*..... ..\.*.* .*. .*#..... ..##...#*#
#*  #.  *....#. *.# ** *### ...#.  ** .. #.#.....# #.\ ...... . ..\\*. *# **.. ... ...*#....*#  .*.#
# .# *.#  * *.. .\**#.  #*.# . ....  ........ .   .... .\.... . #*.#.#..*   \#...............**.\. #
#.\......* *#. #.* \.*. \.#.. #** ..  .#..\.*# #. ....# .. #*..##.##..\ ....#....  ..* \...\ ..# .##
#.\..* .....#..# * *#  . *. .*.#** . .*#* ..* . ..*.#..*#...*...\\..* . \..... .*#. ..#...#..\. **.#
# .\....#\.\* ##..## ... *...  . #..\*.\.. #.**.# . ..#....##..*... .  . .....*. .. .   .#....#.#*.#
#.. ....#.....## ..... .\*\..  . #*..* . ..#\.\  . ..\ . ... * ..... . ..  .. \.....*  ... . #.\* .#
# .# #.\. ..*##** ....... ....# *....\..# ..# # ..  #.**....... .....##. . ..\. .  ........**.#* ..#
# ... ..#*# ..... .#.  ....*..* .###** \.. *..** ....... *..#.* .*...*#..*.....#..# .*.....#..*...*#
#*#. ......* .#*.. ...*\ *. ## *.* .\. .#.   *..*#.. ...* . .#. .#*.  .\*...*..... .. ... ....#..\*#
#.....*  ....#*.  ..*#. . .....  *\....... #\ .. ....*...#....# # *#..#... \ #.\... ..*# ...* ....##
#......#...\#\..  . . \ **.. .....*\..*.#.  **....\.. ..  . *...##...*.....#.\..*. \ ....... . * .\#
#.. . ..**..*\.. .  . ........#. .... ...##*.**.. .\ . *... . ..... ..\.  . . .. .*.\\.\#* .... ...#
#.*...#..*.*#......#.   *....#..*..\.#.... . ... . .....#\#.. ...#\*  #..## .\. .*. .*.*.#\.*.**..\#
#\ ## .... .#\.#.... .*....  .......  *...\...  #.......*...#\.  #    ....\..#\.*..... ....*.* #**.#
#. #. \....#.....  ....#*\... ..# *..#.*. . .#...* ...# .....**... ...  ....**....*#**.. ...*\.. \\#
#.# R... ..... \*. .. \. .#.*  .\ ....*.#\ **..\ *...*. .. .#.**.#...*....\**.# ..**\.  . ....#... #
#\ ##\# *. .*... .\* .\...... .. .. . . .#.\.*. #.. #\..... . .*....  \.. .\... \*. .   ...*.....* #
#*... ....#.* ..\..*.\* ....*.. ...    #... ..*.. . *.*..... ...........#. ..* *.*..  \..*.#*   #*\#
#.#..... .#...#...\* ...*#\. .... . ..*. ..*...*.*.. *.*. *...... *\......*... \. .. .  ...........#
#...#.......# . #.*. .....* \ .........*. ###*...#\.. ..... ...*\.#*... . ...# **. . .. .......#..*#
#\ . . ..# .*......  .\.#...# .. ......... ..#......#.# .*. . #......#. ...  ... *#.# . #.. #*#\.. #
# ....#\   .\#. ..#... ... ....  .*   . ...  .. ..#   .  #... \\.... *. ..\....#.##..*.**.\\ .*... #
# . #.\...#*#*.  . ........# .* .......   .# * *.* ....#.* **..... #. ....... ..# . ..# #. ... ....#
# .#...* ....  .   ... .*.. ....**. ...*.. ...*. \*.  \ ..   . #\ *.. #...#.. ....**.*#... ..#  .#.#
#. . *.*.. * * #.# # ...#\.. ..**..#  *. ..* ... #.. .. . *..#* *.  # #. ## .\.   ... *\ .... .* * #
#..#*.**. *.#\*.  *. *.\...\.\ #... ..... .......*#..  \  . ...*... # .....* \ .#.**. . ...\.. ....#
#..\ .*\.. ... #..  ...##  . ..\. . . ..\.. *#\ *  .*..# .#... ....** *...#\. .*... .#..  .\..*. .*#
#**#..\...#\ #.#. * .*.....*..#*. *... ..... *.  . ....* # .* .#.. #. .*\  .. . .....\.. .#.\. ....#
#*. . #. .*...\.....# ..*.# ..\.. ..* #..#* ...\...*\* #.  ...# .  *..... *. ## . \... . .* . .**.*#
#.#    . .\\.#... ....*. ..*.. #..... .. .  ...* .. ..#. .*  \...*..... #. *....... . . .# .\\. ...#
##.. \ ..*...#.*...#..\..# .#\  ..*..\  .#. \.\#* .*##.#....  \... .* ....#..\.*......*. . ........L
#.. ..\#..... \. *...#....#* ...**..#..\.#..  ..\ ...........*.#\..*.. *.*..... ..*.  ###  #.\.....#
## .\.  *  \.. ..*....\...  #...... .. # .....*...  .#..#...\. *...*... #.*.....# ......*...*.*....#
##.*....#..  ...... ..*. ..\........*..\#..*#....... .....## ..*.. . #.#....#...*#.#... #.   *...  #
#....*#.. *..*...\ .\  ##.. ..  .. ...*#  . .... ......\......*#.*  # ...\\ .#. #. *.....* #......*#
#.............. \#...#.. .*.* ...... # .#.........*..#.*  ..*.... .#  ...  \. ..*.*#..# . .. \.....#
#.\#....**...#  ...... \.. . # ..  . #... ..#..\ * #*#.*..  *..*...#.......#...  ..*... #.....   ..#
# **#*...#.*. #...\.#.#....... ..  .....#....*.*##....\#**\.#\..##. .. .\\##\..*##.. \   *..*.#.. .#
# .....#.......* ... # ..\\   .   ***. * .#........ \........ #  **#.# ....*. ... .... .#*#.....#..#
#\.. .*#. *...#.. *.*....#*#..**....*. ...#.... *...  #....#.    # #....#..... ...* *...*... .. . *#
#*.#\\.......\    ....#..##. *. ..#*\. *.\ . #..#.\... *....  . . *   .**\. .   . ..  ##.. \.......#
#*#.... .\.... ...... .... . #....#.* ....#..*\ *#\ .* ..*\ ** .\*.\..*  ..*..#..#\ .......\\ ##...#
#.* ..*#..*. . ........ ....*  .....\\.*. .... . #. #....  ....\...# .........* ..*#.......... *. .#
#.*. \##..## ....#  ..#.. .... .....  . ... * .*.##....\....\ ..#\.#..\#...# \.. *#*.\..**.. ..\  .#
# .... *. .  ..#..*\ **#   .. ........  *.. **..**...*...#.*... ..\*#.*...*.#*..#. .\....*.#..*.# *#
#* ......*.# .#\\*.. ..*... . ...#. ... ... .........#. ..*....#... .*.#.#.. .. ..# .*.  . \.. ..  #
#*\   .. #....* #. * ##. . .*..  ...** \.  #... .#. *..\# . .\.\ #..\ ....*#\.#**. ... ...  ..... .#
#.*.. . #.....*.... . .\.... ....\.## ..*......#.*..*..\.. #...#. ..# *...*...* *..*  .   .. .#.# .#
##.*...  .... #. ..#*. ..#.. . ...*....# ...  *....#..\. . ..#.\. .. . .#.. . .. *... .*..*. .*#..\#
####################################################################################################