####################################################################################################
#**.#\.  .#\...\..*\.*...........* .....#   .. . .. .#......#.  .. *.# *  ..\..\# ..#.##\\.*..#\\..#
#.  #....#..*  .*. .\.#. ......\ ..*  ..*.\..*...*. ...\.*.*. .\\ . *  *...*#...... #...*.....  ..*#
# .#*. *.*.\..... ...... * .......**\  ..# .*....* \*...** ..*.  . \ .......#..# . .   # .#\.   .# #
#.*...*#. ..#.**\.**.....  # ...#. # ...*.. .. .. #...  ....*. ..*...#. .. ...** ...#.... .. .#.*..#
#... *.#. \*  *..#......*...\.#   . .  ... .#\..\. *\.. #*.....*.... ....* .... .##.#...... ....\. #
#.. #.##.\.  #. ..#.. .. #*. \....#.#.. #.   . #  . *\.... # # .**. ..   .....   *# *...\..\..*#...#
# .\*..###...*. *...*...#*. .*#..#*...*.#*.*. ...#.#. .#..#.#. .. #.....#.# ..*... .*....*..#.....##
#..#. ....*.*. * .. \. *...#\. #...*...#\. #.** .*#.# .. **.*.. .*.#.# # *.*...... #.......*.#.#..##
#*..*...#.*  . ..*......* *.#.* *#*.##.... *\ ..... .#... ... .... ...\ .  .#. .#.. ..   ***..* . .#
# .#....#. ..*..\*.. #**.. ....... ..\*  .*.  #...... .#.   *#.........*.*\ ...  .. .  *..#*. .\#.\#
# .... .. .**.... . ..#*...\#..... . ....*#*.\. *.\... ..\.##. ...# ..  .*  ...  . *\..#  .  ## .. #
#\...#..\ ...  .\\..  ... *. .. . *#.. #*  ** *.#.\ .**...#   ..... . . *.....#.\.*#.#..*  . . ... #
##. .\ . . .........#... *#**\*** ..#*......*.....\* .*. #*...  .....\\ ... ..#.#*  *...*##. ... .##
#\..*. *#.. #.*\ ..*.. . \.#. .*.. . ..*... *#... .  #.* .*.*.# ..*.\.*.    \.*.* .  .. .. ....**..#
## #..#*#....  .#. #.  . *#.  *.*........* . *.*... ....  .\..#..*..  .  .. # \#*......... . ... .*#
#*.#....\##*\...*..... ..*... *#. .\ ..**... .**.*\\#.\...*.##....*#.... \....*  .\..#. *.. .. ..#.#
#......*.. * ...*.\* ... . .. . .. .\.*... .# #...* *.*.#.  \#.. ..\ ... . ..**. #*. ........\#. .##
#...#*..#... . ***.#....*# .  .. # *.. * .....  ...... . #.##..\..*. ..\.*.... ......*....*...*  ..#
# ..#.... .* ...  . .. *.#...#.#... *.. . .....\ ..* *.*......  .\........*.. * ..  ..  #*. .... ..#
#.\... # ..*##..*.*..\#.  .. . .*... .\..*.  . .... . .........\ ##\.##............ .\..\.. ...\...#
#.**\.   ...**.... \. #*. . .....#......#...##....*...  ...* .#..  .... . ...*...  \#.#\...# .#.#..#
#*... ....*.*\ .#..  \.\\.#.. .\.#.  .*.*  . . ..  . .#...\.# . .#* ..\.. .....*....#........# .#*.#
#. .#. .. # * ..*\#. . . . ....#. ... .\. .#.*....  ....*  ....\.  ......  ..#....*.*.#.\..* #.. . #
#..#. #*. .. ... ....\...#... \*...\..#* .*.*............ ..* \* . ... ..*.\.\.*. . \#......#.*\ #.#
###..#* .*. .  *  ....* # .. **.**#.. . . ... #.*. # .. . .#.#.* *... #..  .. ..#... .... ....#. ..#
#..\..* #..*...*... #....#.. .* .*#*\ . # ....  . .... .*.... .#...*.#....##   ...# ........#.. #* #
#*# * .*.. * .  #*.*.\..\....#..*....  \..  \\ . *....# *......\.. ....  \. .  .... **  *.*.......##
#   .. ..  .\....*.. *...#.................#....# ....*#. **..*...\*........#...**...  .*  .... .*.#
#..... .  .\.*.#..*.#...#.\# . #.*......\....* .#...... ..... *  ..... .# #.. ...... .*\....** ... #
#..*.*.........*\.*.....**..\ . .\..\ .#..*  . #.. ..#..#.. .*#\ ....     #.....#.   ..  #. . . .#.#
#.. # **..\ ...... .#....   .#.*. .... .....## \.#.#.  \\. . ....*.. .. ..........#.*...# *. .# ...#
##.\\...*  ...  .#   #... *.##...\.#* \ . * # \.. .*#. \.  ..#.* #.. .... .#.#..*  .. #.*#.#. . . .#
#..\......... *.. .#.  .* . .... .. ......\..  # . #* ...*.. ..#...*\ .. .#..#.*  **..# ##. .*\* \##
#*... .*.\.\....#.. ..#.\. ....  .  ..\.#.#\.....\.#.#\ \ ..* ...  . .. .\.. .*.# *.. .*.. ...* ...#
# ...\.....*  ##\ ....* **  .#.. *...\....#. *..# . .# ... #....  ........\... ..  . .. \#*.* # .*.#
#*..  . .  ......*.......*\  .*..* \.. .   . #*...  . ..* .. . . .. ... ..#.  .** ..* .......*###.*#
#... .... ..#. .#. #**.. .*...... .*..#...#.. ........#... .  ..#   \\\. ....*#  .. ... *..*. ..#*##
#  **.. . .\. ..*....*\   *..\ #.* .#............**. ...... .\****** * ..\. # ..\ .... ..#*....# . #
##.... ... .  \ .   ....##*  ..... .\...#.* \ ..## ..*.\ ...# #..# ..*. #* **.*. ..... .*.. *\ ..# #
#*... . #.\..*.## ...\.. .#* ......**.  *.#.R.*.. . #.#\*.. .#...*#.\ *... ............#... ..... .#
#...#.* #.. .\...\..#*\..*\.  .  .*.........\ *....... * .. .  ......#\ *...*.* .......  ##...#.. .#
#.# ..\* . .. . ##..**.#.#.*# .....* #.. ..... ..#.#.#. ..*. #.....*. ..*#......##.# #.  **.  .#. .#
#. .. ..#.  .*\  # .#.. ...*  .. ... . * .... .. #  .... ......  #.*.... *#. *  .*.  .. *   #  #.. #
#.# .#.....  * . *....#.#.*.. .. #.... #....# .#..#. ......* .  #.. .. ...\ .#.... ..#*.\ *.\....#.#
#.# ..#.\...  #..#.#\......*...\....*....\*\..\.*.## ..... ...*...  ....  *. ....#..#.. *..\#*. ##.#
## . .## .#....#.. #.** *.#.......\ . .*.. .....*  ..*... . ..#........ . ....#.# .. #... ...* **. #
#. \.....*.   .. ...... ..* *..#*......*...*#* .....\ .  ... *\\.. . ..#.....*\. *...*#.... .##... L
##. #..#.. .##.#*##. .......*.. .*..   . #..... ..  .#.*.*#. *\. .*.....*. .  .*....\ ..#*.**.. \. #
#.## .\#....*.. ##.\.. ...**..#..  #* .  ......*... ..#....  *.*.... ..*.\#... .\..*.*..* ....* .*.#
#..# ..  .* ..\\.#**.##* ....... .*.......*....  .##..*. *#.  \.... ..*.*#.........# .* ... .......#
#*..... ...\ .......... . . #.... #.*#. ..* . . . ...#  #...\. *.. \. \ #*.. ........ .\#. #\ ... .#
#.. \*#.#.#. #... #. *..  ##.........*.*. .#... .  ..\* \.# .#... *\ .. .#.\.. ..*..\#. ......... \#
#.. .*.. ....*.. #....*.\. ..  .#. ...... ...# *..* .....*.... ..##*.*.#. .......# .. .* ..#  .. ..#
#.#.....   . ...... ...**#* .#. .## .#.# .\......\ .#....*  .#.*..... . .........#........ .. . ..##
#... ..# ...**..\...# .\# .*..*.. \..**  ..* .....\  *.................#.... .....* .\..#. ...# * .#
#...# . #* ...... .*.........#. *.*..  .*.*... ....*...*  .  # ........ ..#..**... ....... ..#..# \#
#..**#.* .#.....#.\.*.. ... *..   # .....*. ... . . .... *#..*#..#*...\#\# ...\**.#*.... .*  * *.*.#
###* . ..*.*...#...  .. .# .* .#**........ .#.. ... . ....*#. * .  ..#... .\#** .\#. .#.* ..**.#...#
#  .#. .# . .. #.*.#** . ..... . .  *..##...* ....\..*#. .....#... *  .....#.#* ........ .#...  ...#
#.. .. \.* ...... ..  .... ##...#. .\\..*\ .\ #. .*.#...#*... #...... . ... ...#**..#....... .*#*. #
#... ..... .....*. * ..* * ....  ..\.... ...... #...\. *. ##... ....#..\*... ..*.* ..*..... #......#
#..#.*  ..# \.\..*...*.   * \* .\#....  ..\..#.*. #.. .... *..**.  #\#*. #......*.**.....*.....#...#
#.. .. ## *..*#... ..* ...*\...... #\.....# #..\\ .#. .. .#.. .\.###.\..  ...#.   *.*#... .........#
#*.# .. ..#.#.. #...  .....# ..  . .#.* . \..\....... .   \.   \#. ...\.*..#.\ . **..*. .....\...#.#
#.* .**...#*.#.......* ..\\*#..##.. *. *..#..... ...#....# .  **...*. *.\#..\...#. * ......*\# . ..#
##. *#...* .. ....\. .. .  ....*\... . *#*#.*# .... **.*.*...#..##*. .... * ... ..\.* #. ...**.. .*#
#......\.. .*.##.   . #.\..\..*.# .*\. *.# ..  .. # **\ *#..\ * .* .  # ..\*..###. ..\ ...  .. *. .#
#.... ... #*.#...# \.* ....#..*. .\.. # ..* .#....\ .. *....#.*...#.....# \*\ .*\ *....  ..* .. .. #
#..... .*#. ... #.*. . *. ..*...\. ..#.#....*#. .\..... . . #*...#..... ..*.. *..*\ .#.*.* *...*.* #
#*#..* .... ...  # #*... * ....#*.#. . #.  *.*....  * \.  *........  *.... #\ *\ ... ..#..#...  *..#
#.. \..*#  ....*. \. ... .#\.. .*.*\*..*.#. .....\ *..\*.....#.. .*.* \.. ....\..#...\........  .\*#
#.##..#..*...# ....#. .... #.\..\. ...*## ..##. \.#.**..***.*#.#.. ....*. *..  \*. \*. #..\..\..#..#
#.. .\. \ **...#. ...\ .. #....# \.. .*..  *... .# \....*.......\..\...#.. \.*  .*.   ............*#
#.......\ . *   .... \..#. * . ..#..\..\ .*.*\\.. ....* . . #... #\..# . . \... .  . .* *\. ..# ## #
#**\\ *#.*.#.....#...* #.. .# ......   . .....#.  ...*.....#.....#..  ....\....   *..... . *.\.. . #
# #.*... #. . **#...*#.  ..#...  ..*  #.... .#. ...#.*  .#...  \....#.   ...  .... * .  .. .*. *. .#
#.. ... #.#*.\....#... \..*..#.........#.# .....*.#*.*........#  ...*#.....#..*  ......#.*.*....\ ##
#.. . *\# .   *#......  .....#.. ...*\ . ..... .\*...  . *... ....#.  **\..\#..#....*   .#.. \.#...#
#........#......#.. .. *..\\... #....#\ \.*...\ .**#  . . #. \. .* .#.... .. *... .##. ..* ..** ...#
#. *........ ..*..#....\. ..*...... #. ..#. .. **....*\..#*\....#...#*.*.* ..* .*..**.......\ .*...#
#..*.. #.* *..*.*.*.. \#.... #....\*#*.#.*. \ .......#...  .#* ......# . ..  ..... .. ..   ....... #
#.*. .#..*..\.\ ...#\ # * ..\# ....\\.#..# \...\. .# *...... .*..#*.#. ...**..*##....*  \.. *.*....#
# ....#. #\.\#..*#..*.\..*.#.. .*.#. . ..\#*\.*# .#. . #.. ..... *..* .. \ *..  .*. # ..... #  ..  #
#..# # ## #..... \.\ .*.. .**....*.\....   .\..*.*.**.. . ....**.*... ...... .*.. .\..\.#.. #. .#. #
#. ..*.*.. .\..... \#. .\.......##\...  ... .*.\... **  \..* .. ...#. ... .#... .\.\.  . .. .\# #. #
#*... .. ..#..\.*.* *\.....  .#.*  .#. #\..#..\....*.....*. ....#... .........*..**. *.  #\#. \  * #
#*...   ... \....#......# . .. .*.\... * .. # *\\ * .... .* *.**.\\..#  ...  ... ..... .# . #  ....#
#..*. ...  ... .## .*#\.\.   .....   #.  *...*.#  . ..... ** ..  .   \.#..  #***...... .... ..#.#.##
# ..#..##..#.. .. *... .#\ #.\ ..##\#*.. .#   ..#..* . .... ....*. .*..#. .. . ...\ ... #. ..\..# .#
#*. #. .**.#...*.\. ........\ #  ...... .*.#*#.\...... .. .. #...\.  . ....#..#.#... .  * #. ......#
# *..#.. #.*..   \#...#..  *. *..\...\*#.#... .#. *. #.*.#.\ ..  .......... # . . * ... .*.. ..# ..#
#....**..... ... ....*.... .... . *... .\.#. .. #....... ....#.... ..*. ..* *... .....  * ...... . #
#.** ..*.*... #.\.  \#.\....#*....*#...\*.. . . .... .#.   *#..*..   ..#..... **...*.*   #.*\ ..  ##
#...\ .  . .. ..* ..**  ..#..*.. ...*  .\..*.  *... *..*##*#....# ...... ...#............\. .#.#. .#
#... . \*\*....#\...\. .. ..#.*..*...............\.\#..##.*.#....\.....\#... ... ..#.  ... .*....*.#
#... #*..\......* ..*.*.**. ..  .*..#.#..# . ......#*.\.\.... .  .# #.#..   .* ....\....# .....\.\ #
# ...*.......... . ..*.....\ . . ...* ...  .\\.*.  .... #*. *.\.... .. .  .\ *\*  \....... . ..... #
#*#.*..*.#......#. .. ..\. *#.. ...\... .* #.. *.*..  *#\# ..  \. .\.... . ... ..#.*.#.......  .. .#
####################################################################################################