####################################################################################################
##..*. # . . \. #.......#\..# . # ... ....... ..\\#.\.*..... .*.. .\.....#.*...*# ...* **.#.... *\.#
#.....#. .... .... *.*.....\...# *#...#* .. .*...## .  .. ....**\#**....\*.....#.\**... .#**. *    L
#.#. ...\\.. ...\.#..#.......**.....* .\#*.......... . .*... .*. ...  * ....\#  ...\...#..... *...*#
###... ... ... ...\.* .\ .\#... . ..*.* #.. .. .* . #* .*.#... ..\. .  .*.....  .. #.  ..##..* ##..#
#*..* . . . .... ...#..*#.#**.....*\#...*..#.*...\\..\.  *...*.*.\* . .#. . .. ....\..*.#.....  *..#
# ...*..#..* *# . ..\#.#.*.\....#..#.\.  \..... .# .*..*.** ..*..#.\. ...*.  .... ........ .   *#..#
##.* ..#. ....  .    .*.\ # \#.*... ..* . ...\.*. .*##\.*#....*.** .#.\#......*... ##. .# # .*#.. .#
#..*.\....*#....... .\.....#.  .. .  ...# \....* . ..... ....* ..*........ .. *... .  #*\..#\...*..#
#...#...\ \...#** ..\#.. .... .#.. #. *#... .*.. \.\*.**... ... .... .*.. ...#\ # . # . *#.....#. .#
#\ ...## ........**. *\....*  .#.... ... .\*..*.*# . ..*#... **..#..*\. ..*..*...* .#....\ ....#...#
#....# ....# #.... .....\. .#..#..#.... .  ...*..... ....   . ..*...#  .\ *. #...#.#..   ....*#.*..#
#  ...*.... .#.. .  ..#. #.#.#  .... .#.  *#..... .. ...... ..  . *....*. ...#* .*.\. *#..**..\...*#
#.#..  .##\.... ... #..##... .. .##*  .. \.*..\.... . .. .  \ ##...\.* .. .....** .... ..*.. #. ...#
#..#\ ...*. .* # ..*## .# \ .. *.#.. . .. .#...... . \*...# . .... ..# ...*#. .#.*..*#.*.... .*.. .#
#..*.*.  .......#  .*........# ..#... . *.*.  . ........   **\... ....*.#   *.. #. .*... .\.*. # . #
#.. . *... .*\..\ *..\.... . .#.......\  . .#.   ... *  #\*\#.  \.*..*.#*.*. .#...\.\.*..\ .*......#
# \. ..*..\..*..* . ....*.  .. *#. ..* ........ ..*...#.  . .\.... ..\. .*.#*# ..# ..#.... .. .. . #
## #.###.** *** *.* #..*# \*...\#.*\.... .....  #.\.**.*..* *  ...  .........  .. .. .#*..  ..#.  *#
#\.#\\..* #... .#.#... .# *......  ...  ...  # . .#..  ... ....  ....#. .*... ..\...#...*. . \.\.*\#
# .* .. ###.*   . . .... .#. ... .... *..* #.\.* ... *.. \* . *...# . .....#*..#  . ..* *#.*.......#
#..#..  .*#. .. ..# .. .#.. ... #*.\*  .. ...... \.........\# #.. . .## ...#.*..**#*.\.\.* #..#..* #
#*....#.\*# **.*# ..** . *..... ... .. ..#..* # \* ... *..*.. ... #.#. \..\ .*  .. #.* ..  .... .*.#
##**.#  .*...#*.....#. ..# . #.... .... ..#\.*  .....#..\.*#. .*\ **  . ...\.\..  .. *...\ *.\. ..*#
# . **........\.  ..#..*. *...*\  #.*\*..#.\...* .  .#.*.\#..#..\#.. #* #.#..# ..#..*. ..*# ..  ...#
#.#... ..*.#.*... ***\.. ..... . .#...\.#*.*...*.*.   \. ... .#\#...##. .. . . ...#** .*.* ...... ##
##..*.*. ..# ... ..#.\*.\........... .*\..... \.#...####***#.#\**.....#.\#.\ #...  .#\... ... *. *.#
#.\...*.*. .  . .. .\.*. .\*...\..\..** .. .....\#.....**....* .. ..  .. ..****... *.. ..  \...#.#.#
#. ..*.. #...*. #....     *#.** .* \ ..#....\. \ . .. .*.. ... #..  .\*.. #....  ...\......\* .....#
#....*.  .##.. .....*.. ....\.\ ..... ..*  . ....#  .*  ..\.........#.......*.*. . .. ......  .  ..#
#.*.  ...  #. ...... ..*.. .* ..\*....#.#... #..  .* . ..#.\\.\. . *#.*...   . .* *.#. . .....*.\\ #
#. \ #.*  # .*. *\....  .#.*..#...#..#.#** *...*#...*.#*##.**..* . *..  ..  .. .*#.*.  . .*.\ .#*#.#
#..\\\# *.# .\* #*. *....\.* # .\. \* ....... . ..*....##...\...*# *..\.....*.* *  .. .. ........#.#
#.  *#....... ..\..*..........#####.##*# # . *\.*  .#..#.* . *..*....\ . ... .*\. . .. .\...#.#* \.#
#...  .#... ##. ..... .  .  .#**...*.#.  *...   .... \ ... . .......#..  ....  . \*.*. .\. *  #.  .#
# \*  .\ * ..*.* .#.**.... . .#..* . ..... ...  \...#. #* ##*........ \..   *#.* .# ..\.# . \*.. . #
#. *.\....\#..** \*....*. .. . \. ..***#.  . ....#. ... .. ....  .#.#...#\# .#..#..*...... .   *...#
##.. ..... ...*..*... .# *  ....*. .\ #* ...*..*.# \.... . . **. ... ..... .....* . ... .......*..*#
#... .* ... *.....#.#. ....   .. ..*.#... **.. . .\.\. . .......*\...#..*.* ..*.. . #. #.#.\..*.*.\#
#\ .....\.....*# .**#..  \.. ..*\  ..*.*.. ..\ ...#\.\* ..  *..\.\#.. .#. . *.# .#.*\...# .... .**.#
#.\*#..*... ..\#....  \.. . ... . .  . *\ ..# #\.*. #.......\ ..  . ..*  .\...* *. .. ..*. .#...\..#
#.*##...* \*.\.*...*. . . *. .... * ... *.....#.*\... ..   ..#..*...*# ..# .. ...\ \ .*..*.\... ..*#
##*.  * .\ ..# .#*..\. * ..#..*.# ## *.*.... #.\. ....*.. ...   . ...  ...*...#.#..*. ..*..#.....*\#
#..*..*#. ..# \..* # *  . . .#.#....#..\ .   ........*.#. .#.\#. *.*..* .\#.. #. ...  .# ........ .#
#*  ..#...** ..#......  ..#* \#.\.# .# .*.#...  ....\\#  *.*..#..*\# .. ... #. .. .#..........*.#..#
# *#\.#...# .. #.# .*.....##*.... ..... .## .\....# ... #.#.*.\*# #   .#.#.  .. .......*#* *.#..# *#
#.*. . ...* *...*.*.  **..#. ..#. .*.*   *.. ...  ....... .  .* ... .\#..\#\.#..  .#\..*..#*.. ..\*#
#.\ . .\...* ..*... ..*.. . ...*. \ ..* .. ..#....#*.#  .  ##.    \#*.#.. .....**  . ..#.#...#.# ..#
#..*  \.#.#  \# .# . #.#..*.*.*# \*  ....#*..*.##.\..*..   ..*.#.. #. . \ #..## .. .**##*.* .*.    #
#.. ...... ..#.......... #\...*. .  .. ##...*. #. .....\ .. ... ...##. ..#*.. .*\..*.... #..\  #\*.#
#... ..*.... *\.*...\... *# .  ..#*#.* \......**..  ...*. .*.#. .. .. ..*. ....  .. .. ..\..*.*..# #
#\\.    . #.#... ......#..   #. *. ..*.\..\. . ...\....\ ...\.  # ... # ...**.*....\...#..#*.....\ #
#*.......**  #  *.*.#.\.. ....#. ..\  ##.#...  ..... #.#.*\.  .. ...#.   .#.#*.   *\ .#.\*..# . ...#
# ...#..\.. .* ..  ....*... ..... ..#...*...#*.  . ..#*..*#. #.* ..#.#. *......... .. ... ... .....#
#..*. .  ...*. #. ......#\\ \* #.. ..##.*..# . . .*. ...#.**.*.. *....*.# *#  \.*#  .. . .. . ...#.#
#. .*... ...* . ................ \. *# .###*# .  #....#...*...........  ... .....#..#.#.  *..#  . .#
#..\..#*.*.   . #. .... . .. .#.. ..#..*..  .. .**# .*.....*##.* ..\.  ..... \.*..* .........#. . .#
# \..  ... *...\.*. ..### *..#.# # ...\*. #. ... ....**#...... .*# .. ....  ... #.# .......\. . #\.#
#. ... #   * .#.#.*.. #.#\..#. ..... .*#........# ....* ..... ..# .*. *...*. ...*....\. ..#*\....#.#
#*#....#. #..#.#*##..\. \..#  * ........*...#.. #. ...# ...... .... .. .*   #. .... .\ \... *....  #
#  . #.\......\#.... #\..* #... #  * *...*.... * ..* *..*  .*#. ...*.#..#.... .\.#. \#..#.....*..# #
#.#. .. * .# .*#.. ..#..  #.#\\.#... ........ *..*# \ ..#*##..*\.#..*....**.\. #.   # ##.#..# .*.# #
#* ...*... ........*.. *....# ..*.# . . *. .......*\ . *..   .\.* .... .. ....... \*.##.........\ .#
#.*** .*. ...#.. ...... #  ......*.......\ .. ..# ..*. .....*.*....#....#  \...*\...##. #...  \.* .#
#..... .#......\.# ....# ... \..#.\..**. * . .....\......#..*.. ..#.#...#.**#...  #. . \.. ... ...##
#.#..  .#... .. . *.. .. #\\....   ..   *....*... \.*... *.. .....*.. #\.**.*\.*.*.*.#. ##..*..\ ..#
#..\ .  ..#\.. ...  #..#.. ... ..#. .* \.\....  ##..*... ..# ..*\.\..\......\#.\.  .   .#.\. #.....#
##... ..# *........\#  . ..#  *.#.   ...*.  .##.. . .#.....#...  ** #\*.... .\ ..#*.... . .*\  *. .#
# .. .#...#* .*.. ..####....#*. . .. .. ..# *\#  #.#. .# #\.*.*..  .. *. *...... .. ....#.....*....#
# .. #\  .*.... .#... ......\#**.....* ..# ..... \*.. .*. \  . *...  \ .#... .....  ........*\ .\.##
#**...... * .. . *#  .. ..  #   ..  # .\.#..#.\.. . ....* .*.* .*. .# ... ......\#*..#*..\ ..... .*#
#.......#*.. .. .*.\.. ......*  . .*.*..#.\.**...  #.. ...*\..\.. .*.*.   . ...*..*........\#.  ...#
#.#\ .*..#*.. #... *.*  .* .#.... #.*. ..\ . * **.\... .*........#.....  . .*# #..*## .*.. .#*\... #
#.... ..*......#.\.. *.*..#.. *.#.\....\\... . . ..*..**........* ...#*#. ....#...  ..\*.. ..#\.# *#
#. \.... ... #. *... ...#.. ....** .   #.... ... ..........*..#..**..*\..#. ... ... .... .*. *. *..#
#\*.. .#...  # ..\ *.*#....#.*.. .   .  \ .\ # \#...\.*\\ \.\. ... *# \*.   .....*. #.. * ...\\....#
#*... *\R.#..## ..  *.. \.#......... ..#.*..#\..#.\.....\. \ ..* .*...  . ... .#. .#. ....... . # .#
#  #.    .. ...\.... ....  \# *....* .  ...* ... .#.. .#* .. #*   ..  *. .#. #\.........# *..*\. ..#
#.... .\.\\  ....*\ * ..*#*. .... ......#*..\#.. *#\ ...#.* .\ \\....  ...  ...* .** \... .\... ...#
#.. .. *...\\ ....** #* ....*... ...#. *.##*. ....##... ..  ..  .#.**.... ....  ... #.*... ...*...*#
##*#... *...*. #*....*. . ...\. *.. ..*.. ...#. ..#.# ..........#........  ..*.  . *. ....*.\ \*...#
# . ... .....#.  ..#. \#........#*...#.. ##*. \...#. ..\..... . \.     .*. #  **..# .*..#*. .# #..*#
##*. . #\ .  .#.*........ \.....* . .*# ...*.. #..  .  * .* *#.*#... .. ......\# .* .# ..*  . . .###
#*..* .. *..* *.#. ** \.. *#.*... *..\  .....* .*..#............ . ......  \.*. #.###. . .#...*.. *#
# #.. #*.......*.....*...*.#.*#. .*. ... .\. #..*.. \\#.* . ........ . . .. #.\ \ #\ ..........#. \#
#.. .. \. #  ...* \...\ ..** ..# ..*...*. ..#. ..  ..\\.*. .#.. . .#*\ .*. ..  **   * ##.### #. . .#
#...\... ...  ..#.#.##.*.*. ..\*...  . ..\.*#. ... . .*... *.. ....#.. .*..*...#. ......# ......*###
#.#.#. . ...\...#.#.. ...#  .\.*.....\\. .*\.  ..# ... #.#.....#..*..*...\ .*.. \...... * # .*. ...#
##.#. .     . *#**....*..*.*. ........ ...*.. #*.# .#..\.*. \.* ... .. ..\........\...#..#. *....\ #
# * .*.#....\# \ ...........  *  *# \..*#* .. \#... ..*........#.. * . .......\. ......*.#..*...*..#
# .. .. *... #....*. .  .... #  .........\*. # .*.##.\..#. ..#. .   #. .#*.#..#.**....  .. ..*.....#
#...*  #...... ...#.# ...*..*... # ....  .    ##\    *\.*.*  ... . .  *....# .#.#.#... ..#. ...\..##
#*. \#...*#..  ...\\.#*....** ...*#.*#....*..#. . . #..\# .\.*.\# ....#* \.##.... ....*... ...#... #
#*..\\*...*...#.......#.....#.\..# #. \. ..... . * ..  *..#...* ..##.....#*. ..#... ...*.#.*..*....#
#.  .....\  *  ....*......\.\*...*....#*.#. .*. #.....#.#*....*..* #. ........... .....*\.*.. .....#
# .\\#.* #.  ..#.# *. . ... .#*..#..#......* .......... ..\# #.........*# *\*..  .# ## .... \..#*..#
#.\\.#*#...........*. . ...  ** \*.#..*. .  #..*...  ..# .#.\. . ##.##.. .. #. \ #*.  .#. .......\##
#..*.\#...# \.*.*.. .  .\..#.\*.\\.... .\..... ....#.*.##.##..**.  . * #....\\*...## .....#. ......#
#.*..*.. ...  .###...#.. ....#..... *. .  .*........\....... ..\. .#..#.....  #. ... .  . ....*. .##
####################################################################################################