####################################################################################################
#. .* #..  * ... .. #. .*#\\ ..........**.#. ..*.*  .*.. * ...*.\ .\*\.......\.. ...#..#.  .#.  ...#
# #...*...   ....\. ....*.#.. #....... \...*. *. ...... \ .. .#..* #*..#.... *  .. \\... .#...#.*..#
#\ *... ..\..\. * ... ..*.#.. .***.. ..\.#. \..# .  ##\**.....#...... ...... . . . ...##..*.*#  . .#
#.. ..........#..\ #.##.\.\... .* #.....*.. *.#....#...# ....... .... .. *...* ..*\... .*...*.....\#
#.#.#..\*# ...* .#.. #..#. .*#.*. ....  #....*.... .. \.   . ..# \.  .\# * *..*.\*.*.\..#\....*#...#
#....... .. .\..\. *...#..*..\..* .*..\.# . .**..* .\.#.  .. ..## .*..#*##**....#...#... ....* ..# #
#**.  ..*#. ...*\......\..*.....*.*\..*  #.. *...*..#.  .#....\\. ...# ...# .... . ....\.. ...# \..#
#...  .. #.  .. #.....  *#.*... .*.## . .\.. #.... **....*...** ...##..  \.....#  *... . ........  #
#.. .... ...# .*.*. . . .\. .. .. \*#. ........ .\##.... ... * .*... #. #... . ..#  .*....#...*.. .#
#.\# *...  . *  ... .*.**..*.. #......  #..** .............*....#...\.. ##..#.\#. ....*...  #...*..#
#* #*#.. ... \.. **\. #. \ . . ..*....#* * \.. *#... ......*. #.. **....\. .. ..*..# . .....*.  #..#
#....#. ...**#.* .... .. ....# *..*.  . \.\...**#.\## *..#. .#\.#.. ... .#.*   .#. *.. . ...##.  ..#
##.. .. .  .#*....## .#... #..#....  .#  ...##.# *...  #..# #\#.*............ .. .. .# \ .. ...... #
#.....# .. \......*.... ......  # ##. . .*... .  ....... .... . ..... ..*.\\. .**....*  ..# *..*..\#
#. .#.......##....*. **.*.#.... . .. . ...  ..# #..##....###\ .# . . .*..**.......  ..\*.....* . ..#
#.  . ...*...#.*... .\#..#.. .. ...* ....#... . . ...... .  *....... ..#\.\. ...\..... . \... .#...#
##.....\\.#.....* *\........ ... ... *..*. ..  .. ...##....\#.#..... .#.*. ...... ..*.... .  ..\#. #
#. \.*#..  ....... .....#... .  ##.*.... .\. .\ . .#.#.#.....*.##*. .#. .  .#.. ... *..\\ #.#\##...#
#....* ..\..*.......* *.. . .\ *..#*....* *\ #.. ..  #......... ##*..\#..* ..*##... \......#.#....*#
#.# . ...**##.  ..*.. ... #.*... ... . ..\* .......  .. . # .   ...... ....#.  *. #  .. *\.. .\.*#.#
#..*.#.   . .... ....* .###.*\ *.. \... . #..*.*. .##\. #..\ .... ......##.. .*.#.** .*  . .\..#...#
##*. ...*........#..\.# ...... * ......## . .*#* **#....\. .\.. ..#.*.#.. .#.....#...*.. ..*....*.##
#\.. .*...\.# .**\..##\#. .  .\..\....#.*  * .*....#.... *.**..  .  ...\..#.* . . ....  ..*.. ...# #
##.. .#.##...****  ..#............ . ..**...\.\* ....\....\#  ..* \. . ..*....*#. *..# #..#.. .... #
# ..*......\ # * . * **. .  *....#* *.*.*#.....#.  .**. .....  .....*....#.*.# * . ....#.*. #*... .#
##  #.# *.#..#*..\#..**.#..##.. .. ..*...   ##.  .\ . *.....\.. *. .  *# .....*\.....  .##. ...* ..#
#.#...# *.....##....#*....#.*.. .. *.#.....*#.\...#* .  .  *......\....* ..*.*.#..*..* .  ....**.#.#
#**.. #.** #*.....* . ..#.\..*#. .* ... .\... *# ...#..... *##..... #...........*...\  * .... .\ ..#
#. . *........\\*. .. .*#.*.* # .\\. . ..#\..  .... ...#....*..... .*..........  *.  .  ....\..*...#
#. ..*##.*......... .  \...\. ..\#..... .*.  .....  .* . # ....**. .. #.......\..#*##.#* .#........#
#...#*..  ....*..#...* ..  .#.... . .*#**... . . #.   .*.*.*# .#.*  #...**..*##.*# \...#*.. .# ...##
# .*. . ........*. *. *..#...\..  .#.#*...\...#.....\.#.. . .. #.*.... \...*.#..#. #.#.. *#... ...##
#.... ....*\ . ***#*.\.. .  .#..*..  ...#*. .**..#*#*..*.\\..\*....*#.#*...#.... ...\.. .\.**.\.*. #
#...\*.....##... .*# ......... # .. \ ....\#....\#..... \ *....\ ..*.. .. .# .*. ....   ...  ......#
#..\...# . ##.*. ...*.... .. .....#.\.. #. * .*.#.#...#....#.....# ...*. . \. \....\. .. . *#.. ...#
# *. .#* .. *.##..  .#*\.\.\. ....#*...\ * .\*...... \#.\ *... *.*. ..*....#\....* ..  ..*.#.  .#. #
#.......#.....#.   #.*. ... ..#**.. ... ....\.......*....#. ... .. .\...\.##.. \.....\ #... .#.....#
##.. . .... .\#... ..*. ..#.*.. ..#*.... #\#.. ....#..# ... ..\ #...*...* #. ...  #.... ..# ..#...##
# .  .#........ .##. . ..**.  .#\.* #...#*   *.\. *..#..\.......  \....*#\..#.. .# ...  ......\ \..#
#....##\..\#..#*##.*. .**... \.\.*#\.........# .\ .. . ...... ..#..\.#  .#. . \.......\.. .  ... . #
#..#.#.*...*\\...\..  ###.#. ....#... .. #. .*.....   # ## ... ***.... *..... .. \ . *...\. .*#..*.#
# #. .*.\.. *.\...* .#...#\#.#..#..  ....... ... * .\..... ..*.#..#  .. .\.#  ...*...  *.. . ** . ##
#*...  *\...#...*.... #...*.#* ...*. .##*.. #.\\... ..  .\*.. ....... *.......... .......#.#*\...*.#
# .....**..\.#.  .. ..  ...\ .#. . .  .*\#. *.. .\.\#\....\ *...#...*\...#. *..***...\*#. .*\.....*#
# #...\ \. .\\..\... .*.. .\#.....\.  \........# .# #*#* ....#.. .. ...\...## .. .\....     .. ....#
#. ......  \..* . * ..# ..#*......\.....*... ....## #**....\.*..*.*  .\....... #.\#*. . .##. ....#.#
#..**.. .. .*..** ..**.  .***.. .... . .... .. .## . ..\.*. .\# .. ..# # #......*.. .....*###.....*#
#.\... #..#.........**.\*   ..*....... ...\*..  #. #*\ * .\... ##..*...#....\#.. ...#.##\.. . . *  #
#.**.......\...#\  .....\.#..#.#.*#.##.  #..*....*.. *..* .\.#...  \# ...*. *#\*##..***...#.. ...  #
#.\.#.. #...* .#.*....*......#. \.#.. .. *....\ ....# \# .. .\ .. .*. *\* *# ..\....#..#* . ...*..*#
#. .\..  ..*  .\*\. *# .\.# .*..# ... ...*.. . ..##...*.#.#*...*.... .\. ..* **\#.  \...##..#...\\.#
# *.....#.# . . .. #... ...\ ..##..# .....   **.... . #..\. ....#\ .  ..# ..#...*... .. .. ...*.####
#* #*.\....   *#....*.*\ ...*\.#....**......\..#\*..*.. ....\..#.* ...#........\  .#  ..# # .\.... #
# *.*## ..*. ...## .. .##\.  ..#..*...#*.*#*# \......# ..  .\..\#.\ ..# .....*...\.  . .\. ..*#.* .#
#.....*.#..*.. ...  \ #.\ .\*.  ..#*.\.##..## ...#...... ...\....\##*..\..  ....#\... . #..... ... #
## ..\ ...# .#...*. ..  *...*#*.. ....#.........# .. ..*...   . ... ...*.....#.*....#\\*.*#.. *.\#*#
#*..# ....* * .#.. .#\...... *...*.. ......*.  . . .* . # *..##..\*..*.\.#*.. ..*.#..*...\\#.. . .*#
#.#.**  . *\*..*.... ...*.. .*.#*    *..#...* \*#.. .....  .....* ...#. .  .  #.\..*.\ ...*.....*.*#
#..*......*. ...\..#.* *..### .# .. . .*.#.... ......*.#..#\... . #... *.. ....*..*.. \.... #... ..#
#.#...*. \*... ..  . ... .\.*.** . \\\..*#\.\*.....*\.\*....... .*.# . ...#..\. . *. .#. *.#.  . .*#
# ..........\#.*\ .#..*...   #.*.\.*.\ .##.*#. . ..*#....*..  ....*.*.. .* . ...* ...*.. ... *.*...#
# .#..#..*...*.#..  . ... #   .. #\* *... *..#..*. #.. ##. . ....**.#.. .*...##.#....#. . ##.*.. .##
#* ..#..   ..#\.. ...*.. .#... .\* ... . \\. .#.*... *.#. .... \ .. .\. \..#.#.. . . .... #...#..\.#
#.* .\ .*. #.....*.#... #..#......#.... ..#*.*. .. ##.*##\.\.  .\... ..*....# ..*#  # # ..#* ... ..#
#. .......#.  .*. \...*.....\#.......\ .*. .   \ . \ ... . ..   . . ......* # *#. \ ..#.#.. # ...\.#
# \ .....#.#. *..**.*..**#....* ...#..... . .# *.#..*.#\ ..*... **\.#..... *..*.... ..*.* ..... #..#
#. .....\...... \.... \# .#.#..  ..#.... #*..\......  \ *..#  . #......#.. *# ......#... ...    *. #
#....##.*.*.......# * ....*. .. *  ...## .......\. ..#   ... \*#. ...#  . #.*... * ... .  ##.*#. .*#
#...## ..#*.##*.*.. . ..  \##.\....   .. .#. .... #  ..*\ ...  #*#.. . ...\*...\...*.*\ ...#..\.  *#
#..#  . ..\..\........... ..#\\.... . ..* \... #.\. ###......#..  ... .\ ..*.# .. .......#....#....#
#.##*.*...# **...... # .. ..*..\..#*...\ ..    .#. #... ...... # .#.#.*  ....   .\ *\...#*..*. .*..#
#.... #*.. ...  **.#*.. ..  .*..... .. .#.. # #..#... .. ....\\.#*.  .... *.....* .... .. .. \...# #
#   ##....*. #.....\.. .\*\\# #   ...............  \......*.  ....*  .*\* ....*\ *#\..\#....  ...* #
#.\.###  . *  ........ ...#..\*.##.* ..#\#.....  ... ... ...#.* . *.# ...\#\..\... .\..*.#..* .... #
#.. *..**. ...  .  * . ..#  ... .**#.##\.*.#..  \..\.  ...#.#... ...... ..  ##. #\......#. ......*.#
#**#. *..*#. .*..#  . ## .\..**.....*....# ...#...## .. .......#.#.*.....#. *  .*.*#. ..\...#*....##
#..*.#  *..#....#.\. .#. ....#..**# . .. . # . ......#   *.. * ... ...... ... *   .....  *##....\###
# ........*.##... \.**  .. .........*..#...   .. .*.. .. .. .*.*...... .*.*.#*#. *.. ..   ..*.*\..\#
#...\.* \.* .* \..#.*. .....#.. ..\. . . #.  #.. ... ..... *....\***... #.#. ...#\..#\.*\.. ....*. #
#..  **.. . .#.\#...    ... ....\\\* .# ..  .#.#....... #....  ...# *. ...\..\..###.....#\.##. ...##
#\.**. *. . . #..\***. #..#..  ..#..* ..*#.*\  .. ..#....#.. .#... ..#.. ....#*.#.. # #.. ... ...#.#
# ........ ..\#.. ..#\...#  ... ...  #*......\*.  . ..*.*...#. \  ..#.  .  ....***. ....*\...... ..#
#..\.... ...*\ * # ...* . ...**  .. **....#..#..  .\...... ....  . . .\#....# .\.. .. .#.....  * ..#
#* \ *.. # ....# .*..*\#.. *.#* \.. . # .#..  . . # .#... ....#*.. . .*..#.#..##\# #...# . \. .. ..#
#. *.......*. ..#...\\... .\#..*  #...# #.......* \... \*. #..#. ..*.... .#...\*...# ..* .#. .*....#
# .#.*..... . . .*. *....\.*.. ...\.. ....# .......*.. . . *.  \......### .**... .##* #........*..\#
#......#.. .....*..\. .. \#*....* .. .....\  .... ...## ..#.#......  ..\....\.#. *. ##......*.#*.#.#
#. .#...... .. #... .*...#....... .# .\ ...* *.*...\... .*...*........# * *.# ..#... \.#... .....\*#
#.... ..*.. .... ..# ..  *..#....   .\.....#...#.....#......#. #... .#\  \... ......\.*  .   . ..* #
# .............. ...*.\... *....#.*#.#. . ... #..  .. .# .. ....  ........ .. \#..... ...   .**. #*#
#. ...#. .. ..\.. .  .. ....... ..   ##... .*.. .*#\....   ..##*. .\*# *#\#.. .....#..#***. .......#
#. .*.... #*... ##..... \\.\.\..#.....*...... .*.#. ....*\.... #..  *.# \ * .*....#.. .. .*... *.. #
#...*...\ \..*#...... ..*  *.#...#*..#  .\ .*...*...*. .\.... *. *......\..#\\.\*.*.#. #....\..#. .#
# *.\....#. . .* .**. *...*\..*.#..\ ....\.. \...#. .\...\ ..... \...\... ...\.. ..... .\....#.. .*#
# ..#..*..#.*#.* . #.*.*.*  ..#.#  ......\*....**.*..*...** *........**....#... ..**R.. .#. ... ...#
#\\# ......... .*. #\. #*...*\*#.......\ #...#.  .. ..\.\.\.. #.....*.... .  *.*\#...... *.. ...#\ #
#.## .**   ..........\#.....* *.#* .#...*.. #. .# ... ....# ..# ....*...#.\ *\*.#..#.#......#......#
#  .* .\... .....   *#*.# . ...*..\   *  .... .*..*...# \..*.. *\...#.... .*  ..#..  ..  .#. .. *.*#
###########################################################L########################################