############################################################################################L#######
#*\. ##..#. #..\#..   . L ...#......# .*\..\..\..# #  ...*...#*..\**#.*..*...# *.\... #. .#. .. *..#
##..*.  #* ## ..\#..*..* .. #..#...*..*#..*\....  **\\\\ .....#..#...##... # \..\# .#...#.. ##..#. #
### *** ..*#*..\.\.\*..* .\.#*#.####...#...*. . *#\.. ..##....\...#*#\**..*.*\*\#..........*..#..\\#
#.....**\#.. .\..\.#.*..##*\.*.* . *\#  .  #.#*........ ...\.. ..**#. .#*#\*..*#...\........ .#\.*##
#*. #.... ..*..\#. .\\.... #.##... ..#.\.. #*.  #.. *.***....**.*.*.\.**.\*##.*..\#.* \\. ..... *..#
#\.\...*..#.**.#.\.  .... \*.*\.\\\*# .# \ .    .#..\...**..  *. ... ..\*.**#.. *..*.\# ....#..*.*.#
#.#.# ...#.#*.*...#.. #. #.... . ..###LL... .##..#.*.#\.#..#.#..#...**##...# *#\ # *  .#...L\..#*..#
#..*###. .L#.\.. *...*..*   ..* *#.....*#...*.\ \.*.. ..*\ .##**...\#.....# *.*#.\ .*.......#*#..###
#.#*...L#.. ........\.\***.#*.*...... .*.#L# . .**..*#\.#\*.* #\ ###..... * \.*#L. ...\..\..#*.\.*.#
#.\*.\\\#*.* #.. *#\..*#*.\. .*.##. *..*..*...#*.#\*.*.###**.  \.#.#*..##LLL.. ... ..* #...** \ ...#
#...#..\. .#.#.#\ ..... ..#..L ...#\#..# *.#*L...*...#..  *.#\..  \. #*..\.*#.......... ...* .. ...#
#..##..##.*.......L...\*.**...... *.. .**.  .#.*#*\..*#..# #. *..#*.... \....L L..*....*# ..##..\. #
#... *..*..*..#.#..*. #*.\*.*.*\.#... *##.*.#*.#\.*..*.#.#..*\.#..\\\*.... \ .##..*.*.......... *.\#
#. \..*.#..#.\#*.\. #.#\.\#.#..*... ..# \ #*..##....#*.*\*#..#*.*.  .*# .*.#. .....#*\#.*... *.#.. #
#*..#..*. .* #* .#.* ... . #* ..#..##. ...\\#*...... *.*....\*. *. ..*.*..#. \# ...*..#*\.# ...##.##
# *#**....#  ...L#*#.*.....\.\#**. ..#....#. \.. #.\.*#. ...*.#...*. .\.*#..\** .. ..# ..*#..#.*. ##
#.* #......#...#.#.##.* ...#. \ #...\# ...# .*#.\...#.* ...*..**..*.... #\###. ..#*.. . ##\.. .. \ #
#..#.*.#......**. ....\. . *.#.\\..#L#.....*# ###.#..  .*...#*...\#.\.*....\ *.*#L...# ...#.....\*.#
# . *....\*\..\.**#....#\*.....\#.\..**. .*. .#.....#...\.. .*.#... * ..*.#*..\ \  .*...#.. ...*.\.#
#.#.\.\\.#.\* \.#. .. #.#*.*.. . *...\*  *......\##..\**..\... *...*...#**  .*..\..\....\....*.. \##
#.##  #.#..*.........#.... .*#.. ....#. *#*#\ . .#.*#* .#. ......#..## .... *..#*\....##.*.*#  .####
#.. *....# \. \L#\  .\..*.#*. #....... *...**   * #\.. #.#.\*..#..... *#...#.#...L.  **...**.\*..*.#
#.*.*##..*..##.*#*L . .... * ... .*.\.. . .#...*.##*. ....# \*#L#.* ## *.#..\#.#\#**.*.*\*..#\.*...#
#.*#\.* * .....#...*.#..*..#..*#*.#*#*.#...**...*#*.#.# .\. ##.\.*.....*#..#**.L..   L.# #..#\ *. ##
#.. #\.*.  .\.* \.......*#... .#*.#  ....#*.**#.....*..# ..#. ...\.......#.... . ..#...#\\#.#  .. *#
## . \..*....*#*.#. .\*. #.\.*.#.  ..* .**\**.#.####..\# .\# #. *... . * * L.#.*\##. .\ ## # .*###*#
#*# #..#...L.*.*\...\.*.*\  \ ## .#...... #......*.*.... #......** .....  ....*#.*.#**\.*# ..#.# .\#
#. # # # .#. ...#....#....*...*.. #\......#.*\# \* . . \.. ....*. ..##..*#\##...\..*L\ .. ..*.#\*..#
##...#. .. ... *.#.... .##\ . ...*\.# # **##...#.##..*.....*#..#\. #. *... ....#...\#L. ...* .#....#
#.*. *.**L *.*#...#**\#\.. .#.#.... .*  #*..#*...*..*.#..#..*.\*\ .*. .......#...#.\#..#.#.\#* .#.*#
#.#... *.#..\.*. #...*.#..**..#.**#*.\*#.*.#. .##.* .#*.... ##..#.#.* . . ... .*. ..# **..#.#..*\\\#
###..*...L#.# .....#.. . ........ ..\..*...#\......* ......##*\ . *#.........  ...* . # .**.# **..*#
#*..  *.\.*  *#..  #.*.\. .*\. .L#..#.*.#..#...*\.#*.* ..L.# \.   ....\*.###.#L*\ ... **\.\**...#..#
#...**....... ....## .....* .#...#\.# .......##..#.*#. *.*#..# *.*..\#**..#.*.##. **..# #.*.L  ..#.#
#.*\.*..*...#..#.. \. .*.*..*\* ..##.#..\. #*..  .#.  ..\**  .*.*#..*#..\... .*..#.....##*. \.#\*.##
## . #*  \\.... ..#. #.##*......*.. ..#*.#.#\. *\ ....#.#....*\#* .L.\*** .\*.*.#L#*...*#.. *\.*.*##
#.#\.\ .... *. # . . *..#..\..#*\*.L*#\ **. *#*.\# ..#* *.*\* \..#\*#.* \..*.. #..#.#.....#.\.... .#
#..\*.#.\.##...*...  .#..*#.*... ###*#.##.*..##.\*.**#.. ..  \.# *. #..... ...\. ###..*.#.#..*.\\..#
#.**.* #. ..#* #.# .. .....\#*\ .*....... .*.*.# #**...#. *# \..*\...# \ *#........ .#*. *.#.#\....#
#.\.*..*..#.. #\**\L#.\..#.. .  \*.###.*.. * ..   .# .*.. .*.*\..** .*\*.*\.#..\*.\...#*.... ......#
#*.**.. *.#.*##....#. ......#....#.#L *..*.. ....#...\.  \.... . . *.*...# #*#\*..\...*.....##...*.#
#*L#.\.**..#..... ...*#.*.** ### .\#.\ .*.#\.. ..\. .. ..*.#......*##\.#.\. .#..#...*..#\..*\..\.*.#
##*..*.#.......# ..##..*...\  ......**.#\..#\...* #..\..#.###.\#\.. .*#*.#\.##.# \... #*.**....#...#
# #\##..\*. . ..\** \#.. # ..\**.\#.  #.*...*... ..*#..*.#.\....# ..#...\. ...#.#.#......\..#*##...#
#...\.L*  ...*..\.. #.. . .....##\.\\ .*#.#* .#**....#*.....*.\*.***.#.#.\*#\#...#.\L*.*##  *...#L.#
#....\...*.  \* .#... ..\\..* . ....\...##..#.*...#..\. ##....... ...# *.*\#...#  . **#.#...#\..\.##
#.\.. ........ . ####\L#...# *.\#.\.*##\#.*. #..*#.....*#. \...  ...# \.\#.**\.. ..\.   *.\..\...*.#
#.* *..*# #.\.*..*#  ##. .. \*..  .. **.##..*.. .\ . .#..##*# \..#*..#....... . ..... ... #\..##*.*#
##.\..*#** .....* ....#..  .\\*.#....\*...\.\  #.*. .#. ...#L....###.#..... #*..##.# L.....#*## .*##
#.#\ *.. ..# * ..L..#.\ *.\..* #.. .*.**...**....**....#...##.*.#.. #.*.*.#* ...#..**...\..#..# .\*#
#* ..## *#.*.   .\*# .   .#\## ..   .#*.#*.\...*.**#.#.. *.#*....#. .#.#..  .#.#**.#...\\...*..*\\.#
#*\\. .#*...#.....*# .... ... **..*..\. #**#*.*##.....*. ..* \ #.*...# ..#***.#...*# .L....\..##*.L#
#...#*. . ...  .#.\.# .#*.*...*.\*..#... ..#*\..*..\.#..#..###*\*...*.. **.\#. .#...#.#.*..*\..*.\##
#*..*##....*#.L** . . *#....* *..\.#.** .. .. . #. .#L*..*#..*.#.\ ###\  #..##..#..... .\  #..*. ..#
# \.#.*..\..*##. ....#*  #...\......#.#......# *\##. ....\.**.....\..#\.**.......* # ...#...\*.**.*#
#..*..****........ L.. .*.*.*\..#.*..\.  .. # #.\.*#....*.*#.*... ..\*#*...##. ....*#\#..*\**.. .#*#
# \ .* .***.*... ....**#.#.*..# ..**.###.. #*## .#.*\. #*..  *....  \.\\R\*.......##...#...#\\\**..#
#..*.. ....*.#..L.*.#*.......... \ *.#.#*.#..*#.* *.\.\ .*#. .L*.  ..*\......*L*.*#... .. *** .#.###
#..*#... .##\ ##... .\*. ...*.L\#*..#*.*. # #\  .*#.  .**. ..*#..##\* . .# ##...#*. ...*L* **.####.#
#.. #.#..*.# ....#.LL.# ..**.........##\ ..# ##.. ## . #.# ..#.##.\#.# *#*\**\..* . . *..#*..#  .###
#. *. .*. .*. ..\#*..#.\ *.*.# #....#. ..\...*..\##.\.....*.#.* .#.*#......*\..#.#*#.....*.#.....*.#
#.....\ \\*#.. #. #.*\.*.*.\*.*L# # \.#..#..#..**.*...*# * .....**.\.\. #.    \..*\#.*..\.*#**.....#
# *....#*\....#..#....... ..*.*. *#..#**..\.#.#.# * .**.*#..#**#...* \*.*.#.. ..\*\ ..*#....\.\..#L#
# . .#.... ....  *#...###*# ...#.... .\.. ... *....\...##*.*.##. ...\.#*. #...#....#*..#. .......*.#
#  ...#.#\.... ..*..##.  .\*.  *.#....##..\#.*.\..# ..##### .. .*# .* .....#  #.  .. .. #\ ##...#..#
#..... .....*\*\#...#.*#.. .#.*. ..*.\..#\... .\.....#.*..##*#.*# . ..*..*... *# . ...\....... ...*#
#. .\##. ......#..* .#*\#..... ..**  L. .\...\  \# *..##*#\.\..\..\.# .....#.\....#. #.**# #. . *#\#
# .L... \.\***..*..*.##\.. *  ##***\.. * \*\ .#. ....... . #.\* .#.#*..**..#. *.. *\\*\. ...**\   .#
# #*.##*\.*#*.*.#. ..*..*\.# #* . #  #..#\#*#. ..#*#\\.. . ##L***... .. #..\#*#.L*.*.\\ . . ... #..#
#.*....*.*.*..*.*.#....#. .**...# .#*. . \...##....#.#*..#.\..#*.*.#.. L...### *..* .. *.*.. ...#\*#
#...#..# .\ ....\.\ .*#...\. \.* .*...#..  .\\..... .. ......\# ...##.  *#*.\*..#. ...#..*.. .*\ ..#
#. #...#.#. *...##.*#..**  ..##.  .\ \ .. ..*..##\...#**.*..#. .#..*\.#.\....*##*.#*. . .#.**# ...\#
#.#..#. \. ...#.....*.# *#\..\#.* ..# .*. .....#.**#*##.......#..##\#. \.#*.. ... \.***#*# . ##\...#
###. #*\*. #.#. ..*. .....  ..*..**#.#.* .\\.....*..  .* ..\#..*.  ...*..# #... ##.#L #*.... .#...*#
# \#..#.##..#.\.#*... ..  ....#  *  ..L#..\#.* *##*...*..*. **. *\...#..*\**\.. \\.*.###.#\ .*.#.* #
#..# .\..\ *.# .\#....L..... .**.#**........#.\#.L  .* *....#...#.*...#\. \.* #.*#*#*.*\\*. \#.#...#
#...\* ....#..\ .\....#..# .. *\*......\.* \#*.#..*#.#.*#...*\...#.*#.#...  **..*\.\.. . .#.*\\.#..#
#\ \#**#*\..  ##.*.**#..*#\.....*.#. ..#* .#.... . ..*.##..#*....*\..*..*....* ..... .*.* ... *..#.#
#.*. .... \\##*.#*..##...#..#\#*\........#L#. .*....##**#. .....*#..*\.......#. #.\.##... .......###
#..L#**....*. #\ \#.#.**.*.*..* .*L*.#... \...  *.. \..*#...#. \*.*.   . \..*#.L*...*.*# .*. *. ..*#
##*#.....*.*..#.**. . .. .\**\ L#. ...\.#...##. ##..L..#. *## ##..... #.. *..*#....##.*.##..*... ..#
# *...# ..*.\*.\..... *#.. *#* #* ...#.#\## *\.*. **.##..... ..#\.....\ .. .*. ..*.*#*.\. *\.* ....#
# *..*. **.* ..**...\ .*.#..*..*..*.\....#..*...\\.#..# .\. \.###.*\.*.* .*.**. ..\*.#..*. ...* . .#
# \ \#.**..\.#.*.\*..#..*#.*....#...*......... ***. .##\.\ ...*#  . .**#..*..\***..\#. .....\..#.###
#* \. ..*... ...*.*\.#  \.*..*\.##.*.#.**.*.*.\.....\\ .*.   . .** *.\ #. *#.#....*.. .... * ....L##
##L #*.#.. .*#*#.##\..#*..*\#.#\. #.#.#.*...*\.*#.# .# .#.#.#.*## .\... .*.# ...*.#L. *# . . # .## #
#...\. .* ..* ...# .  ..\.# *.*..*...\..## ..\..# ###.  *##.##*.. ..* \....#*L # ..\.... .#.*.* . ##
#*\ \.#..**\\. ...**\.*#*. ..#\. ..\.*.#...\......*..#.\.. #.#.*L.L. ..*..####.... . \.#.... ..*. .#
#.#*.. *.#\.....   * ....#* *\#* .*#..* \*#...#\ .. ..  ...#*. .\.\*..##.#.\#...*.......\* ..#*....#
#*.#.##*.#..*#.#\# . .#..#. ..#.*..  #.\ ..#...*. *..*.##..#... *.#.\*# .#..#.#......... ... ..#.\ #
#..**\.\.#**..**.......##.... ..\#..*..* #.# .*..\\ . \  *....#..* . ..L..* #. ..#...  \\.....#..\##
#*.# **..\.\# ....#. .... #.*.#\.##..L......#L. ..\. *.\*.. *   ..## .#....#  .#..*#..*......  #...#
##.\#.\.   *#*##**\#. #\#.#\#.#...L .#.. #.. . .*.#..#..... \.* .# #\#...L.L.#**# *...#.##...#\##..#
#*.. ##.\ .# .....#.\# #\L.#.#.\.*.\#..\#\#L\.# .*#.\L#.#**....*.  #.. ...#*.\\  \... #.... *..#..##
##.#\..#*... \..#.*L ...#...*....* *.\# . ..*..*.. .....*#\.* .\.#.  . ... ..  .#..#*#..*.* . #.  .#
#. .*...\\*..*...*#\ *##.*.#.*...#..#..* ..*  ...\..#...\.  ..##*....*#.*.*..*.*...#\.# *#. .#.#*.##
#....*##. #. .\.*...#..*\ .#*###\#.\*..**\ # ...# ..*..##*.*.*. # **..*  **#..*.#.*..\#.#\.##*.**.*#
#*\.L...*.. . .#..*.#..*.**.. \ \..#...#....#.#..# ##*.#*\.#.*.*. #..... #.***......#.*\.#..*.*\#.##
####################################################################################################