####################################################################################################
#*  ...#.#...* ....#. #\.# ..... .\...*.....* .. *..*. ... ..#..#. #. .  #..#....*. ... .*....*.. .#
#.#..*... ..*\ ......  .#*. .*......*. **..\. * .. ..... .\.....#. .#.\ .......*.#.#*\##\* \. .. . #
#.  ..#.\  ...\\##*.**.*.. ..#.\. ... .. *.\ *.. ...#.. ..*....#..  # *.\. ........... # *.* ... \ #
# *....#.* \#..* .. ....* .\# *.\\... . .. *..#\.\  .....*.  . ..*..#. #.*\.. .....*.....*\.... .**#
#   . #  ..#\ *.....*  * .  .... *.*.....#...\.  . ..*. . ..* . .# *  .*  ..  .. ...* .. #\#*.*....#
#*\..\ \* .. *  .  .. .. *..#..  ..*.*.. ..*.  .##.\*#*.#....* \....*.#....\.* . .\ ...  *\ . ...#*#
#*.. . ..*... .*. ..  ...#....#... .. .*....  ......\.##*....##..#.* ..... ...#..  *.#..\* ..\.  *.#
# . #..#.....\. #..  .\ .\. #*.#..#..... .. .\.... *... .#. .*#..*..#..\.*#. .*...#*#.*#. ..\*#. ..#
# . ..  .\*. #...   \....#...*.. * .*#..  . ..   #  ...*...*..*..*. ....##...\..#.\. . ..\. .......#
#.... .  .. .\.#......... ..\\#..#  ....*   ..\. . #........##..#.  ....#..# #.. ... # ..*#  .. ..##
#\#...  #.. ..#\.....#.*\...*. .   .##*#...\#.#.. .#*.. . .#\.#.\*. .\. .*... .\*\  .# . . ..*.*.. #
#.. \ .... #\.. ..# #*. *. .\.*.#* ....#....**....\..*. *#*\.. *. . .*..  * .. ..\ ......#*..### ..#
#. .. ........ . . \.*..\ #..\... .*. .......# . * \..*...\ ... .#   . .\..\ .#. .... *.  ... .    #
#*. *\ .*.  * #.#..*...... # .  .... .. ... .  .##* *#....## ..#......*.#. .* ...\#\. ... #.  *..#.#
#.#.. . #...*....# ..#..*. \#....*. .....* .....# ..  . #.... .#.#..*......* #..  .....\...  ..#*\.#
# . .#  ..  ..  .....#.. *...#*..\  ... ... .\.  .. ..  . .....#...\#..# ..#    ..#\ .....#*# . .. #
#.**.\. ... .#\....# #\..... \..  * . .   #*...  .\.# ..*..*\#..#... ..... \ #.*.\ . ...#...  ..*..#
#. \ .. ... #.\.....  *. #..... **.\ .. . . ... ..#....##.. ...*  *...*......  *.\. #...\.. # .  ..#
# .\... ....#\ .#...... \\ ..... ..\#.....\#.# ....* .. *. .#.#.... .* *...... ...#.... .#.  ....#.#
##...*.......* *....#...#*.*.*. ** ..#.... \ .. .  ...#..#*....\ .   . .**...*..#.# .#....\###.....#
#\.  .. .**....*.\.. ..\##.. ...*\.... ..*...#.. ..* .. .#....*..#...#.. .. . .#*...\...#.#.*..#...#
#\*.\ .*...R*.  ..**#. \. .*.*.*... ..#.... ..\  ....#. . . .. ..# ..... .*. #*.......  .. *.*...*.#
#* #..#   \#... . ... .  \.#..\..*.#.....#... ...#. #...  .. .\..#.  ..##..#......\... .#    * ....#
#*.. *... #.. ... ....* .#...\* *. .*.#...\ .#.  .*..*.*.*... . *..  ....\.**.** .. #.   #*..*\. .\#
# #.*.\..... .  .#....... .\* *. \....*\  ....*.  .. ....#. ... *.#*.. ..#.....#\*. ... *..** .. ..#
# ..\# . .. .# #. # ....  *\*.#.##* .  ..#..*.*#  .. #  ....#....*...#...#..*...... ##*## \#\ .#.#.#
#  . .. ........  *..  *...#..... ## .......##.* ..\..#..#. #.#\\......* ....*. ##.  . #....#..\* .#
#*.  * .  .#.. .*.. *  .\.#**. *...###.#  .*. .  ..*.....#..\.#*.. ...   ..#.* ..*.. ...#...#...* .#
#  .# ...  ....#.. ......* . . . #..# #\.#.#. . **.. ....\ .#.. ..*. ....\....#.## .*........... #.#
# .... .#.. .\.*....*.....*...\ .*...* ... . ..  ..\\.. . .#..* ...#.. . .\*.\......#*...*......*\.#
#..*.*...*.  . *.   \..* ....*  *.... .....*#...#\ ....*.... .#..# ....  .  \ .  # # ..#\#...   .  #
#.*..*.  . *.#.\.. ....* *. #*....   ...... #. .   \#..#.\ ..*..**..\...... .. .....#.#.*\\.\  .\.##
# .....#.*..#... \.  ....#.#\. # .......*.. #.*. ....*......\. ..  .. ..**..... ...  .\....... **.*#
# ...*# .... \\* #   .... **..*.. ..*#* .. .......... .. ....#...  ..   .#... # .#..\.#... .*. ...\#
#  *#.\...\..#*..##..#.....#..**.... .. ....\. .... #.. ..... . *... ...#  ... .\..*..  .*.\.# ...\#
#....\.  ...... . ....#....#*...#* #.*#...   .#*.... .\  ..  . ..*. ....#... ....##\.. **...... .. #
#.\... ..........#.#. .# .*..\.... ..#. #.. .\.........#...**\. *... .\...#.# ..........\.*... .#..#
#..*..#..\\*.* .##..#.#...\... \. .#..*.. .\ .\.  #.. ....  *#.....*. #.\...  *\.* *. . ... \. *..*#
#.*. . .... **..... .#.... ## #.\.  *..\.#. .*.... .* **. .. .\. *....* * .* \##*.* ** .. *...\..* #
#........ \ ..\... *.. ..#.#..*.......\..  . ..\* .*#..#......    #  ..# .*\*  ** .*.#..#...*..* *.#
#*..  ..# ## \.# ...\.*.**.*.. .....*..\...#..#.......#\#... #.....#. ..#... *....\. .#....#\..... #
#.#**...#  ## .   .#.# \   .. ...  \..*#.. .. \**.. * . \##....  ....#.\...#.. . .. .*.#. *...  #..#
#..*#. ... .\##... .\ .*..\ #.... *#*.\. . .....#.#..  *\ .*.\#*#...*   #\.*..\.*\. *#*...#....#.\.#
#...\. .. . *....#. ... .. .#.. .*.  ..\.......*...\..** ..\\.#*...#...\....##....#. ..*.\...*.#...#
#...... .   ..#*#...  ...*#...\.#.\...  *...\ ...#*\#*..*..#  #. .# ..**...*.#\..*..*. ...##.....\.#
#..#.#* ..   .*#.*..#\.\.#.....*\#.  .. \\  . #..*.. .###... . .....#\*  .*.#  ...  .  . ......#...#
#..#*\.#. # .  ##....#*........ .... . .*#..*# *...* *.   ..*..*..* .... . \ #......* ....\*#..# *.#
#....#\.. *....  .#..... .. ...  ... .#.* ..* ..*\.###.  .*#......##.#  .. ... \ .## ...**#.* ..*. #
#*  ..  .\ ..\..##.. *..#..  ..**. .*.*# .....#..# .#... \\..*   #....  ## ...#........... ** ..# .#
# . . \#  ..#**...#. #....#.**#. .. #......*.#..##.... *.....#\ ...#\  .... ..#.# ...... ..#.*#\ .##
#.#.*#..\\* .. .*....*...  ..... .*\#..#  *....* .  #..#.\  .*......#..*.... . .\.. # . . .....##.##
# .#.* ....#... ...*.*..  .\ ..*.....*.  *.* ......* ..*  . . ... .\. *....#. .....\.. ........... #
#.....\* ......##. ..*..  ..... *. .. \* ....\ * ..#.....  *  .....  ...#........#.#...*# \. *.... #
# .... . #.\.\ . ..... #..  .. ** .#\..*  * .\. .. ..*.##......... #........ .* ..##  .#.. . ..   \#
#*\....* .. ...# *..... .  ..*\.........#. . .  #*..\ ... .. \. ...  ...###....**.*.\.... .. . . *.#
#...#.# .#. #\..#. .*.. *...#..*. ....... \. .. . *...#. *.\....... ....* .\**...#*# ..##  * ##.. *#
##.# #... *. ..\.#..\*..... ..#....\*... \..*...###. . ..........#.. \..\\#..#*..*#*.  ...  .. .#. #
#*\..  *.\... .. ..*\...... .*. . *..#.*#.... *. . \*\#.... ..   #.\..# ... .#*.#. .... . \   .#.*.#
#. .. . ..\#**#. *#.\\ .. ...\#\ .*.  \. .  . . *.\ ..\* #.#..... ..#. .. #.# ....#  . * \ .*#..  *#
#..\#.\.**##. ....  ....  \ \.\.  ... #.....*#..... ... ..\.. .#.\.* . ##*#. \ . ..#** . #. #  .  .#
# .  #** ..\ ..*#..# .. .....*.\..#..#* *. ..#........  ..  ..*#.. . \\.\#.. . \.#*\.##...... .* ..#
#..# #...#..*. #.# .  ... .......*#\..*  ..  .#.#.\#*.. . .**. \#*..\. ... ...* .. *\**..  . # \ ..#
##...#..... .\   . .... .*... #.*.#  ...#.......#.... \.* #..*  ..  .  ..* ..\.*# *.# .* .\.. .. .*#
#..\..#*..#  .. .  .*.#..\.. . .**#.... \\* \ #  .......* ... . #..#... . **.#....#.# ..... . .#.. #
# #.. ..... ....\*.*. ..*..  ......  ..#. ..#... .... ...***\*\\ .#*#..*. *....*  *.*#..  .**. \.  #
#.*..*.  ......# ##. .*.*....#*......#.....*** .*.*... . ***# ...**.   ....\..* . #... .. .\ *... .#
#.#  . #.*...\...#.#\.... *.....* ....*.\*#....*\..#..  ..  ...... **\. ..\*....\ ..*.. .*...*..\.##
#.... *\##...... . ...\.....**...#. **# .  ..*#... ..***......#.**\#\.*#\ ..  .. .*.#. ....*....  ##
#.#.*...*. .# \\.. .. .. \ *.# .\.*.*# * ... . ... . .. #.#\ . .**... .. *.** .*.. ..#..*\ ......*.L
#. #.#. .\*#... *.. * .**..#.*##... ....#... *... ..  .*.#*##...\.* .  .*  . #. ..* .......#.. \*..#
#... ..#. *  *. ...\... *.............. *... * #*... ....  .....#*...\...\#...\#\.* *.*..\....*..*.#
#.*. .  ..* ...#..# .....  * ##* *.*...##.... *...\  ##....*..* .*.. \*. .#. # .#....*\....*#.#*...#
##.....*. *..*.*\.....*  .  ** * ...\. \..........*\.#*\.\##..#\...\...  #..#..##....\.*...\ ...####
#.\*#.\..#. .. ..... ..... \.. ...  #....*  \....*.....*......\ .\. **#.  *... . ..... . ....#...\.#
#.. .\.#........... .*...#.#.#..#..#.#..  \..#.*... .. .*...*# ...#*.*.***. .....#*....... .... . .#
# *.\.........#.. ...... ... .. . ....#.... #*# .. # ##..#.. . \.\#    . . *.*..  # # #*.. .# \. ..#
##.\*.. .\*.*.*... . \ #\...* ..\....\.#\.......\...#..##*...\* . ... *. .*.# ....  ..#..#.\..\..*.#
#* *#* ... \. ...  .*..... ...*.*# .......\...\ \#..*. .. .. ..... ...# .  ...*.  ... *...  *. ..  #
#. \.. . ..#..#.# *.   #\. .*#.\*....*.....#   ...# . .... .......\# *.... .*#...# .. *#.#  *.*. . #
#.#.#.... \ #... .. * . .. .....  #...  *.##..... ..\#*.#. ..\ *....  .. ..\ ##.*.*.#.*.##.#.# . ..#
#\ ..* ..\. ......#.#  #.#\##......*\...* . . . ..*....\.#...# #. #  .*... .. .\#.*..#....#..... #.#
#*......*.\#..#.. . \.....\..## *....#..\#.*.*..*.  .#... ......\*  . ..**. .....  *# ...*. ..#.#..#
# ***.*.*..... #   #. ** \*............#......... # *#.....\ ..\ .\\ . *. #...\..*#* ***.# ... ....#
#\ .## \ .....*. .\ #.*..#.....*##\..*......## * .. . ..#. *.*\... #. ....#.. * . #. .... *# #\ ...#
#.*#..#.*...#.* #. #..\\ .......  .\#.....*...  ..*...*...\#.# .. .  .## .*..*#...... .. \ **... . #
##.  . .. # ##*  ...  #... .....  ..\.... .  .  . *..  . .*#.  .*.*.... ..*...  # .\.#.  .#.#..#.. #
# .*..#. *    .#..* .**.*##.. .....   * ....*. .#  ... .*...*. . \.*\\\..# .. ...# .....#.. ..* . \#
#.**. ...\ ..  ....# \...*. ...# ....*.  ....**\.#.. \. .#*. .. .**.\\ #. .. * .*  # .*. ...\......#
#\.#. **.\*.* . * #..**..* ##.**. **   #\ \. ...*\...#. . ...... ...#**.. . .\.*. **........#.. ...#
#.*..   .\.  ***..# .#.#....* . ...# #.#.#. ..\.*\.\..#. *.. ..#..#.**..\..........\  . .  ........#
#.. ##* \.  .\#...... *... ...* .*.  ##. . ...*#.#. ......  .....#. #.....\...# #..#..\#..##... *..#
#.#..  ..\*... # *.  #..* ..## . .#.#*.# \.....#* ....\. *###*.. .. .#.. .. ... .....\...** .*...*.#
#* ..**.\.*\.....**...* * .. ..##...  .#. ...  \. \... .. *.... .....\. #..\*\ .  .. *.*\  ..\.. #.#
#.. .*... # #..##*....#\.\.. ###.*.... *.*...#*... . .* .*.#.. .##.#.....  ..#. *....##  .. . \*#*.#
####.... .#\..\....... . .\.*...........#... .\*..#..*..# #. ..# ..    . ....##.....# *..*..   #*..#
# .......##..#. .....# *. .**. .. *  . **..*\\ .#. *....##. ....#.*# .. # .  **. ..* .#.## #.# *#..#
#.. \..\... ...##.... ..*  ......#...... .##....#*. ...# .##. ..#....... . * .... ........*.\#..*..#
#... \.* ... ....#.#. ..# .......#.. .\#.....#.#.\..\.....\......\*.#..#\. \#  .  .....  .. .....  #
####################################################################################################