####################################################################################################
#.#..# *...* * ..\. . ...\.. ..**.##. .*..#...  *\.#...\  *.\. #\.#..## .. \..#....\..... .\...** ##
#.\.# . .\...*.#..*.#. *.#....*. . ** ..#\....#  .. .....# .. ..* ..... #. .#.*..\.. .. . # *.*. *.#
# .*.. #*..*. *..\.*\......## ....**..*#*... ....#.##..... . ..# .. *. ## .... .*...  ..#  *... #.##
#.. .*........\. .*.####.... # * ..... *.\\ .  ...*  ....#.*... .... .  .*#.\##.. ..\#\.# .....*.#.#
# ..... .. .\\..\#..*...*  #.. .....##*..*. ...  #.\\.....*.*.........  ##\.#. ....# ..#.*.. . ....#
#*. #... .*.*... ..#..... .. \ #\# ....#. #..**\*..... .........**.    \..\.# .......#....*.  ... \#
# . . ........\#. \*.#.*.\...  \\ *.. .....  .. .#   .# .*\...**.\**.  ....\..\.\.. ..\..\* . ...  #
#. .. .#. *.. #\.#..#*.#..**..  . ..*... .    .\......\# \... .  .#.. . .. .... ## ...\.\.*.......##
# ..*.#.\....*. .... ..\\.#.. *.\# .....#  ..*..*#..#.. .....#.*.#.*.....***..\ ..... \..*  .##.#..#
#.. .# .   ...... ..*.....*##.**# # . *\ .  . #*.. .. ...# *..# .  ... ..  .# .\**.. .#............#
#.....*#*..... #..#..# ..    ..# \...  .....*..#  \.#*  #...*.#.. . ......  *.##\.#*..*.*..*.# ....#
#....*.....*.. *.. .. .#.*.#..\  ... . .\.#...\ .  ....... .#..#.. . #..*\.... * ....  .#...  ...  #
###. *.#  *.\...# . .  .*#   ..#\ .....*... .. ...\.....\...# #....*.. . \. ..  ......* . .. ....\.#
##.* .\...#.. \....#. ..............*. ...*.. .## .  ..*.#.....\..\ ... ......... #*..*. #.\ *..*.##
#..**. ...\..#**.\ .*  .\ ..*.\##.*\..*.\  *. *.   . #....  .....\. ..\.*.## ...  .##.*#...*.... \.#
#  .*. \ \...* *........ .*. . .....  ...#..*#*.....#.... #. . .*\.*. ...#.  ....*  ..#   ..*. \...#
#.... #...#.  # ###....#\...... .... .\ *..**.....\..*   \.....  ...\ *.....* .....#.. #.....*.#...#
# ..# .*#.**#*....  ..      ... \*#...*  .*..#.....#. #... .... .. .. \*.*#...  .  .... .... ## .\*#
#..#  ....\....*.. . *.  .* .. .*\.* ....#...***.... *.........*.* *# . .*..  *..\.#...#...#. .....#
#......\.. ..# .. .#. ..\...*. ....\...  ... #. # .. . ..  .*# # ..#.# ........\ .. .....*.........#
#.....  .* *. .. #..**. ....#   . \ ......#.#....#...#.##.\...*.#*. ... ..  .#.# #. ....# . . ...#.#
#.. #....# .*.*.. ...#  #. .*...**. #.*..#.# ..... .\.*.*\  .#.. .*...#\#...# \ .. *..#. .. #..\...#
##.  .....#. ..#.\...**.*. \\.*#.**.*...  ...# *  ......#.* *.\.*.*.... . ..  ... .#.# ..##**.\ #\.#
##.#..*.#.\#..........  .. . . ....#..*\\.#. ..... .#.........\\.\   ....*.*....... ..... ..\ .    #
#\.. \#. *.. . .. . # #.*.#..* ......##. \.*..*. ............ # ..... .#..\..  ..\... \.\....\#.##.#
# .. ..\..*\....#*..*...#.* ...#.....\*#.  . #  .... .. .    . ....*..  .*\.\.* . *......*  .......#
#. .  #.\.....# .\.# . ...*. ..* .\...     ....#.\..#.#.#.#.*..\..\ .. #.#...\# #.#\.. # ....*.... #
#*..\* #.*.\ ..\*....#..... #*. .#..*....#. # .. .#.#. ......#. *.#.... .. \ . ..\..  . ..#...#.*#.#
#. *..... ..#.. ... **.\*  ... ..\...   . #\..... ..#.....#.\ *  .  .\ .  .....\..  .*#...*.\..\ .##
#.#..## ......*#.   ..*.. *. #.#..*.\.#* #**...\* # . *.... *.  #..........  *  ... .  ....#\.... .#
#.. *.#.*# .\.*... \*# \#\\# * .. ##........... .###....  .....#....\.**... ...  . .###...  ...#...#
#.#. *.......#\. *...... ###*.. ..\...#..#. .#.#*#....... ...  . \ ...#.**.\  \*.#...   \. ..  . #.#
##..**...*......... .# .... ** ..\.. ...#\... * .*   .  \..  ..  .. ....#*#  ... . ..  #..#*.. ...*#
# ..*.# ...  ... . ***.*\... .... ... ... . * .**.* .*....\..  \. #\ .....*.. .*..\ #.. .#.#.##. ..#
#....*.* #\. ..*. #..... #*..*#..#\..*...*. ... ..#\. .*.\. ....... ...#..*.. ..#..#.*......##. #.##
#.*.\. .#\. *.... ...#*...\. #. .**.  .\... ##..\*.#*. ..\. #.  *.*#..**.. \.*.... ......#....... .#
#.... ..*..#.. ......*.#.* **.*..  *...... #..... .  .... .*......#...\... .....#..  #.*..*.....#..#
#.. .... ...#.   .\...*##  *\. ......#. .#. ... ...*..... #...*\#.  ... ..\ .. ...#.......  **.\# .#
#............##*##.. ...*.# ##. *.\..*\.#**..\....**  .. .*.. **. ...#*\ ..... . *.*.#*.*\..*.... *#
#.#. ...\\....\ .#.\.\....  *..... ..*..... \##.#.# ...**. .... .#.*......#........#... .  .....\..#
#...#..... \  .* **..  # .#  *..\........#..    *.....  .*.\.\*..*.*. *..*\.\......#....\..    \*.\#
#..*. .  . *.* .....*....*    #\*\.*.. \.. .. #.#.*... ....... .*........*# ..*# ...#*  \ ... . .. #
#.  ...#.*.*#.  ......*.# .  .....#... .   ..\ ...........#.#. .\. #..... ... \.*#* *. ...#...... *#
#.. .....\ ..... ....# #\* #..*.. .#..*....  ... .*.#* ... .\#... ... \.*....*. # .\\.#*.\.. \**...#
#. ....\ .#*.*\.*..*...*.. .*#...#.*..\**#*.*. .. . ...*.... .**\.#...  ... . ..#.# .  *...*. # #..#
#..........#......  ... ..    *.. ..***. ...\\*....*.*.. * .........#..#*..#**.. ..*#..  ..* .#.\..#
#. ....... *....#.... ..... **...# *.*\....  .#.....*. ....*....#*# ...*..*.....#...*\... ..#.\ *..#
#*. . ....... ...  .\.....*........#. \.\.. ...* ..\. ...** .#.* . # .  #. * ...#*##.\... .\.. #.. #
# ... .. .*#.#*.**...#..... . *\....**#.. .#*.........\ \#. . .  .. ..#...#..... ....**.*.. \* *...#
#.. .*.. .*....*..**.* # *.\ .*. ..\ .. . \. #. . ...... .*...#...**..\# .......   .#... \...#..\..#
#..* .#..##..  ..#...... \..#...... ..#**##\..*. ..*#.\.. . \.... . ..**  *....#....* ..*... ..# ..#
#. ..\ ... ..\. *.... ...\#.... ...* \*. ..\. # ...*.  . ..* *........ ..# #\ . . .*. **...#**#... #
#.* ......*... . . #. # \... .**..........* .##..*...*. ..* .\ .\. *..... #.. ..*.*#. \ **. . *\. *#
# .. .. ...# .. ##. \....... ... .#*.*.#..*..# # ....\* . *...\.... .......  ..  #*..#\.\.....## ..#
# .. #.  ....#. ....... #\#.# .. ....*.....*.# ... \ .....#...**. .. .\..*.#....*.#.\. ....*..  ..##
##**..  *\...\.. ...... ......  ...#*.. .*..*.#*.  ..#*..#.. .\ #.#.. *..#.. . .#.*.... . ...  ....#
#.. ...# . ..\.... .#....... *...#..... .# ... .*** .... .#.  .##..... ..*... #*#..*. \. .*\.#* .. #
#....*. .#.   . .#. . ...  ..*..... *#.. ... **.\.*..\.#......... .#. *.. .#.... ..#  ..R.   .*. ..#
#*#....*#....# .......##..*#...*  .. .. .*...*...... ..*.*..*.....  ..... ..*...  \.*. . ..\..  # ##
##** .\..*\......*.. *..* #..*#......\.\ .  #. ..** .#....... * .#*....\.*..#.. ...*  \.....**.*   #
#.  #  #\\#. ... ....*. \.....\.......*. . ..***..\.#..\.*.#. *...  *##.* ..#*.... #  .. *...*....##
#.* . ......#.. . .#\ \...##\..#. .........*\.  .#...#*. ...  .\# ...#...*...\#.\...*.*...... .\...#
# * *.. .... *. ** #...*... *.....#.... #..*.........##..*.. .  .\....#. * . #.\#. . . .# .  *. ..*#
#.\.*.... ..# *#.. .... ... ..*.\..\ ##    .#..# \. .\...*.......*.. # ..*.........**.\*..*......*.#
# #......*.* .#.. .. ... *# ...\#....* *#..\..\*. ..##  .. *.**. .*...#.... . .. .......#.\.  .....#
#. #  ..#..*#....  .# .# ... .#.*..#. ..*#.**..... # \..... ... ....*.....\..\...\. ..  .#.# .#.#. #
##  . .. *... #.....*. ...\.*\.....**#.  ..   # .*.*...\ ....#  ...##. .#..  .#.*...#... .... ... .#
#........ ...#.* *....*#.. .....*.**...*.*. . #.*......\  .\... ....... . .\....... ...#..#...* \..#
#.. *.. ##*........\... ..*. * .#...\#..   .. #..#....\.\...... ....#  ..*. .##...#..*.#....*...# .#
#. .#..#**\*.. .......*#... .. ...*. ....*.#... #. * .. ..#..\.#...#..#.... ...*..#...*.\. ..*....*#
#..# . *. #.....* ...*. .#. ..*#....*..  #.# *.. #. \ *. #. ..*.......\*# .#.\*.....* . .. ..## .*\#
#  *.. \#... ..*.......#..*.\..#.*.##.*\ # **..#.#.*#.*. ...#*.\.. .* ..* . ......** #\.#.*... ...##
# #\....*..\..###. . *...  ....* #**.. .#.. ...* . ....#*..*.*# .##.#.*..*....*..# *  # \ ...... . #
#  .#\#.....#... * .... ..*#\. # .# ..#.* .#..#...... ..#* #..*... ..  ....\##. .. .. ...  . *\. .*#
## ..#.*#.....#\...... ### ... *#.\. ......***...# ..*##........ .# *. ....#*....\ #. ...# .*......#
#* ...#. .\. .....*...#.. *# .*.... *.  *#. #..  ..  \ *... ..##. .*..  .  ......*... \ . .*.... .*#
#........ ......#.. ..#.....#.\.# ***.***...##*#..* .#..#.#.......#\.*.*.. .#.  .\*..* ....\*. . *.#
#......# . ... . .\#. .# ...   \....  *#*..*.\*#....\*##* ..*. .*.\. .# . \. #.*.......# ......... #
## .*.\.. .... \   . ......##\\ \. .**.#*.#. ....... #.. . ... \.....*...*..*.**\.*....*. *...\*.#.#
# *.. ...#....#\ .#....*...#*.##...... .* .\*.. .*....*..*.\.  .*#....*# . #...*...# .... ...... .*#
# ...... ..... .*...\. *...***\ ..# .*.\. #.... ..*#. .#..*....   .. .. #..#. ..#.##* *. **.**.....#
#....**.***.#  ..#.*.*.. .#  . ..* ....* \..*.**...\.##. . .\#..#.*#.... . ...*  .... .\#*.....  . #
#.. .. ........ \.###*#\ *   ......\ .*. .    ....... ......*#. ...*.#.*.. #....#..  ....# #..**  .#
#*#... .. *. ..*...# *..\*.. .  \# .. .*.. ...##*..*...#......*  . *.......*#. *  ..#.. .*.. .... .#
#...#* .\...# .*.*.. .#*... .   ..\..... .#. \...... \.... **\.*.. ..  ..*#*..  . .... ...\ \ *#...#
#....... .. #.*...*#..  .#*\... ...#*..*..... ..*.\ . .*#.\.*....*  ..\.# # .... . .  #.....# ...* #
#..*.###. \\......\.*   .... .# .... . ..    #...#....   \*\ .. *.... * .*.  . . \. ....** #..*....#
# .# **.. .*...*#.*..   ..*.... \* *. *..\#. .......\.#\#**.  .#....#.. \.* # . *.   # #*..*.....\ #
#. ...#.\. **.... # .  ..*.. *.#.#*...\ ...\\.. . .*..... . .\\. *. #.......\.. .#..* .* .#\*  ....#
#.*\.#.\.. *.....*##..... ..\.*.#.#..** .  .  .. *. .\.......**...*.    .\. ...  #.*.. .\ .. . .##.#
#.#. ...#\.... .....*.......#\....*\..*..  ..#......\..*\.    *# . *.  ....*.*\.\*# .. *.. \ \.#..##
#.*...    ###... ..#.. ..  ..* *.. ....*.......#.*.... \*..*.. .*.... \.#... ## *. ..#.....#... *..#
# ... #\  ...   .\*  . ..* *  .  ... .. .....*\ \*..* ..#...#...... ..*.. ..*.  ##  #.##.* ..\ .#..#
#  .. ..... . .. *. ...  *.....  ..* ..#*.....*.  .. .# *\....... ..*.\...   .*..... *.\*..\ ... . #
#\**.  .....* ....\.\\.\*...*.  ..*#. \... **...#.#\.#. # ..\ #.  ....  \.* .*.\...*\ ... #..#.... #
#.  ..\. ..  ..**.... \*..*....*.. ..\ ..\. #... ..**#....... .# .. . # .#..#*.#  \. ....*.#*..#.. #
#**... ..**.* . \. .*..*.# ..*..* .  . *..#\.......*. ..#. ...#*.\...*...#... **  ...\*.#. . . .. .#
L* **#. #  .  .... .*...\. ... # ..# .\.#. .  ...*##*. .# #.#.. #... ......\#.. *  . .*....*.*...\##
####################################################################################################