###############################################L####################################################
# #\.**.#.......* ## .#...\.\  .#..#*#.....# .\. *.  ..*.* ... # ..###.... #*.#....*\.##   *. .#  *#
# \...\  *... .. ......* # .. ..\* .. ... ....# #. *\.....*.  .##... ..*##\.. *.....\*...**  \. .\.#
#*.# #\. #. ..*# *..*.*.. .. *. .# *.....*....*#..\. ....#.# \\.#. ...##*.#.. . .. .\#..\*... .. . #
#.*## . .* # ..*.. .# ..... * ..#.....#.*. ...*#. .. ..\.*...# ..... ...#  ..  #*#*   ..#\  .....  #
#\  .\ .. \*..... ... ..#.. ... .... ... ... ..*  ....*...... ..#..#*.. .. ..*..   \.#..#* ..#. . .#
# \.*.#\.#...  \*.... ... ..\*....* *.......*. ..#..     .* *\\. . #.... *.* . . #\ ..    .*.......#
#..#.#**# ...  ..*.\...*.  ..\.\.\.... #.*..*..#*\...*.. #. #..\ ... *\.......*... *..*..  . ....#*#
#*.#...#...* *.* .*  ..*. .. . ... .\..  .#...* ..*.#..... ... # #.#...*.#. .\.\..  .# ##....*.\.#.#
#  * ......*.\ . .*. . .#.\   ...... ...... \ .\. . * . # .\..  *....#. .   # #*..*...*....*..\..#.#
#*.. . .** .#..#*.... *.\#. \...# .\.#.#\ .  .. #  . #..# ...*.*. ..#. . .*......  * # .#.#. . \.#*#
#*  ... .*\.#*** .. *. . ...*. \* .. \.. .\.\...... .*. .# ....**.  ..#.##.. ..\... .#..  ...... #.#
# .* .* **.# . .*\.. #. * .. *. ....#*. #....\.\*# .\... * .....#..#**.... *...*. # #.... . . .. ..#
#.. . .#..\.. #.. .*.. ......*. * ..\   . *.\ ..#. .#.*.  .#.. . .... . .... *\..\*#. ...*.  .*..\.#
#..*..#. ... .  ..##.. *.... ...  *..*#..#.. ......*#.*. .\\......\#. \  \..*....*\..  ...##.....#.#
# ......\. #\.#. #.*#  .... .#.\ ..* .. #*#......* .*#\..**# .  ..*.. *\ ..#.. .#\*...*..... ...  .#
##. .#.# \....#. ........  ..# \##.*#*..*.. ...# \\...\. **..\....\\....\.......*. ..# ..*#.. .... #
#.. *.*..# ..\\.#...  . . . . ... ..**.#**. .\* .. . ... ...#...\..\...*##. ..#. ## *.. ....#.....##
#...\..... ......* #..... *..\ ......#.. .*..#...*.....#. **. ..##.. ..#.\ *.... *\* ....**  \... .#
#. ...# #..  ... #*  . *.**... ............. *.*..#.\.#...... ......# .\. #..*#..   #\\ #..... #* *#
#..*. . \.... ... .***...\..#.#...... *..*..\.... \#....#.#....    ...    #  .... .*  .......#*.#.##
# .. .\#* . .  ...*..*.#...*..#. ..\.*\*. *.#.. #.\ ..#..\..*...*.# ......*\*  # *.*..\\**# .# ....#
#\#\#.**... ...# ..\.#..*... \ .#..#... *... .... .... ..*\.##. #.. #*#.. * . ...*.**..  . # #..\ ##
#.*..*    *. . ..#... *..#...\* ....*.......\..*.   .# .#. .#*.......... ..## . . .  . *... .......#
#..\*..* .\*#   \..*.*# .....* *. #...#.#...#. .. #.\..  . ... ..* .  ..#. ..*...\..  **. \#. . .#.#
#. .. ... ... .*.*.\..**.#.*\...**. \. ...  . \   * . .....\ ..#*\.\... ..\. ##.**.*#..* .*....##**#
#.*..  .#*... .\\ ..*..# ..*.*... #*. .\.....*\* . ... .  .# * .#.*...#..  . #..... **. .###....  .#
##.*........... .\.. .. . .. *...  .*  . ..............\ .*..#.#.....\...... ... .\ ...#.*\#..*.. ##
#.. .\.. ...*.... * ....**. .*  ........... \..#*...#*# . . ..  . ... ........#...*\. ... #* ..  ..#
# \   * .... . ... ...#..*##. #* ....... .. ........ ... #   ....*#.\.*..\\  \.. #.* ..... *.......#
##. .. ... .... ..   ..##*..  .#.. ... .*#. ....*.*. .  \. .. .. ....  *.. *#* .#.\.*# \.. #*. ....#
##..##*....#..#..\ .*.  *. ..\*..* ... .. .**..#...*...... #**#..\#* ..\... .. .*.*\.\\.  ..*##..#.#
#.#.* .\ *.*.........#\ *....*..#.. ....#.. ...#.. ..*##.\ .......#.  .* # .#.......... . . ...\..*#
#..... .  .* . *. # ....*....*.. ...#***...... ...* .. # .  .....###  .#....*\\.......*.*  . . #. \#
#........\  ..*..... \.# ....\.#....#.#\.\#.#* .  ...#...*.**. ....*...#*. *\*## #.\..#*.\#.\ ..*  #
##. \\..#..*  .\*\..#.  *\. ... ...\ .*..#. .\  ....* \.# ...##.....  .*... ...*..*..#..* .. . . **#
#. .... . ..*....*.........##...#...#**...*.#* #*....\# #. \... ...*  .#..#..*. . # .**..# .#*.   .#
#.*.#....\.\.\.\  .#.\.. \ . . ..#..#....##. ...\#*\.*. .... ...*# *..... #\*..*. ..\  ....* * ...\#
# .......* ..**.# .  ..  ... .#  . #.  *.\.*#....#\...  . .. .\ * ..# #.  . \ ..\ ....#  #** .\  ..#
# .\....# .. .*.....#*...#... .. . ...**....#..#*. . .\. .#. .\..*...\  .#..#........*#*. ......*.##
#..  . \ #..  ..#. .........#  .\.#.#... *.*....*. ...\ \.*....\. * * #.\.* * . ..... ....*.....\..#
#...#. #\#.......\ ...#.....#.. .### .* .*.# .*.*#...*.*.#. #  ....*...* . ..*...#  ..*....*.*..\.##
#.\  ....  ... .\.#\#.* \ .\  .**....#. ...   .*.. .... *...### .* .\.. ...* ...\\ . .......#... .##
#.. *#..#....\\.##..  . .....# #.*.. *. . ...\ ..**.#  .\\#....*.*.*...#...#.\.. .....   .*  .. *..#
#. .*..\...* . ** .. **... ... .*.# *..\ ##..\...... . .*. \.. *##... *#*....  *.*.#......  #. *..##
### .#. * #.* \**\.. .... .....#..#..#..*#*.** .#..## ....*.   \*.........#...* ... ...*..#*..#.*.*#
#.. ...... .. *.*.  \ \ \  . ....\. . #*.*.#**.....\.... #*.#R....  #....   .. * #..##..*.......*..#
#.. *#...*#..*.*.. ... .... \.*.*..*......\ .. .. ......* ..*. ..* . *\#\\ *.*. .#.....\...  # ... #
#. ...*......*\..\ *.*.*. .#. ... ..... .#....\.#... .*..#.\.#..... . #. .. .....*\....   .#....#..#
# ....*. #.\.. .  .......*  #*.##.\# .......\ .... #  #........#.\ ........ ..*..   .#...\...\ .. *#
##..\.. .. . ..** .#....#..*#*..# . .... ....##.# \.  . ... . ...#*....*. *  .....  .\.... #....\..#
# .. . *.\*..#.*#...#  ..#  ..    .  .*...   *..*#...\# . #   * ....##.......#*...##....#.. . #    #
#...... . ... ....*#. \.*..#.*.\... . . * ...............*.*#... .. .*....... ...#** #.*.*. \.. \#.#
#. \  . ..*..**..#. . . .....#. ... ..#..........  **.\..#   .*....*  *..  * .#......#.*.. # .#....#
# *.. # ##. ..*. ...\.\#  **\.\.\ .\...# #\#\*.  * *.*.. #...#. #.. . #*.#. ..* ......#.\. ...... .#
#. \.#..\\. ...*. ..\ ... ...\#*  *.#..#*# .....**. .\ \...#.... . . ... #.\\.. *.* ...#.*..*......#
#  ...#.#...*...*.. *#.###.. .*..*.*.... *..*. *#\#...** .*. .* . #..*\....#.....\.**. ..\.#....# ##
#.* ..   .. .###.... ##. ... ...  ..*\...#.  .#.. .. . .  ..* #  ..  \..... .\\*...   .##...\.  ..##
#.. . ......#... .* .. .. \...  # .  #. ..  .\.  #... . .*....\. .. \.. \. . ...##...*...*##.   ...#
#\  .*.#. \.*.\#.*.#  ** .#..#\...*   .. *.. ..*.. # #  . ...* ...*.*.\. **...**...\....... . .....#
#* * **... ....... *. .#*..# .*#. .*.....#  ....#....*\ \..#*.. *.#. ....*...*. ....#*.... .....  .#
#.*..\*..* #. *. #.  .*#..   ..\ ..\.#....* ....* ...\*.\.. ..## ..... *......*#....*. \ .\.....\#.#
#.* ..\.. ....#..... ... ...*  .**.*... ..# *.#.* .... *...... .. .\. ...#..... ..  ..\... .#\*....#
#.#   .#. .\...*#\ .#. .  *... ..\...  .#....*. ..   .   \..#..*. .#......\*.....#  *.#\......# . .#
#  ..    .........# . **.. #  .. ....*........#. . ..*..**... ..#.....#. #. *.. .#.\.\ *.#.\. #. *##
# ..* \.. ......  ....  ...  ..#* ....\..*# #.. #. *...  *...#.......#.  .\#. ...#.. .\ .*.. . ..# #
#.... ....\ .  *. # .#.#.\. ...* ..*\*.\#. .* ##. .# # . ...##\ . \*.. \.*.. .. . #.*..#. ..#.... .#
#*...    \...  ...*........ #. *\..* ... ...# . **. \*  .. #.. # ........\ *..* . **..*..*...\. .#.#
#.#. #.... ...  *#..*.  ...#.#\..#....\ .#...# * **.#...  .\.\#*. ....#...... *##.... .#. ..#.. .*.#
#.## \.#.\......... ..  ..\... \##..*..\.##...\ . #...#.....\  .. .... .*.#..\...\\....*. .. * .# .#
#. ...#.* . ...*#.....  . #. *#.. .\. .###\ \\*...*..  ..*. *.\.*..\.*.#.   .... . *#..\...... * ..#
# .*..... ..## **..#\ .*#...#*......#..  .  .*..#\*  **... ..\*. ... ..........\ ..*..... . ......##
#. .\. .#.  . *.....#. .*... #.......... .#. \........... ... ..*.#\.  ..... .*..*# .... #..... .. #
# ....#. . .#....*. . .***# ** #......# . ... \.\\ ....... ## *.*. .# *...  .*. .* *...**.*##...*..#
#.\ . . .*..\# ...*.. .* * .#. *. ....  . ...# #..  ...#.......#...  ..*....*.. .......\.# .*#.....#
#. # ..#*.*.  ...*.. .*......... \.  ...\\#.# .\.*..#\ .. ......*.. . ....#...#....  .... #.*\. . \#
## .#........  * \.\ ##.#. *.*...# #* .\*#. .\. ## .*.  .#... #....#**.# ..## ...#.\.* ..#. .... \ #
# #. ...... .#...#....#..\*.*. * . . \.**...  #* .#.. .\.#. *#. ..\.*.. .. .... \#.  . ..#.# *##  .#
#....*. #.. .* .......#..*...**........ . . ..* .\....#.#..# ..... .*.. \#.#\#...## #.  ... . .*...#
##  ..**... .. ....\... . ... .. *.......#.*\# ..... ...   *..\.... *\.* #..##  ..... .*.\*  ...#. #
#.#..# * # .  \#*.#... # ... .*..\.. ..  ..\..*.  .  #  . .. .... ... ..  *.#.\.   . \ ....* ...  .#
#.#.....\  *.... ...#...... ...*. ..#.\...#\...*. ....   .. .. #.. .***  ..#.#....*\ . \**...... . #
#.* ..*#\  ...# .. .*......#\..#. *.*....... *...#.#.#.#. .#..  .*. *.*. *#.  # \.......#..*. #*#..#
#.*.#.. \.#..*#.**........ .#.#.. . .. ... #. ......### .*#.* .*.....#   #\...** ..**  ..##... ....#
#... .. \ .##*  . ... ....\*....*....#*....#...\.* *..... . #. ... ##**\.# ... . . .#.....#.**#... #
#. . ....*  ..#* ..  \..*..# ..... .#... ... *...... ##.*. #. ..\...  *...*#*.# .. . .#* .....  ...#
#\#....***...... . .#...*.  # #...*....  ...\ # \....#.*...... ..... .   .........#. ....* *. ##...#
#  .\......... *.\#.. #*.#. .*.*.. ..#.........  ##.*...\......#. *..##*#.... *..*\#.. .*##.*.....##
#* ...**.###* ...*. . \#....*..  #.. *.##. .#   .... ..#. #...* .* ... .* ..  .# ...*\ .\..   ... *#
#.#.... ..*..#..\.. .#.**.......*\.*\.#.* \.   . * ......#.\ # ..... ......  .# \. ** ...  ....\ \.#
#. *.\\... #....#.#....\... \ .\...  .....  . .... . *.*#.  . .. . .... ..  *..#  ....#....*##.....#
#.. ......#.  . *...#..**.*..# ..#.. ....*...#. *. . #.. \...\*.. ...     .*#......*.\.. .*.*#..#*.#
#*.....*\*.. ....\.##...\#.#..*. ......#*..#*..*.*#..\..* #.# * ....# .\ .. . ..#.. .*.  . .. .. ..#
#*  .*#*#.*... .#* ..#*. ..##*.\ **..*. .. #.....*\*\.. . .#*... ...  . . ....\\  ... ..###.. ...# #
#.. . ......*..* \*.# *# *#\ ##...**....\... #*\# ...\\.*......*# \.. \*.#...*#** .#... .#. #\.\...#
#*... ***..##. . .#.##... ..*.... . #.....    # .\  *. .# *  ...**#.#.\....\#\### *... .**.  ..# .##
#. .#. .. ...\.#  *..*#..##.*....\#.#.*..... . .*.... ...*.#*...***. #....*....**..   .....**. .*.##
#\......##.   #..  * ...*. \\. ..\..#*#  \..#* \*.. ... ....*#\# .....#..#. ..* . . ..   ..... ..\ #
#.   #.....\.\*\..#..... . . ..\. ... \... ..... . ..#*.. ... . ... .* .  . * *...#. .. .#..*......#
####################################################################################################