####################################################################################################
#  ..*...#..#......#. \...#...\.#.*#* .\....*...\......  . . ...# .  ..##. . ... .. . .#.. .*.....##
#\.*...  ...... ........  .... ..## . ..\... . *.#... .#.. .  ..*#. .###.. ..#*.# .  ..  *. .*....##
##.. ...*. *.#..\#\ .... . ....#. .. .... #.*..\....* .\ ..*. .......   \*...\   * .**.#..*.#.*.*. #
# .#.. .   .  ...#. ..*......\#...\.*.#\...... .*.....   *#..  \.#.. .\. #*...*.*.  #....#\  #* .*.#
#####..  .#*.**. ... . * ..*......... ..... #.... \..*..# .*. .#\\...#*.##*... .# ........#\ \.....#
#   . \*  ... .... .*......... *...* . \\#....  .....# \...*.*...*..*   #...*. .**... ##.*  .*.#...#
#.. .#..\  .*..*..\......#.. **........  ...** ..*###..... .. . .#*#..... ..  ....*.\  .....*.# .###
##  ... #\. **... . .. ..#*.....\. ..#.. .# .# ....\.*. ...#..*. #  ## ...\. .  #...... . .. #.#\. #
#..*  .  . ..... * ... ..# .*#.. \...#... *#*..##  *... #.\ .. ......#.... ....##....\## .  .##.***#
## ...... R.*.# ...  .\...... . .  ..# ..*.#..... ..*#. .. ..##.  ..#*\........... .. #\.  .*\..  .#
#..* ... ........##.. # .*#*  \. ##.*..*. ...*..**#.*........ ..**...... ....*..... . ....*.#......#
# ..\. .. *.##.##.# .\*...* *#\..... . * ..... . #.....#\........\\\   **.#.* \* # .**.* . ..#*  .*#
#\...  ......  . \...*.... .# #.#.##....#..#....#...*.* #.\#*. *\* * .. .#\ # ..#. .*  ..#.*\......#
# .... *#. . . .*. .#.....#  .*.* .*#....\...*##*.. .... .... .... #*.#*.... .... ..*.  #*   #* .. #
#..  #.... . \*.##.*....#..#.......* ...*.  ..*# .......#.#. ..* ..#.. \*....... . ....#. . ... .  #
L .*.#....*##..  ...#.. . . ....*.#**....*# .## ... ..  .*...\#. ....*.#...*.##.#.\. #*  . .#.. \ .#
# \ . .#*\##...\.. #......... .##  ... *...\\ . ..##* ..*. . ...  .*#.\* * .#.*.. *.#..*#*...#. * .#
#. . ... ......#.#.... ..##.#.#....\... .....#.  .  ....\..##.**. .........* .. ..  .. .. *#*.....\#
# . #*.. #.......**........ *.  .. \ ..*.  . . * .. ...*....#.#.#. .. .*\.*. ..#** \..#* # ..\.*#..#
#.#. ..**...#\..*#.* *.# *. .* .... ...#.........*. .. ... ... .#.#...#...\..\.\... # . \..#  #....#
#\*. .. * ...*#..#. #.. #......## .....*\... *..\.#. ....##..*.*..#.#*..*.#.. . #.*.....\.....\### #
#\...*#*#..... ..*... .\*. .\...#..#.#.#.. ...\ \\. ..*..*\#.. *#.# ....#..*#    ..\..\..*#..\#  ..#
#..\*...\.........#... ....\**.#..*.\. .. .. #..*.. #.#.... #.# ........\ ....\....*# . ...* *\..\\#
#.#...# #...* . .##. .. #....*. ......*.........  #....\....* .* *   ..........#*..........  ..  ..#
#.\# ..*#. #..*..*.. ...#.. ..   *..*\* . . *# #*.#.*... ....#...\.... \.*.* .# .# ..*#.\\. # . .*.#
#..#  #...*........ .*  *.#.\.\..... ..##. ..\\...# ... .*\......* .\# ....#.*.. ..*  .... .\*...###
#*.## ..**  ...... .*#.*#. *.  *. .#...\.*...#..#...\....*. .. *... ......... .. .... ##......## .##
#*.. .##..\. ..  #\...##....\..*...... .*  \ # # ...   .... *. .#.#..*.......#.. .... #.  .#*\.*. .#
#*.# .#.#..## ..* . ..*...*... ..**....*  ...# ....*.#.\#**..\..#..  .. .\.. *. .   .#  .\ ... #.\.#
#......\.  #*.* .#..***. \.*.#......  *... .........# .#.\.... .*...\..#.......*#....*..  \#..*.#..#
#*..\.#.#..*..#.....#.. * ..#.\ .*  ...#..\...#..\  . \  ...  ..\ #... ...  ..# ###  \ ..  .. * #..#
# .* ..#.#..**.. .##...#  . #*... . #*\. #.  .. **.\..*.*..#.#. ...  *\...*..*...... ..#. #. ......#
#....   .##..\..#.*###........#..#.* .#.# .... .#.*.. .....# ...  ....  \.  *.#\#. ...#.*.#*#....*.#
# .. .*....#.#.#.\  ......*.... . \.\\.\.....*#* ..*.#.*.. ..  .......\... ....*. . *... *....*....#
#*.. .# *  #. ##.*......*#. . .\...*....\ .#*...* . #.. \.*.#.  ...... ...#.. ...* . ..#...\. . .# #
#.\......  .**** ......*....*.#.\\*.* *# .# \..# ..\ ..... *.....### ......*...  .#...\\..#*.... ..#
#.......*.#.. *...#.*#. ..#.  *..\. ..\ #..## . \..# . .\.# .  * .## .... .*.. .#. \ .. *  *  .#..*#
#.#...*... *#..*. .# ..**. ..#..*.\# . *#..........\ .. .... .*#.*.. * .... .. ##.##... ..\.. \  \.#
#*#.*....*.... ... .#.... *.. .*.#.. . . *..# .#.  *#.\ . ..*. . #.##.. \ ...#.. \.. .. .. #....*..#
#...*\*..#\ ###. .#...... ....... ..*    . . ..\ . ...*.# ...\ .*.   *...   .\*.    *.****. .#.#**.#
#* .....#... *.# .... *#.. .\.# . # .#  *..*#   .... *  ** .# .....*..**. ...#....\.#......*#...*\ #
#. .........  \... .... \......*.....#.##.*..  *... *  \.... .. ..... ..*..\. . .... *...... . ..*.#
#. .#.\* .... . .# .....  . .....\.....#.#. #.\.. . .#\*. *.#....\.... . . #\....#. #......*. .....#
# ##*. # . .*..#.# #. ..*\. .  . . .  ..\#. .*........*....**. . \.#. .\.......\*...\ *#.........# #
#*....#... #. .\... .... *.***# .....#.... ..#. . .#....#.. .*.#...* .. .#    #. ##.##.........#. ##
#..#. *.. . ..#*....*.#..# ...#. \..#........*. ... .... ... \ . . ..  \...# # ..#.# ..**..*...* . #
#. .\# ...... ...*# *. ... **. . . .*# *. # .\..*   . .  ..*.#. . *..#.#\\....  ..*.*. .... ... *#.#
#* .#. .. #....\.... .  *  ...*. ..*#. #. *..  ..#..#.  .......#.\..  .. ..*. .... .  .#.....#. \.\#
# ....... ....* . ..... ##\# ...* .. ......*  *.* .#...#.... ... *# .*#  \. .*..*.....#*. . *.... ##
####...#......#.**.\.\\ ....\\ ....* .#.*.*...*...**#. .. .....\ #. .#.... \.....#.. ##..#...*.. .\#
#...*#   ..\ ...*.# ...  ..........  .. .....#...\\*.\ .#....\ .**....*.... .#.  .\..*   *.# \#...\#
#...  .*..#..  *.\ #\\# . #....#. .. .#*  ......#. .*  \#. .....*..  # .. . ... ..  .#..#..**.\ ..##
#*.......... .*...  \.  *... .......* #...*...* .. \..#\.......#.. . ....#\.......*#.# .\#. ##  ..##
#.....#.  ...\...\ ....\...  ..*..\#....  .#.\ ... #...#.*.....* #.*\*.#... .#. \ ....*#\*#. *.*#. #
#.  ..... .*#\....*..#...#.*.#.. .#  .* .*.....*.... .  ..#.... ..*....*.... .*....  #....*. ...#.*#
#  *. ...\  . . \. .*...... *.. ..*... ##.....*. ......##. ...*.#.... ***..*...## ......#. .*. *...#
# ...#*.. .. *....\*#*. .\..#...#.#.....#.*..\. . . . .. .\*.\......#....* *#........# .\... # .  .#
#.#..... . . #..#..#..... .... #**. .##....* . ...\*..........#. #. .##.##.*#...*....*. ...#\ . *..#
#. .......\.*  . ...... ..* . ... . ..  \ ......# .** * *.. ..*... .  . *..#.\..#*..    ..*......\.#
#\.. #. ..# ..... \#.*  ......\ .*#....\### .*\*.# .*. ..* ..## ... *.... #.. #.. #..* ..  .. ... .#
#.\.## *..#... ...*..# ....#...* \ *. *.#..  *#.  . ...\ .. .\ ..\..##.*....*.. \ ...*.\# .........#
#*.*\..**.  .** *.* # .*# ##  .#..#.. #.........\.#... *#.\#.#..#  # .*...*.*#.* * . .....#.  .#.*.#
#. .. *.**#.\...# .*. **#...*.*....... .. #.. #..#  #.#. ..#...  ...#..  *. ... #....#. #  .  ...###
# .....  . #..\. ....*.#..*   .. .*..  * #.*.*...#...*  ......*\. ....\ .... . ...#. .... * *  #...#
# * ....\  .\. *...*.. ... .*\ ..  ...#.\.....\#   ..   .....*\....*.#.. * ..*.. ....\ .#\** #* ...#
#\... #... * *... .*#....#. ... ...   *   ....... . ....... .... ..* #. ...#....*. ...  \ ...  ... #
#.* #.* ... ..  . . **.. #..\. .  .. ............\....#. . * . ##*...* #.. . #...*.....\.....   #..#
# . ..*...... #.\#..  .#..#. .\#\..*.#  ## .*.#.#... ... *.\...\#*.....*#.\#*.#.#. .\.*#. ....#.*  #
# \  . ...... ...#.** ....  \#\ .*\. # . ...*.. .#. ...*\ ...*#.#.*...*... \. . #..#...# .... .*.. #
#.* .#...\.##.#..#..\ ...**..#. ..  ... .   * . .*..\ .\    .....#..  ..\*.#..\ ..#.. # ........#\.#
# ....*...... .\. #\  .*.#...#  . ...\.*#........#.*.*..*. .#*.. ...#......## #.*.... .. .#.. *#..*#
#.  ..* #\. *. ... .. . \. .. #.*#...*.  .. ..  \..  *. . . ....#.. . . ..#     . ..  ..#.  *.*. .\#
#..\##.... #...*.*......  ....#..**# .#. .#. ....\.  \ #....#.\\. .... #.#\ .\ #*.*#*. \..# .  *. *#
#..*... .\..#....\...  .#*..... . #..\.#. .*\. ..#.. ..* #.#....  .* ....*..*..*...\. . . #.#*#....#
#...\... \... .. .*.#....\....*  ..  . .*\.. #\....  **. . .#..*  .\#.  .\#...* . ..*.#.*.* ..# ...#
#...... #....*....#   ..#... . #.....* ........** ..*      .*. ..\.  .#.#..*  .......#.. *\# \\..*.#
#........ .*.*.. . .......*..\.  ..\..*. .*#..#* .#. ..  #\. . ..*.\ . #... \....*..\..*##..\ .. ..#
#..##\#. .# .*...#.#.*.*.\.  .. .*.\....  .. . .*  . .. . . .. .\ ....  #.. .... . ..... .. .....*.#
#* *...*  *..* #... *..  .... * . .\\. #.... ..  # .*... ..##*..*.*..* \. . ...** .....  .*..... ..#
#.\  *.   ... ... . #  ..  ....\*......#. ..#   . . ....... .#\.......*... .. ...#... \*   .#\  ...#
# . ....#. .*# \.... \ . ... ... .........#.  ..# ....\...**.*...#...\ .##..#. .*.#.*. . \*..  #*#.#
#*.. *. . \ #..... . ... ....\#.  ...\..  ... .*.... ... .. .. *.... . ... . .....\#.. ..*..*. .*###
#\ ....\*....  .. . .# #.##.*.\ ...* ..  ...*.... \...... .* .#. .*##... ...# . #.#.#. ..* # .*.\#.#
#.  ..* .*. ..#.....#.#. . ..\.* #*..*#   #....*........*#*.#*#......#\.#. ...* #.... ...#.\# . #. #
#\#.  .    ..#*  ....   .\...*#.. ##.#* .*......\#.#  *. .....##.#. \.#. ..#.*#. * #.. ..\.. .. ..##
#.. . ..  .\#*...   ...  ...... ...    #.. ....*#.**. .. .\ .. \... *..*. #\.*..**.*  .. *.... \ .*#
#....\..*....#... **.# ##..*..#\. .#.*#.*#..  .  .#.# . .  ..  ###..... ..\#.\\..##...#..\.........#
#.\ ... ..#*.. .#.. ....#.  .*. . *.*. . ..\..  #  . ........*..*#.*......#. #*.#*\ .#..*.. ..*..\.#
##.#. .\...#. ..\  .# \*.... ........ .....# .. ... ... ... ...# \.. *..... #... .  ......*..*..*.*#
## . .\\   ...*.....#**.*#* #.\#...*.*.#. ....#..*. #.. ... *  . ...**.. .*  ...#.*#...\ \..#..   .#
#. .. . ##..........#... ..#....*  \....... .*.........  #.*# . .........*#. ..* .. . ..\..... \.*.#
#.\ *.. #....#..#.\. .... . . *.*..\. . ....*. .. \#*.#\ * .. #...**.**#**.\ \*.  *.#. #.## .* ..# #
#..... ....#..#.# ..# .#... .# \.#\. .#...........  .*...#.*...\.#...#\ .* .#. # *..#*. * .......\.#
#..#...**\... ...  . .##* . .\.#. ..#.#....# #. .......*. . .#*..  ##...#*#... #.#...*..  #..#.#...#
#\#*\.  ...  .#  ..#*...*#...* .# ....  ...\#** ....*\  .. ... * .#.#....*.. \**#* .#* *...  #...*.#
#...#....#..#\* ... ... #.. .. ....# .......**... ... ..*\*...  #...\# .....#.#.**. .  ....#.... #.#
#*. ...*...*.*..#....#.# #.... *# ........\#.  .#...... ..# . .\.. ..... .# .. #..# #    .. * \ .. #
#.. ..**...........*. #. ... .*. * #.* ....#. .#. ....*..**..#..#\..\   ..* .*#..*..#..**#* #.. #*.#
####################################################################################################