####################################################################################################
# *.. *........#... ... # #. .#  .*##. *... .... ....#.*.. .....  . ..  *#.**..  ......*..* *. ..#*#
#\..#*#*.....* .#* ..  \..#. *..\... #.......* . ..#...... *....#. *#.* \.. ...**.*....* .*..*.\..##
#. .#.\.. #.. . .. .  . *.....  .*..  .. #...*\\ . .#.*.....*. *.....*.* ..*.. *. ....#  .*.*...\..#
#**..*.#. \....*... .**#. ......  ##  ..#. *... ...*.. ....  . .  .... \...#. ..... .....   . \...*#
#..#**#... . . #.*** \*......#.##.# #* ...  .# #..*.#*.*. ..* ..#....... ..#. *# .....* .*..... .\*#
## *..... ..\# ...\* #.\....#....**\.\#  ...#. ........  \.  ..*  *.. **.. *.\ .#.....*....  .\.*..#
# ..  .*..#. .*\.#.\..*... ......... #. .\..... . . #\.* .#\... ..... ##..\...  #... .... ...\...\##
#.. .. .. .\. .# .....*#  *.. .#.\...  .*  #*.\.* \#. ..*#..#. ..#.#. ..#\*.. . #..#.##..##....*   #
#....*..#*. * *... ...... .  #..  ...* .#...## ......#...#.   .#.*.. ..#... ...*#.*... .# .... ....#
# ..*..**...#..#  *#....... ...* .  ....#..... ....*... .*...  .*** .. #.. .#*..  .....#.....*.\# .#
# #. . ... ..#.. \.\....*  **# . **#..*#.*.*..##....# ....** .#.#..# .*.#..#.#.  *..# ..  #....*...#
# . \.*.#*.........  #.*  ... . \*...**##. ..**  .. ... *...* .#.*... *.. #. .. .  ..#..\#....# *\.#
##. \# #..* ..#. .......#...*.\...#.  *..# *.#.... \.  *. **.*.#\ *... .. #. #. ...\.*...#\ .. *...#
#.. .. \\. #........# .*.*.. #.. .. * .. #..*\. ... ............*  ...\...*. ##... ..* .#*... .....#
#..#........  \....#..\ #.  ....\ ........*.. *.......*. .. # **.... ......#**.* *#.. \ .\*...  ...#
##...  ......#. .... ...*  \*# ...#...\ .. . ..# ..*. ..#.*.........**.*#..   *#...* ...#..#.#.*..\#
#.*\.....* .#.\. ... ## \#. .*...*\. ..\....# ..... .....  .#.......#\....*..\ ..#.##* .. **#.....##
#.** ... ....#\*.\#.#*.\..\ .. .***..\.... .*.. # . \.  ........#..*.... ...  *. .\.* ...#...*.#...#
#* ......*.... ..#.*  ..*#. \.... ...#.....#... .   . ..  .. ...#......*.*..*......*.# . ..#.*\# ..#
#.*..... ...#..#...*\..#. #. .\.#.. .... #... #*....\#.*.**.#... * \.#.**#. # ....  ...  ..\.. .*\\#
#.\.##..#..*...**....#  \*.#*... #.#..... .#...# #. ..\ . \#..* .* *..# ..*.*#.#.*.........\.\..***#
#.... . \*\.  ..#..*..... #* *\#*....\.## . .#. .. .\\.* ..#.#...   .... *#. . ...\.*.. ...* *. .*##
#..  .....\  ....\.. ...... ... ....*......\ \....#..... ...*..*. #. .#  ....\ .  *....... ...*..*.#
#  *.##. .#...#.. .. ....#\..*.#... #\..*. \.#...* .#... *#*. .* .. ...  ..##.   .#\* ..#\#..... .##
#*.\. ..... .... \#.... ## .. .#  ..*.#...* .* #..\..* .##*. \ ..*. ...   .  . .. .\... #\.\... .**#
#*#. .... .. . # .... \...... . ...... . . ...*#*. ...*...\*... * .. .*. .#*.*.#.\. **  ....*. ....#
#... #. .. ..* .. . #...*.#.. .... .\. *#\....*.#*#\ ..*#   .# .*##.#....*.#....#.#.\..# .... .  #.#
#....... .. ..*.# .#\... .. . \..* .#..*.#  .. ........\* .*.. .#.*..*.... . \.\...  .##*.# ....  .#
# .#..#.\# *# . ......# ..#. .......\#*. .  .\..\.  ...\## ..* #* **...... .. .* .\#**  ..#*....\.*#
#. ....\*...\#.. . ##  .....* * . . .. .....#..*  #...... #...\...... ..  .\ .*  ... \ . .**.... *##
#.. ... *.#. *. ......... .. .. .*.#. ......... ...  # \#\....  ...#..*..*..#*. ....  .......**..* #
#.. .. ........ .#. ## . * . ##.. ........*. .. . ...  ....... \  .#. *.. * **.*.*# .*... \.*#.   .#
#..   .... ..*.. #.# .*.... . \.....#..#.. \..* \. *.. .*..*.. *..*#*\ ...#. ... . *.\#.*  .. ..#.\#
#. #...  ..... .*...* ..  *..  ..*#....   *.# *.\#..*...\.*..#* ... \.* \* .  #..\*.#  #\.#*.#. ...#
#.     ...#... ..*.  .*.....#....   .#..\#.   ..\ . .\.. ..\.... ..# ...*.... # .\.#   ... .*#*#.**#
#. *#*.#.... ..#.. ..  \  . *.#..#.. \*.*.....*.*.*.\*.*.... .\..#.\#*..\# .*.. .  .\*..\.#*. .#\ .#
#*..#\... ...............*\.*.....  .\.*....#... . \.\  #.........*#  ...  ...*\  ..   *.#*.....\.*#
#.\\.#.  .#**#...... *#.....*. ...\  ## ..\ .# ...#*#.. .. .*.*#** .....  #.*.#...  ...  . #.#.*#..#
#..\ *.#. ......*##. .\. ..#.. \. .... ...  \..... ... #..*..\..#*...\.\ *.##..# .. . .. ....... ..#
#.*.. .   ##. ... . ...#..... ..**#.*. ... ..\.. .*.*.#.*#.... \.  .#....#\.*..** .*\\ .#...\..   .#
## ... ..\. .*  .   .....\*.#\\.*\ #**..*... ...\*....\. . *.# .\..\\.. \.#.....#... ..  .......#..#
#...... *..\.. .  \  .. *....*.#... .... .#**  .. .*. .#...***... .*..*... ** .... ..#.# *.#. .....#
#.   .# \**...  ..* .. # ... ...#.. .#..\...#. *#..    .\..#.* ..* ..##*...#.. . .. #** *....... \.#
#.* #..  .  .#. \.... .# . .  ..*...   #\.......*.*..*.*... .. . ....\#  ..* .*.\#..# . ......*. *.#
#\...... ..##...#...#  ...**.....#.\ ...*. *# #..*## *.. ..* * . ...##.. #### .......#..##... .... #
#.. *\ ...#.. #*#.##..**....  #   ..# #*.. .* #  * ...........* .. .# *.. . *...... *.... # . .# \##
#. *#.*..*..***... .. * *....*....\..#.. ....*.*#.*......#. #\ ... .\ .. . . .*. *.\ .*#. .  ..   ##
#. *#\..#....**. *...\*.\. #\*#..........\.. .....  ##. *..... .*  ....#.* \ .....  ...\.. .*\.#...#
#.. ..\.  * .. ..\*   \#..*##*. .. ..*..# *.. .#.....*..##...*#. **....... .    * .\..#....   .*.. #
# ..*.# . . \ # ..... . # .  ..#. # ..*...\.\..*.\.. .#.   \*.*.#.#.* .\.\......\#...#*#.  ..##  . #
#.**..... ......*.......\  ..#..   .. \.....*.#..  .#. ...*..#  .  .*.#..#*#.. .\. . .......#.# **\#
#. *##...*.*. . * #.    .. . ..*.. .*  ...#  ..*. . ....... ..*.## #    . # *   .#... *\\.*. \. .. #
#..##\**..#*.. .....* .....* ...\\.. ..*...\.#..#... .* \.###. ..  .*..\...*.#.. # #..*  .....  .#.#
#\....*.\..... .\# *.... *.... #...*# .... . .. .\#   . . *........ ..\*.... .**# . *.... .\.. . . #
##..# \.\...#.. ... ..... ..* ..#....#.* #*..*  \.# ... *... .# .\\.**** ##.*.  .. .\  \... #..##. #
#..\. .#... ...#.........# ....*#.. . ..#... *... ..#..\ .....* . .#.\... .. ...\* .#....#...\.. *.#
#.#....... *  .\\.#. ...*..\.* ...*..*  .#.. ..# ......# .....  .......* .. .. ....*\...\   #.... .#
#.* ..\..   *.........R ..#.*  ... *# ...# ...*. ....  . . .#.  . .. *#. ........#.#.... *# . * #\ #
#.#\...*..*\.....#*. \  ..  .#.... ..*... .*. .... # . .#*.   #..*#....\#*.  * .....#*#*  .#..*#.* #
#.......\\# ...#.. ..*.#.*... .# .*..  ... ....*... .. ..*\  .#*......*....*. ..#*. ... \\# .#*...*#
#...... *. * *. .\.. . #..#..  #... ... \. ..*.*.#...........##. ....#..*#.*..  ...\ ..\.\...... .##
#. *. ..## #\...  .. .\. \ .#...#....*....\.\#..  ..... *... * .... *.#... # .#* ...#.##...  .\\*.*#
#.   ##*. ..# ...... ..*  ...#. \**   ......\.\...  . \..**..#.  \...  ....#*.. #. .#  .    *  *.*.#
#.*. ...  \.....*..\... ...  #....* * ## .. #.  \*..\. .\.. .. ...... .*##.*.... # #*......**......#
#.#*...*.*. .\.*. \#* . * ... .....#..\#...*. .* .... ..  ..... ..* \...... .*....*.\ ..... ..#..*.#
#.........*# .#.*...  *.*... .... ....#.#. \.\ \ # .\#....#. ..#*.# ...\. .#\ ... ....# ...*..*##*.#
#*#..  ##*.#...........*.###\* . .\......   .*.#.\.#  ..\#.#*#... .#.....\\#. \...*.  .*.#. . .. *.#
##.....   ..... . *  .*..*..##.. ........    * .   ...\ ##   .## ..**.  *.  *..# ....... ... *...#.#
# # .*.#.  # *#*..... .. ..*.......\.\** #. . .....#*...... #.\ .#.. .*#\...  .. .#.... .. . .. ..##
#.#.*.....*....... .. .....  .#\#....\....#\\ ** .... .*.##.. ....*.. \#...\.......#  . .  ......#.#
#....  ..\.. * .  ............. *.* ...#.\.*# ... . . #..#  *....*#. ...#.*..#  . ... ..\.\..*.  .*#
# ..**.......#.#. .# .\...#**..*.*#  ..* *. *.\*#..#  . #...* .*#.. .\..#..... ...*.....\.### \#. .#
#.. .*... ...  #  .........**#..*......#*....# ...#...# ....\* . . #*. .\.... ...##....*.* . .....*#
#.*.*...##..#. ..   ..#.##.... \. *##... ..* .\..##   .# .. * ..  .....*. ... #*................ #*#
#*...*..# .... ...\. .\.   *.#. . .**. . ...* ...**#..*.  .*..*..\*.. ...\  . *\..#...*....  *..  .#
#..  .........\..*.* **  *... ..*\#.. ...    *\........ . ..  .#*\#.# .  .* #..\.*  . ....#. . .*..#
#*.*#.\... ... ...\..*##   . .........* .... ... * .. #*. \. ....* #..*.# **..*...... . ..# \  #\..#
#*#...#*....** . .....  .....#. ..*  \*....  #... .. #### \*. .#  .. .  ..\#*.*..*.# .# ..... #. .##
##. ...*..  ....*..#.. *.\\.#\.  ..... ... ....*.  *.  .#\..\.#. ....# ..... ...*#. .#. .#.# ......#
# .. ...*#  . .#. .#. ..*. ..*   .#.# ..\#...... .\ \.##\* ..#..\.#  .#\.#.\... ..*.\ *.*.. . . #.##
#...* .. *.#......\. .\\..#\.. . *#. . .#.*.\\. .. #**#.*  ..#  **.. ## .#..\\..\.  .. *.\. .*#... #
#. .*.#.  . ..... *..\.... .# .\. \..#\ *..##....#.#.#*. ...* . ..*..*\.. ..*... .\ ...... ..# **. #
#.   .*\ . .*..*.#.... .#.**# .** .. .... .*.. ... .#...#.. .\*#. #.*. \........*. **# ..\. *..*\..#
#*..#* \.*..\.......  . .* ...# . .##.#.......... .* \*. ...*.. \#.*..\\.* ..\..* .* ...#..  *. ..\#
#..   .   .\*.  . ## ..#.. ..\....*.*.*#  . ..\..#*....... ..#........ ....   #*..   .#...*. *..*..#
#  ...\.   .* * . .. .. . . .#\....*.#.#...\ .\\...*..*. .... ... *..*.. #.... ..# ..*  *.#. # ..  #
#..#... .*. ....*..\.#* ... ***\......*\ ...##..#. ...#..* #...\... .*\\\....*..#  #.*...*......** #
#. ..... . . .#\ ...*..*...\ ..  .. #\...*..##...\.....# \..#...\...##. #.. .......  .*   ... .. . #
#. ...*..#....  . #\.\## . *...# ..\\...* **...*** ...#. . ........#... .#...* . *.....#..# ..*....#
# ..*.#*..* .#.\ .......... \*#.  #..*..*# .....   ..\............# .*..*  .. .#..  ...  #.  . \...#
#.. # * .  .*.... .#....#.. ..#.....**.\*..#.  .*.** .  ..... #.. .**..... ..*.. *.. .*...\*\... ..#
#.... .* \... ...*..#.. ...*... \##..# . .  ... .. #...*#. ...# * .....*.  #....**. *....##*\.. ...#
##. .#..... .. *#.*.*  ..\\.. .*.\..... . *. .\..#.\.\.##  \#*# .* *...*. *#...#\\.#.....\. #*.\  ##
#....*.. ..*.  \#. .....*......#*...... ....##*..#....*...# .. .*... *.....# ... #..#..............#
# #.*... #*. *.#....... .##* .. **\ .#.  .\#. *.........#....*. .... .... .#.* .....# ..#..**......#
##...*.\.#.#.. ..*\* . .. ....\.. . \\ .*.*.#..\...#.  .....\ .. ..... #.. .# \*#*#..\* .*. * .   \#
#.... . ...#.*.*.. #.  .#  ..  *.*.*. # *. # ..**..#.... #...\ .* .........*.*. ......\...#.. .....#
#..*.#...#....... .....  *..#..* ..*..* .* ...*...*.#..   #.#.#..# ***. # # ..\....#...... ..*.....#
######L#############################################################################################