#####################################################################L##############################
#.. ... ...*. .#...#... .....  ..\...*... . *...  \.# ..\..#.. .# .. .....*.. \# .\. .*...... ....##
#**. *..\.\. . .#*... .  \ .***\#. *#*\ . .....* .#..*..* *\ #...##.. .. ... ...**.#......* .*.#\  #
#.*.... ...*...*. .. .  ...\...#..#... .#.#.... .\*\#....... ..##... * #.\ .......*   *..*.... .#..#
##*. * #. *. ...#..........# #. ...*...\..#\.  #. ....* \...*.\*.#. *.*....#..\* ..#. ..*  #*. ...\#
#.*\  .. \  *.....##.....# ..*   .. **\.. ..#.. *.  . #.. #..#.#...# . *. . ... .\#....*.#..*. . ..#
#. ..\......  ..#. ...*...*#*. # . ..*#..*##.... *  ##. .... ..... *.. ......*.\\. .* * . ....\ # .#
#\   .*... .  .*.\... . .\..\.... \..*... #.\ ...  ..*...*..# .\*.*..... .*....\*..#.#*##.*.... . ##
# ........ ..\ .....*.*.*#*.*..* .  ......  \.*..*  .\ .....#*.#.# .... *. .# \...* #.## .*..#.#.. #
#***.. ...  # # ......\ \# . \..#.#. #..#\.*.....#.*.. *......#. ##.##*#.#. . # ... .*  . ....*\*. #
#.*...\#.....#..#......\.. ..\.  * .... *.\*... ... *   .#\... .\... ..#....#.*  .. #. #.. ## .\...#
#*#*....#...\..*..*..   . .#..  *. ..#..*...*# ...#...*..\\.#.....#.*...# .##... ... . . *.#*. #.\*#
#.. ....  #...\.*..\....*.#*.. **....#....* ....*..#..... .......*....*.#.#..#....... .....*\\  ..*#
#....... .#\........#..*. *.....*.. . .*..# ..*. \...#.**.#. . #.# . . \.. .. ...# . ...#..#.. . . #
#. #\..*.#*..#\ .  .  *...*.. ....\#.**..*..#*... .  .\. ....#..*.... ..  ..... ###...  ......#*. .#
# ##.. ....#. .#  .. *#  ...**.#.\ .# ...\..  \#..#..\#..*\ ..*\ ...\..*..*..**.  ..# ...# . #.#...#
#*  .* ... .\* .*... *..* ........#...\ ..#..\...\....*.# .*# #.......*#....*.#. *....\  # * #R.*..#
#..\. .  .*..\..*. . .#....*...\#. ..#.#....## ..  .**.. #..  .   ..\.\. ....#....#.# ... ...#* \..#
#...#.#..*... ... ......... ..\\\\...*\.#.\#*#.. .. ..\\   .*.. *... .   ## *.*...# *. . .... .. ..#
#* ..*.# \\.*..## ....\. ....  *#.\.. . . .. . *  *..#..#.. #.*..#*.#..... ... *. ... #..  .. #..#.#
#.... .  ..  \. *.  ###*#..... ...****...\*..*\.\ #.#*... . .. *  \ .. # ...#.# ...  .#.. ... ..*. #
##..#..#..   .\\.  ...**........##*\..*\.  ..*\.#.**...... #  .  #....\## ..*..# ..#......#*.\**. .#
#.  ...\*.  ..#  ...# #*. ... ........##....# ..#.  *..#... .*.#..*\. ......*\ . ..*.. ..**# #*# #.#
#......*  ...#.. .#. .. .....*\ . **# ...#..  #* .#..\ ..*....\*.... #.....  ..*...... .\\  .*#.\.##
#..  *..\\  . #....#..#..*...*.....* .. ..\...... . ..#. *#** ..*.. .... #*. .. # *...#.... .......#
# .#.##. .....*#.#.. *.  #*......\#......\ #.#...... .  .*\.#\....#*## .*#...*. ...*. \\.  *.#.. *.#
#*#.  ......#\....#. .*..\*...***..#... .......... **  .. .*..#...#.*.. ..#*..  ... .  .\...#.**..*#
#. *#..#...#*. .#..*.\....* .*.##.*...#. #..* . #.  .. #.. ......#.... .#.*... .\.\..\#. .#... **..#
#.  \*#.....*.  \#.. #.#....... .\.#*.    ##..... .#...  ..#*#.#.# ..*.*  ....#*\  .....*.#..# \...#
#. #. .*# ... \ #..*.. . .... # *. #.#**. .........#.*. . ###. .#  *..#..#** .. ..* ..*.* *..*.*...#
#.#*#.. *... #.*...# .... * ...#\***...* ............. ....**.*.. .*. .# #.  .....\...\ \....# *...#
#...*..*. . . .\.  . .. ... .   ...*.#.*  .## .#.... ..  .*....*..*#. .. #*.#.... . \ .*.*# .. *#*.#
# \.#* #*.** #  .*....#. ....  .. *.#.. .....# ##...... .  .#. *.#...   . .#*.. #*...*. .*#.*.*.\..#
#....\....* #**...\.. .* . . *. \.#.\......  . ...* . .*.##..\..# *... .\.. . .#.#. ...*...#...... #
#.**##.*.. \ . ..#... ........ .*..........\ .# .#.*.....#. ...#. ... #... . .... .... #.**. .#.#..#
#.*.... .. ..#.\.. \... \. . * .. ..*.......* .  **..*...* *.     . \....#. .. ...\.#*.###..#..  ..#
#.*. ....*.. .#.. *  .#***. #...*.... . *#....*..#.#.*.. .#.**.*... ...*.. ...* ..\*  \.#..# .*. #.#
#....##\...\. ..*.#.#. ...   #..*\##. *. ...* \.#### . # *..# ....#....\.*.... ... .# #*....#.*.. .#
#. .. .. ....... ..*... ..#.##*. ....  .*...#..# .. .#..#.#.##...*.. .*.. . .#..  ..*....#. .. . ###
##. .\.. . #. *.\........*# .#.*  ..\ .#... ..\\ .. .....   ...... ...#.#**#*....\.  ..  \.\*....#.#
#. . ..###.\**\ #*....... #.*. .....\....*..#*#... ..#.#.**.. *........\   .* ..... ..*... .*##....#
#.*.#..\.*.. .\..#.. ...# .....* * *.# #.*.*.. * ..##.#..#.. #\..... \. *#*.*...*#.*.. # \....  #  #
#  . ......*.  *#.......   .... . # #.. #. *..# \ #. ....#* ...#   .\*.*..\.. *#...*... ..#. ....  #
#.. ....#.. #\*......\* ..\ ..\#*.#...#...# .* .#.. . ...#..#... .*.. \#. ....#*.\. ... ..*#..\.#..#
# *.   .#.*#\.*\\. ..* *.##.\..#*#.. .* #..  #.... .##.# #..#.*.. #. .*.*.\..\... . ...... \..#.  .#
#...  #. ...  \.. ..... . .. .\.**....*..#\...# .....#...*..\ ... .#......*.#..#...\.#....#...\*.*\#
#.*.#. #..\.. #  #..*.#\.\# ...  .. ... * ..#.# .\.. .\..#*.#.* ...##.*......\ . *\##.# ..... ..  .#
#\..#.#.# .*.  .  . #.\*\....... .#.#.* ..... \.* ..# #. .\.\.*\# \.... #...#*.*. # .*.\..* \..\..\#
#....* .....#**.    .** .*\\*. .....# .  .. ....####.*..*. ....  ..#*... .... . .#...#.#.#  # *. #.#
#\..*#. #..... ...\.. .....\.  # . ..**..*  ...*....\ # *...**... #..*.** ... *.....#....* \......*#
#.#. .*  #.#. .....*.#.#.  ..   ...\.\ ... *.*.. ........\*. ....##  . *.. * #... ... .. .*  .\.#* #
##.....*\* . .*.... .**..# .#*..#.#\# .#.\#   ..# .....*.. . *..*#.*# #..... ....  ..  .*..*#.#.. .#
#*..#..#....* ....*...**...\* \..\.... ....*.... **...##..##...  .**. ...  * . ..........*.........#
# .\. .#*.... *.... .... *....####.... ..\*#..#. **.... .. #.*... .....#..#....   ...\...* *..*#...#
#**.#.. .#. .. ..#.....*....  *. ...##.. .*..#*#..**##..* .... .. .    \ \. .#.\......# *.## .. .\.#
# ***... ..*.*. .#...*. ... .. . .\.. ..#... . .*#....*# ... .#.  ....\..... .. *. # **. .. .. #.# #
# ......**  ... ... \..  .....*....*.#. # ... ..# .......#. . ........... .  .. . *.#.#\\*.  *..*.*#
#   . .*... # ..\\###. .*.#\.#*   *.. ...# .. ##* **......#*  .#...\.**.* ...\ *... .*...  *###... #
#. ..*....... # ..... .......#.#.... \...# ..\* #... ......*\..#....*\\ . .# . *... ..#....... # * #
#....# .. * *... *#..#.. ...#.#.. *.#*.  ......*. . * *..*. ...... ..  #.... ....*#.#.\... ...  .. #
#..\.....#\\...# ...#...# .....\** *. **.. *..*##\\#.# . #.\....#.....\\. #\#.. .#  .....*..... #*.#
# ..\#. . #    *.....#.*.*** .......*.*...  .##.\. .#*.. . .*.#.*#*......** .*..*#.*.###. ....#...*#
#. ... .....# .   #.....#..... .  #. .* ..* #. .#....*.*...#.\*.....* ...*. .   .\ .... ..#..*.....#
#....#**...\# # .\.. ..\... ..#.   ... **.*#.  ....\.**.* ....#.. ......##.. *#.. * ..#.*. . #... ##
#...*  *..... ....... ... #.* ...*......\..**# ... . .*.\ .*. * ....# \ *. ..#*..* ..#..   ..*...*.#
##...# .#\*..#.. *#.#...* * ...##..... ..#...*#*..* .. . \   #  *..... . ....*.# .. . #........*...#
# #.. **#.##....#\ .#\#.. .*.*...*#... .#.\.#.. *.#..*.....*..#*     .....  ...*.. .# .   #.....*.##
#\ .   *.*..  .*...*.....*\.. .. . .#. .....#.....#....#.#.*..*.#.. .\* ......  #* .#*\... #\. ..\.#
##. ....* . *.  #..*\...*..... .#.. .. # ... .. ....**#... #. ..\....*.*.. *\. .\....#.\ .\*...\ *.#
#. .*.# \... *..#. ..* ...##..** *.#. .. ... ... ...\*  #*\  #.... ** .**..*\... ..*...*#......\.  #
#..*. ...#\.*. .....#.. ...**.. *.# ...# # ..... . ...  ... \# ..*\.##.....*.. . ..........*   . ..#
#.\ ... .. **.\.. . . .*#*....#*** #...... .\. \ ....*.*.. .#...\.. . #....#*.  . ....## . #  .\ * #
#.*..#.... ...#..\#.#......#....* ..... . ... ......... . ......*. ..........#.. .... .. ....\ ....#
#...* . .........# ..\.. .\...#  .*....\ ..# *# .*....... .*#. .\.    .#   * .#. . #......  ..# ..##
# ....\.* .*.....#. .*....*......*  .# .**\.# ... ## \...   ... . .\\.*..#.*..*...  ......  ..* .. #
# ....\.. #.\ .... ..#.*..*.#*# ..#.\.. ...\. . ... ...\  \\ .# . ***. * .*..  ...*....#. #. \ #...#
#.. ..#* ..#.. ..*.*... #..*..\. **..#.  .***...\...#.... ..*#.#*..*  ..  . .  *.#\....#..#.# ..  .#
#.##  *...\*  *.  ..*...#  . .*. . .... . .#.  \. #  ..#  . #  .*#** *\......\.\. ..#..* ....\##.. #
#.. . ..\.... .... . ..\..........\ .*.. *......*..... *.*\..\*.#.*.***  ..#.#...*  # *#\*..#**#* *#
#*.#.*...*. .\\.*..* #  .\.. ..*.... ..##.  .#***......  .*..#\.* ..  * #*..*. .......#.. ... *#*.\#
#*# .  * . . .#..*.# ...\.\.#  .*.. #  #...#..#.*\.**..\.... ..* #..\.......#.#.*...##*..#  \ .....#
##\....##* .\  .#  .\. ....  ..  ..#.. . ... #....*. ..#*..*....* .  ........\*  ..*..*  .....\.#..#
##.*.. .....* \..\\*. .#.*  .. .. **... ..... .*. . .*. *..*#  .\.#.##*\\. ...   .  ....*..**..\ ..#
#.\.. .    ..#\   ....  *   . . .#*....# ......\###\\\.  ...#.#......    .* ... ..#  ..  . \ * ..\.#
#..\ ..*....  . . ..\#.#.*..........*. # ..*.... ..#**.# .... *.. ..#.*.... .#  .\......#*  \* ..  #
# ..*.*.*. .. \...#.*..\. . #.*..#\..* ..#...# #.. ... . ......#.. .... .*........###*.#...  . .   #
# ..*.......#.*.#\*\...*.........* ......##.# * #*. .**.   ...##......   . .   ... .....*.   .**.* #
# ...... *....# .\... #...\.*\. \. .#..*.....*.*.*.  \.. ... ..*. .*..\. .\... .#......##\\.. ..\ *#
#... *. *.#.#.. .\  ...\*#.\. \..\#  .* .\.  ...#.*.... ..# ...*.. ... #..#.* #..... .*.#..*#. .\#.#
#...   ..#\##....#..*. *...**..# .\....*....... ..*.*....... #.. \ ......*.. #*  **.*.***. .. ..## #
#.. .#...**.#*......**  .  ... . .*... #..* ....#..  . #*  ...#.  .#... ..  .... #.\*..#.*. ..**..*#
#..  #....#.*\. .. .. * . .\. ....#..  # .\..... .*..... ...*# #.........**.*....#. ... #.* #*.....#
##.*  .*.. .# .. .  .    .. .....\. *#..#.   ..#.*.  ..\. .  . ....  . ##.*#.# *.#***  .. .........#
#....... ..\..#.* #.. ...*......#..## . .*..\ ..#.. .#** \...*..*..* # ..*# # .*. ..#. . .#.....   #
# #.....#.*..#........#.  . .#.. #*.  # #....*..#\\..#...*#.. *#*...  ..#*.*....\ ....*#\*\. .#.#*.#
#..*##.* \.... .  .....#* ....  . . #\.#. \...... .. *.*#.....  ..... #...*.. .  *..#*........ ....#
#..\ ... ...#....\...#...#. .*.*  *.* .#. ..* .\.#.  ...\... .... \#.....\..*\...  ...*...#.. ....*#
#* .  ... .. .......\\\##... .#*. \......\ #\... ..\ #\#.#..... .. ##*.... ..#. ... . .. ....... . #
#..#.\....  .# .  \ #.\  .. . .  \..  ...*.........*.....#.\.. *.. *...#.#  ...*....*...#....... .*#
####################################################################################################