##############################################L#####################################################
#\. *.. ..  # \..... ...............\ *.\..#.\.*... ..#. # . #.*..#.\.. ..*...\\....#.*..*..\*  . .#
# . .*.. .. ..##....*.\.  .. .  ..*..# ..#*.. * ......# .*.... \.\. .*.#..    . .... \.  *......  .#
#... .#\.... .#\. .... #...\*\. .. .#... *.. .#. *#. #\.....*... \..*. #\..*#*. \  \. ... .# .... .#
# #*.... #*.\....#.. .... #**.. ...* .  ......#......\ .....*.**....*#........ *...# .\ .\..\# .\..#
# ...#.# ..  ..**#. .. ..###....*.* # .  *#.*.\ **. ... ..# . ..# #. ....  *#.\#.#......*  ..*\. \.#
# #\.*... *. ..*. ..  .# .#... .#.*.*.....*.\..\.*.. .. .. . .\#  #....*.**.....#...... .##.... ...#
#... ..*.\.#.\\#..**.#. ..*.#\.* ** \*\*. #. . . .  .*..*. . .*  ..*.. . ...**... .. ....* .....**.#
#... #  ...  *#.. .#.. **\ .\..*.. ...#...\..**\* #. ..#.*... .#...........#..#  ##.....*. ... .. .#
#.#\... . *....*.............. ....  \ .. ..#......*... . . ## ...\*... .................*. ..#....#
#*#... ..\..... # .#...\.#...... ...... #** .\...  . \##..... \. ...# .*..\ ...*. .. *. ..#..... ..#
#* # .  .. ..*. ..  ...... . .#..\.#.\ ...... *. \.*  ..\ ... ##.*.     ....#\. ....#..... ..  ..\.#
#. #.##..  *\..\..# .# .. .\# . *..\#*\ *.  ..* * .#..*. . ..*. #** ..\...#\.. .... .. . ..   #  #.#
#... . #..*  .....* *.***.\.. ..#\ .  *.* ..# ** # *.#.*...... ##...# *... ....**.... *# .*...#. ..#
##. *.*#*... ...*..*#** ...# ...  ..#..#.*....... . . *\...* #.... *. ... *. .. .. *....#..**.** ..#
#..#.  . .  ..*.   *.#.# ..*#..\ ...#..\. .#..*  . \.*   \ *.. .. * ... \#.. ..*.#..###.. ...#.....#
#. . ...#. . . \...* #.  *.*.\*..* ...*.....* ..#...#.. .*..*  . .  *.#....* .*#.\\*#.#... . .... ##
# .  ...... **.*.  *.# #......... .# . \ .* ..........# .... \.*.**.## #. .\.* #..*.*#.#.#. .\*##.*#
#... .* *... ..*......#......*.*. .*.#* . #...*. ..# .......#.. . ..#......#. ..#.... *.... *... *.#
# ..#...***. \.#.....* .... \*. .#.#*#..#...*.. # . . ...#.*.#* ..*....\#....*.*.. .#*..#..** ..\.\#
#\*.. .* ..... .#.#...\.*\ ..... *..\..... *... .#.\..#...* ...*. ...\*... . .*... . #... #  .*\...#
#. .\..\#..*............ ...  ..... ..*\....*.#... .**.#..\.\#.. ....*...*.#*.\#. .#.  *. ...*.  #*#
#* *.... ....*. *. ....#.... ....  #. .\... . \.. ...**..*#. .    \# *...#\.....*..* #. .. . .* # .#
##. ..* .. *.# #*.*\ ..#  .......*.......*.# .. .** .. .\#\.. ...# .. ..\...#.....\#.. *\*  #   .\.#
#*   #.# .. . #. . ....\#...*... ..    .  .# ..   #*##.....#.\\. ##....\*.*#.. .....*.**###.* #....#
# \*..#.#..  . .  ..\..*. .\.\.. .... #\. .  #...  ..#. .... .* ... *....*##  #....#*....#..#\..\..#
#*...#.  .* ....#* .*..# .\\. ..#**.#......##*. \ ....#. *....*.. \..  .* ...#. #...*......*#.##.. #
#.... ..#..#.  .*.*.# *.\.. #.. ..*.\.\.....##..# *.# ##. . .... .*\.\.......#.#. #..*.*.. .#.*#.. #
# .......#  \.... *.. . . .....*. . .\. .*....\... ..# . .....#.*.......\...*\... ...*.#..#....#...#
#. .**\*#.. .. *.*#\............ . ....*........ #.**\*.....*. .. .#...* ..*.. ...*  #.  . .\  #.#.#
###.........**... #  *....**..*..  . .\#..# # *.. .\. ..*... .  ......... .**......   \.. .#.. . *##
##..   ..#\.# *#*.\.*.........#.#.#. *.......... # ..\*.. ..#  ....#.. ....\\.. ...... .*#..##... .#
# #...... ##..##.#     . ..\*# .*........#....... .. ..*#*......#.*....#* *. ..#*..# .* **. .  ....#
# .*.... * .*. #\.*.. . .#.. .* ...#. ...#  ... . . ..\\...# .....# \.*  . #. .  .......*.**#\*..#*#
#.  .*#.  ... ........*......*#\.....\....*\.# . ...#.**..* ..#..*...#.*   .*..*.  .\  \.... .# . ##
# .. .*. ..  *. ...#**#.  .....#.... *... .#....*. ..#. .*  .## .#....\#\ .......... ..   #  ......#
#.. .\ .\\.\ . #...#..#*.# #. .....#... ..#\. . . #\...#....\.*.* .. .*#.* \.#..*#. ..... .  ....###
# . . .\... . .*##.  *#.*. ...\.\ . .* ..\#..\. #.....*.  ...#.#.*# ...**#*. #..*.. ..  .. #.  #...#
#...##*.*.*..#.. ....  *  ...# ...*. . . #* .. . ..#.....*.......*....*...  .*.*...... .. .  . ..*.#
##.#**#..  ..... #\\*.# *....*..... ..*.* ...   \. ..*  **. .. . ..... *.#..*..#\..* #. .. ......*.#
# . *  .. #* .##. ..  #. ...\ .\..\..*... .#  ....#..#........... . \.*..\.......**..*....\\..#...\#
#.#  .*# . *. .. .. ..*...*.#. . .... .*.*..#....# *\#\# #......*.* .#. #*.#*.. # .  ..  ..#*...*..#
##.  \ . ... #. #*..#\.... \..#.#..#. *.....\. ..#  .... #..\...  . #.\...#.... .*#..#.# ..........#
#.....#..\.\* ... .. *\  * . * .#.\....\.. ......\..... ...... .*.  .# ...***......... \...*..  *..#
#. #.... * .  . .. ....#...*.*  .#. ....**...... .... ...  .. . * .. .##..... ...*   .  .... .\ ...#
#\..* .*.* # . * .\..... . ###....*  .* .. \.##..#\..*..#...\ # *  .*.* \....#.. .#.*.#. .. ..## .*#
#.*#*.##. #..# ....\#**.\\..... ..#...*.#.....* .. ...**.*.. ....\.\..\*... #*.##..#\....*..#.. *.##
#*... . ...*..  *... . .. .*  . ## .. ...*.  .#..  #\.  .  .. .\\#.#...\ #..*. ##..##\.*# *... * ..#
#.#.***....##....*......\##.#....\.***.#. ..*.*.#\ ... .*. #...# .*#..... .\.*........  # ...*.*...#
##\..#.*  .#...*..... \......\..\. .. #.\ *.\.  ...#.#.# .#*.. *.....*..   .** #.*.. ... ...**#.. .#
# ..    . \  .*...#.*. .. \ \*..............\ *\. ....*   . #... ... .* .* ..... .. ... ...#.. .#*.#
#\. ......*....\. *.**.*..**#...#* ..... \ ........ .*...#...... ..#\.*..... *.. #\.. *.. . ....  .#
#    #\ *. .. #...** .* ... .*.#.#... .. .\#*........*.\.#... # .## .. ........\\.... ...##..\ \.\.#
#\. .*...##*.. ..  . ..  \...\# ..#...*..# . .#*#. #*. #\.........\.\#......\...*..#..#.\..  *.** .#
##...\# \*. #.. . .#**....#..* .. ...\ .. ..#\.*.*..\.. .*..# *.\*..    ...*#* #*.*.**. #\.#*  *...#
##..\#*. *.*#.*..#......#  .#.....* *#\ ..*.. *....... . .#.\ #*# ......*#.#.* . \.. ...  .. #.....#
#.. ..#*#...\....#.#..#. .#..#..**..*   .... ..*.*... .. .. #  #.# . *.#.# *..*#...*.*......**...\*#
#. #\.#\*.#.*#.... *.  * #..#.....#.... ##.. ...#.#  ....* #...*. #.*.##... .*.. .# .. ... ......\.#
#\# . #.... .*..**... * *#*...*...#....  .  # * *.*  .#\ ...\..\.* ...  .#. ..*...\.. ..\... #.  ..#
#. ... . *.#\. #..  .. ....\ #.*...# .\#. .. \.#..#*...\...\  ... .#...\ * ..\#. *.* #... . ....#*.#
#.*#..#*.. .....\... .....\ .*........ # .*..  #. .\...#***..***. \#*..##*##...* .*...*. \*...# . .#
#...*. #..#....\ ..\ .. ............ . ... .# *. .\.   . #\.\.. ....... #.# \..  *.. *.. . .... ...#
#.#.#   ....\.** ....*... .\... .. .. ....**..... # .....#\......#.. . .#* .#* #*..#... *..*.......#
#*..*... .* #. .*.. ....# * . \.*...#...\..*\*.* \. #\ .##. ... . ..  . .. ....##..* *. . .**  #**##
#*......*..## ...#.. ... .*..#...*.# . ..  ..*** ..#.  .##.....# .....#.  ....#......#..*##......  #
#..... ##..#.. . .*......\.. . \# *.#. *   . . * .*. ..  .# * \#*. ..#*\#... .. . ..  \...# .*. *  #
#.... *.#.. \.#... .. #....  *\*.  #** ......#.#.*##.#*...... . .*.....*. ** *.\   .....# .##*...#.#
#...  .. ..\#..*.. #. # . .*....\\#.#.......\ ...*.\.# #\.......\ \\. .. #....*..*......  .#..\#.  #
#..#.*... .... ... ##......  .. ...#*. ....... .##.. #.*. . .. ..* .#.. . \.. #* ..  ..* #.\.. .\..#
##.....\ .*\..# ..*. *.#. ##*.*\. ...\##.*.\##. ...*.  \.......  \... .#..#.. *. .*#.*.. . .#. ....#
#.. .  ...###.......\.. . .... .. .....*...#.*.  #..\ ...#....#.. \.# *. .\. . .\.\* .#*. .##\.  ..#
##..\.. *. ..... #.  ...\*...#. ......*..#.\    ... . *# .#. ... .# . *. .........# . \  \#   .....#
#.... #....... ... \ .*.*\..##.  .* . ... #...#.\..#..  .  #\ ..#..**..... .\ \..\.#.. ...#.. .... #
##.......*..*.. *.#...  ... ... ........ .***...**. . #*.#.\.*.  *..* *...  ...... \.*.... # # .*. #
##.\#.. ....*.\....*... ..... .#. ...#....#.. .....*..\* \. ...**..*..***    #\..#\#..#.... .#*....#
#**..##. .#.   ...#   \.#....*#**..* ...  # ....* .\. ..* .#. . . #..*.\#.\...**#. *.**\..  *  .. .#
#. .*.* .....\....*  *  .. #..#. .. ..   * ... .  ... ...##. * *.....\... ......\...  ..*..# #... .#
#\.\#...*.#...*.. .* ........ .. * ... \* . ...... . ..  .....*.... .#    ..*...#......\.#...*.    #
#.#..##*# # #.#.. .... .\..... #....*.*...* .....    ..* #..#*... ... .  * ... ...... .... #*.*.  .#
#\\\#...* ...#. ...  .. #.#\.\* .. \# ....... ...* **..* ......*..*.**.#  .. .. .....#.*# **... #..#
#.... . ....#.*...#... ..\....*... .....#.. #.#........... ..\ .\  .  .... \. . ..#..*.#..........##
#... #....*#... .. .....**. ...\ .\#.. #..# .... *..  ... **.. *# # .*.\...#*.  . . *.  .........#.#
#..*.***. \\.....** # ...#.**... ....*.\*.*#..#.\. . ..*#*\ #.#........#.#. .#..\.\. *..* ....*....#
#*.*.. .R ....#*\..  *. .... .....\#.........   ..#\#....* .*.. ..*..\.. \.#*. \...  ..  #*.#. .*..#
#*..#*.# ...\ # ..#...... #.*. .*#.#  . .*  .*...#....#.** *.\**... ... . ....*.. .....\ *.#......##
#  . ..... *... .* \ .. ...*. ......#.\.**#...\\.....#....## ### . * *....\....*. #.. # .##........#
# ..# *..\#*... ..*.. * ...#..\ \. ... ........###. .\...\. \......#.. .#.#.#..... *. . .. ..*#..# #
#... #..#.....  *#...... ..  # *#.#...\..... ..#* # ... ......\ \. . *#.#.\.....# . ..*.#*........##
#... ....# ....#.*.\.. .   .#...... *.... # .....*#\# *.#.   #  #..\..*\ .... .\.#\# .\..\. .*. .  #
#. *.**. ....*  ..# .. .##..*.*... ....# ...... .. .. .\*..... .....\ * .. .*.\... ...\ . . ..*.\  #
#.\..*\ .* ..#.*  . #*. . *.... ..   \#  .* .\ *# ....#....\*.#*.\ ..\#....\.*.*.. \*..\.##.* .... #
##.#*\...\  \......*..... #*#*# ....*##.. ..\.. ....  *. .\....\. *. ##.#.........  * **.#..*....#.#
#...  . *.*... .\.*. .#..*.#.. *..\ ..#*..*#... *#........... ....*#.....#  ..* ..#\#*.*#..  ..#.\##
# \.#*\* .. ..*# ..#..*..#\.....\* \. \ \  \##. *........*..#..*. .*. ... ..# .....* .\.##...# ...##
#.\\ .*..**.##.#..*. ..\.... ** ... .. ..**.* .#.#.\*.###..#.* *. \. .....*.**..#.#..#* \ *...*#..##
# .\#   #..* #....##.##   ...\#*\.. . *... .#...... ..\......  . .##...  ...... .......*.*.....* * #
#.. . .\\..\..*. ..\...... * .\.\*..\......\ .\  *  ...... ... .#......# **. .#.....#*\...* ...* .##
# .... ..*.  ..*..\*\.*....*..*.....*.*##\#.##. ...\ .. .. ....## *.........\ .*... ..  ..*\..#.#. #
##.... .*#.......... .#. . ...*........*.....\ #..#.. ... ......* ## \ #.... .  ..*.. ...#..    ...#
####################################################################################################