#########################################L##########################################################
##......\.... .*... ..#..\. .#....\.......... ......   ......*... .*...#.*... #.. #....#.#.* *....##
#*........#    .... .... ...... ....\.. .*.. ..# ..*..#.\#. . .\....\*....... # #..*... ....#.....*#
##*..#..  * .*.. .. ...#. #  \..**. ..\.. ....#*#.#\ . .#.**\.#...#.  *...* #.. ...* \.....#.. .. .#
##.*.. .# #... .. ...... *.\........ .# \.#*.#.*.*.**.. ....*... ...##.\... ....#....    .**....#..#
###  \.\\\.#.#.. #.. .\* .... ...#..... .\.. ..... ....*..*. ..\.. .\. .* .    ..#.\*..*#.#*\.\.# .#
#.\..##..*.*.... ..#. . ....\. .. ...#** *\..........# .... ... # . * .#\ *....#*.\\.. .. . \ . *###
# * ..... .. . ..... #.# # .. #*.* . ..*. # .*..*#..*#**..*...*#   . #. .*  .. ..*. ##.\#..  . ..\.#
# ...*.....\ .... .. #. .#.\ . \..#.*#**\.*.*.*\..\....#......* .   \. . . #.....*.. * ....# ......#
#\. \.  *... .. .#.##..*.  .. .#.*.. #... ..#\..  .\\.........* *. \. # .... # ...  ... **. *  #.* #
#... ..\ ...... ..... .......#.#...     \#...\*. ...*.#\... . ...... ... .. .  . .* ......*#...... #
# ##...\ *... *#...##..  ....\..*....*. .. \......*. \.......\ # .....   \.*..*##...* . ..... .... #
#.* ....\ *.*#..\.#*..\... ..#...#.....*# .....*..*. \*... *.\\#..... \.....*. .###*.. *...\...# .\#
#.. .#.\.... ..... \ .. #..# *.#. ..* *.\...*.# #. .# ...#...  ...* ......\. ...*. ...... .. .. ####
#....  . .#...*   \#.  .\##..# .* *#.. .\. *#  #...\..\\ ..... .. * .##\. . ..#.....#.... \.  # .#.#
#..*.. *..  ....   .. .**#...#.. #...\ *.... ..\ .* ...#... *..*.... .*.\* *\..*#......*..#.#.... .#
##...... .#*#..... ##*.#\....#.# # ..\ *....#...\.##...\###*.\..#.\#. .. ... .\. .* *.......#...*  #
## . *...\#.... ..#..\ .**.#.........\ \\.\.. # .#... \##. ##..  .. ... *. **.  .\.**.*...  \......#
#. \ # ....\ *#.. *..... *.*#*..#  .*.#*... *# .#........ ...*..#.#... ....*..  ..#.. ..  .#\...#..#
#......#.. .*\\ .*#. . .*.. * ...*.....*.#..*. .....#.\ . * .. \#.#...  *  .. ....#..* # # .#...*.*#
#*..... ....\*.\##..#... ... .\ .....  ... *   ..*. ...#...#...*.. #.\  #*...\...\.##...#   .*.\..*#
#.... .#..#. ##...#.. ..##......##......* .#.. ##.... . *..#.... .. .. .   .......#.* *....... . ..#
# #. . .#.**.*#.#* .*.*.*... *.. ..*.  .. .\.#* . .   ...\ ...  . * #..*.. *....#..  * ..* ..\# #..#
#.*.** .\... .. .#.. *... . #*.*..# .\ .... #*..\.. ##..... .....#*.... ...#....#. .   ... .\ .#.# #
# .##.##.*... ....** ..*..# .*  .*....#..#......# \.*. ..##\.#.*..* **.*....*.....\......#... .*.#.#
# ....*....\*.* ........#.##.   . *....\. . # .*.# ... .# .....  #..#*.\#.. .*... *...\... . ..  . #
# .  .\... .\\*.*.#.*.  ##  . #..*.. #. .*...# **....... . ...*#..#*... . .  \ .*..*\...      ... .#
#  ........##..... *.......#......#. ....\.* \# ..###...#. .*  ..........*   #.*.......#.###. ....##
#. .. . ...*....\#...#  *.*..#..  .......# * ..*\. #. ...*\ ...*.\#.. #*.*. ....... .. .#..#**. *. #
#... *\. **.#.*.\. ....\*.*...#.\  \#\\  #....  . \#..#.**#. \.  #.# . .#*.....#.*.. #..* *\.. # .##
#...#... .\. .... ....... ......* \..#...............\*.. ...........*  ........ .. ..*.#. # .#...\#
#. #.*.. *\. ..*##. ..*.\.*...*.#..#.  .\  #.. ...* .\.R ..  ....#..* ..# \\.. *..#\...... # .*..  #
#..\*..#.....#*. ........*. . *.\...**.  .. #... #... * ##........#\ .. .*... .. *# .*. .#*.*###. .#
#.# ......#.#  *\ . .. . .\## ... #*#* . ..*... .#...#..*..#.\... . *... \\\ .\# **..#.#  *...# ...#
##..#.*.. #. .........# .*....#.. .   *....\ . .*...#\ .**#. .\... ..\*#. ...***....*. .*.....* \ \#
#.#...  \...# .  # .*##.......\... .... ............. . *#..*..*.\#. . **.#. ...##...... .. .#...*.#
#.*....*. ..*.*...#\. .\ .*#..*#...* #*... #... ..*  ..    ..\... ..........*............... ... #.#
#\\. .. *..\#..# .* .*#...* .... \..##.\ .#.*. #*\.*#* .  \****#..*. .*#.  ..\.. ...#..  * ....\...#
#. #..\#...\. ......#.#. *....*.* *..#......*   ...**..*....* ..#  #..#*.*..#. .......#..*. *... . #
#.. . ... ...*#.#*... . ...*.. ... ... ... #*##.*\#.#\\ . .*. #.. ## .. .*.... #..**.. .\... *...\.#
#*\*..  * .*#.. \ *.\*.....# ...\...*.*..... .#..*..#..... ..*.#*....\* .... \.###*#\.#...*#.*#.**.#
#*#. . ... . ... ..#..**.\. . #........ ....##...\* *.... #... . \. *.#\# ......*.#\.. # #\..#*#...#
#....  ...\.*.**..#..  #*.... .   *..*#* .*..   *...# .. ##. .#. .*..*\.. .. ....#..# ..... ..*#..##
#.. *.*. .*.*... ..  ..... .\\#  ......*...*..*.#..   ..... ...*..\...#.. ..*.\.#\.. *....... .*.* #
#* .   .. * ...**.*##*#*#   ....\ ....  #.. .. ..#.#.. \ \......#..#.#.*.....#...*. .. ....  .#.##.#
##.*... .... .#... ...*..*.. .##..  \....*...\*... .##......#.\#* . ..   **.*  \\.\*#... *.#*.#. #.#
#... *..*.....*..# ..##.*..#.. #.\ ..... *.#*  .  .#**#....\.\. ..*.. .# .. #.*.. ...... . #.. .##.#
#..\#. * \....#  . ....# . .#..  \.#. \....   .#.# . .... . ..\. ......*..*. *.#.. #*. . .#  * .\..#
#\  ...#.# ... . * #.... \. .. ..... *........*......* #.**#...\*..#\#\.....#....\.\. .#\*..*..#* .#
#*.\....* #*....*. \...\..** *.. *..*... ....*. ..\..\. ..*. *..#* .. .*...  ..# ..#.#*..#...#  ...#
#.....#.. **..*..#    .........  *.. *\. ..*.. **#...#.\. . ..\..........\...# ...\*.. ... *..... .#
#..*...* ..*  ... ...... .. # ........ *.....*. *.  ..*...#. . *\*..#.. . #\.  *..#.*   .#.. ...##.#
## #.  #.\. * ..# \.#.. .. ..#... .. \. .. *.# ***...#**..  ..\  . ....#.\.#.* ... .* .......   #*.#
# . ... #.#. .#.#.#.\ \ . .*\ . . ........#... . . *....  *.. ..... . ....*. ....** #..*.....  ... #
#. \.. ........ *... .##*.. ...\ #*.#\.#..#. .#.# ..#   # #. . #... #... ..*#. .... * #....#   # .\#
#. .... ...\.*.\* ... .*. * .#**..* .....#. .. ..# .* ...#*..*.#\ *.. .#. . .\. ....*.  *.\ .#..#..#
#  .. *..#...#* .#.......\*.. .#..# .*... ..........#*.....#.#*. ..\*#..\#. .\. ....*. ..  #*.*.#\ #
##.#..*.\ #...# ..*.*........*.# ..#**...#*.. #...\# .. . ......\.#... ..#\*#........#.... #.\ . .\#
#. *#.*.... \.  .* *..  .. \..... .. .......# .**#..\..*..\\.#.#\ .  *... *.. .... ...*.#   #*.   *#
#\.. ..\. .* .#.#... ......# .\# .*\.. ... \.. .\ .*..*..\..#..# .. *##. ....  * .. . *..#.. *. \  #
##\..#.*#*....\........*.# .\. *.*...*..  ...*.. ...**....#.#.#*  . ..*.* ...\. .#...... .#* ...*..#
#..* #..\.. ..... ...\.#...  .  ...**...##...#..*.  .*...#.*  . .*# ..  .......# .#.... . .# ..\ . #
# **.# #..  ##.. #..   .... .....\ .    .... ..#*.. .\...\.... .\.. .#  . *.   ....... .#. .*.... *#
#.\. ...... .. .# .......*..#. .# ##.#\*.... ..*\.  *..*........\# . . .* #\.#...... ... .....\.*#.#
#...*....*\*#.\**#.... ....\ ......##\ #. ........ ... .# # .......... ..  .\..  #..*.#..#.. .*\*..#
# ...\\.\. \\   .. \ ...#........\...#.... \* ..*.. ...#. ...  *.\ ..*\  .. ...*\.. .. .**.*\.** .##
##. ..  #.. .  .. .. .*. ....* .. .... .*..*..#.#.\. *\#* #\\.. ...** .#.............  .#.#.  * # ##
#  .....   ..* * .*.*. . ..*.... ...\#\.**.#\....#...\..    .  #.. .#....   #*.#\..*.  ..*.......#.#
#..  #..... #\. .. ..* .... ..#....#*  ...... \#. \..**.**.#* \ *..... *.... #.. # ... #.#.*# \#...#
#.\\*   *#  #...  .. . .... .*#*....* .\..**.. .#.....**.\.. .... *#... ..... ..# #...... .. . \..##
#..#.## . ..##... ..#.*.*#..#....... .# *. \.... *.\ *...\*#.....* * ..* .#. \.#....* .  ...*.... ##
#**......\. #. . # ...#.#*.....\. \...  .*. ... .. .#. ..*  ..\. ...#..* #... *...  ..#*..*..\* .. #
#. \ .. # *...\*.#.. ...*...#..#...*... ....#.. . **..\ . ## ....#.  . ............ ..*.*.*.. ...#.#
##.  ......  .** #*... . .*..**... .*.  \*.....# .....#...*..*   .  ##...*\.... .....#.... ..## ...#
#**....*...........*. ....*. .. .#.. #   ....* . * . . .#\*....#  ..........   ...#.......* #.. ...#
#...*. ...*..... ...#.....#.. *  ..## ..*.. *  .. ...##.*\.\...#. .. *.   .##. .#*..\\  .*........##
#*...#... ..#.*.#... #. .. ........*...\.. ....\..\  ..*. #\ .......*....... ....*..\..# .  .**. .##
#. *** ..\ ...#.\*...\. # .. . .*. * ........ # \. \#. .#.#..   .\ ...\* .... # ..*...\.#...\#.....#
# # *..* ....... ...*#..#..... ..**.*...\* .\.  ...#* ...... ..... .. ..  ..*.*.....##  #....  #. .#
##...........#. ....*#... ...*.. ..\.. .*  ... . *..*  . ..... #.  # .... ...**....  #\.... .##.*..#
#..* .*.. .. . . .  .....*..*.... ..#*. . ........*.\.* ..#... .  .#.. .\#.# .*..* .....#. ....* ..#
#*.# .. *..*....... *. ..#.. .*.\ \.\*. .*.*. . #..#.. ..#*......*........#. .* . . . ..    ..* \..#
# ..\.  .*...# ..*.....\ ..#.* ..#.* #.*  . .*..# .\.#...*... \.  ..*...#...... .#\.  *#. *.# ..\*.#
#.\ ......#....#\\.\.#. * ............ ...# . ... .# #.*..#. *..\*..#.....  ..#... #\... #...\. * .#
#*.# #. ..#. .*.**.... \..... ..  .#.* .**..*....... ..\ . .....* .. \..*#...... ..#\...*...... .. #
#.....*.. \..# ....#. ... .. ..*...#.... . \#.\#*.  ...#.*.#. *.....#..#.. ... *.#.*.#. .. . #..*..#
#......\\.....#..#.. .#. #...*#* .....  .....#*..#...\#... .# ..# .* #\.. .#...#..*.#..... .\... ..#
#\. .#...#.*.. .*. .. ...\\ ... .  ....*#.\\ ..*.... \   *..*.*.\.. \# .  ....*.# *#..*.... .......#
#..# . . \.... .#..#..#\..# .\ *\.\ .... *.#.   #.#......... *...#...#...... .....#\..*.  . ..    .#
#.  * .. .\.*. ...* ...#.#...* ...\...#.. # .....#*...*. ..\ . ... ##\..   .\ . # .***.... #*.. * .#
#..   \ #...\. *...*.#.........*....  ..  .#....\ #..# *\ .  *....* .#..##.*.# .*.# ... .. ...\.#. #
# .  ...#. ..*..  ...*.**....# **.\.#..\.  .\....#.#..\. \*#.. .  ...  #\.#*#.\ . .....*.#....#....#
#.**.*. .. .. ... ... ..  .\...........#  .. . #\...#..\.. . .*..#\..\...**. .. ........\..#...* ..#
#.# . *.... .#...   . .....#*..\ ... . #*.  ..\ ...#. .....*.... .. .  . .....  ..#..\..\*# .. ...*#
#......\...*... .#.....*..... ........\.#....*.. ...*.#\..**. .#.. *#*#. . ......  .  .#. .. #** # #
#.#.. # .\#.*...\.# * .. .#.... *.  ....\..... *.. \##..\*...*#**.  .*##..#. ..\.... . ..#..# .#...#
##..*.*.....\#..** ..  .* ....#..#. .  .....##.. .*##...... ....   .......\*.*.*...#...\*...#.* .. #
#..##.#.*..  ..   .. .#.. .....#**.. #....*...#.#..*. * .. \\ *.* ..*#*........\*.  . *...#.# ... \#
# ..#.#\...*#. ...#....*.......#.. . *. .. #*.#  .. **..... \  .. \. #\\........* ..#. ...*..*...# #
####################################################################################################