####################################################################################################
#\..#.*..*....* ...#\...#.#. ..   ...##....*.\  \.**.#*. ..#...**. \ ..*.*  ...*#.*....#.#.... .* .#
#.....#. . # #....... ... *.\ *. #.#  .  ..#. *#. *.\\.\#...#.*...#.*............\.#.*.... .\..*...#
#.# ..\...\..*. .\ ..  ....#.....** # .#*.# .#. * ..*.. #. *\... . . ..#\....*...#.... #... .#\*...#
#..\ .  . **.. . #.#.#..#....*.. *.... .....\. ..#*.....*. #.. *...*.\   #...\*...##.. #  ## ......#
# .. .\.....#  ....#\.  \.#. .. .*#*. ... .\#. ..*..*...*. .. #..  .\. .. ..... . ... ....##..\*. .#
#....*# ..**....\.\.....  ... ......#### .*##..##* ..   *.# # *  ...#..#....#**. . ..*.. #**...#\. #
#. ##.. . .  ..*#...#.#  ..  #*.*..#.. #.  . ...*.  \..*#. . *..## # ... ..* . *#..#*.*..\\.#.. ...#
#......  #*.\....... .. ..*     . *..  .*...*. **#.#\  ..... ..# .. ..* ... *....\.\ .. #. .  ..\\.#
#....... ...*.. ......*\#.#...... . ....  . \ *.....  ...\...\.\.. .*.\*.*..*...# #*.##.# ...... ..#
#.*..\ .#.#.. ###..*...#.#.*.\ .  . \..  #..... .. ....#. #..*#.. . *.*#*.# ...\ ..  ....##..*#..\.#
#..##...... .\\.#....*. .**.\.#\  *# ...*..... . ..#....#...*.  ....... *\.#.... #...#* #.. ..* .\*#
#*.. ..*.. *.  *...# \###.*.*.\... \ *.\# .* .  .*.. .*...... .. ... . . \.    . .... .. .*... #...#
# \..# #.. .... *.... ..#..#. . ..*. .. .#\........... .#..*#.*.... *....\.*.....\.  .##.#... *\.\*#
#.# \..* * .#.. . .*#. .#..#.\#.*.  ... ...\ .. #.. \....*...  ...# ..  ....# ..\.#...*.*#.\#  . .*#
#...  .......... .  .....#.#. ...*. .#\ #. *.* ...*\ * *.*# \#. #**\  *. .#.. \.#....#. #.\...\..#.#
# * ..#.# ... .##. ....# #  # .\...# * .*. * .#... ...\#..#. .\ ..\##.#*. ... .....\.* .**.\.... ..#
#.  ..*.. ...\... ...........* ...**.. . .** .\*#.. ..*  ...##...*. . #..... ... .#...*..  ..*....\#
#........ *..#.  .#.#.#. ..**....*.#..#.*....##.# .  ... \#.*.# .*...# .**...\.\ .......*.\... ..#.#
# ...  *.  .......*#.  ... ....\... .....**..\.. *..#.* **.. ..*.. ..#.*..#..  ..* ...* \..*. ... .#
#* ...#..*..*...* . ..\.*...*# .#. . ..#. #..  .#..... .. ... .  .#.# *........#. .....##...\......#
#*  .... ......  # ...#......#** ..*.. * .*...*.#\ #...*...... ..#**...  \ . . #  ...  ......  *#..#
#.#. *.  ...#. .  ..*.*..# .\* \ . . \#. .....*   *  ##\ ...*..\..***.. ..#.... *..   ...  #.# .*# #
#.*##*#* . .*.. ..#..#.* \ *.. .#..# .............  *..#..\. *.#...#\##..  *#... .#.#\... #. .. .*.#
#\#......... .#.## ##*..... \.... # .\.# #. ..* ........  .. \.#...# ..... .#.. .....*#. .*.*..\#.##
#* ....\.#.#\.. ..#.......*#  ..*.#...#. .......  \ *. . ...*...  .#*.\#.#*  . . . ##*....# .#*##*##
#* ...#... * ..\.#..#....#  . *...*.....#\*....#. ...#... .... \.\#.. ...\.*.  ..   .#. . ..#.#... #
#\....#  .....#.#  .... ......  *....*.# #..\ \  ..#*.#.#.....#... . ..#..\  ..*..*\.* * ## ... .. #
# .  .. .\\. #*.. . ..\...*....#.. .... . .... #. . *\.. .#\.*. ##.... .... ... *##..... \.. * .#..#
#**... .. .* #* .*....#.... .\ *.*.#.*...* .##*.*....# .  ...... * ....*#*......  #**\ .*##.* .# *.#
# .. ... #\ *..#.\..... *..#...*.# ...#.  .. *...\..#.*.  ..\\....#. .. ....*..**..  .. .*.#..# *..#
#...#*....**.#....*....*....*.##*    .#. . .\.#   .\...... .#  . .. *. .... .*..\.## .#.*.#... ..*.#
#....*.*.\ ....  #*  ..*#...#.*... ....## #.. ..\# .# .*.*.....# #  .  *#..#\. .  .....**...#*. .* #
#*... *#\\. . .\..... .*..*  ...\ \.. .. .  .  *.*#\    *...#**. .# ..#... #*.#\.*\..\. .#.....  ..#
#.#\ ..\*...\  .#... ..  ....  ..... .\* ..*  . *...#........\  ..... .* *.  .....*.# * .. .# .*...#
#..*. . *\.. .#....#. .......*.#.#*..#.....*..# .#*##\...#* . *.*##..*##.* .#. *...##.*.... \ ...\ #
#..* #.  *...*\.. #\.*..#... ..##....#.*. *. ...... #.....  .. . ....#.... .#.\.\.*. . .. .*#. .#..#
#.*#*. . #....#.....\ .*... .. .  .. *.#...*  *#... ..\#.# .# .....\...* **. ....*#........... ..*\#
#...*....*..  . ....\* ...*. ...\...*#*..# .* \. ..*..  \* ...*#..*..  ..# .*.. *..# \#...  . * . .#
#* \.. *.# ...*.#....*.. ..#.... ###..*. **. #... ... \#\...# . .*..#..... \ .*.  .#..........* ...#
#.*.  .  . ..\. .*# \\#..\.*.*.#*... .... .# .. ....  .#.\..#*.*.#  ........ ..*...**...\.#....  . #
#\#.*.\..  \. .#....# .. ....# .................#.\. .  .#.*......  ... .. .. . .#.\#... #..#\.#...#
#.. . .#\#  . . . . .. \..# .  ....\ \ ....#.. * \.*#....*#*.....\..... ...##.* ..\...   ....\..#..#
#.... ...........#......*.\.... .**..\....... ..*.*.* #... .*.*. . . .*. .. .*#..* .*#. .. .... .* #
#..* .. ...#... .. .. ... . ### .\.... ....* ... ...#* .. . #.#.*...\.. ...... #*.\. .....#..#...  #
# .#.\  .. . #  .. .*.  #.. . .**... *.  * . . .....# .*  . ....*. # . ....* ...  #*# \ . ..#..*...#
#..\..... ..\. #\*..#  ...#.##.. .*... *  .#... \.. ... ..*...* ..* #...#. ......... ... .#*\ .#*\##
# \..\ .*#\..*.  ..........*.\....#\#*. \#..*.* ...... .. *.... ..*. \  #* ... ..*.. . # .*#.. . .##
#. ..#..*..#.#. #..#.#.#.#. # *.. ** ##. ..\........* \.. ..\  ........#*... \..\ .#. *.. ..#...*. #
#**#....#........*.........*.#*.*#.\.**. ..... .\. ..\.. ..\\*........... ..\\. .*# .#. *. ..# . ..#
#. . .....\ . *#....\#  #*. .# ..... #. \*.  .*.....**.. ...  .. .\*.. .\....*  .\\..  #..*.#..# ..#
#.#.*#*.. *.. .\ .*.. \.#.  .  ...... . ..  .* .*..*... ....\.  .*.* # *#... . *#....\.* **. .... ##
# ..#*.......#.#..#.....#.#... ....*..* *#....*..  .....#\**..*..# . *.#.*.#. ...#.. .. .*.*..#.#..#
#*... ...#*\.....  ##....#.....*\\.#.. ...  ..#*...#.#.  .* ... .* \..#.... .   .#.\* *.## . .\*...#
#. ....... .. .... .** * *#*. # .\###.*.#.*.\*. #* .**.\. ..\*.... .... .. .*.. .#.... . #  .  ..*\#
###   .# *.#   .#*#. . .....*.. ..\...#.*.....*.. ....  ##. \ .* .....*..*## ...  .*...\#\ .   ... #
#.\..#..... ..... ..... ....* \.....#\...\ *..*..*..... . .. .#***. .. #... .# ....... .#...*    ..#
# ..  \.#.... . . . . #.\....*.#.\  * *.## . .#...  .. .. ..#......**.#.  * .*. *#*... .......*.*.\#
#..*..#..#..... #.. #...#..*.   .#...... . \.*..  ...*#.........*...*.# #\.#*.*.#.*  . ..#....*.. .#
#. . ..#....\.....\... .# #...... *..\.. .\ \*..##.#*..#...#*.###...#*.*\**..... ... .. #.... .....#
#*\. **  . . \ ...   .##*.* ... .*.## *#...  . ..........*\.. .#.... .*...#*.   ... ..*. ..  *#..#.#
#...# ..*. .....  *.. #... ... #*\ ...  ..  *... .*. ....#\..*#..*#.#.\ ...#....*... . .\ . ..*##.\#
#\# #....  .*...\. .. ...#.#  ..* ...  .. #..*...  *#**.........*.  #....#....#.#.. .. **.** \...\.#
#. ..#.\ . ...*. *.*. ...*\* ..   . . ..# .#.*  .  #...\ .  *.. ..... . #..\#*.* ..#* #..\. . .#. .#
#.. ... ... **....  .# .. ..... .. *..*..... . .#... . . *.. *...#. ....*. ..   #..##*.#......*.#..#
#..\... .. .........   .*.#.. ...\....  # .\..\....\....# ...\ \......#.#\...\.\.\..... ......#.# ##
#.*........ .# *... #..*. .. . ... .......\*.\* ...* #.\#\.....*. .*. \.....*...#\..\ . .... ..\.. #
#..*....#......* .....#..... ..#.......\.\ ...\*  *...*....#\..#.#.  ......#. #.  .... ..#\. .  ...#
#....#..*. .\ #. . ..   . ...... . #*.. #. ....#  ... #...*#......#  *..  **..* ##... ...# .    .. #
#.......\. .*. .#.*#*.*\#.\*..# #. .#.*..*#... ..\..... .*.*..*.... .#.... #.*# .  ..#... #..#.\ .##
#* *..\..\... .....#\. \ *....#... ...... .. #. ..... .#*..\.  ........ ..  .*# ... #. #..#*\.#..  #
#. . ... \#\.\..\. ...\#...#. ...*. ....#.*#  ..*.... *.  ..* . #.  ......#.*.*##.#.. .\. #.#....\##
#**.# \...#..#..R....*... *\ #...#.. .....\. *\.\.#....... **. ..\........  \.. \ .\#\.*.... *.*.  #
# ..*..\.....\* ..\..  . #..*...#*..\*. #.. * .#. .  ... *.** ...#.#.*.\#..*#*.#.\\..#....\. .  ...#
# .. .....\#. .*. ............*..#...#.# .\* *.........##.. \..  . ....# ..# ..   ..*.. .....#. *#\#
#....# ..* ..*. . \ .  .#..    \*.....*. ....   ##.\..  .. .*#* ...... .  .# . .#.*.\...\.. #. #. *#
#... ...\    .# ##. ...*...#   ...\#.*  \.....\.....#* #.\. ** ....*\ ...\ *.  . . #.#\. .....*.*..#
##\* .\#. ...\...##..#.*   . .  #.## .........*#  ...\ .  #* ... .... . ...*..\. \. ...\ *#...... .#
#*\... . ... *.#...*# ...\ #... ..\.. ...     .*...**.... ..*.....*..*..#.  .... .# ... * .\....# .#
#.  *.# ..#*..  .  ....** .*.* .## \......... \. *#  . . #..  . ....#..#.  #... *..* #. *.*..*.#   #
#. #..\... ##..*. *.#.......\.## ....# .#.# # .##*.*# . ...*....#..... ..\... . *.... .. . ..  ....#
#.\.. *#....*#. .#... .\.*.##.. .* ..#. ..* ...*..\.. ...##. .*.....\.*. #.....* \\.. #..#. ..\ **.#
#\. #...... . #.* ....* .#*..#. .... .*....*.............# .#* .... ..\*...... ...**. . ...* *# *.##
#*..  \.### .   .*.   . ...*.. .*. ...## .. ...  .......  .## #*.....\ .. #. ###...#.. ...*.#. #.*##
#....#* *#.. . . . ..  ..\.....\... .#.\. ....  ## *\*. . ...*...#.#....\*.\.... \.#. #..# .. .\...#
#*. *...*# .*.\.. #...#.... . .     .# .**.*# .*..*..  ... *..  *.*..\.   .. *.\.\.  ..#.. ..#*.. .#
#* *.......* #.#...\## ... \..# . ... * .*.#..*  ...#.. ....*# .*. ..#. #...... .#.....#....## .*..#
#.* .#..#**. . .......* ..*.. #..  .  # . * ... *....  ..*.\..#.. *...  ..*.*.  ..*\.*.....   . .. #
#.#. #.. #....#..*.*##... *..#.\ * *...#. . .##.*.. ...# ..*. ... ...#... * ..\#**.. #...*# .\#..#.#
#. ....#. ..\...#....\... #.... .....** #....#.   ..... # ..#..# .....  .....*..  \... ...\ ...## .#
#...#\*.#*.*...##.#. #.\  . ...*    ...##   # .*.. #\  .... .\. ..*.... ...  .\.\#*.#*...* ... # ..#
#\.... ...#*..#. . #\...##.... . .. .. .\\#.*# . .. ...##.#. .... .#.. .  .  ... *.. .*#*.#.##. \..#
#*. . ##*. \. . * ..*...## \....\*.. .....\. . .*.* ...*....#*  .#. .#. #*.#.  . ....* .*.\. ...*..#
##..# ...*. ..... . .. \.##....*##..*# #.  \#\\\......... .. .* \. ....   *#  *..#.*.#............ #
#...#.....   .* .#\*.#...#...#*...... *#*.. . ....  .. ..\   ..\.......\..*....\.*.....#....   . *.#
#....#*. . \ *.. ..#...#*.....#..#..*#*\.. ....* *.\..**\. . .*.#*\\... \ ... #....#.......#** .\..#
#.*#\.#. .....*.#.\.... ..*.   ..#....*** #. . .... .##.... ...  ..* . \\.* .... .*\ **.#.*..#..*. #
##....#. #. .  ...# **.*## *...**. .  .. ..*.*.  #......**. .. ..\*.....#.. .#. ...#. ....  ##.....#
#.#..*\.....* ...#..#  \ ..  #. *#........#.* .*.*. ..   ... . ..* ... .*\. . *..*  ...#..\ .. .. *#
####################################L###############################################################