####################################################################################################
#\*.#*#.. . ....# *   .... .*.....* ... ....#..# . * ...*. ..* .*. .. ..  ... ** .#\  .. *  \.#  ..#
#. ....**     .** ......... .*...*  #.... ..**    ..  .#. .. #. .# .. .#*...#.......   #.\**.. ...*#
#.. *..........* .##.......*.\##*.. .# .... .. .# # *. ...*\#.##\.. *.#. ...\.*.\ *.......\*... .\.#
#*.#.#.*.\....\......  . .# #.#.#.*..*...##\*.**# .*.. *.*. *.*..##. .. . #.#. .*#..#.....#... ...\#
# .#... ..  .# #..\... ...##. \.#*...#.. #*.....*#.\ * ..\*...\...  *. ...## *..  .. ..*.....*#\. ##
##.#.........*\..*.#.. \#. .#... *.*#\....\.....#...*.*  ...\.* ..  .\....  .....\. ..\*.. ..\#...\#
#.. .#.* .*.* *...*.\ ..  . .\....** . *. ..*...\ .*..\.. ......#.# ..   . . ...#*\...*..*\.... ...#
##*..*. .* #.*..#.* .. *.*.  .#. .........  \.. .***.\. .*. *.* .* \.....#....* #.....\* .. ..# * .#
#...*..##..#.  ..\.. .\ .*.. . ..\ .......#* .....#.... #.  .*. *#..*..\.......\.  .*# .....\ ..# .#
# \#. ...##. ..... ..# .  ...*. \  .#*..#. ..#...*#.  ##..\.#\...#* .*\. .\..*.#.#.  ..\....*..  . #
#..#..\# ..*...\.*# #. ..#..... .# ..... ... *\ .  **.\.*# . #  #...  . .\.*. ......#\. .. #. \\...#
#.... .*# .\.\...*.. ........ ..   ....... .#.*.\ .....  ... . #..* .#. ..*# .*..#. \#\........  ..#
#..\#.... ..#...*.\. ..*.......# .#*.......\...*  *.*..# ...  .#.   ....*## ..   ....\.. . #.#\....#
#.. . .\ .... \ .*... #*. \.. ... .. ... ..  . \* .*.\#\.\..\....  .\.**.*.*.#*..\ #. .##.**..* #  #
#.. .\.. *.  .\* ....\\.  ... ..\..*.... * *.** #  \..  *...**..   ....\.\. ....*#.....* .*.... ...#
#***. ..\*#....*#*......... .*.##.. *......*#.. # .\...\ ##.#*.*.... ..* .*......\..*  ..##.*. .\..#
#\. *. ...*#.. # # ...* ##.. ..... #*.*. ..\.....#.#*. .....#.##.* . .#.. .**..*...\#... ..........#
##... * ...#.# .## \.. ......#.\* #. . ...# ..#\#.......**.## .... ..  *. #    . . #.* .#...*.***..#
# #..#.# ... #. .. . ...* #..\.\..  .*.. .#......##.*.\..*#.#. .. ....*. *..  ..*.\.#.#.#.*.... ...#
# \ . ....*. * .#*#... #.. *..#..... ..#..*... #*. *. . ... *# .  #\......  * .*.  \#....*..*\. . .#
# .*..#... . .  # ..* *... .#.#...*.* . .  ... *.*.. ..*.* .\ #*##.*.....##...\ #....*..\..  .*.\#.#
#.\.\.. ..\\..#..*.\.#......#..*..\.#**#. # . ... ...#...**. *..* ##...  . .#...*. ..#.. # *###.  .#
#....*..# *.. #*.  .#..\.  *. .. .*..\#..# .*.\....\.  * . . \*# ##... \...*... *....**.. ...\.*.*.#
#... . .#.#....*#..#**.  ...\.\...   . .**# .   #.. \..**...#. . . .. ..\ . ...**#*.. #. ....# * ..#
# .  .* ..*\.......* ...\..*#.... ..#.*.. ..........\...............*#...# . .... ........  ......*#
#........ ..#*.** ..  *.#...#\.....**... *..\*. ...*.. ............#**. ........#* #*.\..*.#*. \ ..#
#.##.\...#  .   #...#......# #.*    .* .. . ...#...* .. .#....* **..   .. #.*# .....* .. .##.**.*.##
#*#. #.....  .*...  *.. .. #.. .##.#.*   .*.*.\\ ...#.\..... . .*.....\. ..#... .. .... .*..*.  .  #
# \.. ..\. **.\.* .*.*. . #..##..#.*..*..* .#*..\..* . *..* \ **\* .. .#. \\.#..... *.#.* \#.. ..*.#
##.*.. # *\ ....... ...\...\  . ...........#\*. . ....  \   .\.# . *#*....# . .#* . .* \...  \  *.##
#  .**.\\.  ..... \...*....*.. .#...#.*.\*. *.##..*. ...... * #\\. ..*#........ .. * #**..*#...**\ #
#\...  .\\. ..\*#.... . .# ....\#*.*..  . #.... *\..#..*#.\ .. ..#*. #\..... ..\.\.. *....# ...... #
# *..  .#.. ..#....*\..##\* *...* ..#...##.*. *#.  ..\.*.*.....* ... #...*..#  *.#....#...#\...#*.*#
#.\.  .#..  .. #  ... .  ....\...# .*.. .....*.\..## ..... ..\....#*...#*.. .. ...#....\ \...#.... #
#*. .. # .......#..#..\*.. ..# ..*.*.*#.... *..  *.*.... ......*#*....#\#.....\#......* .*....*....#
#. . \...*. .#...*........*.**.* ..... ...*#....  #.  ... *\. #\.\..#..\...\#** ....#. .#.... ... .#
#....*..#\*.*..#. ... *..*. ......*  ....*## *# .*#.....#..\..\.. .\ ....##... ..#. .. . *..  .  . #
#. ..* ...# \*..... .\ .#* . #.\..*  ##..\..\...  #.  *#*\*. . .....\ ..# ..  .*#.# **..... .... ..#
#*........  \.**..  #...#\... **. . .......*.. #.\... ..*...... ....\  .. .  .....#..\# ..  .**.\.\#
##.*.* .###....*....#. . ...... .*.\  ..#.... .#. ..  .........  #....#.  .*  \.........#..# .#\*..#
#... *.......*.##.... ... ..#\ ##..  .. \..#..*.#..*..#..# .. . .#  ##..#.\..#. .. . ##....*. . . .#
#. #    . .#.*\...  .....\..\..  . .\.. ..#....#\. .  .....#.#*.#....   .. .#..\....# ....*...  .. #
#. #  .....\.#\.#.*.\  . .**. ... . . .#.*. ..#.*.# ...*.#.\.#... *...*..#\.# ..#.**..\..  #...... #
# *.... *#.# ....#...#..*.. . .. ...#.. ##...  ##.*......*  .....## .........#.. . *..... #*......##
#.*##. .. .. #..*#*... .** *.*. *........#. ..  . ..\##.\..*#\\.#.*.*.  #*..\ ...... .........##*..#
#.... .**..\ *\ *\.... #  ...*.. ...#..*.... .#...#. *...*....\ #*.#...  .## ....#...#. ...#\#..#..#
# \\. #.**  ....#.. ....#...\. .# ....  ..*..#...# \ .......#  .\.*......*.*.. *.* ....\.. ...  ...#
#* .\ ...\... ....#. *\. ..## .. .  ... . .R.....  # #..\.#.##.#... #... . .*...\#..#...#... ...*. #
# ... .*..#.#.***\\*  .*...   .. #. .*..#.    ..#  ..*#.\. .... \#. .. . ..#..* ..#.. ..\.*.# .##*##
#\#......#.#  # ....... .\. #... .* ....\.. . .....#..  .. *  .... .. .#.#.#..# #*.##. . ..\*.\\...#
#* .... #. ...... .. *.\.  . .*. .. *..  . *  \.......*..**#.*..**.*..............\\.# * . *.## . .#
#. . ....#\..*  ..#\.. .. *\.*.  #.. .. * #. .. .*..# . .# \.##\*. ..* .....#.....#.  . \.#. . *\..#
#  .* .....  .* .**#...* *.......\ .#....\  ###.. ..  .\ ..# *. . \ ..... .##..* # ......*# . \....#
#.. .. ....*\.\....#...\..\..\ . .#*##..#  . ..** ......\.*.*#\...... .##*\..   *. .... .#..  ...#.#
## \# #. .*...#. .....*.#....  ...*.......# #..  *. ........*** ..#.# ... *....*.* . ..... #.......#
#.. ..\..# ...##... ..# *\ ....#.. .\ .\... * .#. *..*.. .......#.\... \..* ...**. .....##.. *.*...#
#.. *..*# ##.  . .. .#.*#..\ ..* .....** * . ... *##..\..* ... #.\. ......#.#..* ......#\*.# ......#
#....#.*....  .**. .* .. .. ........*....*  *.* ...* ..#.*#.*   .  .\. .*\...**. ......\*.. .*.....#
#.......#. .*... ...*....\ *.. .#....*.\ #. ..... ... ..... . ...  .   ...  **..#... .. .......#. .#
# ..*..    \*..# ...  .. ..* .. .\.... . ..... #...*#...*#*#\.... .* #  .*..  .*# *.#....*. . .....#
#.#.... ..  ..\...... . .  ..\   .*. .. #.*.# ......* .....##\.* ....\  .#*.. .# ..  ..... #....# .#
# . .. .#...   .......  \..... ..*#*# .  .*.. .\. .#*....# \. \..#....  ...\ .\..\ ..*..*. \ *.\*..#
# . ..#.*.  .* *\. . . ..... \#.# . #.#..# .\#. *..*.\*.. *.... #. . .\. ##.#\ * ....... ... .#....#
#......  .*..*.....#** \ . \.*  ..*\..#..# .* #*. .#....*.**.......\.#***..\..*.\....\ .# #.. ....*#
#.#.. . .......*.*..#. ....**.. ..*..\... #. #.\..\ .# #. ..# .** .#.### . .. ..#. ...#** ..*.*... #
# .\.... .**... \..* ... . . .\...\*.*.....\.  . * \#*.\.**#.#....\.# ...*\\ . .* . . ..... \.. .\.#
# .#.#.*  #  *\.  ##*... ...\.. ...*.# .........#.# *...#..  *.*#.#* *..*#. #. \ \ .*#   ... .. ..\#
#.. .#* #**.  ...## .. ..\#..     . #. .. .#*\\..**...* .. #*. #..   ..# *#...#....#...* \ ..... #.#
#  . *# ......\ ...# \...#. *. .*.#. *....*.\. \.#....\ .#.#..*## .# .....#...  \... .*.....  .....#
#.  \.   ## . *...*#....#*#.  *\. \.#\..*.... . .......#. ...#.#..*  #. ... .*..#..*.. ..* .. ** . #
#**...#........  *#...#.*.....# ...# ..#..#. ....##....**#.. * ..  .....#\. .. ..#...*.\ ... #..\#.#
#\... ... ....#*.# .# ..#. \. . ...*.*\.\. *. ... . \....*. *.\. #.\#... ...  *..*..  *  .  #. .*. #
#...#.#* .\...*    .. \...#. ... .......#*.*  *. .\ .*. ... . .* # ..*\*.\*.. **  #....#* ....#. * #
#..*. ..*.*..*.... \..#.\.  ..#..*..\......#  .# ##*..*....*..# ..#....#..*\..... *.\...*...*\.*.# #
#..*.. *\ .  .\ ...*\*.*  ... *#\..*..**.... * .*..#\.. *...... *.# .*.#.  *..*..*.\.....  .*.\ .\.#
#\... * ....\#.. *.\.\*..* ........*.*##.......* * *....*##...* ..##..*..\ ....\  #.....\#  . ..# *#
#..*  #.....#.#** ......\  .*..\... ***... *..  #   *..#*...#.*. #* *..#..... .#..*... ..*..  ...*.#
# ..... *. # ...  **.\#.......#. .*..  .#.#.#\\.. ..*..\.*    ..#.#..#.   # .#.*.... .. . ....  . .#
#.\..\ . . .\. ..\#... # .#.... #.......  *...* ..\.\. #..  .. .  . ...#   ..# .*.\.. *#...#....*..#
#.#\.#* \.*  \. .. .   #. ...#.** ...* #.....*....#.#.\ .. *.# * .. ..  ..\.*........\ .**. *. .\. #
#*#.... \..\*....# * #..*...#*. #*...*#.....*....... .... ...*...... ..#.. ..... ..***. .....     .#
#.#... ....##  ..*.... .*.* . .....*... .#...  .#.#.. .. . .*. #...   .... .#... .#.. ..* . *.   ..#
##*. . \.. ... #. .##.\ ... \... .. ...*.#**.  .. .#...... . \#.....*.*. \  .... ..... \. ** ***.*.#
#.\.    #.*. *.*..... .......###... #. ...#........\..\. # *. ....  *...*. ..*.#.. .. .#  .*.\\. #.#
# * . \#... .#..\ ..*...** #....# * # .*.#...... . .....# .\#*#... \.\#\#.*. .# ..##.##...  .  * .*#
#. #*  ..#....... .#...*. # .#..... \.*. ... ...#*.. .*....#. .\.. \...*.*.. ..#.#.*. *.. ..#.*...*#
#..#. ... .....* . .*.*. #*\. ......  #.  .#..#* .\.#*......\ .\...\.....#.......\.* * #..  #..#...#
#\  .....#..\  ....##.*...\..#... #..*.*.\  ...#.* ...#*..\... ..## #... ....*..  .. #. ...*#. ... #
#..... .*. * . #*. . ..**.....#..\#  ...... .  .#..* ....##... ..\\# .# ....   .##... *.. .#. . # ##
#..#.. \..*..\..\..  . .* .... . *......*.#. .....#.#.*....... .....*.* ....#.. ....#**.#...**..#..#
#.....  ....#  .*..\# .\. ..##...# *. ..*..#. *. #*.... .....  ... #\#. *...... .#.*. .* ... ...\..#
#\.\.*......\.... .\*#....  *.#.\ \\* ... . .#...\.. ....*.  ..#*#.*. ..  .... .  ....* *.#.. .\.#.#
#.*.*#..#.. ..* ...#  ...* # #..... . ...*  .##. *....* *.. \. #..  #\*.*.. ..  \ #*.... ..#..#.*. #
#  ...... ...   ..*  #...#..\..\ ..\.*### * *...*. ..*..#.. ...*.. ..*.#. * .#.# . . #.  *...  . .\#
#.*##.  ...\*..  .... ...#.*   .\ # ..  #...*.*. .#..#...... ....* .\# \.... * ........ ..... ...* #
# *.....#.. *... # ..*.. .*.# ...#. ..... ..*  .#.. *..  .*... . ....#... . ... .* .... .... . ....#
#. . \#.. ..**... . .#    .. #..**. ..# ..**.......\*  *. ........* .*..\... ....\  .#.#..\* ..\.#.#
# *  ......#.. .#*.\. ..#*#. # . ..... .#.... \# #.. .. .  . *....*#*..\....\.#....... *..# ...#.. #
##############################################################################L#####################