####################################################################################################
# .*.. * .**.#..*. *#.\..... .   ..*.... . **## #.. .......#\#..\\ .\  .. .\... . ..*#. *...#.   ..#
# ...** . *.. .\.#..*.#... .# . ... *.# .. ...#... .*\.....# ..#\\  \. ..*. #..*.\. .. *# #..# . *##
#.#  . ...*.. .  ...* .........##...*. . ....   ..#.. # ... #. . . .\#....*.....*.#.*#\.  #......  #
#*..# .*.*..*. ... .. .\.. .  . .*.**#... ....\#.  ......... .....*# .*.*...#.. .#*\...**.\.. ...###
#.#.\***#.  .  . . ........ .\*...*#**#.* #..\..#.*\*. .#\#. .. ..#.*.......#...* ..  .... \..# ...#
#. ....*#..\#....\*.*#* ...#.......*. *.  ..#*#.   .*..#*.# # ..  ...... .\*# .......\.  *  *......#
#....#.*\... *.  ..* #..... ....*.. #. ......#  .. #.#..\#.* ....... . .*#  ...  ... *.. *.* *.... #
#.# .\... ....#..............  . #. *\..* \....*.\#..# * ....#.*.#.....*\.*..# ....... .. ..#*. \..#
#.\..*.  . ..*.....#.*#........**\  .*.#. .*.#. # * . #.#... *. ..  *.#.*\#\ .#*#... *... *\ ..  *##
#..#. * ...  . . . * . ..# .. .*...#.* .. .   .. *#..#. .. .# .\..*..   . .. .*....* *. .....# **.\#
#  .* .. .. .. ....*... . ..\.\*#... ..... . *......#\#....** ..\ .#. .. *...\.   #*..*\...##...#*.#
#..   * ..##... #.\....# #. ....#..  *. ...\#..*..##  **  ..  #. .#.*.  *    . .....*. .. *.. .* * #
#... ...*.. ..#.\ ..#.#..... .#\*#....#***#. #.. .#. #......#.#. .....* *...\***.\.# \#.....# . \#.#
#..# .....#.#.  ..\. .#\.\....**#....... .# **.# .. .*..#.#*..*.. *.# ... .\#.*#\..*  *  \ \ .*. . #
#. .. ...*\#.  ..  \. . #.....*#.#.. .*.*...#..........  .*....#.* .#.#. \*#*.*. #. . ##*..#.*.# ..#
##. #.. ....#. .*.*.  *.... #\...*...\..  .**.. .#*...#*##..  . . *\\... ...#...##..* #.. # ..**...#
#..\.##..... .*  .....###\ *  *..\.. ..  ##. .  ....#..#\#*\..... *........*...*..#..#.#...#.*#....#
## \....*....* ... ........##.*#..*..# \.. ..*..# . ...   ... .... ..... .  ..........* .*. ..#*#..#
#. . .*. .\........ .#.. *.**....* ... ....  ... . .....#...  . .\.....#.. .. *. ## .  . .... ..# .#
#\*..*.#.   ..# ................#.*... #. \.. .. .... ....*#**....#.  * #*#. \ ..\\#..... .\.*.. \ #
##  . **......*  ...\\...... .  ...  .\.\.\.   *.  . .. \#..#. ....... . ...#.#. # ...# ..... \.\..#
# ..**.#.........*...\. .. .*#. # .*...*.#.**..#. ....\#....\.\..... . ... *..# .#.#...*..........##
#*........ ...#.  . ..## ..#.#*...   ...\.#... .. ....  .    *.  \.  *...*# *.\*. ..* \...*...  # ##
#. .\*.. .. .**.. ...**.   .*......* .#... ..# .... ...... .. .... *..# \#......* .. .....*......* #
#.. *. * ....\.#\   ....#\..*..*....#\#  ..*...\**#\#.*#.. .....* * .#......\#..*...*. ...  ....*.*#
#.  ##.\* .  .. ...... ...#.  #\. *.\..# **  ....... *#...*... \*....##*.#\......#...\.*** \ ...*.*#
#.. ..*.* .* ** .....#  .... .\#...#\*... ..#. ..*  \. .\ ...*..\......#..  ... *.#....#...... . \.#
#...\. . ..\  *.....*#   \..#. . #.*\ .# .  ...# ..*..#.*#.. ...#.#.......\\..\. .*\ ...*.....##\. #
#..\  #......# .. *.........##. .* *.. .\*... ...*\#\..\#.......### \ . #....... ..##*.. . ...  .**#
#.....#....#. ..###.. .* .. ...#*..# ..\. ..\ *.  .##....# ..  #.. .** ..*.. .*..\.. .#..#.. ... *.#
#  ..* #...\.**# \*....#.....  ... . * *..# . ##\ #...*.......#... . .*..  *.#..\ *.. .... \#*#.. .#
##  .*....##\. #. ....###.\#...* ... .# \..#.. .*..# *.  .#. \ ..\. ..\.. .. * .#.#. *..#.*. . .*..#
# #. # .. ..# **. * . #..   .....#.#................\.*..#.....\#..\.....#.   .. .## .. .... ..##\.#
#.* .\.#  #..\  ..... .# . ...    *.. *.. ..... .......#..*. #.*.#.*.#.*.*... . ..* ...... ..*.# *.#
#*. #\. .*  *...\.  .#.* . ..*. **..  ..#. #. \.. ......\#\  # ## .....  ..\.*\ .* ...##....*...  .#
#.  .*.. **..##\... ....#. . ..*..#\#.........##.... ...\.#\ ....#.*.#.   .*.... ..... . ..#* .**.*#
#.\..*. \.#....*# ..*\... .. *  . . \ .... .#.#*.* \*...... *\. .  *....*  * .*#.* . .*..#.* . .**.#
#..# ...#.\   .. .  ....\...\*.##.# .. *....*#..*.\. ... ..* ..#*..#.#\..*.#.  . *..#*..##.*..   ..#
#** . ...... ..##*..***     .. ..\*.   . #.. .  *. .#..#..#.* *...... \  \. .\#* .* .......#.#... *#
# .. * ..#*.. .\***#.\... .** \*..  .# * ...*.. .. ..* .*. .#..* *.. #.. .#.\.\  .. ..\.  #..*\....#
#...   . ......  . *.## .\.#..#...#..\ ... \.  ..#*. .*\ ..........*.. .... ...#.#.....#.  .. #.#* #
#..... .#* ..*#\..... \. .#....... ....\#   ....* #.\**##...*.*.#.*..  .*. . * ....\  . .. ...#....#
## ..*... .* ..*....#..  .#* . .*.. \#. \##.*. . .. ..*.... ....   ..## #*...... *.......\*. ..#*\\#
#.#.   . .... # .....#....   ........*  .#. .*..   ...#\ .. #..* .... ..#*...  ... *.  *. . .. .. \#
#.*#.* #. \*....\ .#......*. ##.#*.. #.. * ....\... ....#...\##.#..\. . .#.*. \.#..#. .... ...*.#. #
# .. ....\..\.. .*....  .  *...*...#.. .*\.  .##.#....*..##... .. ..*...*....##.   *. .......... ..#
#.*...\...*. *.*..# ##. *\.. ....* ...... .# ...*.\...\..*.*... ...*.*... .. ...   .*...\.\.. #.#. #
##.* *\.*...\*.#.  .*.....*.##. .*. ....# .....#. .\.......#....#  #........ *... \...... \#*. .  .#
#  .  .*.#.*. ...\*#.*#.*...*.*...  .*. .. .. . .\......#.#*   .* .\\  ....*.. .. .. . .##\ .\ .. .#
#...  ....   .... . .\.  ...#    #  ....# ..\.\ #*#. ..*....\#.*...  ..* . *..*.. #.. ...*\ .......#
#.... *.. #*......* ..#..*#*..  *. .*. #. ##*  ........*#...  #. # *... *\.... .#\#..*\..\. # .... #
#.. .#.*...\... *...*..#... .\ #.#....  . ..  ... ......*.......*...#.#..#.*. ..#..  .*\. *.....\.*#
# .#\#.#....*.\ #..* #\ #...*.# \.... . \\#.#..##.....#\\. \#.#..... .#........#.#.#\... * # .#....#
#. \..# .*..... *... * . ..... #. . \** . *.#.. .#..... ##.. . . ..\... *  .#...  ....\......#...#.#
#*.... ..... .*#.*.... #.*.**...#. #...#*...... ...\.#* ...#. ........*..*. ..# ..\.#... ....*\ ...#
#.\*.*** ..... * *# ** \.#. ...#\ *\  . #.#.*.... #.....*\# ...#**##.... *.. **.. .*......\.   *...#
#.** ...\#*\.   .....  .*.#. ...** ....#  .*..\.* ..*.#..*..*\ .*.#.#.. *. ..*.. ....#.....*#*..*.##
#.*...** ... .#. ... ...#....#.  ... .*... ........#* \  \.... .\#..#.\#**. . *.*. ..\.#.*..**.\ ..#
# ..\.#..*.*#......\.....#.#.#...#.  \ .... ..... #.... ...\... . .*.\. .***. ... .\.......... .* *#
#. ..*..#*..#\.... ...*.. .**. #.* ..\ *......\  . .\ . .   .*. *....#...... . .  .*... . ..\.. \. #
#.......   \\ ##..*#. #..... ...#..*.*#....\ ..*.*.#.... #.. .*..*..*#...\ .....#.\.*.....\# #. ...#
#..*. ......#**....\  *   .\..... # .#. *..# .... \ # ..  .. .......\.#.....*\.#.* #....\..\ .....*#
#..# \#...* #...  .  ..  ...*.... ...........* .  .*.#..*. ....*.... .*##.*#. .# * ... .\.# #. .\. #
#..# .. ........ *. . ...* .# *#  #  .....##..  #.#..\#\ #. \...  .*.......#.###   *...... ..*..#.*#
#. ......  ..... . #.#. *  ... ........ ....# ......... .# ....# ** ..  *.* .. . ...#. .\# .. *.#..#
# .. . #**#..  . ..*...*..#\. .. .*\.. ..# .*.# . .. ...*#. # .  ..\.  #..... .*\  ..#..\..*.#.*.#.#
#.... .*#..#... ... * .*..#... .*...  #. .  *. ...... #.**..#** ...* ... .#.. . . . ..*.* ...  *\.\#
#.#*..#...   #.**.# **....\........#. .#.. *........   .\. \  ... .. .#**.\...\  *#.#. \...  .\.\..#
#..    ..  .. .* .. .\...  .\ *. #.  . ... .*.*.#..**.....  ..#.  .. ...*# \.*.\.#**#.. .# .#... *.#
#  ... #.  # \.....    ..#.*.. ...\.\ ..  .... ...\... *.***#. .*. *..... ..#...#...#..* #.\*#..*# #
#.. ..\. .. .*...# ..# ..#.\ .. *....#. ...\.. #.*. . ..#\. ..\.*.*..# . ..\\.. .## .... ..... *..##
#  # ....#*.....\ # \.. ..  .. *... ....* .\.....\#.*.  .....*#.#..\ ..#.  ... . * *#*..\ #.....\ .#
#. ...#.  ...#...#. \.....#\* .\\.. . ..*. ..#.# \. *\ .......* #.  #. ..#.. ....#**.. . *... *.#  #
#...*..*..  #...*. . *. . .....\ *....  ..... . ....  #..**...## \#..\##........... ..* .. #.... ..#
#...*.*.. .... .#..# ..\ ..*.. #.....*.*..*.. #\....  . ..* ...\  **.**...... *....\..* .#*....  .##
##..*. .. .  \.....*..........*.. ...*.. #*..#.**.... . *.*.. * ..#...  ... *\.* .* *...# ...... ..#
#...**. .... . ....\ . ....\ .#..*..#*...##.. .....*  ##  *.. \. ..... * .*..* \ . . ##\.  .....*\.#
#  . .....  **.\.......  .   \\.. .*...*.... .*..\... ##.....#.. ..\*..#.. .....#. .#.. .. .... ..*#
# \#  #.*\ . ....#...\.\....##*...  .. **.  ..**#.  .*  #.... . ... *....**... . .*\\\.   ... .*...#
##* .**. . .*... ... . ..* .\.....**...* ...\ ......* ..*..#.... .*. ...  .*.\ ..\  ..**.. \. ..*..#
#..#..* #.. .... *. ..##.. .. *..# *#. ...#**..\  # ..* ..* .**...*  . * .* . . .**\#.\ .## * .... #
#..*. ..... *.#.  . # ..*.... .** ..* #.\.# .. .. ##..*. ..#.. ...*#.  *.#.. . #.**..\*#*.. . .#.*##
#. .#.... .#....* ......*.....*.\**\ . .. ..*. . . ..# . #. . #.#. ..\ ...#\ . .#*.#.#..#*...*..  ##
#.#*...#\..\..#*..... ..*. #.. ..#* *#\..  *..*..*.. .. . *.... .# *.. . . .. . ..  . . .  #... ...#
#.\..#...#. .. #**#. . ....\..#.*. .... * .\ \.*. * ..*.# .. . # *#...*...\ ..* . ... .#.... .* ...#
#*.  \.... .#*#.#.. . #  ..#.*\\.  #.#.  \#*...  .... . #*.....*#. # . .  .*. ..  . *\..#...#....*.#
#* ...#.\.#.#.\.#.#*.. .#. .. * .*.. .. *...#.#* .. ..... ..\*#.*.....#. #.\* *. .. ....*.#..*..*. #
##  #***#. ..\#.... ....*..#..\.*.. ..* .....*.. * **. ....... *.\.. \....# ...... ..* .. ..... # ##
#..#....##..\.... ..*.* ..*.  ... \ .#..\..*..#\......#*.#..#....#\. .  . . *#.....R*#\ ..*..#.. .##
#\.#.. . . # *  .\.. ... #*.*. **..   . ..#** ..* .. \.* #*.*.#..\ . . #..*  ....  .*...#* .\#.#...#
##..\..\*# ...#.....*#.\*.. \. ..*\.#.*..  *\. \\.   .\.. .*.*#....... ....**...\ .#.  .*....#...#*#
##.. ...\..  *...# .... .... .*....\.*.. .*.... *.\..#.*\ ..#*.....#..\#.** #...*.  .#.# #...#.... #
# * ...\. *... *....*. *.\.#*.    .........#.#* \  ..\ ...*........ *..# .. #*.#..#....*#...*..#*.##
#.... .. *.##.*....   #. .. ...#.\.#...#.#.*..#.\.** #\.. ...\...... *.... #....  .#.#*.  ...... .##
#.....*\ .*.. ..\....*.. #.#..#. ..* .#. # ..* #..#**.. ...\..  .*.... .  .\#.. ...*..#.*. .*. #..*#
#.#* #..* #.. . ..*.. * .*.* .#...* \. .... . ...#... .. .. .*\....*... .....* \ ..\ .. ..*..#.\..\#
#.. . *... . .#.....#*...*#.\ .......*... .#...#..\...\.* *.*.#. *...#...##.......... * ....#    ..#
#.....#*.* \*#\.  .... .##*#....*.... \..\.* . . *#.\# ... ....* .. ..#...*...* .......# #.#.....\.#
###############################################################################L####################