#############L######################################################################################
#*  .*#... .. .\\*... .. .*\#... \.#. ..*  \. ..  ....\#.#.#...\#...\.*..*. .##...##.......... *..*#
#...... .# *.  ... # .\\.#..\...... *....\.\. #.... ..#.**.  \ \..*.*.#..... *.... ...#..*..##. \*.#
#.#. .\#... ... ..# . . ... .*#... .*...  *. .*## #.\#* .....\. .#...*..# \#\.... *.   . ...** **.\#
#.\..*   . *..*\ .#...# #..#. .\. .... ......#. *....... .\\#.*...*..**.**\... .. #.....**   .... .#
#...###..#..#*.*....** .. .. .#   . .  .... ...  .*...*..#.#..*.\.# \..## .. *.*# ... ... ...... ..#
#*... \*.*..\*.\ ..*#.*.*#...*..  .. #* .# . ....#*..#\#..     \ .*. ....# . ....# .. .#.*.*#.*. .*#
#.  .  * .... .*...\.. *.#.#. \.*.. ...**#.......  ...R.#.... * #.#..* .*#.  # .....#.\ .*.  \ **. #
#...* . ..\ ...#..\# .# .*.* .#.  .............\...........#.# .#. **...  \.*.. #.. *.....*....#.. #
# #*.#.#....#.*..#... ..#.......#\..\... ###*..*.  *.*...*...*#.. ..\.   .# .*....#.. .#\...\..#..##
# .....*.\*. ... *#.*.\ .\... # ... .##  .#..#.# .\#.# . .... ..*. \.*....#..... #*.. ...*....#. .\#
###\\.* #\.***.  * .. ... #. .. #.*. . #*.* .  ... ....*. #  .. \\ .... ..**\.. *..*.*...#\. *. #**#
#.*# **   . .. ..# * .. .#.# .. .#...\ ....\. .\...\. ....  \* .......#. ...#*........... \ .... . #
#.\...# #. .....* ..*..\*.. .  .*....**...*... #..*#*\#* ...#..*#. #   .. *#..*. ....  .. ...#  #..#
#.. ... ...\.*...# *...  ....#.#....  .*\*... .. .* * .....# ..##..# .* ..* ........\. ##\....*... #
# .    ..#.\\#. .   .#.#\. #.#.* .*    .....*...**\# ...  . .* .*.  . .*. ..##..#. ..# .# ..#.....\#
#.**....#\ .  ...# # ....#*..#\.\ #... #...\... #* . . .#..\...  .   .  .\*...... .. ...#..... ....#
##.. #...*.#  ... #.*.*.. .. .......# .. #...#.#.. ....*.##.... * .#*#.. .. .*.....*.. ....  .# .. #
#*.*. \.\.. ......*.......# #*......*.* ...*.#.*####*. .... . # #.  #...#... *.#*.* ..**... . #.#\.#
#  # .. . ...   ........ . . ## .* # ...#...  ...\ ..  #. *..\.*. . .#.. . ..#*.. *..*  #*.*.. *#  #
# ..#.\..\  ..*....**.#... ##*..## ...#  .*....  #...  *. .#. ..*. *##  . .*.. .*# .#\....#. \ .####
#.\.*#\#.  ..   ..\#*......... .*...... . ... #.#.*#. *.#..*.. .#.#. . .\. .. ..#...#.....#.*..##..#
#. .*.#.........*.... .. .\ #*.\.\  *#.... .. ...   .*...*. # ....## ..\* ....   ...\...#...*#..#..#
# ... *#. ....*.##..*  #*. ..*.\\.\... ..... * *.....* .* . .#....* #*..#. #..*. .. . ...*#\#. .*..#
# . \.......*..#... .#.*  .\\  .*.#..* ..*.\ .# #\...#. #.#... ...\.\.#.... ....#..#... ....# ... .#
#..  . ..#.#.##\...#.#..\ .\..  # ..#...# ...  . *...\.*\**.. . .#. ...\ ..#. ....  ............*###
# *.\ #\.. *.  # ..\.. ..#. .  .# . .....\ *# .\. .  . *.....**# # ....... *  ..# ....**\.\.\ *. .##
# .  **... ...... * ...*. ..... .*..#.*.... *..*\.\........ ...* ..\  ..#.  * .......*  \...  ..*\ #
## \.#.. #..#. .  ... ..#.*...\... # ...*. *.#\*..#..*  . . . .\## .*.*.*....* * .  .*..# .... ...\#
#..\\#  #.##. .*.. ...*.*. . #...... \...#..#\... ... ....* #......#. .* ..#\*.....  # .....\.#.. ##
#. .#.*.. #*.*#..#  .#\....\..**.........#*. .*.. .. .*...#  .. . ..*.......#\.\\*.....*##. ...\.. #
# ..\.*..# ...\*...  .. . .\*.*...*..\... .... .. #.. # ##.. .*.*\.  *   .*..*... ......***\....  .#
#.#*.# * #. . .. * .  .#....\ .#  *..# . ..#..#. ...##  ..#..... ... .*.#.#. \.#*.#\..# * ..*....*##
#..#.#... ...** .  .............  # *..\ .#.  ..\..#.*...*.#......#....\ .. *.# . . .... ..# *. ...#
#\ ... *.#..\.. \\.....* . . #. . . *.  .. ...* ....\ . ..#\. ....  ###* ..........*.*.....#....\..#
#.#.*\*\#. .. #....*.. ...**.. ....*. ...  .* ..... ..#..*#.# *....#   .\.*.. ...#.** #*\..* .*....#
#* ..*.  . #.    .#  # #*... .. ...*..\*......#.# ......*. ....*..  .  .\# . ..#.......# ..*#.  #. #
#*.. .#.*.. .##. .* #.   ..... #.. .. . *\. .....\...#.#\.........\..*. ...\. #  *..**... ..... .#.#
#.... # . #.  #\...*. . * ##.* .**...*#............ *#.#..#.* ...   .. *...#.#...*.. ...##.#*\. #\.#
#  ..*..**..  ..* ..  .. #.  .*..    .##. ..... ..#  .....#...#. ..# * .   . ..#..... #\# . .#.... #
#. .*..# * ..# ....\ ......#*#..... \*...#..*. #..\ . .#.\ ....\.*... ....#..*.. *.........# # **.##
#..........**......#.. . ....\*..#  .....#.....*. #.\... *. .#....*.#...**.#.* . . #\... .##...#. .#
# *.**..  . *..   ..#\#. .  .. .#..* .*.. .# ..* . #.#.\ .  * ...*#.  *.#..\.*  ..\..... .#. ....#\#
#.*...\..... ...*.\ ***.  ...#. ..... #...#.# . . *. # .# .  #....*. *.\...... .#.*.\..##.# . *.*..#
#.\  \. .. *....* ... ..\#..\ ..... .#  ##.... . ## #....*.*\ .. .* \...*.#*#. ....*.. .*#*..#...#*#
#.# ... . \.....  ... ...*#....#.\.....#...*.  .*... ..##\#... . .. .\..#.. ##.*..  . *..  #...*#..#
#... # ..  .#* #...*..*.#. ... .\..#... .. .#... #..#*.\# ... .. * \... ..#*...  .\#.#..*... .....*#
#..* ..  *.\... ....\..#   ..#.*........ .  ........\. *#. #.. *.*. *.  #....# ...*...*... ..\. ...#
#....#. ......*..  .. *#..#..... . . . .#\ #.**.... *\\# \..*. .##*#.  *#.. *. ....  ..#\ *#*.*..\##
#....##.##..\..*.#..#.#.#..........*   . #.   . . *....** ...* .\.. #*........#..  .*..*.##*.*.*. .#
# . .*.   . . \ #\.#..  .. ...* .#.... .#.*.  .\..   *#.. .  ***..  .#. . ..........* #*.## .... *##
#..\.*... ..#.... ...#. *.*    .. *#\..#.**#..#..... *.\..#.#* .. ..#  *#....\. ...  . .. * \... ..#
#....... .#*.* # *. .  \... \... ... .#.\...    ......#*...\.#. ..* ..  *. *.\  . ........ *.. ..  #
#.. . *.... #. .  ...\...... #....\.#.*#*  .*# #.. ...*\ ..*#.*.....\.*  #.. .#*#.#*\*. ... . ..*..#
#...  .. *...... ..*# ...*..* #. ...#.. ...#....\#* . #.\.....*...*...  .... *. *\**\. ..\*  .#...*#
#....#....*..... .*.. ... ....\.....\#.* .. ......*.........*.*#. .... *.. .  .#..*........*... .\.#
# ##.. .. #\..# ........*# .........*..\ ..*.***.*.#. . ....# #..*.....  .. #.....#. *...\*. .#..*.#
#.#... ...\..............#. ...  ..... . . ....*  .#\.. ..#* *.. ..# ..# * .\...\.......#... ... ..#
#. ...*. ... #* ......*#.. . .....***.. #*\   ... .* *.##* .##\.. . #... .... . #*#. #..*  *  .. ..#
#\*..* ..*. ....# . . \..**. .. *#.\**.... ..*#*# .* ...#. . ....\.....# ..*.\*#.#. ..*..#****.. ..#
#.....#* ..... .....#\.... #....*.* * ..#.#\ \##... ## .#.*.###.#.. #.. ...#**.#.\.\. .*... *\. . .#
# .\.###..  ..#..*\  *#..*.\...#.*..*...*.\. .*.*.*.. ... * . .#\....*.#.....*#\. ... .   ..*..*#. #
#....... . .....*\.. #..*#* .... ..\..#...  .# ..* *. #  .**##...*.\..\... ..*. *..  ....*.*. .. ###
#..*. #....#.* ##\...**#.... . *...*#\..*.  .....*. .#... .##..#..*. *...# ..* ..*#.......#.  \*..*#
#.. *.**...\. .. ..# *#\*......#. *.  ...#..... . . \ . # ... .*\#. *  \..**..*.#. \*.....*....# . #
#.  . ..#*\.* .. ..*...*# .##..... . . ... *..*.\..... #..\... .*.#**. ... .*... .  .. .\..  .....##
# .##*.*.   .##  . ....#*#....*...#...\ ...*.... .****.....*...*....#....\...* \\.**.*.......*.. . #
# ......* .... #.. .*..*....#. .  \...... ..  *...** .. . .  ..*....  \  ...*....  .. . **...  ..*.#
#...**...*. . ##.*. .#*.#..\ .\. .. . ..  ... ..*..#.#.... *#  * ...*...#. ....#..\#.*\ .#*.\...#..#
#..  ..  #.\.\.# . ...#.. .. # ...*. *..**....*.... .** .#.  ...#... \\.... .* \...\..*#.. *.....\.#
#.* .#..*#\. \.# ..  ....*   .. ...*.*.*#..* #.*\.#..*. .#. ..##.\ #. .. .*... \ ..##   .......#...#
#. ...# ##* *...\ \ ..*.. # ... ....  .. ....#. .*....#.*. .. *.. . #.*  *.\.  ..\.* ..... ..#.\...#
#.. .... .  ..#.\ #.. . #  #... .... ..#*.*.#*. ..###...  ..#.*##..*.... . \*..##...#.\..  ... \.\.#
##..#.# ............#. .. . ... ......*....\*..\.*...*...*.   . ..\.## ....... ..*... ##..  #...##*#
#.... ..... .#..# \...\.\.* ....#. ...  .........#..*.#.. ... .. .*  ..#.  .*#... ...*.*.....  . ..#
#***.. ...# .  ...#. .#. .*...\..#.... .  ....#... .  ....# ..###..* .. *#....#.. ... . ... ...#...#
##..*....*. ..\ .\......  ..  \#  ...* .\#. ...#..#. .....  .*.........*...*.*.. *  .*#.* ...#.#. .#
#..*.....**.. \.*\..........  . ... ...#.\. ... .*  .# .* *\.\.... .....*...\*. *. # .#.#....*.*...#
#.#. ..#.##..#.*#\   .  #... \... ............*.*#..##. .. *#..*.  \ . .####.. #...*...#.### .\ . .#
###...##.....#.*. ..#....*#. .... \ *#.\ # .  .* ..** \... ... ...*# ... .... ...\#   . .#..##...**#
#.......#... . .....\.   .. ..\ *..#.. ..#.. ..*  .\ \ ...\ . ...\# #........#\\ ....\. .. *.#.*. .#
#.*. ##... .*.*#.*.#. . .#\\ .#.# #.\ .  # #..\... \.....   ...*.#\#....*...* .#.. #*# .*#.\*.#. ..#
# .. ...#. * ... ..........\. *.\.* #..*...#.\.*. ....# # ...*#....\.*# ... #*.#.#. **...#...*.  .\#
#.*. .*. .....#.# ... . .   .\\.... .. .#.... ..... .*.  .#.#.*.. ..*...#.....*.\. .. #..... .\  ..#
# .......#.## ......  .*\..*... ...... ..  .. ..    ..*#.... \..#.   ...*. *.*....*. *.*.****..   .#
#  .*#*..*....*.*..* .#...# .. . ..#....#.##*#.  ......#..    *.*..*... ..*#..\..... ...*.... . ..\#
#..*. \. #.............\\*  *#..# *\..  . .*#.* ..#.. * ..*.. ....# \...\..*  .....*#*.*... *.*..###
#*.#\. ... ... #..\...*.#*...** .....  .. *.  ..\#..#*# .  . #.. \\* .... ......* ..  *.....**. ...#
# ..  ..#..#... .... . # . #.*#\..# .\. # . # #.... ..\*. .  ...#.#**## ...#...* .......* \ .... ..#
#  ... ..\. ##*...... ..\.*.* . ** ..*** ..  . ......#  . \#..*..   .*. .  \ .#.. .....*.*.# **... #
# .. .....#. ..# *...#\.....*... .\..........*.\....... .#......#*..   ..  . .  .... \#.. *#**. \* #
# *..  .....#. ..#  .. *.. . ....... ..\....# ..#. ..\#. *.#*..#.*......... .. \* #* . .**.. ....*##
#... .#  ## . #*#..\#*#.. . .\ . . .*. ....#*.... .##. .*..*...*.#.\. .\..\  ....*# ....... ..*\...#
#*...#... . ##\ .*.  #.....    *#\......  *..#..*.#... ...#\.*#.*#\**..#*.#. .*.  .# . ..* ....*##.#
#.......... ...*.##.#. ....*# ...# .*.*#.. *.*  .. .....*...*....* ..... * ....... ..*.....\ .#... #
#...* .. \. ....... *\.#..*..*.........####\.....\.... .*. .. . ..** ...#.. . . \ ..... ...*... *..#
#..* * .\#\ #.*.*  #..#.** .* ....... .\.*  \..#. ....\..#.#...#..#...#. \....\.... #. ..#.....##\.#
# .. .#..#...#. \ .#*... .*  ....*.  ..*......#.\  *  # ... #.. ..# ..*.*#..... # . #..*...#... .*.#
#  ...#* .\* .* ........*............#... .......##  ...\#..  *...# .#. \.. ## ..... *  ..*..  .. \#
####################################################################################################