####################################################################################################
##*...#..   \#.. ..**.. . .# #\ ..\... ...# ......... \. \* . *..##..## ...##....... ..... ..* . \ #
#.. . #\.*...##  ......##. ....  . *#..\*..*###. . #*...\.  .. #.. #.. .#..... ...* ....  ....#.. ##
#...##*..... #..*.#*. #.. ..* ....\. . .*...# #\*..##. ##  \* .** #......... ..* \\*.* . *#. . ....#
#..... ..#..#  .....\. #* .. #..#  ..\...##*....# .. .#...  .\..\* .#\. .  ...#.* .  ...  ..*.*# ..#
#.. .\. . ....#...... #...... #*##*.....#**.##  . ..   .* .....\***.\ .*.#..*. #.*...... .\#. *.*..#
#*.... .. . .. .....*.\  .  *...#..#...**#. ...*.#..   #.\**...... . ..\ #..*# #.. \.#........# . *#
# #..\\  *...  ##\\#...\.  .*.  *... .* .... *. *.. .. .*.#   *. \ .# *...#..\....#.. \..*.... ###.#
#*.#**  # #.\.... #. ..... ##\##... .. .#. . ## ..*...# ## .*#...*..*..... . .. . .....  #..# .....#
#...*#....*...\#. .  .  .  #.*  **... ..*\.... #.. ....\   .#. ...#....** *. ...  *..  ..  ..#...#*#
##.... ..*...  ... # .*.#. #. ..# ...**..#...*..*#.#.... . #. ..#*.*# .....*.....  #.... ..#.* #...#
#... #.#.*........  #..... .#*#.. * . .\. ...   \......*..#. .# .*#... .*... ##.# . *... ...\\..*..#
## . *.\. . *..*...#.......#.... #... ...#......#.. .*. ..... ......#. *... #. ...#.. .... *..#.\..#
#... . . ... ....*. .*  .\.. .*... ...# # .. .. .*  ..#  .**.. .#    ..#*.. .\ \..*....**...... .* #
#..\ ..#*.. ...... *. * .....#..*#........ *.... #.  . ..#. ......  .. ..#.\..##.  ..#...*...\ .. .#
#.. .*.# ..*..#.**..#*  ..\.. ....*..#..\.# .#.*...**#***...... *.....*....\\.# .. \\.#..*....  ..##
#.**.\\ .  .*... *..#. ...*. . \ ......*#\.. *.#\#*..  .... ..... .*...  ...... . .##*.#\* .....# .#
##....\.. *.# ..*.##.#. \*.....##*.....**#...\. ..\# *.... ..#...... #. ..#..*.. .\ ..**#.#..# .. .#
# ...#.**...#....\..\.... ...*..**.#....#.#\*. .\....*......#...#...# .....**...* #..#. . . .. ... #
#.#.#.*... ##*.# .....##..*... .  .#. ..#*.#.\... ......... . .. \.\ #.....#........ ..#.#*......**#
#.  ..#....#...*.  ........*.#.*.#*....##....\.#.#.*...  ..* #.. *.#..#.. ... ...  ..*#.. .   .\*\.#
###.. . .  * .#.\  ....... .... .\*...  ...\. *...   . .... .. ........*..  .#****.#. .*.. \. .....#
#  .. ...# ........ \....*\#.... .*..\..\...# .*..# *..\\.  \. #...*# \ .. .. .*......... #.....*..#
#..#. ... ..* .\ *......*.  ..... . *.#. . *.*# # ... #..#.... .\..# . ... # .*.  ...... \.# .. ...#
#..   . #. *.. *.**...*#.    ..\.\............ .. .\#.*  *.....\. . .......#....#.. ..#...**....*..#
#..*..*  ....\. . . .  .... ...\.\.#. .......*.*...#.*...\*...*# .. ..#..\.......#. . ... .#*. #\..#
#*...  *...\.. *... * .... ***. *\ .. **.   .*....\ \.. ## . .   .. ...#.*. ..  #...#.  . #.*......#
#....*\. .  ...\ *.*# ...#...#.#. .*.....#...  ....... .\.. *..*. ....  ... .  .\.#.*.. . #\.  ....#
##..\.# . . ..\.. .  .* *\ .*. . .#*.#*  \..* #*.*. #..#.....  .. #.* **... .*.......#.....#...#..\#
#..*. .. #. \.#*..    ......#  ...* .*#.*#\#. ..\........ .#*    \.. ... ....\.. .....\ ... . ##.*\#
#.* #. #. .. .#. ...\...**.. .* ..\.....\.*.#. .# ... . #.*#..#..* ......#.*.. .....\.###\# \ **.###
#.\ #\* \. .... ......#.*#... .* *. . . .*......\..#..#.*. *... ..*#.. # #. *.. ..*# # \.#....#..* #
#*.... . \...  .# ..#  . .*..#..\ ....##. ..# ..#....  .\.     ...*..#*.  .....##.....* .# .. * ...#
#..#. .   ...**.\.## .***.#.#...#. #.* #..*\..*.. .. ..*.#...#. . . .* .. ...   ......... *.\.   .\#
# ....   ..... ....... #.#..\#.#. .\ .  .\... ...*.*... .. . *.#.\... *.#.  .\.  * * . .#.. #...   #
#... .# .*. ....# ##. ... ... ........#.*  .#*. *#.\ ..\ \\  .\\....*.. .  ..... . \*.#\... . .* *.#
#.\..\ #  .##..*. .\*. .* #.* .....*.#..#..*.# .\..* .##..##* ...* # .... ##. .#..............#*...#
#..#...***. \  .... .. ...* ......\..*.#. #..\.\..\ \. .*...#. .. . \..\. ... .  .\..*.*. . *..#.* #
#* ....... \\ ..\.*.....#.. .\...\..\*  *.....\..*... .*#.#.. ... .  ....*... .... *.  .*.*... *.  #
#..\* .........*.#.........*. . .. *.**... ..#... . .. ....## ....\.* .. ... . .... ..#*   . ....\\#
#. *.. ... .*.. *#. ##. \... .. .#...*.*... ..\ #. . ...#.\..*.. .\ #.# #..\\........#...\ #.**. \ #
#..*.*.*.... ...# .*.. .#.  \#....#. \.. ##.....**.# *#*..\.#...#.# ..* #**.##..#*.# . ....* .*.. .#
#.#..........#..#.  ..\.# ..** .#.*#  . . #.\.. *. ..  #. .\.#\.    *\\* .\\ ....#*..*.*.. \...*...#
#.\#.......... .##...*...# #.*. #***  .... . ........ #.........#.* *.....#*.#. .... .. . \ ...\...#
#... *.*#.\...\#\#. # .........R ..  .* ....\...# \.*. .. *....*.##..*.. ...*... ..*\#. ..*.\.\.. .#
# # .. *..#.*.\..\.\....  ...#*.*. .. .\.... .#. ..**. ....*.... .\.**. \# #. . * ....# .* \..#..*.#
# ....##...\\ ... ...  #.... .\\ #\ .*.\..  .#*.*\#.#.  *...**\...*\*.*....#..  ..##..\\..#.. .#. *#
# . *..*.\*  #.....#.. #*..#......#. #*##*# .#* ......#*# \.*..*.. ... #.. . #**\..  .. ....#.*##.*#
#.*\*....\....\ #... .  ...###. .... **.. . #.#.... .*...#.*.   . ....\.*... \#..#\#. .....#.#.\#* #
#..#. ..\..** .*#.......\ .# \.*....*..#.*... . .\. . . .\... .  .\.\.. *. .\ ..*.... ..#*#.... *..#
#...*..#. .......#..*. . #... ..##...\.\*\..#. #..#.*. #..# .......# .*. .* ...*..  ..#..# #.......#
#. #...*.  ..#. \.#..#.\#.*.\... .*..*.*..*#.. ...*** #...*\ **\.*#..# ..  ..\. .##..*..#.\.\. . # #
#.#**...\...* #\. ...# ..** * ... .. # ... ....#. * *.....*...#*....#..  #..\  .. ...#.* ...# .*.. #
#..#....*.*..# ..#    *... #. . .. ..  ##. * * .*. .  # .#. ......#.\ ....  .#  .....\*. ... \. .###
# ..#..*.\\... .. #. .#*. #\.......... #.# ..\  .*.*#....  .*#... .. .....* . ... * ..#. .....*.#..#
#. .. ..*#...*# #.** ..#.#.  ...#. ..*** #....* ...... ...#...  .*.\....#..*..\.....*#. ...\ ...#.*#
#...*.. ...\..*... .*#\ . .**..# *\.#..#...* .# ..*.*.. ...\.....\*#.*\ ... .....*  .\.\# #.. ....##
#...#.\#*.. .. ..\.. ....... .. .... #. ..*......... ##..*. ..... ...* ..... .  ...#. .\.#. . ...* #
L.* .\* . #. ......#.  .# *\##. .............**........# #.. #.. ..*...*.*....*  * .*...*    ......#
#...\. .\.\.#\\..\...*....... .\  ... .... .#. ..  ......... #....**..*..\ *..\*.. .* .# . . *#\...#
#. .  ***.  *..**\**.....\ .. .. .. .\... ** ......* .#....... *#....\     .\...  *... *...\##.... #
#..\#.*.*. ..*    #. .  #....\. . *.*.. *.#. ..\..\ ....... .. \ . \ .# .  .... ...  . ..#... \. ..#
#.....#.## *. .\\\.. . \..#..\# ** .###...*.... *.*.\.\.**..*. #\#.#  ....# ....**#.*..... ..... #*#
#.\. .. *  ..*....*.......  .#..*# . #..*....\.. * . .#..* ..* .#..\** ..* #. *.#\ ....... #. ...  #
#.. ...... ...#.......* .....\.#.* .*........ .#.......  #.\.*.##...#...*..#**.\..*.##.. ......  ..#
#\..... #.....*. . ....#.*.#. \..#. ..* ..*..  .......**#..*.. #.......\. ... *..\..... \\.\... .. #
#..*.# *.*..#  ##. *.#..* *.   ..  ..\ ... . .\\.**.  #... .*.\ .\ .... ..#...*.  #. .. ........#*.#
#..*.......*..*  .#..# ..... \*#\.... *.\.  \.. .  ... .. . ...#... ....... .*. .\.. . .\..*. .*.*.#
#. ....*\##..#..#... ..*  ..........#.....  .## .. .. \*##.#* .......*.\#.  .........** *.**.\. .###
#..... # ..... .....\...  #..#.**.#\*.* .#.#.# . ......*...\  . .. .##...*.*.  ..* ...#.  . ....#..#
##.\. . . #\#*###.* ..***  .#...  .......  \.....*. # .# *........*..*...*. ...*..*. .*.\*.#.. ....#
#.. ..\. .... ....#* . #.........#...... ..\. .#. .#.\..... \ .# .....#.#. .. ..* ... .......*.....#
# . \...\....#...#* ...  # #.... #..# .*# .. .#. *. .*  ..\#.  .\..*  ............#....  ...\#.....#
#..#... . .. .#.........## .**.*.\..**.....  .. .*.. ..**. . ............**# ..........\#......#...#
#\. *..## ....##.**..#. ..#... .*.*...*..\.. *..\.... . \...#..*......#*..... . *#. . #\.#.. ...  .#
#. .  . ... .#\*\* * #*..##.**.\. .. . ...*.#.*  .. ..*..........#  ..*#* ...##... *.. ....* .. *..#
#..#.* # *. . .*#.......*. . \.... .\.. .*#.*..#.\..  #*.. .*#..............  ....\ \...\#.*..*...*#
##...\......\. .. . ..*... . ..*. ##.##..* .#*#......\#... ... . .*   *#. ....... .. .#.#....... #.#
#..... ##. ...  *\... .*....#......# *. *. .*.#... .. . .....\ .....*..... .#\##...#. . ..#*  .  ..#
#.... .  #.#. ..#.. #.*  .*........*..#.\.. #..... .#\ ..*. .. ..  *. #. ..# .**.*.... ........*. .#
#   ..#..#.#*\#.#.......*..*... . ..\ ...#. #...#\ .......*......\........*.....  .\.#..# *.. . ...#
#...........# \  #*#.# .*.# . ..... #*..*.#.*      .\#...* ...... .* .. .*...... ...... .*... .# .##
#... #.. #....  .. *#.*#....#. #. .#...* .....#.*.#  .. #.*.. # #. ..  ###...*....*\*.#....   #.* .#
#.. .  .....\.  ....#.#...*.\\.# \. . .#\ . *..  *..##**...#.. #*.. . . . . #\ . ..\*..*#.. ...\* .#
#*.......  #.. .. . \.. . .....*.*. .#.. .*.*.. ...... \   .....* .* ...**..... ...#......*... .. .#
#. . .. ...*..*...#\.##..**..*..* ..*..#..*..#*# .*..#..*# #\.. \   ... \*..*#.. . .* #    ....... #
#  *.#..... #.....*\*#*. .\.....# . .. *...........  ..*#.....#..  *\.#........#..#..#.....* #..#..#
#. ....   ..* ..#. *\ . .*\#.#  .# #*#..# **. ..... * ....\ ..#.#\..####. ..#... ... ....*\....*\ ##
#.  .#*.\...... *.\...*..\.#*........\\.*... ....*** ..\.. *.   *\ .  . . .......*.....*..... *.. *#
#.#*#.......*.# ##. .#*... ..*\\.##...... \**... #*..#...#.... .\ . . ..*..*. .....##\...\.  ..#...#
#..  \* ...* ....\......*....*.*.. . ..  ... ..\#  .\...# . *...*.. .# \ ... \.. .*.. .#\......\...#
#\. #\...*  \. . .....#\.....   ...\.*..*.. ..* .*. .#...\..#\...\# .*..#..... ..*....\.  ##.....*.#
#....\... \\.\.*...# #..#... ...#.. * #. .... .*#..*# . ...\*.#... ..  . .*...*..  . .\... . .\ ..\#
#... .#.. ....  .. ...  #*\..\....* ..\.   * .. ..#. . .***... ..\ .. #.... . ..*. ..*.. .\..*.#*###
#..#.\#.*....# ..*#.. .*.... *.*....... .. . .*..... ... ...###..\..# #.....#*......#..#.  .* . ...#
#.... ...\ ......  ... *#. .. #.*.#.. ... .* . #..........# . . *... *..  .*.**.  \. ... *  ....*###
#...* . . .#  .*..\.....#. ....#\ ....# *.. .*.\ \.*# \..#*..**... . \#.\ ...* .*#. #.. #   * ...#.#
#..*.#\*...#*....  ...#*...  .. .#.#*\ .\#.. ... ... .   . .\.*\... .\.* .*.. #....\..... ..*#.#...#
##*###.  \. ....##..*. .    ......#..\..**..*#..\*..# .. #.\#. .. # ...*.#*.*. #.* .*..\... ....#. #
####################################################################################################