####################################################################################################
#*.. .......... .* ..... .........*##.#.. .*. \...*..*.\# . \ #.. .......* .... .....\ .. *. \....##
##......... .. *#*.#*#.** ..........  .#..#....\.*...  . * ...\ .*. #*.##.#.  .  ......*#.* .   ..*#
#...*.....*.. .##  ..##..#  ##*  .....  .#...#.*.\    ....* ....\#.*#.\*. ... #..  .#.....*. #.....#
#.#*.*. . ...  # .*..*  . ..  #.... #. .. * .. #  .  ...*  ...   ..  ......*........# .... #. .#*..#
#*..#   .  # #.....*.##.\*....... * .#\..*..  . .*  ....*.*.  .#..\..#... ..*...*   *\.\....#..##  #
#.......*#.\..\.. ...**....*.# . ....  . *.*. . **\.#..*#.#..**# #..# # ..# *..*. #...........*.. .#
#..   *. ..#..... .\..........#. ..*..#..... .. . ..**#.#......#.#....\ \. ...# ... . ..........**.#
##. ..#.  . ....\. *..\.#.*.....##.. ... ...#.*. ...*..\....\.....*.*.* ....\*..  ...\.........#. .#
#.. ..#.**.* *#. ..  .#. *.*. ..* . .*.. .  .*#....\#...**....* #.* *..  * ...... *.#  ..\..* .\ ..#
#.  . ..\.*.*. ##*....* . .#* .. .#.# ...\ .** ... ..  ....# ..\ ..*. .......#.##..  . *.*..#.\....#
## ..*.#. **.. \.*#.. ...*. .... ..#*.... .\.   * .*.#.#**..... ....\\  #. .#\\..\. .. ...* ..*. . #
###.\*.. .#.#*  ...**..\. #...#  ...  . ...\ ...*  \ .\.* .*#. .\.#**..#...  ...\..#......#\ ... ..#
#\*.. **##..# .. . .#....*  * . .....*.......\.*.......\ #\ .. ..#.*. .*..\... \#*... ##.. #... . .#
#.#.. .......*#..  .. ##.\....\.*....*   .   .*.. ...\..........\..**.....#... .*\.. \ .#.  . ... .#
#. .\    .. ...**... .... *\ .#*.*......*... #... .*#.#.. ....... ...*.#. *#. ... \.* #.. * .\.. . #
##.*. .\..*#. ...# ....#......\..*\..\.#..*. ...*..#.... . ...* *  .\ ... . . . #...*  *#.... . \.##
#   ....* #.#.\#. .**  . #..*. ..*......*. #......#*#...#\\ ................## . \...\#\*.  ..* ..\#
#   .  ... .. . .*\..\.. #...\*#**#... .*.#.  #... . .. * .. .#......   ..*......*#.  # .. ........#
#.  .  #...*\....*...#..... ... .*..........*#...... #.......  . *.... ##..*.. #. *..\ .\.* \.\ . .#
#... .#.##. ..**. ..#*......*..\........#.#.. ...*. ..... . *. .. ..... ...##* ..#..#.. ..  . ..#..#
#.. ..### .#.  ... ........\..#......##..#.\  ..\....#...#..#. *.. ##  \*.*....#*#*.\* .#*. . **. .#
#..#*..*...*.. ....#.*..#....*.*#...\. *#\#.*.... .\ ..# ..\*.*....*. #* ...   #..\ *..*..#...  .  #
#  .# . ..*.* ....*   ..#  .#*. ...#  ......#. *. #..#........ .....* *#.......\.  ...#.. ..*...  *#
#\.. *.#...... ##  .....#*.........#...*#...##*..\.....*... *.#.....**.. ..# # ...\..* .  *#* # #*.#
#... .... \....\...... .*#.....##.. #.# .... \....##...\  ....#. # .**..*.*..#\. #  .*.#......\   .#
##..\..#....*.......*.*#....###...  .# \#...**.... . .# .# .  .........*....*...*... .*..#...\...*.#
# \*..*....*.  \*..*....*.. *.#..* .#..#.##... .......  .\...*...#..*. #. .#  .\..#...\.*.*. *\.. .#
#. ..\.*..# * . . #.\. . ....*..#. .#  *. .*. . .  .# ..#.#. *. # . *...#. #.#.\ *#.....#..  #.. ..#
#...#..* . .*..*......*\. #..#.  .. .... *.*......# .*. . ..#.* .# \....**#.\.*.\.\ #. ....#* \....#
#..... .#... . \.\#*... .#.... ....*.. .......\...*. \  #. \...*#.* ..#.. . #.#...#...#...... #....#
#.. . **.*\ *..*...#....* ...# ...#.. .....** .\.\... . .*..#..#.  * ..\ ..#*#.. .**.... ..##.*..* #
#...*..     ...  . .....*...* .. .# ..*. * . *. .... ......#..*. . ..##. ....***..#.. .... ...  .. #
# .#. ..*. ...#....#..\.\...#*#...*. \. #...\.* . *.  \...*.\.*.#...#*..  .*#\.# . .... .\ .\..*...#
# . ...\.#. .. \ #.\.##........*..\  .*.**\... .*\.*.. *.. ..  .. .. .#... *.   . . .............* #
#.*  . *...  \. ...  . ...... ....#.  .....*. .\...#. ...... .. \...\.. \..* ..# #.# *....\.....***#
##*...*..# .......  ... * ...#  #.. #...*.. .  .#*...\ ..* ...*.*.* ..#.*  . ..#.. \....** #.... * #
#.***#** .\.*.#. .# . .*.*#..* #..#...*. #..**\..*. .#. ..\..  #..*. #\..## ..# .*..... ..#.. . .*.#
## #  .. \.#...*.* #.*.. *\* .. \* *....#.. .. *  . \.*.#..*........   .*. ...  ....**#...*........#
#....... .. ...#.#.*..*#   ..* ..#...#. ..#.* *\.. .\. . . \*#. #......\...\\. ..  #...... ...... .#
#.......* ... ...\.#.*.#.........#.*.*#. ... \\#  .\  .**. ...**. #..\.......#. ...*.. ..* .#. \...#
#.  .\*#\*.#  ..\*.  .* . . ..   #...**#... ..  ..... ## .. #..... ........#.....*...#.\*. #..#....#
### ... ....#...  *...** **#. .. ...**.......... ..*#.*..  ..\..... .\  . *..#..**....*.**. \#..**##
#.......*....**. ..# *... #..*.\. . #*...*.. .. *..##. .#...# ..#.\.\.#. ......#.......  .*..#\ ..*#
#. ***...\.#**# .. ....##...   # #.. ... #*.. #. ..\...*#. #....  . \.# .*#..   .# .# *# #.#.##....#
#.\*... .\.\.......\... .#.*..... . .....#.......# *###*.# ...#*\....#..#. .#.   . ..\.. *.  .# ...#
#.*..#...*..\.#.....# .*....#\#. ...#...# ..*#* .*..*......*#...* . ..*.   \*...   .# . . ....*.. .#
#*... ... * ..#.. *.\#....\\...*\*.* .....#.*...*.. #\\.\  .....\ . ...... . ..#.\*..#...*.## \.. ##
#.. \ *#... .. *....** . ..\  .. *.#  .. ........ *#.#\.. . .....\.....#  #..  . .*.. .*#..*..... \#
#   . .. .. . ...*.. # .#*. .#. \ *#. *.. . .\*...*..\... \ .* ...\.  * .* ...# . .# *..*#...\*. .*#
#..... ..  ... *.*#\  . ..*...... .*. . \ ... *.. .  #.#..*  ..#....*\.** *... ..*......  ... .   .#
## ....\*. .\# ..\.\.. ...*.. #...#.*.*.  #.*.... \..\.* ..\# #.* #  .. ...#.# #*..   .#.. * ......#
# \*..\* .#...#.....*.*.....* .\##..#.  .*.#. ..*.#.*.# .*..# . \\*... #* .#..*..*..*.*.. ......   #
#. .*.##....*. .*# .. ...*.   .. # ...# ..  .. .* \.. .#.. .........   *#....#.#* .#*... . \..\..\.#
#. . ......  . ... *..\. .* .#.* .# .#.#..\..\..#.\**. ...##  ..#* #.... . .#.......  .....# .. .# #
#. .. ....# #...*...#.....# #.\#.....## . \. . . .\##.. . *.\... .\..#....*.#*.#...\#..*.. .#...  *#
#.........# .*..*....\*..#.*.....   .. . .\ ..  ..\.. #.. .*.* .*. ... * .# \.**.*#.... .. ..*...*.#
#..  .....  #*.  \.**#.. .#. ..##..\*.*. .. ..*#*.##... #..  #*. ... ....#..*\.   ....*....\. .*. .#
#.*.*\\.. *.  #.. *. ...\........... \#.. .*.  . .\*#.....*  . .. \......\...##..*....  .#...#.... #
#......##.#..##** \.*... *#.#.* **  . #\..\..... .... . #....*.# .. ...\.\......... **.\. *..\#... #
#.#. ....#...** ..  ... #.*  ......*.*  *......... ##.. ..* \*.. \.....\... .\....\. .*...... .. .\#
#...**...**.... #.**..  ........ ##*# *#....\......*# ##.#*.....# ## .*\# .. ..*#. .#. ..#....##...#
#.....# . *... .* ... ###*..\. .. . #......# . .* #.. #. \#.*.#\# ..#..#..\. ...# \....#*.. **...*.#
# #..*\...*...**#  . ..#*.. \...# .. ....\..... . .#....*. .\... ... \.#......  ...*.  .*. . .. *#.#
##.........#....\ #...#...#.*.#\....#.... *. .\#.  \.\  .*..\...#...#. *#  ......**........ .*.\ . #
###*.# . .. . .........#... ..* *... ...#*. .# . *...* .#.... #... .. \.. \..*.. .*.... .*\. \ ..#*#
#*..*....... ...\#..*...*  ... .#** **\.....#. .*..*...**. ..*.#....  *. *.*..\# .*. .  #.....\..\*#
#. ...*#.\. ...\ .\ ..*.#........   .. . .#....... . .....*..* .. ... \ ..*#* .... .#..   \ . . #*.#
##..*  .. .. #.##. .**...*.* ...#.  *.#*##*# .. *.. .*.**..... . .\  .*...\**...... ..#..... \.#\#*#
#.......   .... .......#..  *\  .     ..\\\.......#..  .. ..# .# * .... *  .*... \.. .# . .*... *. #
#. ....#.#* *..\  *...\.\.* \.*... #.#.. .. ...\  ..#.#.#.......  #.........*.*#..... ..# ...... ..#
#.#...*.* .*.* \...............# . # .... .\** . ..#........*#*#  .....## .*\.. * .#...* ......\. .#
#. *. ... .  .*.... ..#. .  .....\.\.\# .*. .....#..# .*.....\...  ...\\... . ...*.. * .  #..\\  . #
##.. . ..* \*.....*.. \ .*#.\......#.... .....*\...#\...#*...... . *...#\*. .. # ..* . ..*. .. .#**#
#. .. ..#*.  ..**..#...*  .. .\.# \*. ..  . *.......*#..  .*..#. .#.. \...#...#..#..#.... # *# . . #
#. ...#\.\.*#...#.*##....  .\......#\..\. ..  *..*..... .#.. .\#... ..##.* \. \...  .....* *.# \##.#
#..  .*.. . ... ..*#  .#  . . ...*.... *... . ....*#.**..\.. ......*......#. . .... #.. . ....*\. .#
#..\ ..#......\ \...... .\. R......*...*.. ## ..# .###..#...#...*.**. . * *.....*.. #*..#.#.\#... ##
#...*\*....  #*....*... *.. \.## ***.\ .**. * .  .*.... #    .... .\. . .#*..#.. .. #.... .  ...\..#
L..#.. .... * ...  ...... .   . . .... . .*..#.*... ..#.. . .. .. #. ..... ..*  .*#.  .#.. #. \*# .#
#...... .* #.\....# #...*.. *# .\#.. ..   ..#. .#* ..#. ..# .. *. . #.#.**\\.............# ...#. .##
#.# .. #.  . .. ..\.   ....... \  .*.#  ...*.\..* ......#*.# ....#.. \#. *..*. . .## .\. #.........#
#..#...*..*.\.*. .  . ..*\* .....*#. * ... . ..... **.*..*......*#.  ........\*..#... ... ...*. .. #
# ...#.\... ..#.... ... ..###. .#....\.# *\. ...** \.. .* .*#.......\\.. .. * .##..\.. ..#\....\.. #
#*#*#*.\  .. . ..*...#.*#..**..#...*.# .*#* *..  ........*...*.*.............*....#\...*  \ . ..#.##
#.*..##**..* #.. .. .\ ..*. .. .#. . .* .# *. \ ##.  #*#.. .\..#   *#... ... ..... ...  *. ##\.*. .#
#. ....  #**..#... *..* .*. ... #...\*.... ...   ...  .\.. .#...... . ....  ..#*.\*... .#.*........#
#.#. ..  ... .... ..\..#.. ..* ..#......*.. .\.*.. **.#....\....*.*.#. .. \.  .*.##...\.*..... \...#
#\.... ##. ...\  ... \\#........ ... ....... *... ..#. * .*.....* *.*....*. .#... ..\.*....\  *#..##
#.*...# ..#*.*..#....# *...#. .#\*\*#... .. ........#.  *#.#.... # . .*...# .*...*.  #.....\.* . ..#
#. #.#... .\  . \.* .*..... . .*.....**...\ *.* #  . *.# #...... ...\. ..\.*.#\... .*\..*.  .\. ..*#
# .* . . ..  ..*##... .. . ... ....*...\.  ## ... ......\... .#.\..*.. *.*\*...**\......*..*#.  *.*#
#...\..*.*.. \# ....\. .*##.....#.#.\... .** .. #.*. . ..**.*...#.. .#.  ... .. .  ..# . ... *... .#
#..*.# *#* #* * .. #.....**...# *.. . .#..  . .#.**... ..  #  *...  ... * .*.#. #.#*. .#* . #.  ...#
#.\#*# ...*... ...  *#.*.....\... ..#.*.\.. #**#*...# ...#.   .. \.  ## #\ #..#*\. . ... . ....*. ##
#.... \# #\ *#..... .#... . . . .# .*...\..##.. ..*. .#.... #.* ....** ...*. .  .  ##... ..*....*..#
#.*.. . .... #\....\ .\...  .#  \#.#.....##\.#**. .. #. # .. # . ... .#. ...* *...#. .#.  ....*..**#
# .. .*.\ ......# \.* ..## .#.... . \. .\  ....\...*.#..*.. .. .\ #...\ .#. ...  ......* ... .\*. .#
#. **.*.... .\.  #. . .. .#...*\*#.#.#* ..* *...  #.#\........## ....#.*...#..... .. #..*...*\ ...\#
####################################################################################################