####################################################################################################
# .# ...  . .... . .##\..*.... *\ ##.........\..\#.#  ..#  . *. #.....#. .##...#\.\#\...#.. ..#*#..#
#....**#... ..\. #.#* .#. #.. .....  .#*.. .. . ..# ..  *..#.... ...... ...*...#.*.....\ .\. . * . #
# .. #.** ....\... #...#  .. ..... ...#.  *..*  ...#\* . ..  .#. .....# *..##..  . .\..\.*...#...*.#
#.#\ .  .....** *..*  ....* ....*  ..... \*.... .  * ...\\\#..#. \....#. *. .. ..\ .*##.  .. *.#.# #
#. * .#.  ..#....\  # . *..*.. ..#.*..\....#. .#..*\.# ... .* ...#....*.#... .*. .... ...*.##.* . *#
#..\ \.... *...\. \..\.\* ..*...#.*. .... *..\....... *........... ...\..*..*  . . .\..\#.** ...\..#
#*.# ........*#..\*.... .  # \ #*.. ..\.**.#.* ....*.#*.*#. .*. ***..#...## ..\*...##.\ .\...# *#.##
#. .. #.  .... ..\.......*#\..\..*... .. .#.##. .# *. #.* *..  \....  #..\...#.. ..*.*.#......#\ . #
#..*#........ ....#**.....#.**.. # .. . ... .........#... ....*.\.   \ *....... ..  ..\ .* ..*. ...#
#.  \..\#.*.\. .\##....... . ..........  ... #.#..#..# .* *  #.... . . .. .. *.. .##.#. #.*... #...#
#.*...... * ...**...#... ....#\# . *#.. ..\..#\  .\\\ \......*. . \ .*.**..   . ...\...# .. *#.#..\#
#  .\..# ..# ........ .. .. . ..*#.....** ... ....** . *.*.   * . *.......#\ .  **..\ \.**...  #.#*#
# .# *.. .  . .\. . .#.. ... .*\.*..... \\.\*\#\*. .... .#..... **. .... #\.\* *#..  . ...#. \   . #
#.*...#. #. ..\.\.\... \ .  .... *  .#...#*..#*.. .*# .  ......*.*...*. ..... #....\.... *...\ .. .#
#..#.....#. #. ..\...\.##.\.. .. ...\..  .....#.#.\*. # ......\.\...*. ...# *  \ .##. .....#\ ...*.#
#.# . \ ##.. \# ..\.. ...*.* #.\\...#... \... ..**. ..... .# ....*.*# .*.*.* *... .***#.....*. ...##
## ...*.....\....\#..\.#..#. \.. #..\\.*#.....#.* ...#.*..*# .#.... ....* *.\\. ....#.*#.. ..#..####
#..#. ...#....\... ..**.#..# .*..# .*# .......**#  .*.*.*#* ...#. .#*.*..\.#.  ###.\ .*.**.. ....\.#
#..   * \.. *... . ........ ..\........\.  .# #.*... #.#.**...#.. \. .... ........ .. .. .*..*. . *#
L.#  *.#. .. .... R.* ..*#.. .* *..... .....#*.  ..#*..#\.....\ ...  #..   .*...  ..#.\ . #.\.. ...#
#...#...*.*. \*....#\.......*.... *#* ..  ..#..*..... #.........\  #... .*.... .#.  ..*## . . # *..#
#..#.. ..   .*..\ . ..#.#. ......  #.#..#...*#........  .# ##... ... ..* .. ...*\#\  ......* ....* #
#* .. \ #..*........ * #*#... .*. .#.*#.......#.#..# * .*.   .....\....##*. ... . ....  .... ....* #
#. .#..*..*.*...*.*.....\ #. .#..*.....\ # .. *....#.  .\..*.#......\ ... #..#.......*.......*. .. #
#.....#.*.... ... #*.  \ #.. *.. ... \\. * ...#.....  .#\ . .**.##.#.. .\# # ...\  *#*.  .*.#.. .#.#
#.##   .\..........*..\..\.# ....#. ...\.#.... ...* .... ... #......*# #.. ..........#.. #.\...*  *#
# ..\.#........  .......*.#. ..........\.* ##... #**.#. .#*. ..\...*. .... .. #.#.    ... ....*\*..#
##... * ..   .. *... .. ...\..*.##\#.#.*... ....*.  .. . ..\\ ... #.# ........ ..... *.#...*.......#
##... *. ... .\*# .... ..\ .. . .... #. #. .  *. ....\  #*#.  \. *..\#*.# *** ...#..*#... #* .....\#
#  .. ..\*.. \..**... .. . \**.. ..\\..... .*.... \ .*.. ...#..... ...*  # .. .. . \##*.*\..#..* ###
#...# .....#\.. .*...\.\ . ..#..   ... .\.#  #. **......... . ......*....    .##..#...\ . \ .. \##.#
#...#*. \...*..   . *....#.\...... .# *#....*... \*...**..# \.  .\.\  .....   . .  ..# ****##.#. ..#
#. \.#*.. ...# \*.#...#......*  .##.#  .*. ... .# .##.  .... ..* .....*...*.. #*..**..*.... .\*#.. #
#....# . . \..* . *... # .\.... .*...#*.*.... #.\\.  * #..... . #.....# *.\..**.  **.. #........*#.#
#... \.*. .#..#. *.*\*  .. \*.  ..#*....*  #.#.\.....# . #...*.*#.#...#.   ...   ##..# .. .... .\.\#
#..*#....#\.#....#. \..##. ...  .*#.. *.....*..#.......  ..#... *.   .*......   .. .#\..*. #.*. .\*#
#..#... * ..........*#.*.\#.#*.. .  .#  ...#..\.. ......  \*#.... *.# .*..#. ..*\.#.......\.. ..\..#
#. ..*.. ..#  ... #.. ..#...##* ..*. .. . #. ..#.*.. ..#  ...\#.#.. .#*... #...  .... .... ...**.#.#
#...*..... . #.* ..#* *.*#...\..# ..*..  * .*....#*..#...#...#.\#..*...*. *#......# . ...#*..  . . #
##*.\#\ ...#.. . .   . .*.. #.#.\.*...  ... ...#. ..*.    *... .. ... **#..  ..\.... #.#.*#  ....\##
#   .* .\ . ... #..#*.* ..*.. *.  .#.. *.\#   \......*.. .\\.#  \.*.#. ......*........ .... . .#...#
#...#..#  ..# ..#. ..... ..... *#.*.  .**#..\*...*   \.*....... ...* .. ..  .*\. .........\#. .#...#
## ... .\#..#* ..*.. . *...............*... ...  ...... ..# ###  # *.. #*..... . .*. \ ...#.# ....*#
#...\.\..... . *.#   ......*. .*. ...*  \..  . ... *...\.#. #*.......# ..   .. #*..*..  ...*..#..  #
#.. . .*##   #......\.## .*#.\.#   .. .. \ .\ ...# #..##..\*## \*#.....  * \..#.\.... #..... ..... #
#.##...\*...*.. ..#.#.\#.#*.**#*.... #.*...#...#. .#* ...   .#   *.. #..#. .#. .*.#.* \.... .. ...##
#.#. *.**..   ..... \ ...\....... ....\# #.. \# # . #.\\.\*.. #.... *.\#.#. \.....#..\.... * .. .*##
#...# . ..........  .......*.#.. \..\...* .*#.#**  * # .*. ...#.. #..##.*..*##...*..#. ...* ...#.#.#
#..*.. ... #.#.\\..##..   . .. ..*#**. ..#  .*# .\...#....... .* ..* .*. . * ... . *\.*#  .\#  ...##
#.# **..\...#. .#  .\. # ..\#..*.# .#* # .*..*. .#.#. .. .....\. .\.## ..  .\\#.. **....#  **.. \..#
# ..  ..  *.. ..*.. .\....*...... # *.........  ...#.. ..... .... ....... .* *.......*##.....*#....#
#  ......#. .# *\. ..*.. #. .\#.....  ..*..\....\.... ...*......#. ..#...#..#* . # .*....#*.##..##.#
#\.... .#.\**..\##...#.. .#....*.\...#  . \..* ...#....#.#   ....\..  **. .... . *.# .   . *... . .#
#....#....... ..#. ..\ ...... . * .#  ..##. .*... ..*#.# ....# *.......#.#*... . .  ..* #*###.\....#
#..*. *..#* . ......*.  * .. . .... .#.*....\.. ..#.*..*#.# *..*.\ #*... .  *.....*.*. .\\*..\...* #
#. *#. ..*\.....*\ ...\# .... * \... ..........* \...#..# ........ ..... .. .* .. \ #.  .  ..*\.\*.#
##..#*  * ... .*#.\.#.. . .... *# .#.. . ##.#...###\. ..*..#...*  ..# *.. #.. ...*....#.*#..#.. . .#
# . ..*..#  \ .*......*. ...* .  *... ....#   .....*.** \#..  .\.#..**.\...*.. **** .... #. .\.*.#.#
#.....  #.# .. ....  ..\.... *...*...\. .. # ..#..  .  #....## .#\*# ...#.*# .......# .... ..#*....#
#... .. \.*...***.  #.*...# .....# \. * ....   .*## #.\\  .**.*# ... ....#.#....#.#.*.\.*##...##* .#
# **....#..*..\.\...........#\.. .. ..#..#  .....# #...*  . *. \. ..*... .*. .... .......#* *......#
##..#. .. . # ... . . ..  \. .# ...#.*# ...*.#\\..*. \...# #.......#. . ..  .*.........#.. * .. #..#
#. *... ..#.\. *... #  .\.... ...* ..\. \  ..*#  .  . .*..  ..*... . ...#.#............. ..*. .# ..#
#.*....#.*.. ... . .#....#. * . .. .* .# \.\..  * ..*** .# .*.* *#.#.*. .*#.. .. . #..*. \.. .*.\. #
#*\.....*\.... .. * \#. . #  ... . *..#. . ......*..# ...**.\.......#\*...\#*.. *. .\. . ...# ...#.#
## . . *.*\*.#\*.* #\...\.*... *... .#.* #.. . .. *..*#*.. #*.....# ....#. .....#.#*# ..#  *.\.# . #
#.\. #\. *........ . ..\*..#\  .#..* ..\.\#.# #..#***....* #.\*..\.**   \. . \ *...#.*.. ....\.\.\.#
#\\.#. ....# .\*. #... .......*\  #..  ...\#*.. ....*.... #. . *#.......#..*..* .  ..*. #..\**..#..#
#.#...#..#  \. \  ##. . . ..#. ....  .* #. .#*.*..*.....  ....... . #\\ \. ...*.\.*** .\... *..#.#.#
#.*.*. . #.#........*..\...#...* .#.......*.....*.. .#....\.. .. #...*....#. ......#**.##*.\\...##.#
#\.*  *..........*#.  \.# .#...  ....*. *.*.. ..\ . ... .*.. . #.. *... ...# .#  .#..*........ . .\#
#. . .......\. ... #.#.  .#*\..**...#...... ..*. *.#.*.. .#..#. ...*..\.\.#.....   . .#.*... .# .. #
# . #.... .*.*.....# ....* .\#..*#.. . #.*.**\.#........# * . #...#... ....#..*.  ....#.. .#.  . \.#
#.#...*\*##\\.*.#* . * *.#.. ..... \*.  #.#...  ....**  .#.*#...*..... . .. ##.#**. .. \.#.# .... .#
#...#*..*\... .. \....# #. *.  .#...... ..*  #\......  .*.....*. #\ ..\  ..**#\  .*.. #. *..#..# ..#
# .....\#..\.  #..*#.*. #.*#.  ..  ##...\.. ..* *.. ...\......*..\*....*..*.\...#.*.#....  *. .  #\#
#.#. .  .\.* .#*.#\* .#   *..  *. .....*.  . **.*.. .... ... ..... ..  .\..#. .........*  .*. ..#\.#
#.##.#*\* *...#... . #..\.. ##.. *.. *.#.*..*. ... ........ ...*\.. .#. .\.........   .\\...*.*..* #
#..\......**. . . *..* ....#.#.#\. .... ......\.*..*....#*..  .  ...#.* .\.** # .**...\...\ . .*...#
# .###.*.#* .  #....#\#..... .# ...#.# *.*..\*\* ......\.  ...#*... ....\........*\.   #.\ # * # ..#
#. ..#.. .# . .  #  .... ..**##. .. *.#.#.#... .* .... \.\ ..**.\  . .... .\...  . ... *\. #... ##*#
# ...... . .\ . .#.. ...*... # .#*. ...  .*......\*#.   *  . .. . *.. *.... \.. ..... #....*.......#
#* * .\.#.... .#*..... *..*.  \*.... .\...*..\..# . *.#\*.*.......*.. *.##\.# * .  ..  ...**.. \.\ #
#.*.#.*. #**#. .#.#.***.... .*.#.\.#...***. #.\......*#.............  .*.#. . .#. \.. ....#.. ## ..#
# .. . .  \.......... #..  #.... ...#..\.. #\#. * *. .*..#**.#. .....*....* .#. .. ..#.\... ..\..  #
#....#.#*... ... **. ...*.  \ .....\.\....... .\.  .*.*  *...\. #**.* * .#.*.* .. ..#.\... ..#.. ..#
#   ... . .#.*...\\..* ...#. ... *#*..*. . .#**..  .....**..#. *#. .. ...\...#.  .\..\...# .  .. \##
##*  #*. .*\*.....\ .....*\. #  ... ....# .#  .  #...#. *.\# ... #...\.\......  .  .*..  .. \ #*.  #
#....#*.. ...*.....*.#. \...#\.*  .. ..* . ... .......  ..# ..*.\...*. .  *.* .\\...  ..# . #..#.#*#
#. ..\  .....#. .* ...#.....     # .  ....*\.* ...#...\ #.*. ....*...\. ... .*...... .... .#....#..#
#.. ...***. .. ......*. \. . ..*\*.#... ... ... *.. .*#  ..\ *.. #.. .##....*..#. ....#..\. *.*.. .#
# *. .\..#.*..#. *... ..*.#..*...\  ... .#..  . .  .....  #*\. ..................\.* ....# .*...#.\#
##   #*. ... ..   *. ...#. .#...  . ..#*..  * ..  .... *.*.*.  .#... .. \ ...*..*.....*. .....##...#
#....\ *..*. ..........**  ......*. *. . . ..*\.*  .*. *.* . *.  . ....#* . .#*. #**\. ....  .. .*.#
#...... ...*#..*... ..#...  ....**........*.#. . .... \\...\. **#... . .#.# #.#...*.#. . * \*.. *. #
###.#.\..... .. .... ....*..  .\.. .........  ...*#\. * .. ...#...**..**.#.#....* *.#.\.   # ... . #
#. *.  ...#..  ..... #..\\##\ ........*#**.  . #   # ..   #.\...\..#...*.. *.... \...*...#*   #... #
#. ..*..  .... #. ...**   . \.#..  .. **.#...  .*#  .. .....*....*..* ..* # ..  .#.. ... .\*.....*.#
####################################################################################################