#########################################################L##########################################
#*\# ..  .. .*.\.## **.... ... * ..# .#* .* ... .* *.. .*.... ..\*..*..**.. #  \.# .*\.#*..#..\... #
# *...#*. #*  ..\.....# ....**.. #.. .* #.*.#....* ... ..  .**.*## .\... ....... . . .** .. ..#  ..#
#.#.... . .... .#*.#.. \.####.  . .\ \...\. *..\.*....\*.. ....*...#..*. ..*# .*...*.*. ..*. ##. #.#
#*... . ...#.\.\.... .*..*#**... #.. . ...\ . .#.#. #   .#... . .. .#.#..#* .#...*. .\ .\. #.....  #
#. *.....# ......*...#... .\.*... ..#..\.##. ..\.. . ....#.\...##*.*  . *  .*.*. * \#. ..... .#.. .#
# \.* . #.\....#..# .#..... . . \. .. . * .  *..\* #..... .* ....\ .\\..# . #..# ....   .##\#..*\.*#
##...\..  *#.#*....... ...* .............*  .*.   \......  . *.. ..\ .. .. #..\*...*. ... .\. ..**.#
#...# .* .. . *..## #... . .*..  .  *... #. ..*.\.#... ...   ... ..  *.  .#  *. ..*. #..#..# .##...#
#..  .*#  ## *\.*..*..#.*.. .. .\.#....*.#...#.*.#.*.#. *.. ..  ....*##\# .*.*.. . . .* #*..#..#...#
#  *## \ * #.*..  .* ....*...  ...... *.. ....# ***.\. .\...*...  ..... .#* .*. ..... *\\. . .. ...#
#.\  .. .# .... .\ \.. #\.# #. *.. .* **..*.*.* **..\.....*..*\ *#\ .. ...\.#..\\.. #      .. ... .#
#\.\.*\ ..   ..*#. # ##...\.#.... ... . *\.# ..*.*#.....##\ ...# ..\........* #.*....#  #..\.. * ..#
# ..*#. ...*..  #.#. . * *......  ....\*........*. ....\##.. .....#.#. . . .\.......... ...........#
#...#*#...#*#.*...#.... .#..\#..............*...*... ......   . #...*\...# # ....*...\..*.....\\\. #
# ... \.. .  . #\...*** .  . .........*..*. ..# . #... #.... \....#..\.  .\... .\ *..#..**. ... ...#
#.**..\#. ..#. ..*\##..... ......#..*.....#. #.\.**. ....#*..   .....#.*. ... ..\.\ ..\....#**..*..#
#\.*..*....#.*. # .. ....... #.#....*\..#. \*....... \.. .*...*..*..*.*.*. ... .\\.\.*#  #.*.# #  .#
## ...... ...  ...# ...*.\* **.\......... *..#.. .. .*..  \*...#  ... ..\... . . ..*..**  .\..  .\##
#.  .*# ...*.*.*.*#  ..#..##\ . ..#... ... ...  . #.*....###. .....  #... ..#\*.#..#.. #..#..**. .*#
#..*..*.  ..  .#\..\.*#* *. .. ......\...\*.. ...\#...*#... .....\  .*.\  .*#..# * .  \.# ...  ....#
#.. ... **#...  *#..*..#  ..... . \.**. #....*.##*.... ..*.\. #.\ *#....# #..*..#. . .\..\#... *#*.#
##...\#\.... ..*#.*.. #. *.### *.. .#..#.... ...\  .....\#. *.  # ..**. **\ ....  ..#\.*. .... .#\.#
#..... .\.. # ... . *. *.\..# . ##. #*.....#\.\*.**#*\*.... .. . ##...#\#*\. .*.  .\. *.* \    .*..#
## .* . ..#.....\..*. .#....\** ## . \ *.#....\ .\. *  .....*...  .*...  .. .. *.##.. ...# ..... \.#
## .. . .*.....*... ... .   \.*..*.... ...#  ##...  .#...... .#..*. .*... ..**..\. .. .* *#\.\.. ..#
#.. ...*#. ..... .*.*\.#.* . ...*.\.. # .*.*... ..\###. *. *#\ \.#... #\\.##. .## . .#.......##....#
##..#.. .# #..\..**#...\... *.  #.\*. ...*#...#. #. \ #.. . \..#.#.. .*  . *...*###..\.# .##...#  .#
#..  ....#....*.. . . .... ... * *....* #*.....\ ..*#...*\\.. .#.## *#... .  . ......\  ... . ... .#
#.*..  ... ..*..##.. *#.....\*.......*.*..#...... ..*. # #.....*. .*..#*. .*# ... .*... #...#. \ ..#
#... *##..  .*  ...#.*\*#*..**.. \*. .. .#.. ....##.*.# ..## #.*  .. ....* ..#. .*.....\.. \#.# ...#
#..#.#.#..#.  *.... *..... . ...**.  ....... \.#. #* .#**.* *.  ..* .#*...  *...... .. .. *... *\#.#
#..*  ...\. .**\\\\*  . ... *.. ...  .. .*.***\##...  .*\..\#.......#....#..*#...#**.......*.#* ...#
#..*..* #\**...#.#...*.... ....# . ......#. ...\\ .... #*. ## .  \#....  #*\  \....*.#...  \# ...  #
##. ...* . .. . ... ....#  #  .*..#.#..  *#... .# # . . ..*... \..#...*.. ...  . .... .. . *..... .#
#. . ...*.#.*\ ..**.* .. . \# * ..\*#.. \...    #... .. ##*\.#  *....# . . .#*.... .#\... *.##\  .##
#...  . . .\.....#.\ .... #. .#....# .# ...... \...#..#*.##....*.*#. *  ..  .*#  .#.\#*....*\.. ...#
#..\\. . .\ ..... ...\..#....*.\* *..... .. . *........#*.*#.#....*.. ..*.....**.*... . #.  ..... ##
#  ....  *..... .  .. .#.* . . ** .# . .#..#\... .# ..#. .#\**...*..... .**  . .*....... #...... .##
##.....#.* .#.... ... #...#............#......#. . .. . *.. . . *. #...  .  * .#.... ..# #... \.\.##
#*.. \.*#..\ .#.*... \# #...*. . ... ....*  ...... # *. . .\..\#.#..*..#.. .. ...\*. . .. #..*.....#
#.\ #.. .....*#.. ...*. .. *#. . #. .....\ #..   .#. .  *** .....#** \. ..  ...#.....*..  .... * ..#
#. ..#.... ..\........*..*\.#*..  .###.. .#.*.. # .* .*.. . ..*   . \....#.......#* ....\ * #\..\..#
##  . ..*#.*#.#*. .... .. ....\.... ..*. .. ...* .#.... ..*...... .#.      .#..*.. ....*.. .* .. .\#
#..  . ...# . *.. *. ..  ....\\.......\..\.....* .*#  .  #   ... ....*. .*. ...* ......#..  ..\. . #
#.*. ..... .\.##*.# #.. ..*...#  . ...*.... . ##..*.\. ...*. .... ..*........ *..\..#..# ...#..#*#.#
#......\. #.  ... \.. .. \.#.  .#.\..........*..# \..... ....*...#    .# .#..*#. *.\*..* ...\ ..  \#
#....*.# .\**.*.##. .*..*#* .#.\*..**#..... . #.  .  . ..**#. ...... ...# .*  . *#*.* .**# .*\##. .#
#... .. * .. . . ....**.... *..*.## \.**.....#....\... ...* ..**.... .. .\... .... ..* * *. .\...# #
#. ......  ##...... **. #**  .# .......... ..###..*..*\.*#\...\.*.. *#.......\***.*\.*  ... .## . .#
#  . .. #*#*.#....\.*#... ......*..#.\..... ...... ##.......\. ... #.#  .*.*  .* *..... .*...  #..##
#. ...  ........#.\.. ..*...\#*...\  .*.. *.\....#.. .*...# \.....#.... ....\#.. .\ . ...*.# ... ..#
#\..# **# \.\  ...*..  ........# ..\. .# .# .\ .*..*#.... .... #....... .*#... .. . . *. *........ #
#..*...... .   ... .... * ..  .\.*  .  ..* ...*.  ......##.** #.. .#*... .##..#.#.# .  #\#.*.. ...##
#.**##.. \ .#.. .*.....#.##...  ..... ...##.. .#.. .. ... ...  .#*....*...   #.\....  ..*\.\#..#..*#
#.. ...# .#. *.....*#.. ...*  .#.    #\..#. . .*#*# *#.\\ .# .\\*.........*   . .*.#.. . ... .... .#
#*... .#.  \*....... .# .\  .#.* ...#. **.*.   . .# . ..  *...#...... \.\..#..#... #....... .....  #
#.. ...\ .#. ..  .*.#...# ....#. . . *#* # .......*. ..# ......#.*\  #..# #*.*. ..#. #* ...  \...*##
#.*.## .*.*. *....\...*   .#.......*.#.## ...#*   . ..\\... .# ...* ...**. \..**#\#..#.##...**..\# #
#.   .#  . \.. .. ...\....*.  ... .\\.* .\..*... .... \.  **..... . .. .....#.....\ R. ... #.......#
#....   ..# ..*..#. ..... . *.\.......*\*#..#. .# . .*.*......* #.**...........#.*..* *.....\ .. ..#
# .*.#.\*\. ... .  .. .# \.* * ...*.. ..#..... \.*.#.* ...# . ... ..*........*.\.... *#..#.*#.#.  .#
#... ..#*  ..*# ##..*. #. ...\\. ...*.*.. ...  .. #.\ .* .....*  .**#. . .\..  #   *..*.   ..#*.# ##
#.... .#...\. *.....#...... \.... .## *..#...  . **. .....#.... #.*.*.*.#\..\  . \.\.... . ...... *#
#.#*.#* . *. ...#. #  ..   \.*\.*. . .*. ##....*.*...#.......  .... ...\. #...##..# .*#....\\  ....#
# .... ..... .*\..*..#.*...#.. .*.*.# ...*..#.. ..#\.\#*...*... #. .*#.#. \.*.. . ....\.#...  \#.* #
#..... .**..#.. .# .* ..*...*#. ..*..*..#...*. ..*... \.. ..#.# .\ *. . ... #.**  ...... *..* * ...#
#*.# .*.***.. .......*....**..#... .\.. ..# .. ...*#... *  ... *.. .... # . ..  *.....# *..*.....*##
#....#*.... .\.#.. ** ...#..*..####. \.\...**.#**.. **..... .* \ ..*.  .. .\.\#..... .. .#\..... . #
##. .\... .*.. ... #...\ .# ..*\... ...#*.... .***..  ..... .\.........# .* .. ..**#. . ...*... *# #
#\.....    \*#....*...##..*...* .*..*... .#.. *.*  ..##.. ..# . ..#\#. *# ... ...  .#..* #.\*\.# ..#
#...*...*.....#.  .* #. ..\.   . ...#. . . .#.#*......* ...\.#  * ...  .  .*....* ..# .# .. .#...# #
#*..*. * #...\....#...\*.....\ . .......#. *.*#...#... \.. #.. .*...  *..#. *....#... ......*..*. .#
#*..#.....#.  *. ... ..  ..\..# .. #\.#.   .... .\   \  #* ......... *.* * \... *\# .... ... ..#.*.#
#.\ *. #\\....\ . *.... ....*. .  .\. .#...  ..##\... .. .....* #... .....  .....#. ... ... \. \*.##
#...\. *#\.....*..*...*   .*. *..*..#........  \. .....  .\ ..#  .##..... #.#.*.... ............. *#
###.\ ...*. * .\\. *...\#..*.#.. .*.#... ..*.. .#..##.*.*.#...#*..* .......* . .*..\ ..#.. ** \....#
#.\ #.#   . ... *... ...\.. . ..*..*. .#.###....*.*\ . .....  * .\.. \.. .#....* ...*...**\*......*#
# ...# \.#  #....*. ...  \...\... ..#.* .. . #\.....  ..# .#. .#.#* ..*\* # ...*. #.*. ..#.... *..##
#...... . #...........\.......# .**#.#.. .....\. \. .......  ....\ ....  .*...  #.\   ..#.....#... #
#......*.#..\.#.... ..*..#.. ##..\.  . . .... .*..#  . . * . ...  ..#. #.*.*#.*..# .. ** ..# .. .. #
#.###.**.   \*...  \.. .#**...... .. #..#....... . .*... .#..# * *#..#.#.#. *.. #\#*.#.*.\ .*.. \ .#
#.*. ....*. .#... .\.  *.#* ...#*. .#\.\ ..\ ......#.#.  ..*...#*. *...# ..  .#.*. ..##.##..\# .. *#
#...## ..... ....#.\#..   . . ..*...  .##..#....*.*.. \...* ... ....\ ....*#.. ..... ........#..# .#
## *.. . ..\ .*....*.* . *#\. . ..#. .\#   .. ...#.. #*  ..  . .  ..\ .##*.\.#. . # . * \ .*......\#
#.*.*.# .\....*... ....* .. .*..  ..\. \....#. *..# ..  *\\ **. . ....#.... *#.*....##*.#.#... ...##
#.#.....\...*\....*....\ \.. ..\....#\....#.* ..\.*# .... .... *. .. .. .**.##\...*.......*...* . .#
# ..*\*...\..*.. #* ...\.*.#.... ....  ....\..#.*#... # .#..*# ... ...#..\.. *... .#...  .#... * ..#
# ...*. **#.\. .*#...\  .....*...# . .##*   ##.#...*..... ..#.#...  .....  # ..  .#.# . .\#*#... . #
#.  *...\\\.\.. ...#  .....*....*#...... . ....*...#.... .. * .*.\ \...** .\...* .# #\..... .\... .#
#..#*...#** #..#  .#.\.*..*.. \.** *.... .*.......\ .  .*...#...*.. #..\.#...*.....*. .. .*.#.\..*\#
# #..  ** ...#*..**. *.. *.....  . \#..#.. . #... .*... ..**#... *...# .. . ..\ .. \#. *...  . . \.#
#.. ..\..#\...\*. .#\# ...*. .......... .\* ....... .. ...*###\#\...*.# .\.*#. ...   . #* *.*#. .#.#
#.... #....*..# ..  .*...  #.##...* .....# ..\ .  ...#.*.. ..\..*....*.  ..... .....  . .    .*..\\#
##.#. . ##* . .*...*..*..\..#..*.\*.  #.....*..\.#.     #..#.   .#*\. .*.\.....*. *.* *...... .. .##
#...# .#..  ..*\.. .\.#.#*.#.. . . *...... #\ .\.. \.\..\**....\..  #*... ....*  .*.#. .#.*.# .*..\#
#.*.#....*..... \. *.# .*  ..* #..  ...*#.\ **..*.**. *..*\.. .# .\ #.*#....\.....#............... #
#... *..#*#. ..*... ... ... .*.... .#... ..  . ... *..  .. ..#. .# .\ .. .. .... #   ..\ .. *# *..##
#.. . ..*...* .# #......\ ... *........#... #.. ..  #.. ........#.....\ .# ..  .##.. .... \ ..# .**#
####################################################################################################