####################################################################################################
##.#. \....#.*..... ......* *.. .....  .   *..........*.. .. . . *. .... .#  ..\......#. #.*.* #.*.#
#.#.*.. ** .....\...  \.\## ..* .....#.. . ........#\....... .. . *.*.. .* .\#.   ....# ..    *....#
# *.**. #.*.....* .**. ..   ....##*.....*.#  *\#..  #....\.. ..* #.   .....  .  . .\.  \..\. .. ...#
###. .# .# . #. ..  *\. ...  ....*#  #.#*..# \. .* *. .. .##. *......... .*...* . ... .**.#.*.#.#. #
#.   .. .. \*....... .  \ ..*..... \.. .##*.*.......  ....#.** \...#..  .... ........  **#......#..#
#.  ...*\..***.#.....*#.. .\ # \.*.. ...*.#*\...\ ... . ..# .*.. .. .*....\. ...........\.##\. .# .#
#*.*# ##  .#.#.... ..  .\.\. #..#.. ...\#..#...#...*.\*.##...  ...*.#*. # ..#......*# \# .\# ..#  .#
#.. *.*#... . .. #...*\.  .*.*##. .#*.....#..#  ....... *.\. .*#.. ..**#..#... .. \. ..... .* .....#
#...... #  .# *.......#....*\. .#*.......# .   #.* ...# ..#*#*   ...  .*. *#..##...... ... . *#.*. #
#\*...#..* . #.....\ * ...  ..#.#..##.* *.. ........   .#. .# .*..*..... \.... #...\.# *.*. \..  ..#
# . .\.*.... .\.*... ......*.  * ..# ..**. .#..# ... .....*.*.... .... .#*.... .. *. #...#.##....  #
#  * ....\.\..* ...... .*#*. ....*.....#......*.*\........\\..*. .*. . .#.  . ......*. *. .. .#. ..#
##.## ... .. ... . ......*.##.*#.\#. ......##\ #*.. #. .  ..* ..#..*# \....*\ *.#.......    ..\#  .#
##.* #*. # .#.........##.....*..*..#*#......*.\..   *.....#.*\... ...\ .....#.. #.. #..  ......\*\.#
#... .....#...#.  .\.##....*..# .. \.......... ....*....\  . *. .# #.#...*.. ..*... * #..  .*\  .*.#
# # ... \... .###...\. .*. \..\ ... .*...*..**#. .#.#.... ...... .  .\..* ...#\\ ....#...# . ....# #
#...*.. *#..#....#   .. ..*.#..*..\ ...*. .# ..\.... ...* . *#... .. .\............*#.  .#....\.*..#
# *.. *   ... .* .*.##*..# ..\   ..*. #. .. ..*.. *.....\.....#. .  ..*.#.#.. ..\...# ..* .. ..*.*.#
#...* .....####  ...#*. ...#.**# . ...\. *# .*.*\.... .\..*. ....\ .#. . #..  \#.*. .\* . .**.  ...#
# . ... *...*.  #\.........**#.#..#....#\..*#** .... ...*\# *.#.#.. #  .... .# .*..#.*.....   ... ##
#*....*.... . \..* ..... *.#** ..*R  .  .. .*..#\... ..# #.*..*...#*\ .. #. #*..*.......# .... ..#.#
#.... .. *.\ .**   #. ....\.#.# .* ......#.  ......\.. ... .*....... ..  ...*.* *. .#.*.**#.\... ..#
#.*..... . #.. . ....#.   .. . . . . .. ... ##...* .*# * ... .*...#.**. \* \..**   ... ...#......\ #
##. ..##. .. *..  .. ..\.*... ..  . . .*. ....* .*.. \  #. ... . .*#*.. \..#  .....\*.*..**....****#
#. ..#.... ... ..*. ..*.*. .. .....\\#..#..*...*..# . ..\# .. ...*... .... . #.. ..... #..\.#. ... #
##  #.. .\#\.......*..... #*. ..  . *..\. ..*#  #..**#*** .. #*.*.. ..... .. .#...   ...\...*.... ##
#.*. #*  \.*..* . .  #\......\. ..*. #...\#.#...#.*..  ..*##.. #... ..\#.\ . *..*..*..# ..*..*.#*\.#
#.. #.\  .. . . .....\..... .#*# ....... *.. .*. # ..**.. ...\#.*.#...\ ..\\#. \#*\ ...*...... .#.\#
# ..#..**.*..#... .. .... . \... ....#...# \.... .....*.* .  .#. .  ..  ...*#. .**\ ....#..*. .  .\#
# ...#...\*#....... #*..*#\.#.. #..#  .. .#.. .#*....   .#... .. ...#.\..#.*.\.. . .  .#.*.## .... #
#.*.*..  ... ..*#....#. . .*.. ...#. \..*# . . .**...# .* ... .. ..*. *.  *. .. #..# . .\..#.\.... #
#\..*.#. . ..#.. \... ... *...## ........ ..##\.. ....#.#.#*.*.#..*...#*** ..#. .....* . .* .. ....#
##....*..#.....* ..#.. . ..... .* ...\.\....#..\. *##.#*. .#  .*..  . .. \....  .\. *..#.***.  ....#
#.*  . .  \.. ...... .  .*.**... .*##..* #...# .. ........*.  #.#\..*\**.*.*.   ..  .#*.*..... . .##
#  .#. ...*#. ...##. ... ..*\. .\...  ... ...*##   * ........ ......\ .*....#..#......**......**..##
#.*  . ..\\...#.# ..*.  .. .# .*  #  . .*......  . \*..... .....# ...  ...*  .#......#\*...#. \.*.*#
#*  .. \..*..# . ...*#\..  . .*.*....... ...##. # ..\.... ..   .... * . *..#.*#.. .......*.#..** ..#
#..#  .\   #.**. *..*. *##\...*..*\#....*#**#...# .*. .... .. *..*. ...... ..*. #  ....*..**  .. # #
##....* ..*  ... .\* #* ..#.*..*. *\#. * ...   *..# ..*.  .#* .#.\..  *... ..*.#...\*. ...#..#..   #
#..*. # #. #......  ...*  . ..\ . .. .......*.\.  #......*.  #.#... \#   .#..#.#.. #*\...*.  .. .* #
#.  *\....\..... .\..#..*. ....\ . *..#. \ .*#. .#. *  ... . \..**...#  . . *.. .....#...#.\ .*. \.#
#.#. #.\# #..\*.. .\..*. . *# ....... *.....\*. ..#.... ## \ . *  *.. #.. .....  .#..#. #....\ ..# #
# ..  \....* ..# #......#... .##\\.    *..#* ..\...*....*...  #. ... #..\ ..#..#. .......  .#.... .#
##.##.# ...\.**...#. .*.. ...# .. # .#....**.#.......*.\.  ..#\** ....  ..#... ..**.  \. . .##\ .\.#
#.... .....   #..#  ....#..#...# ....*...  #..*...# ...... ......##.*..#  .*#..#..\.  ...*.\... .*.#
#.........#..#...\.#*. *#.. #*\.#......#.#\.* *...*#..\*.*.\ .* * .......*# ..* .#.  .\....***.....#
#..*.. . ... .*. ....\ *......# * .... *..#..#.*..#..* .\ ..# .    ..\ ...#..# .#* ..#...* .....\ ##
#..*#.*.*#.*.... \ ...\.*  ..*.....\.....  .\ ....#. . ..  ...#**..*...\..*.#.* . .##.\ . #. *#..**#
#.*...#*.*..  *.. . .. . ....#.\.. \. ...#*. ..*.#. *.... # .. \...\....    .  #.\. .... ..\..#* #.#
#.......... ...*##... **. ........ .\....... ..... *..##. *.**# ... \  ..... ..*.#....#**...*#\.. .#
# . # . \.. **#.......\\\#. *.#  ...*..  ...#..# ..# . ..  . ..\ ....\.  .* .#......###*\... *#....#
###*..*. .....  .. ... ..#*...... ...... .....*  .. . ..*.. #*.. ...\..... .. * .  .  ... ...*....*#
#*.. ..  . \..*. ..**  *.*#\#.  .... ... . ..#.*#*. ...*.. *. \... ....#..*..#**.. #.. . . ..*...*.#
##...*#*\  ..* .....   .\* * ..**.##. ..\...##*.\ #.#**.. \..  ..# . .....\..#...**.....\...*..#. .#
#......#... *.# *#.*  *. ... . \.*\..*#... ...  .. #...... . # #  *. .#. .##.\.\..\.  ...#  . .. . #
#.##*.........  ....** #.# .#..... .** #*.#\ *....\. #.. . \. .#.*..##..#\\*..\ .. \.#...... ..# ..#
# ........ #* ....*.#*..#.. .......... *#. .. ..# ...** #...*.*.\# . ...#..#..# *.  .....*# .\.*. .#
#.... ..*#..\#*..#..\ \*\ \\  .\. .* \#*  ..... *.*.... #.. .*\**...... ... .. ...#. * .. *.. *..*.#
#..#.. #..\.  #... ... ...#.....\.......... ....#....... ..# ##...\.  ..... .*...#*.\.. . ...#*.*.*#
##* .... \..*#....# * ..*. .#.*..#.\... ..  . .......*.. *\....#..#..  ... *...#.......   ... .\..##
#.*#... . ..*.. . . ..*....\ .*.. ........#.*.... ...   ...# ... ...**.*.* ... .*\#..... ..... #.#.#
#  ...##..... .\... *.*....\.#......\..#* ..\....  .*..*#.. .#... .\#.*# ...... * .*.... .. .  * . #
#..# ...##. .....#\* ..\. .#..*##. ......##.....#.**.. *....\..\*\.\.*.\..... ..#. .  .* ...#. ....#
#...#...#....# *#.. \#....*... # *.\ .#...... .\...#*#..*......#......*. ....# .*.... #.... .* *.. #
#...\...#.*.. .. \..\#..*#..*. .*.\ . ..#. *# .\* #\\ . #.. #....... .....*.*.... *..*.....##... ..#
#. \.*#.....** ...  .... .#   \**....... *.  .  .*.*#.*.. \. ...#.. ..#..#.\.. ........\#. ...#* *.#
#..... ......*. *...*# .. ..*. ..*...*.....*# #*..  .#.#  \.*#. ... .   .#.....\* #*#. ..*.. *#..\##
# ....... . *. .#.\......***....## . ......#....   ..*....*.#*#..... ....\..  .....\*. . .#..**.  .#
#.* .#.*.....#.*  ....\.#\. \.... ..   ...#*# **...\ .  ##*.\..  ....*.... . ..*#.\# ..*   . ..**..#
#.*#  .. ....#.. . ...*..#..*\  .# # ......#  \.#.##.*.  .. ...... .. ....* * .*.. **.*.#. .\#.....#
#.*   #..\..\##..#*.... ...\...*\ . ...*.  ...*..*..**#\*.*.....\.*....#* . ..*..... .##....##*  ..#
#.*. . . \.....\.*\ ....\. *\.#..\  #.. . .. .#  .\##.......*......*.##........ .  ...# .*\..  ..*.#
#.  * .\   .*.  .. .\\... .. ......\........* \.*.\.  .#.\..#..#.. ...... .\..  ... ..# *..***.*..*#
#.##. #..#..*.#* #.*.*#\\. . ...#* \\.. #..... .\ .**.  .....#\... ..  ... ............ *..... .*..#
#\#.*...*...#....*# * #..*.. ...\*.. .\. #.. #\#**. \ *. ..... .\.....* *..#..#.. .....*. *..... ..#
##. * \... ...##... .*#...\   *. ..*. ...** ...  #*..##... ..##.  .#.*. #***...#\.\.\* ...*  *.##. #
#.....*\..*.\#.#...#....   . . ....\.. ..\.  #..*.\**..*..\.#\... ..\..#.... . .......\...* ##.\ .##
#.*. . ## ......#... ..*.. .... . .... ..# # ..*....*\.. .*. . . *\.*.. ..#....## ...#.*.\*...... .#
#.#  . ...#. .\....*. . *#.* . .  .. .*##. # ##... .#.#.##..\..#..... ....\. *.......#. # #  .\# .*#
#..**. ....\# .*.** . #*.........# ........ #.#* ....... . ...*...   \*.. \.\........#.... *.   .  #
## .\\###*.. . . ..... ..  ... # \\....\ .   .. ...... *.  .\. **\*... ....# ..#  .. . *.##*\ .#.*##
#.. ..#. .. .... #..#.\. .#......... ..\. .. .* ....  .#. .#*#. * \....#*. . .#........ *#####..*.##
#*...###. .. #..#..... . ........# . .\. .......   . ...*\.*\. #.##.**.#*\...#...* .#\.. ..**  .. .#
# .#..* .... .#.  ....#.\.. .  ...#.. .* \.\..#\.....#* . ....#*.  \..\#***.#*  *.....* . \#.*\*.. #
#   \  .# ..*. ...# .. . . ...*##. .#\....\..#...  \*..* .*........... ##.# .# ......\. ...**... ..#
#...............#...*.*\..#.* ...... .\.#...#\ ..** ....... .. ....* .*.*.#..\ #. ..............*#.#
#*#..... .#. .. .**\..#\... . ....\\...*# .*  ... .*... . #*...# #. ...  .\  ...##.. *.... ** #.  .#
##.***. .  *.*...* .. ......\# .#.... . *\# # ...#.. ..* #*.... *. #.*#. .#*#....\.....*\... ......#
#.. .. .* ...  ##...*....*. ..*. ...*..#.*\.#. .  ... .*.. ...... #.#.## .  .## \..\.*#..*\*.#**#.\#
#**# *..... .. ...#.# .#....\...*..# ..*\...\#.... .#  .*. ..*. .* *.. .. .....**... ....#\*.*.. ..#
#.   ........ .....\#.**. ...#.*.#*.*...*........**#..\# # #....*.* .  #.....*.. .*.* ..  ...# ... #
#\*..*......#. #.... \ ...*. .*#.##  . .*.# #..*#.*.#.\. ..#.# .*. *..*. ....#.\. .#\ *#....# ...*.#
#. #. *. .** .# ....*..#......\#*. #.\..\.* *. # ..\#. #.#.#.#. \.  ..#..*.\.. ...#.*   .*.#.#.\. .#
#..#.#....\ ..**....#....\.....*#.*** .... ..#...#...  #...*..**..#*.\  ..#....# .. #. .. ........##
#*\.#*. \.#..*.# #..# *#.. .#\.#.........  .##.#*.....*.** ...*..**.#...*\....... .. .* ..**.. #.* #
#.......#..#.#. ....... #  .\*\\* .# .  ........... * .\#\##...  ..**. #* ...*...#...# .. ..##.*#..#
#*....\. .. * .. ... ...#...... #.#.# ....*... \  . ..#.##*.*.  . .*#. .  . *... .....#....... ... #
#\ *....... ... . . .. ......*.. ....##\...** . ..*..#... . . *.* ....**.#\  ...*..... *.\..#* ...\#
##############################################L#####################################################