##############################
#..*.# .   ...#.\.. #\..* . .#
#. .. ....* .*.......#..\*.* #
#  *** .... .\.*.  \#   *.*#.#
#.** .\. .. .#.\\* *...\ .#. #
#.. ..#. #.#*.*.. #*..*. ....#
#...   *\\*   .**#.......*.#.#
#\   .. #.*\...... \ **......#
#.##.. .*.#..**#...*.  #. .#.#
#.. #.... #. .##.*.*#*   .\ .#
#.*... #....*... ...*... \ *.#
#*...\.\.. *#.*\ ....\##.# ###
##. \ .. .# ##*. *..*\..#\  .#
#*.. ..... *........ . ...*\ #
#*.*...*#*# .# .#. ..  . ..* #
#. . # ..#.#*.#\..#.  *.....*#
#.* *##......\\....# .....*..#
#.*..*  \........ .#.. .    .#
#*... ..#  .*..... ..#  .*...#
#.* ..\**#.* .\.\. .*..*.. .##
#...\.#. * .. ...\\...#....#.#
#*....  ........**. \#. .....#
#\...... ## ...#*.** .. **.*.#
#  ..*...#.#. ..\.#.....*..###
#.... .* ..* ...  *.#........#
L .# .#..\#....* . #.\ \..##.#
#. ..**..   ........#..#.. ..#
#..##..\.*....*.\ .... ...#..#
#  .. ..# *......  R#.. *. \##
##############################