##############################
#..  .... #....*. ........\.##
##\.....\...  . . .....#. .\.#
#..#..... #.\..# ...\ .. ...*#
#.\..* . .#. ...\ #..*..\....#
#. # .....##.... ## ..*#..*###
#\....#*..#.  # .#\.*.. \....L
##.*..#.*#..... .#. . *#.*# .#
#..*.##*..# \. ....#......  .#
## ..*..  . ..  .#.. .. #.*\.#
#  .* . ... #.....* .*...#.\ #
#**.* .*#..*...  .. ......* .#
#. *   .. .# . . ....\. . .#.#
# .  ...  . . *\.\.........  #
# #.\*. ..* ....*.. ..*.*.  .#
#..# *.*..#......*#. \..... .#
#. *.#..   *. .....#\ . \#.*.#
#... .. .. .. ..... ..# .\##.#
##...#. .*.*. #..#. *. \.. ..#
#.#.. .. ..\ #.. . ....#.  #.#
#\..\..* .#.*. .  #\...#.\ \*#
#..#.\#. ... .*........R#... #
#\.*.# .#*.#..* .#..*.. *.*.*#
#.......#. .. . ... . .. ....#
# ..# *.# .\\... .*#.  .. .. #
#.#.... .# . *. ... *\.**....#
#  *..##.. .# ...\#.## #*...*#
#* ..*.... ....\..#\... \*.#*#
#..........#.\ ...  \#* ..# .#
##############################