###############L##############
#..\.. .#..#..\ \.....*.*.*.*#
#....\#...#. ..#.* \ *. \*.\.#
#........  ##* . .#.*.\#...# #
#.... ....\.#** ...\...* *.. #
#*.##*    ..*.. *\#\... .# ..#
#..*#.... ..*#....*.... .....#
# # \  ..... ...*. ....\..#.##
##.# .# *#* *...#.#.*\.  . .\#
#. ..*..**. \.... *.#  ..... #
#*..*... *#..*..#....#\..\#\.#
#.. .#.#R .. #.....#..#.....##
#.  #. .... *.. #.*... *.. . #
#..#...*..#*.. ..\\.#.. .... #
#* ..*\...*.#..#.# .. .*#....#
# . .\...*.. #*....#* \ *\* .#
#*..\.......#..* .#. #.#  ## #
#.#.. #.\..... .......# ..  .#
# *. #... .. ..*..*.  *. ..#.#
#* . * .\.#.\\.#...#. .#.*\..#
##. #  .....#.. . ...  ...\.\#
#..*.\*  ....... ..  .\....\ #
#.... . ....# ..... #....... #
#.. ....\# .\.**..  .......*.#
# .#.#.. *...#.....\.*.. \#..#
# ..* #\ .... .....#. . ....*#
#\*...*...#.* ...\. ...... ..#
#* . .... #.  ....#..*.. #.#*#
##  * # ......*...#  ..#.\ * #
##############################