##############################
# **..*\R.* .*#.....*\*  .#..#
## ..* \\.. . ....##.*#  ...##
#.* #.#. .#\. .*..*..*.   *.*#
## . ....*.....   ...\...*...#
#.\***.#.*.#\.* ..\......*.*.L
##......*.# \... **. ...# ...#
#  #...#   .   \...*..\*#.  .#
# . . .#. .\*..#\.*.*.. #..###
#*\.. .. .... . . . *. \. ...#
#..#....*.  .. . ... . ...   #
##.*....\.* ... .........#.#.#
#.\ ...\ ......* #..#. *..# ##
#.. ......#.... ...#*..#..\ .#
#*.....##..........# . .#* ..#
#... #*\..\ #. ..... . ......#
#  #..#\.##..#\#.#\..*. .....#
#..#*....**..#*.*.#..#.....###
#.*# ...* .  . #\. .. .##.* .#
#*.....**.*..# \\. ..... .. .#
#.##.\..# ....#...#..*.#.. \.#
#.. #.....#. .#.*  ...* #*#..#
##... .\ *.\\.....#.#.#.*... #
#.. #. . #..\  .# ... . .#.  #
#*#.##. ...\\*.*.#... .....*.#
##....# \##...#.....\ . ....*#
# .....*.. *. ......  ...#...#
#...  # ..#\# ... *# ....  #.#
#   ..  .. ...#  * ..... ..#.#
##############################