##############################
#*...... . .. . \*#* .\ #..* #
##.# .  .. .#\*. .. .\.\.\..*#
#*\..*.# **...#...  ..*   ##R#
#.. ..... .  .. #........\  *#
#.. .#......* **...... *. . .#
#.*#.\..#......#....*\#...*..#
# ..#  *.#.. ..   .#. *\....##
#.. .#..# .. \  #.* . .......#
#.......* ..*.*.  \.. ... #* #
#..  ... .*..\ ......*... .\.#
#.#. ...#.. .\ ..... .# ....##
#**#... *..**# *.... . *.. ..#
#*.*...  **.... ..... .\#\.#.#
#..........#. *. ....#  #....#
#.....#*.*.*  # *............#
#..   **...*##.. .....#* #. .#
# #... **#.. *  .  ...\...*..#
##.## ...*.* *.*..# ..\.. ...#
##.# ......*#*..\ .*..... ..*#
#.. ....#. *.  .   ..... .***#
#*..### . .  ... . . ... ....#
#  .. \*...  \..#.#. .\ .##..#
#\.*...#\.  *...#.....*.....##
#.. ... ..# ..*#..... ##.. ..#
#\. *.. \. \ ..*..*.. . \\.. #
#. #. ..*......* *  ..##.  .##
#.. ..*...... ..\..\. ....*..#
#. *** \#*. \..#....\...\*..##
############L#################