##############################
#\.  ..* ....*..... *. ....\*#
#. ..#*..* .. *....*. ......##
#.\..*....\\*#. .#....# .## .#
#\..*...#\.. ....... . *.\...#
#...#*........*.*#........#..#
#..#.\.#.\*#.#.#.\#.. .#.#*#.#
#.. .#.#* ..*..\ \... #.##* .#
#* *....*.#... *... #. ..*.**#
# .#. .. .#... .\.. .*.## *..L
# ..#... .# ..# ..*.... \... #
# ##. #*.. . . .\....* .....*#
#..... .* ......*.*.*..# .. .#
#\**...... ..#. #.  *.. ...\.#
# .... ......*... ##.#\.#..\ #
#** . ..*.. \.##....\.#R.....#
# * . ..\...\*. ... #..   .. #
##*.#.*. .... \ \.. #**...#..#
#. ..#. .*.*. *  *#...... . ##
#.  ..# ...\.... . .\..#. . \#
#. .  #....* . .#*\  ..... ..#
#.. ........  .. . .. . .   .#
#. \  **..... ..  ....... # .#
##.......\.**..\\ . ..* ..*..#
#\. .... . .#..** #.... * .*##
# . ##*. .... ...*.*.*  #\# .#
#..\..*##... .. .....  ....#.#
#. #*.. ... \..#.#....##. *..#
#.....#\.#....\... .* .# ....#
##############################