##############################
# ....\ ....... .#.\#..*# \..#
## .... \... .**\....#.#.# ..#
#  ## ....* .#.#\...*.. .....#
#. ..... . ..* #.#.* #.#.  ..#
# .......... ...#.....**... .#
#.#*......   .#....#......#..#
#.#.#.*.  \. \...**\....... ##
#\ . #.# \#..*#......  . # ..#
#........#......* .*. .... *.#
#. .. ....#  .. ... \ ..# \..#
#..*.**     # .\..***   .. .\#
#*..*....##...*...... .#.. . #
#... .. .#*   #*#*...#....#.##
#  ..\... .\*. .\. ..**#.. #.#
#..\#.......\..\*** .\...*...#
#. #... *...  . #.  \..#. \.\L
#  * ..\..#.\\ .. *.#*...*...#
#  #****. #*. ..\.\... . *##.#
#. ...*\... ......* .*...  ..#
# *.\.#* #.*. *.*..  .\...#\.#
#  ......#.##.*...*....*... .#
#. #.....\   . .#  ..*.......#
#.. .*...  *. .* ..\. .\..*. #
#.. .. * \#....  .*.##\.# **.#
#.#..... ... *   #  .  .....*#
#....#..**  .*.#.... .#. ... #
#.... ....*#* ..#.#..... #...#
#R .......*........#\.*#..* ##
##############################