##############################
# .. ..... *........ \...* .##
# #.*..* \.  ...... #..# .. *#
#..*.#..\*.*... ......#.. . *#
#.# \.....*...\. .# #*  .....#
##. ... .. #*#  ..##..##.  .*#
#.. .... #.#....  . .*. .*.###
##.\#.#.. *  *...##. .##.#...#
#\.. *...*. .* . .** .#* . ..#
#*.*   #...  . #... .. ... *.#
## ...# .. #.##\..... #..... L
#..\ .. .  \# .# .......*....#
#..... .....#...\.. .. ..  . #
# ...\........ ...*. ..**..\.#
#\*\...\....#.. *.. .#.   .#.#
#*##. ... ..# .. .*.. . .#.*.#
#.#.. .# .#..\ .....\#.#...  #
#....*.....\......#..*...... #
#.. ... . .. .#....*.#...#..*#
##...*\# # #\......#. ##.....#
#..*...   #.. .#..*\......#..#
#  *..#. ...#.\. \..\.. ..*..#
### \. . .# *.... .\. .#.\...#
#R.   \#. . ........\#*. ..*##
#. .......**.*......*#..*#\\ #
#.. .*#.....* . ..*  ....*.#.#
#.. ..**.....#.\.. \\..*# *..#
#.#...  .....#. *.. \....\ ..#
#. .#....#.# ##..##  **...#..#
##############################