##############################
#.*.. ..# ...\.#. .. .#. ..#.#
#......\ ......#.. .# #*#... #
L##.\..  .. . #. . #.... ...##
###..  . # \..#. .*...* \.. .#
# . ..**R\.*. ....  ...... .*#
#. * *....... *..*   ....#.\.#
#.*... #..#. ..#....\\..*. * #
#..*.#  .\ .*..##... .. #. . #
#\ .. ..**  *  #. *.##.......#
#. *.. **....\* * #.*....*#..#
#*. ..##. .* *..\#....*#.....#
#...*...  ..  ..*.#.\.#.##..*#
# .#.. .#.......  ... .   \..#
# . . .*. ..**.. .\ ...\.....#
#.*. *.......#.* .*##..*.. .##
#  .#*\ ..... # . ... .....#*#
#. ... . . ... .  ..*.* ...  #
#. ...*... ..  .....#*. ..#*.#
# \..  *..#..*...\.#.. ..\ ..#
#.* .. .*.\. *.... .... #.\# #
#.  #..*.*.... .. ..  **. ..##
#.#* .... *..\. . .\...##..*.#
#..  .#. ...   .  *.  ..#\...#
#.. .**. .. .   *.*.#* .\....#
##.#.\....\. .....*##... .. ##
##.. .. \..*.\\.# .. .*....#*#
#.....#. ..\ ... ....\....\..#
#..*#... .. #. ....#*# ......#
##############################