##############################
#.##*...... #\.. . *  .*.. ..#
#.*. *... #.#.. \ . .*.......#
# .. *.  ..#. ....*...... .* #
#  .*..#  .* *...............#
#\ .*. .# .*...* ......... #.#
#*.\ .\ ...\. .  . .\#.#. .\ #
#\.\....*..*..#* .. ...#.##. #
#*##...#. .*# .#.#. .#.\ #.*\#
# .#..... . *....  ......*.#.#
#.#.#...  #.... #..#\  ......#
#.. . .#. .##........# .#...\#
#.  *#..\..#..  .  .. *..#...#
#\ #. *#   .**.  .. ..  . .\ #
##* *\ .#..   . . .......#...#
#* . .. .... ....\......... .#
##..*.#. ..#.\...*#. .....\..#
# * #  ..*. ..  . *\. ... ...#
# ...\ #*#.\... .#. * ..*  *.#
#\.* # .#. #....*#.**..\ .. ##
#.\....\..#.*....#   ...*....#
#*..#..##.\*#... .. ...#.. . #
#*\. ... ... . ..*. . ..\\...#
#.....#.....\.#....  . .*.\..#
#.*.  #* #... .##...\ .#\*.. #
# ...*#...#.# *..*. ..#.. *..#
#*.. ........#\.# .## ..   .\#
#*..... ..#....##..* .#......#
#..*...*..#*.#\ #. .*# R....##
########################L#####