########################L#####
#..*...*..#*.#\ #. .*# R....##
#*..... ..#....##..* .#......#
#*.. ........#\.# .## ..   .\#
# ...*#...#.# *..*. ..#.. *..#
#.*.  #* #... .##...\ .#\*.. #
#.....#.....\.#....  . .*.\..#
#*\. ... ... . ..*. . ..\\...#
#*..#..##.\*#... .. ...#.. . #
#.\....\..#.*....#   ...*....#
#\.* # .#. #....*#.**..\ .. ##
# ...\ #*#.\... .#. * ..*  *.#
# * #  ..*. ..  . *\. ... ...#
##..*.#. ..#.\...*#. .....\..#
#* . .. .... ....\......... .#
##* *\ .#..   . . .......#...#
#\ #. *#   .**.  .. ..  . .\ #
#.  *#..\..#..  .  .. *..#...#
#.. . .#. .##........# .#...\#
#.#.#...  #.... #..#\  ......#
# .#..... . *....  ......*.#.#
#*##...#. .*# .#.#. .#.\ #.*\#
#\.\....*..*..#* .. ...#.##. #
#*.\ .\ ...\. .  . .\#.#. .\ #
#\ .*. .# .*...* ......... #.#
#  .*..#  .* *...............#
# .. *.  ..#. ....*...... .* #
#.*. *... #.#.. \ . .*.......#
#.##*...... #\.. . *  .*.. ..#
##############################