#L############################
#..  .#.... . #... . *. ...\\#
#*. *#.. . #.##*..#* ...#* ..#
#\. ..... \.. .\\. .*.. *.. .#
#  #**. #. *...\#..# ..#..  .#
#.. * .... .# . ..... ..*.\..#
#. ... .* #..\* ... . . .*.. #
#..#....*#.  .........*  .  .#
#.... #.. #.... .....#*.. ..*#
# . #.*. .*.*.*........\## . #
#   * ...... ..*.. ..* .#.. .#
#... *..* #R..  . #...* . .*.#
#. #..\ *....*...#...*..\.* .#
#.* .....\#\....#. .\. ......#
#..  . ..* #....\..\..\.# ...#
###.... .. ##*  ..*  ...* ..##
#.*. . \.*# #*. .#*.*  ...   #
#*\*\ ...*.. . ..#  .#** . .*#
#....  **.\..*#.*....\... ..##
#.. ... .#. . # .....**...#. #
# ...#. .**... #. ..#..*...\ #
#. .... *# *.....*..#.#.... .#
##\..#.***  . .*. . . ..... .#
##.**#\..#*.*. .#*.  ........#
#*...*.*...*... ... . . .*\..#
#........... \ ..#*  \..*. #.#
# *\#*.. . # .  .    ..#...#.#
#.......#..#*#*.. .# * ..**..#
#.#.. ..\...*\  #*.# .. *#...#
##############################