##############################
#.... ..  .*  #..\\...# ....\#
#. ......*...*. . ...\...*.. #
#.*#*   ..\....#\# . *....  ##
#*#.\...*#*.#..*  *...... ...#
#... *.*#. ## .. ...\....\.\.#
L\ *.*. ..\.... .*. .*.. ...*#
#. .*..*.*. \ . .#*.*..#.....#
#.. ..*.....#. ..\...........#
##.. ...... . .\ **.#\#.#.. .#
#* \ .#... ..*.*..*# \   \.*##
#*...\.**.#..#...#.....#. *. #
# .\.#.  *.*.. **.#...\ . .*.#
#*. #.* . ...#..\\*. .* \ . .#
#.#. . . .. #*. .##.. *\.. **#
#  ..... .*. #.#..#. . \.#..##
#.##... *. ##.   * ..* .. .\.#
#*... ..#.#* . #*. #R.# ..   #
#*. *.  *.*.*.#.. ....  ...  #
#*.*#. *\. .. . .* .##..*..* #
#.#.#.\  ... *.*.#.. .. *... #
#...#.*....# ....*\. . .  . .#
#.. ..*.* # ...\.. #\ *.. .. #
#.  .*.  .. .* .. #. .#.*##. #
#.....*....# ...#. ..** .   .#
##.. .*. \... .*..*. .. .....#
#.. .# ##.*.*#.#...##. . ..*\#
#. ..*.#..\...*#.  . ..#**...#
##. ...#.....#.*..#\... .\# .#
##############################