##############################
#.*  \...*..............* ...#
##..*..  . ..  ......#*...#. #
#...*\ .* . ......  .... ..###
# * .. .. ..# .#....\  .#..\\#
#...#..#.......##*  ........ #
#\..##. ..........\ *.......\#
# *. ......... ..\......#.# *#
#....*.\  .#.#..* .\  . . *. #
#.. ..\*.....#.* .. .. ......#
#.\.*.  .*.*....... . R.. .#.#
#.\#.. *.. ##.** \  ..   .*..#
#*....\ ......\* *. ..*  ....#
#. .\ ......*   ##....    . .#
# .*.. *.....*. . ........*..#
#\ .*.#*\ ........ .* #....*##
#....#..*.\ ..#..* . \  .*#..#
#.. \..\ .....#*.*\. .#\....\#
L.\.**.##....*..#.#.\#...  . #
# .*..**.. .......#. \..\*.. #
#..... ... *. * .... **  ... #
#.... . ...  .##.........#..*#
# ....#...# ..#. .....   .\.##
# .  #....... . ..\  . ..  * #
#. . *.\. ....*.\.#.*..**...##
##.. ...\.... ..*.#\...#. .# #
#\. # .#.#\ .*. ..\.... ....\#
#..\.*\...*.##..*...... # ...#
# ....#...#..*.. . ..\....  .#
##############################