##############################
## ..  .. .. .. ...*. ..# .#.#
# #....*... .\ . . .  * * ...#
#..\ ..#\ . *#....**.\.. .   #
#  ..\#* .. ..  .#....\.  .  #
# .*. ...#.# . *.* *#.... #..#
#* ..#..  .*..*. ... #...\...#
#.. .\.##*... ...#  .*.......#
#.*.. .. .* ...#...  .*.  #*\#
#...#.... # *.*..\\* ..# ...*#
# .* *.. .. ... .....\...*  .#
#.... .##.  . .. .. . . #\\..#
#.#.*.. *.... #.* #*..## \...#
#*.*.#*....**..\.*.*#. . ##. #
#..\. ....*... .\..*.  . #\*.#
#.....#.# ... . # .. .. ..#.##
#. .\...... . .#  \  # #*.#..#
#.. .... *#.# ..** \***  *..*#
#.** ........ .. . ..#*. *.. #
#.# \. .*....\.*## * #.\.*   #
#.* ... ...*........\* *\*\.\#
# \. .. *   . *.. ....... *#.#
#...#..\ # ..#.*.. *..** R.. #
#. .. . *.. .##\.* *..*  #*..#
#.  .#.\..*.#.......\...   #.L
## ##.#...#\* .  #  .. .*#...#
#.* ....*  #*....*.*#.....*. #
#..*#. ..#.\   ..# #.. ##. .*#
# ..*.\.....#...  \##*\ .  ..#
##############################