##############################
#...*...\ ...#... *...\**## .#
#\. . ...* #. ...*#\#\. .# \.#
##. .#.*.... ..##..#*\#.#. *.#
#.*#.\ *\.  ###\.\.\   .## ..#
#..# . . ..*# ....## # ... ..#
#.\.#....#.*......*..\.\...#*#
##\.  .#**\.\  . ..*\..... . #
#.*..\ .# . *....## .... ....#
##.. ##...  \\ .* ....**... .#
#. ...  #.#. .....  .....*...#
#   . .. .  #..*.......*..#*.#
#.. *#.#... ..*#.. ..  .. ...#
# \* .*...** ...# ..*. #.#...#
# *.*...* ..*. # *...\. ..#. #
#.  *.. \*...**\...*# *..\..\#
#.*. ..#*.#..#...\.. . # ... #
# #........ .#   .#.. .*\\.#\#
#.#  ...*\\...**.   *. ..... #
#..  *...\.#.###*#.. .. .. \.#
#.#..*. ..*. *....*.. *....*\#
#.*. ..#..... ...  **. .* ...#
##............#.....#*...# ..#
#*....**.. . *.. .  ..#..*# .#
#.\#.*.....#..#.* . \ . .....#
#.....\..... . #..# * .##  . #
#. ....... .#. ...# ..##.#   #
#.#\ ....##\# .#.. *..##.*..\#
#\. #.R...\ ..\.. ..#..# \.\.#
#####L########################