##############################
##...#........*.... \..   #..#
#. .... .. ... # ...*..\.\\ .#
#.  ## *.# *. .   \#. *.*#...#
#..\*.*.# .R#... #.. *  . . ##
# #. *.*..\   ..... *.#  *#\.#
#. .....\...#.#.*. # ..  .. .#
#.*# ....... \\*.. ....*...  #
#... ...# ..  \#.......*..#  #
#..# #.  ..#...*....* .... ..#
L. ...#*... .*. ..*..........#
#\.   *#.*......  ..#\  . . .#
# # *.. \.\# ...\.\. #\.. #..#
# *.....*....#.\**#..* ..#**##
#...# .#. ..*. .*.  .*... .*.#
#....* . ..\.. ..#.*\...... *#
#.* ..# #... *.\...  ..#*.#.##
# *.. *..*.# *. . . #* *#  ..#
#......** .** ..*\.*..\#\  . #
#....#...#... .# ...##.. ..  #
#...#...... ..... *   **. ..\#
# ....... ..  ...*.... ... ..#
#. ..# . \. ..#. \..\ * . .  #
#.** *.*#... .... * \. #..*..#
#. #.**... \##\**.*..\#... .##
#  . .......\.#. .. #.\ ..  .#
#.#  * .. ..\# .\......#... .#
#......#....*.\*..* *...#  ..#
##. .... #.# #\.##. ... .....#
##############################