##############################
#.... #\ \......#*    ...*#.##
#  .*#...#. #.  ..  *#  *  ..#
#. # ..   .....\...#*...*.\# #
#.\*..\# ..... \.\...##\.#*. #
#.#... \. .*..**#.... . .  .*#
#.*##.. # .....#.\..... \ .*.#
#.##. **...*. . .... .*#.#...#
#*......*\#..  ...... #. ... #
#.#...##*. #..* .#. ...*. . ##
#.  .#.... #*.*.....  #\# .#*#
#.*...   . *# . \.\. .. \...\#
#..  ...\.#... ......#. . .\ #
#...*.#.  . .... . # .## \...#
#.#..... .#**... ...* \ .## .#
# ..*.  ... ..\.. ...........#
#* ....  * \..* ..#**#...*.R*L
#  .*  .. *.**...*. ...*.....#
#.. ..\...#*. .#...*\....\*. #
# ...#...#.#.... ..# # .\ #. #
#\.*.......# ..* .*.. #.. .*.#
#. .. .. .....# . . ......\..#
#. . ....\.*. #...**. .. .. .#
#. . . ......*# .. .\.*.#... #
#.  ##\. .*......#.......... #
#.....#.* .#.#.. ..#.\....# .#
#....#\ .*.#.##.. .*... . .  #
##.   .... .. ..*\*... . .\. #
#...*   #. ............ ..*..#
##############################