##############################
#........... #. ##*.** \ .   #
# ..*... .\.... .#*..# . # . #
#.# .#....... *.*...* . . *.*#
#.. . .  ...\...... .*. .....#
#...##  .\ .. ...\..#.... # *#
#......#.*....  . ....... # .#
##...*.#.....\*##... # ....*\#
##....   ....#.. ..#*....\*..#
#.*.. ... # .*..# . ....##.. #
# ... . ..#.** .\.*\.. ...*#.#
#..*   *....#. . * ...\ ....\#
#\..*..*... .#  ...#.*..... .#
#*...#...*.. . ..\..# \. . .*L
# . \* .*.#* ........... . . #
# *. * #.... .#..*.. \... *..#
#.#. ... .#.....## ..\. \....#
# **.......\#..*..*..   ...*.#
#....  # ....#. .  ..... ..\*#
#..  .* . .\. .*.. .......#..#
#\ # .*.*.#  .. ..... .*.....#
#*.... .......*. ..*........##
#.# * .#... \.*...R#*  **....#
#...\ #\. ..*.*#... ...... #.#
#..**.. ... * .. ...#....*..*#
# ...# # ...*. #. ..*#.**#...#
# ..... ....* \. .*  *.* #...#
##.*.* #. ....# \.....#\#.. *#
#...*# .\#. #.. .# ...... ...#
##############################