########L#####################
#.*#....#...* \...\* . ...*. #
#.. .#**. .* \*.\ .. # ...**.#
#..*.\.... #.*\.#. . ... .*..#
#........*\. .... #.....* #. #
# . #* #..#.#.**\.#\**..*#*\.#
#.  * *. ...* #  ...#.**.....#
##... .#.. ..\...   .\.\ ...##
#*. ...# ....\.#.. \.*\.#....#
#\..*## .#*\....   *. .**..#.#
#*.*.\#.. # ..... \.. ......##
#*. #..*. .... ......  *. .*.#
#..#. ....\*\#..   ..... ....#
#... ..*..*#. ..#.. *.#*. . *#
#.#..#  * . ..  \   ..*.... .#
#.*.#.. *##...#. .#... #*.. .#
#. . .*# \..#....... . .. *. #
#..... #.\\..#.... .*##... . #
#* .#.#. R*...\  ..\.#.......#
#*.*..  ...\#  \..  . *.#..\.#
#. .  *.**#.*** ##\.* ..#*.  #
#. ...#..* # .... ##... ..\..#
#..\..# *.*.\............ ...#
#.* ..... ..... .#.*...** . .#
## \ ..\.. ....\.....#\#. ...#
# .\.. .... #...\.  . ...\...#
#...... *...*...#.. #*...\. *#
#\....#. .\.*#.### . ..#. **.#
#**. .\ #.\* . . .#. .. ....\#
##############################