##############################
#..........*  . .*\ #\*....*.#
#...*... \.... .  . # ..  #..#
#.*  . .#.. ..\.* ....#\.\.\.#
#..***....#.  ..*\ # .*...\**#
#..*..#    .#....  #.* .#..*.#
#* .....# ... . .##.*#.*\...*#
#..*#  .... . .....\.* .*.. .#
# .#. .. .\.*.\...  ...*..#..#
##. . .. ## *...*. .* . ... .#
# *.. ###  . .. .*....*..\. ##
#*.#....#. .. .\..#...... .. #
##.... ... \ .*.\...*.. ..* .#
#.*#.........\#. ..\..#.....##
#*.# #*.#*.. ...#.#.   .*#..##
#..... .  . #. ..  . ..*# . .#
#. . .##.\ .\*. #.....#  ....#
##...*.*  #....... .*. #..#.##
#... # ....*.. .....\..*.....#
#. .*...... .#* \ #..#.\ .#. #
## .  .... .....\.# .*#*. .*.#
##*.#..*. ##.........R*......#
#..# #  ..*..#.*. #. \  ... ##
#\......*. # \.#..... ...\ ..#
#...**..#. . ... . ... \.*...#
#. ...#.*..#............ .. .#
#.#..  ...#.. .. #.*..... ..##
#...* *.*.#.*\.#**  *.**   ..#
#.. #. ..*.  ......... ..* ..#
######################L#######