##############################
#.\..*... .* #\.... . .. . ..#
#..\. . .....*.... ..# ......#
# ..#. .\..\#..# . *...*\.#..#
#...#. \.*# ...#*...  .\#....#
#*.. .  .\.....#*. #..*#.#...#
#..#..*. ...* ......*.\.. ..##
#...... ..  . #.. . \*..\. . #
#.... ..*..#... .# #*.# .#...#
#. ..\ .#*..*\..\.#\.  # ..\##
#.. ..  ... ........* .\##*..#
#.\. .*.*.  .* ... . # *#...*#
#..#. ..** .\**.....*..*...**#
#.# *......  . .........  * .#
#.*..*\...#.*..*...*. #..*.#.#
#\ .*. .##.\ ........... .\* #
#.## ..*#..  .#. ..*....* . .#
#...  .\ *... ...*........ *##
# . \.. .. .. ... ....\... .##
#\*..*.....*......  #.##...#.#
# ..*..#..  . .. .*.*. ......#
#\.......   * R*.*\ ..... ..##
#*.. . \.. .#...*......*.\#..#
#...*** ..  .* .\... # . ..# #
#  ..\.. .* ... . . ..#...# .#
#* .. .\# *#.#**....#.. #  ..#
# \..#. * #....  # \. ..  . .#
#..*..# *\...*..... .... .. \#
#.....*** \.....\.*.. . ..\*.#
##########L###################