##############################
#*.#  .. . .. ..... .#.#.\# .#
#*.#..    ...* ... *.... . \\#
#.#. #..... . ..** ##.*.. .*.#
#\#*....* \#..*\ ..* .** ... #
#*... # .#....#.  # \\ ..#. ##
#.  .  .#..\.\#.# ..\**.*#\..#
# ...#*** * .... .... .  .#. #
#.\.## ..*...#..  # . . \.\\.#
#... ..\. . *.#...# .*# *. .*#
#......\*# . .#* * #...** \.##
#...*.\. ....\#.... ..*..   \#
##.. #.. . # ........#.  \ *.#
#.. ..  .\.*.... *... *.*... #
#*.   . ....#..\...\.##*\#...#
# .#.  * .*.R .##*. .. #.*...#
# .. \.# ..#... .*..#.....**\#
# \*.#.#  .# #..#.*....#.  . L
# * \*...  * ..... .#..  # ..#
##*..... *    . \#.. . .* #.##
#*. .*. ...\.##*...   .# .. .#
#.##*# *#..\..   #.**.. .***.#
#....#......#.#..\.. \.... #.#
#.*...... *.\ ..\....*. \..*.#
#.#.....#.*.. ..  .  *... ...#
#. . *..## .  \ ..  ..# . ...#
#..* #.#..... . \..#..  ..*..#
#....*   ..\.....*..*\.....\ #
#.... #*..*\.\. . *. .  ..# .#
##############################