####L#########################
#.  *..... . *.# \#.\ .. ..#\#
#*..\..*   ...... .*#*.. .##.#
#..*.....*.. ..*.#..\  #..* .#
##...... #. . *..#*....  ..**#
#*.. ....*..   ......  .*.*.*#
#  .*.\\  ...\. . .#. # .....#
#.* \.*. ..\.*\# ....\#..\.. #
#*... .#   .. * . *...#. .#*##
#.#.*... . .... .\*#..*.#.*#.#
#........ .\.#.\*# . *. . #.##
##. . ..#... .. .#.*\*.# #.. #
#*. .#..  . .   .*..* \#*.*..#
# . .  ... # ..... .... *. ..#
#.#. .\ .  .. . ....#....#.* #
#**.....# ..* . .............#
#..\.\#\\*..# .. \. ..#R. . \#
#.. ##.*#..  .#....**..\. . .#
# ... .. .\....*.*  . #**   .#
#.....  ......*..... .  ..\\.#
#.#..\...#...#..# .. \.. .\. #
# \..  ..... . .\\.\ *.......#
#..*. ..#.    *...\....#..\ .#
#...*..... .##. # #..####.*..#
#...#.*.# .. ...#.. *.... *..#
#....  ..\.....\.#*.# ...\...#
#. .*...  . ..*...#* ...#...*#
#*.#.*.*.\ ...* .  .#.*. *# .#
#.*..  ..#. .\. .....*  #*#..#
##############################