##############################
#. ..\..# ....\..\.. ** . ...#
#\. #.....*..\.. .#..*....# .#
#....#.....  ..  . *.#.   *#\#
# ...   . ....\... . #.....#.#
##.. .#. .* *## \.#.... .#...#
#..* #.. .  *..  #..* ## ..#.#
#... .. . .# ...#...... .... #
#.#.. .. ...*..\. .**  .. ...#
#....*.# .  \....*....... ...#
#*# # .... . # .....#..# .*\*#
#.*\.\*...*.** ...  \#* *\.#*#
#.#....\  #\......  ..  ..\..#
#.*.#*...*.. ..\.......# . . #
# .#..... ..#..#.*#. #.\....##
#.*. R.. .\...........\\. # *#
# ..\#. .*. ........\...#*#..#
#. *.*..# ...#..*\*..*..*...##
#....#. #...#..*. .\..*....*.#
# .*\. .....\.. **..#..*  ...#
#*\...... . . **#..#. . .....#
## .#..***.**..*.. .. ...\.. #
#. . .  .#.\..\..# #..... ..##
#.. . .. . ...*.**# ...  *.*##
# .........#.* .#. #.**.#....#
#.*... .. \..##... #.\#.   *.#
#...\ \. ..... \*. ...*.   ..#
### *.. .#..   \...*  ..# . .#
#.....\... # . . #*..\..*#..##
###################L##########