##########L###################
##..  .. ..*#..\#.*...\  *...#
# *..\#.*...*.*..*.\* *... .*#
# .*   .......#...  # . .... #
# .. #* *.## #..#......#\ .. #
#*\*....  .. .\. ..  .  .*...#
#. **..*  ..*\.  #.#**.....*.#
#   .#..#....... .  . ..#... #
#..#....*#\.#.. ...  R . . *.#
#\  .. .*.. .*#.......* #.* *#
#* .*..... . ......... . ... #
#.. *....***.#  .. \. *#..\..#
#. .*...*.. * #..*.* . ..... #
##. . .*..\..#.#.... \.....# #
#.#. ..\.. .. ...........\\..#
#*... ... .#. ........... . ##
#..*\...# .#.*. ..* .\#  .#..#
# #\....\.... #\..**# \...\. #
#.........* .* . ... . ..*...#
###*  ... . ..**......   ....#
#. . \ .#....... .*......... #
#.#..*. *. .#.  .  ...#.#...##
#\. # .#*#. .# * .........*..#
#\. .. \   ..*.  ..* *.#\..#.#
#.#\  ....\ .\    # #\..#. #.#
##... #. .#.. \*\.#.#*..#*.*.#
#..\\. .*.\....\ \.  .\...\ .#
#.#   . .* # .. *. ... #.#.* #
#.   ...#*..#.\ ..##  ...*...#
##############################