##############################
#*..\*..\. ...#.  ...*..  \..#
#..*.#.... *#.. ... ..#.# ##\#
#. *\.....  .*#\\..... ..* .*#
# . . ..*#\. ..*....*.\..#  .#
#.#...#\.*#..#. ....... ..* .#
#.#... #\\\ . * .*\  .*** .\.#
#.. ...... ..*....* .*... .*.#
#.## ....\* ...#. .....#** ..#
#. ...  .*\..*.#. .. .*#... .#
##*.\.. .*#.... . ...  . #.\ #
#*.. .... .. *..#\.\ ##.... .#
#..*... ..\.*...# .. #....\. #
#.. .#.\#. *....# .... ..**\ #
##..*\. ..#... .#..   *.. ..##
#* ..\.#...*.#.*... .* ......#
#  .   \* .#...#.... . .###..#
#*...#**...*.    R#\...\\#...#
#........#. . .. ....  #  ...#
#..* \.  * .*..*\..   #..\\.##
#. #*..*...  \. .#.*#..\....##
##*.*.... \*..... .\. ... .#.#
#....... ..*... **# *.*.\.. *#
#\ ....# *.\...#.. .#*...#..\#
## ..*.*..   ...\. ..*#\...* #
#..........#.* \ ... *..*.  *#
##.\.#.\..# .. ..   .*.... .##
#\ ### #\. .. *..#.*.#.....  #
#...*......\ ..*.. ...*#.#...#
###########L##################