##############################
#.*\ ..* . .. ....*.  # \ ...#
# ...##..  \.#.*\#.. ...*.#..#
#\#.....\ ..* .......  . #...#
#...**..#......\...*. *#..\. #
#*.. ... ..\. .\#.... ..#\..\#
##..* #..#... #.. ... *..... #
# .*..  #. *..# .*...*.......#
#\#*. .#....*.... ...*....#  #
#. \  .. .*.... * *#.*.... .##
#*....\*...\.#.\..*... ......#
#. *\.......#.*.*. . ... ..\.#
#\..#  .*.. \.*.. ..... .  .*#
#*.\\..\*... ...#.R*.*.*. *..#
#..#\ *....#.* .#..\.. * ...##
#.\#..*   * ...\. .** . *....#
#. .. *..  ...... *...\......#
#*.*..#.*... *. # ... * .*..##
#.....#*  ..\. ..\...*.....* #
# .  .** . . ......#.##. \.. #
#.#\.... . ..\. \#.. ...\#\ .#
####. # #...... \....#.. .*..#
# ... .. #*... . \ #....* #.*#
#*.*  \...*.#.. ...  ..  .# .#
#. #.. \ ........*..* ..... .#
#. .#\...#.  .  #.#...*.#.. *#
#.. ..  \. . #.. . #.*#  .\#.#
#  .* ... *...*.....#.#..\.#.#
#*.#.*.......\..... .*. .....#
#############L################