##############################
# # ......#.....  #.\.#..*. .#
L .*...*.. \#\.\. ......#....#
#***.\.......  . .*. . ....*.#
##.......\.. \*. ..*..# ...#.#
#.  .*.. .. ...\*.\ ....*. #.#
#.*\.  .#. ..*  #.*..*. #..\##
#..*#.*\*.  * .*. *.*. . ....#
#.. . .#...##......*. ...#* ##
#* ....  ..*.\. #.\*\ #.* . .#
#\. \.*\...#.....* . .\..  *.#
#  *..###*...\. #.. .....# #.#
#.. .......# .* #.\  ...\....#
#.#....* #.*.\. ....  ...#...#
#..#......  .... ....#......*#
#....* *#...*..  R..... .. ..#
## *.... *..#...... .#. .\...#
#.. .*\  . ..**..*... ##.. # #
##...#.*.* \\#.. .*...  .\.*\#
#.* . #..\..*.**.........* .*#
#.  \.. *..## # .. .#.. ..* ##
#..  ......\. ......#...\.\. #
##.\.*.....#.*  ....# . .... #
# .#....#. .. #\.*#**.. # . *#
# .....*.#*. .*.\*.\.... . ..#
#...\.## . ...\*........ . ..#
#.#.*...*#....... .#.. ... #*#
#.  .\.  .    \.\.. #* ..**.##
#.. ..*...#..#..\*# .*###.\ ##
##############################