##############################
#.. .*.........\.. \ \*. * ..#
#\....... .\.#* #..*....  \..#
#.\...#... .# ..#. ........*.#
#..## ..... .*.*  \.*. *.....#
#* ..... \.. .*.. .*...*\ #..#
#..   *..  *..\ ...... *...#*#
#. .\ . .. .....*\ .#.\ .\  *#
#..\.. .*#.**..## ...... #***#
# ..*\...*..*..#.*... ...  \ #
#...#.. ...  .#... .    **#.\L
#*.\ .. #.  . .\ ..*  .  #...#
# .#..*..*..\ *  ....*#......#
##*...  .\.**....  .  .*.#.*.#
#\.....#... * ..#....R. .*...#
#..###.. .....*......*.. * ..#
#.. **...\...... ... .*\.. .\#
#...... #........* ..*.. .#..#
#.  . .. #. ....... *\.... .*#
# .*.#. #\....*.*.. . .. .\ .#
#... .*\*.* *......#*.. .#...#
# #. ..*.  #.. ........#.. . #
#. ..*\.# . ..#...\# .. #....#
#..*\#.. #\**......#..*.. .. #
# .\#..\. ##. . *...... .#  .#
#....# .#.#.. *. .... \..  ..#
# .#... ..*..*.\.  ...#.# ..\#
#........\..* #* *.#...# .  *#
#.....# .#.**.. .##..#. ...\.#
##############################