##############################
#.....#..  ........** . .. ..#
# # \*.\.*......* .. #. . .. #
#... \.. .* \..   *  *\.  .. #
L  .#\* ..*....*. ...#......##
#.#***.. .*.* ... .. \...#...#
# ...*..      ... #..#\....\.#
#...... #.....*. . #.#...#...#
# ..# .......\.\*  .#..*..\..#
#..... .#..* #  .##\.. . #\. #
#*..   . \.  ..  ..#..# \....#
##. ... .\*.  .. ... ..*..*.##
#..* .....\  . ..#* ...#..#..#
#.... *.# .*#.  .  #......*  #
##\ .  .*. ..*......  .....#.#
# * .\.##*. *#*#\*.. . ......#
#*\  .*... .. .\\.# \*...\\..#
#.*.. ...*.#.....#..** .*#. .#
#........\..   .*...  *... .##
#... . \\...# ..\.....*.\ .  #
# *.... #\.  . #... .. ...#..#
#  .\. . #... ** #\  ......#*#
##... ... . #. . .#...#......#
###..#. \.\..#.*.* .*.*......#
#.. .# *.. ..*... .. ..#* .. #
#..*.*#..*. . .\#.#.. *\*. . #
# . *. .\\ .. #....*\#.#.....#
##.#.\.*.\. . .  .... #...#. #
#*.. . .. \.# .#...*...R. .  #
##############################