###############L##############
#.#... .......* . .## .*.....#
#*....*... ....\  ....* .....#
# .**\...##\.... \..#.#R.**. #
###.......#.. .\  .*.... . . #
#   .#.... . ..\\.** ..#.. ..#
#..*\***.. .. #\*  ... .*#.###
#..*.\#..#...   *.. #. ....*.#
# .*.*..# ... ... . ...*.*.# #
#.*...#**\#....#.... *...#...#
#.*.. ......#.#.*..\. . .....#
#.\ .  ..#.* .\ .  .\.\....*.#
#..\. . ......\.#\*..#\..*...#
#..\ .#...  *.*.  ...... .*.##
#*..\*  \ ...  ..........##. #
#...#..* ...*..#.   ...*. #.##
# #...#.......#..*..\..\.#*..#
#.....# ......***.\..*.. ..  #
#...*#..  ..   .#..#.#.  * .##
# ..*. .#.  . .#.   *... . ..#
# *....*#*  .  . # .*. ..# . #
#.....#... ..*\  . * *# .*.* #
#.#.  . ....... ..#\.... .#..#
#..# ....##..............###.#
#..* *.  ........#.#  ..*. ..#
##.. ### ##  . .#.. ......#..#
#..... ............* ........#
#*# . ...*..#. .#.#*.*...**..#
#.. ..\#..*\ .  .....  .#.*# #
##############################