##############################
# ..#.. .. .  .#. ...*..#..\.#
#.......#...  ..**.\.\.\.#***#
#.*#.#. .*.**..\..\#.\#\  #.##
## . .. .#*  **. ............#
#.#..\.*.##  . ..*..*....\*.*#
# #.........\. ..*.. *#.  #. #
#.*.\\  \... ...   .#. .# *..#
#..#.##**.....\*..*..*.. ..\.#
#......#..  #*. .*. \#\..**.\#
#......#. ......#..*.#\.. .. #
##\ .*..#.....# .*\  . # ...#L
#........* * .. ..*.# .*....##
#.. ..#*.# ... .*. .  #* . ..#
#.**...*#...*...#... .. \ .. #
#. ...# *.#....  .. .. . ..**#
#..*.R.  .  *..\.#..#.....*.##
#.   . . .***. .....* #. ... #
#....  ... . \ ..   ..#..\#..#
#..#.. .#..#....*. ....*.. . #
#...... .# #.  .\  .... .. .*#
#*....#. \#. #.. ..*....\.. ##
# * . .... ..# *#..# *....#..#
# *..* *##. #.*#....##.### *\#
# **....*\.. ..## ...*.....#*#
#..#.. .#..   .# .#.* \. .. .#
#.#.\.. .  .\..*. ..#*.##.\..#
# *#. ......\...*... *\*.....#
#. *\.... .#  .#. \##..*...###
##############################