##############################
#.*....  ......##.# .. .. # .#
#\..#.. ..#.*.* ...#........ #
#. . ...#.... . .*. ##..*\...#
# .. * ..# .. ..\  ..*.** .  #
#...#*.#\*...*\.\ *......#  .#
#..  .....* ....*\ #..#.#.* .#
#..* ##.. .  ....*...\.# ... #
#..*.   ....*#...** \....#.# #
#.#... * .  .\ ....*. .*.. ..#
#*....*..#* .....  ..#\...#..#
#.  *....#.*#... .\  * #...\.#
# ....*.... ..    # # . ## *.#
# #. *#. ....\  ..*. *#..*.*.#
#. . ......* ...#*.... . ..\ #
#  .... ..\ .#. . .#*\.**.#*.#
#.*. ..... .......\.......\*.#
#....  ...\...*. # ..#..*#.*.#
#\# \*...* ..# #...*.#....#\ #
#.....*\  * #.* .*#\.... .*.*#
#...*.. **.R.....#..*#.#*#...#
#\.#.**#.. *.....\.\  .  \...#
#\ \.#  #..   \...#.*.. \ ...#
#   ..#..\#.  ......*.. . #..#
#.#. . .\ #.# .*.  ..*  ..\* #
#    .#.#**... ....#..*...*..#
#.*... . #  *\.\..... \.. . .#
#..#.... \.#*.. . .#*. # *..\#
# .*...#.... . ...........*. #
##L###########################