################L#############
#.*..*..#..*... *.\. .\.*.*  #
#. ...#....\*.... .#..*  ... #
#..... ...#...*  ..*.*.##.*  #
# .##*........ .....#\.  . #.#
#.# *..*... .\.  ...#......  #
#.\**..*.*..  .... ......  .\#
#.#.... .... ...\.\ .. ....  #
#..*#.. . .. \\. *....#..* #*#
#.. *#.*...... .#....* .#.*.*#
#.. .. #*........#.\ #... ...#
# .*...R..  * .... *.......**#
##.. ...... .#*.\.*. .. \..###
#.\ . .. ....#.... \# #...*.##
#  .#.#.. * *.... ....# ...  #
#.#\ .***.....#.    ..* ..*..#
#.. . .... #.....#.**#\. . .##
##.****\. ..#.   .#*.....\.. #
# ... . . \.\..*. .. ........#
#........#...#.#...##... ..\.#
## ... ... .....*... ..*\....#
#\.. ....*. . .*..... ... . .#
#.# # \#.. #..#..** . ##  ...#
#  . .#. ** ..  .. .. .. ....#
##*.#.  ... ..**#.   .*.# #..#
#*...*\*.  ..  \.* .....#..*.#
#.*..*. .# .*.. ..*......  ..#
#......#. ..*#*.....*.....#..#
#.#  ...*\.. .  *\. .##.... .#
##############################