##############################
#\.*.#*...#\*** . ....*.  ...#
#...#*...*.. *.....#..... #..#
#..*.\..\.  *. .#...# ..#...\#
#*...  ....*.#. .#.....*\..\ #
#.. *.  ...#..\.....#.\ #....#
#..*#\.... . .# \  . .. \#..##
# *....#...  .\# *.... . ... #
#. ..#*.. .. ...\ ... #. ... #
#*.......# .\ ..\..* . *   #\#
# #.* . .\.. \.. ..  #. **.\.#
#..*..#  ..#...#..##.\ * ..#.#
#  ..#  #\......#\..R.#.. . .#
#.\ . ......*.# .. .. *. ...##
#.\#..#...*....#\.*....#. .#.#
#*.  .. ***.#..*#.. .. .*.#.*#
#\.. . ..# *.*.. *....  .##. #
#... ..*.*. .  .....  ...#.\.#
# . ..#. .   .*.....* .#*..\ #
##...#*.\*.#.\ ...*....#.  ..#
#......#.. #.. ..*.... *# ...#
#.#.*   # . ...#...... # . .\#
#....  . . ..#. . *....\.* *\#
#.......\.#.  .*   .#.*....*.#
##.. .*... ...****.*.** . .*##
#.*.*  #.#.#\\.*\..... ..#.. #
#  . ... ..  #.. .. # .*..*..#
#.....#.....  * *. *. ... .* #
#*.*. .##.**.....* ..#.*..* .#
###L##########################