##############################
#....\..* ..\.##....#..  .. .#
#.#.. .  #\.#  #  . * ... #.\#
#.  .*...#... #.* .#...\.....#
# ... ...#.... ..\*#\.   ....#
# . .... ....  .. #.. ..***  #
#........   .....  .# \...  ##
#*. . ..#.*# \...#\*..#.\...##
#....R... ... .\ .\....*#.. .#
#.... ##....#*###. ....#.#.. #
#.\..*.*#* #.#.... ..#... ..##
#\.\.*.  .\#.. *.*.....* ....#
#.** ...\   ...*.\..\*..*... #
#..#. ... .. .. ..  .. #.#*..#
#..#\..........#..... *.  .#.#
#......\ . #.*.  # .. #**.\. #
## ..** ..# #.. . .....#. ...#
####.  . .#. # \. .  #. . .. #
L*#.. .....**. .# #.... ....##
#. #*.......... .*. ... . ..*#
#  . ......... ..#.#.  .....##
#.. #.* ... .#.#.*#.... .**.\#
#.#*.## .... . .#.* #.##....##
#.\ ..#.*.... #*......#*..# .#
#. .. \ ...#. .\.#.........  #
#*...... .. ..##..  .... #.\.#
#. ..*...... #..\... *#.\...##
#.#....#... .#....\#..#.. *. #
#. .\... .#* **... ..*  ..\.*#
##############################