##############################
#\..#. ... .#.. .**...*  ..  #
##.\*. ... . * . #........ ..#
#.*...**.. \ ..\ .... ......##
#\**. *..# *.... .  #. *..   #
#.#....\..*... .*..\. . \*..\#
#  *  #... .*  .... .\......\#
#.*.  .*.# ........#*.....\.*#
#\.*.....*. .*....#* .... .. #
#.. ..#\\...#... . ..\#*#*.#.#
#...* ..**...\  .  #\**.. ...#
#...  ...  . .\..........\#.##
# ... . .. .. . #. . .#.#\..##
#*..... .*.#. #...*.......*..#
#.#  ..\ .*..... .# # *..   \#
#.\ .... .*....#*..*.*.... ..#
#** ..*.\..**..*. .. ..# .#.##
# ... \. ....  ..*..   *..**.#
# ...#\.* ..  .#. \ \ . *.* *#
# .#. ...*##\..*..#**.  .. ..#
#...*.....*....  #*.*#....\# #
#. ...** .\. . ......*.#.....#
#...#. . ..\ .*..#...# .  #..#
##... ....# .#.. ...........\#
# .\ \#...*# . * .#.#*... #..#
#*....#. ....#..\....\.....R.L
#.#\ .* #. *.*.**.* ..\.*... #
#. ..\.##.*.#*#.*#*\.*..#....#
#.....* .....#\\. *  ..\.....#
##############################