##############################
L *.....#..\#*#..*#*.  ...\#.#
#..#\ ..#.. .. *.*..... .....#
#..*..#.*#.. ..  .*#. \ ....##
#.\..#. *.. ...... .#.#...##.#
##.... *. #.....# ##.#*...#.*#
#. \.#*..\..**.. ......*. ...#
#*..*\ ..*.    #.. .* .\.....#
#..*.  ......##\\. .#.\.*... #
##......#.#  ... ... . .#....#
#\..\......\ .#* . # .. *.#*.#
#** .*...* #.......*...... ###
#   ....#..#.  ...#.*... #.#.#
#. .\.... ##. * ...#*.. ..#..#
#.#.... ..#.. .*..#......* ..#
#\.#  *.# #. \...* #...***.. #
#.*..*..\....# #* * ....#...##
# .. .*  #. ...\\..*..\*. #..#
#  .*.*..#**.**...  .. ...  \#
#...*..#. . *  # #..*..... #.#
#.*.* * #.#.#..\*. ........  #
##......#.\. . .* ..*.#. *.* #
# ... *.# .# . ....#  * .*.#.#
#...*....... \. . #.. .*.....#
#. ..##...** #.. ....# .# * .#
#.#..  .* *..*...\.\  .#...* #
#. .#  ..... ....#...**.*.. .#
#*..#.* .*. # ..#. \..... ***#
#. *  .\#..#..R. .... .#..#..#
##############################