##############################
#....\. .##.\ .. .. .*.   .*.#
#...... ......\.**..  *.#.  .#
#*. ....#..\#....#R. #  ... .#
#..*.  .. .* . ..#.  * .#.\. #
#. . ... *..*...... ..*.  . .#
# *.. *\ #...##.##.*.*..\.#\.#
#\\.. ** ..*#... .   .#..* .##
##.. ....*... ....\.. .\ .. .#
# #*. ..*....* *....#...\...##
# . #..*# *.* .\###...\  ..\*#
#.\.... ...\..\# . ...*. * ..#
#.* ... *# ..** ....*......###
# .  *....... .\.##..# #. ...#
#..\*. .*.... ..*  ..*.... **#
#.*#.**#*.#..# .... ... ..*. #
#.......\.##.....\..\.#.#... #
# *. ... ...*. .* ...   ...* #
#...*\ * ...\ ...  .*.*...*. #
#. .#..***...#.....#.\..*  . #
#..* .*.# *#.  * . . .* .. *.#
#...#... .  ..#..*....  .....#
#..**..  ... .. *.# .*..... .#
#..# ..* ... ...*...#........#
# ...\ ..#... ....*......\.\\#
#...   ... #.. ...\ #.. **  .#
##... #..... * \.#.*..\.\.# .#
##..#......*.*..#..#.*...  #.#
##...#..  ##*.*.. \# \ . * #.#
####################L#########