##################L###########
#.#. .\ ....*. \... ..  .#\. #
#*..*..*..\\. . ..\..... ....#
# .. .... .#..*.. .*... .. \.#
# **.## ..*..\.*.\*....   #..#
#\.\..#.*.... ..#.*.. .#*. *.#
#..  ....\  \. #...* .#....\##
#. ..# .\* * .**.\#*. ..\.#..#
#. *.... ......\* #......\...#
#*.  ... .*.... ........ .#..#
#. ........ ....\..  .#...\*##
#.. ....#.*#.... ...*  ... ..#
#...#......#.*....... .....#.#
#. . ...##... *...*. .. . *#*#
#. .... ...*\ ..##..*##.*....#
#...##...*.**  ..*.. #. .. ..#
#....#..* .  #....#... .\*.* #
#....*.\ ..\*# .**...........#
#.. . \.... ...  \##...\##\. #
#.. .  .\    .......... .\...#
#...\.*. ......*  \  .. *....#
#.#. ... . .... \.#\*.......\#
#.*. .... R * .# #..*.  .....#
#....... ..   .. \.. . .*#  .#
#*. #..#...   .....\ . .*..#.#
# ...... . .. ..*. *.#. . . .#
#.#....#*..*..*.#. ...\ .... #
#..#\.. ..#.. .*.......*.#.. #
#. #\ \* ......#.\   *# # \..#
##############################