#L############################
#  \....\..* .....* .#..#  *.#
##. *.  .....\.\\ .*.\*. .. .#
#......#.  \*. .*\#.*.*... #\#
##...R.*...\....#.* *#.#\. *.#
#.. # .....#.  .  .* . ...#  #
# .\. .......*. ....#..#.*...#
#.. ....*#..  ..#...   \  ..*#
# ..... . ..*....... #.. ....#
#... \..*\........  .##*..*.\#
#*.\.\***...\*   #... . .#...#
#.\....  #.**. . .  * .#.*...#
# .#..*... ...*....*.*..\#. .#
##. ........ #...*..*#  #..*.#
#... *. .*\......*.....*..#..#
# . ...#....\\ .\..*.....\  .#
# ..*.. ..#.*.....#......\ *.#
#....**...........\  .....  \#
#. *\..........*.*** . *...#.#
##. ...*..*...*.  .*...\.* .*#
#......*. .....  ...\  ..  . #
#.#.##......\.* .... ..\. .\ #
#..*... ..*.*#.#.*.. \..   ..#
#.*#..*..#...#.......*.......#
#.*..*...##.....\ ....#* .#. #
#..*..... ...**.*.....#*  ...#
##  *. . ........ #  \.. ....#
#.#. # .......*..*.... . ....#
# ...#*.#....# *....#..  . #.#
##############################