##############################
#.   ...#*..#.\ ..##  ...*...#
#.#   . .* # .. *. ... #.#.* #
#..\\. .*.\....\ \.  .\...\ .#
##... #. .#.. \*\.#.#*..#*.*.#
#.#\  ....\ .\    # #\..#. #.#
#\. .. \   ..*.  ..* *.#\..#.#
#\. # .#*#. .# * .........*..#
#.#..*. *. .#.  .  ...#.#...##
#. . \ .#....... .*......... #
###*  ... . ..**......   ....#
#.........* .* . ... . ..*...#
# #\....\.... #\..**# \...\. #
#..*\...# .#.*. ..* .\#  .#..#
#*... ... .#. ........... . ##
#.#. ..\.. .. ...........\\..#
##. . .*..\..#.#.... \.....# #
#. .*...*.. * #..*.* . ..... #
#.. *....***.#  .. \. *#..\..#
#* .*..... . ......... . ... #
#\  .. .*.. .*#.......* #.* *#
#..#....*#\.#.. ...  R . . *.#
#   .#..#....... .  . ..#... #
#. **..*  ..*\.  #.#**.....*.#
#*\*....  .. .\. ..  .  .*...#
# .. #* *.## #..#......#\ .. #
# .*   .......#...  # . .... #
# *..\#.*...*.*..*.\* *... .*#
##..  .. ..*#..\#.*...\  *...#
##########L###################