##############################
#.#.. * .*.*...*..  \*  #\# .#
##..  ...*.. . \. .*.... ..###
#. ... .. *..#. .* *.  ....\.#
#. ....#. .#. ... **..\#*. #.#
#... .## * .....\*. ..\#....*#
#... ....  .....\**.\ .#. ...#
##...*. ... \..  . . \..... .#
#...*...\...*.#.*\   ...#.  \#
#**....*\.... ..#* . **.. #*.#
#..#.#.#R ..# ##..**.........#
#.#. #. . ...*..# ..\..#.... #
# * ..*. . ..  .*. #..# #.#..#
#..  . ....\.......*. ...\. ##
##.*.  . * *# #. ......  .**.#
#.* ....\* .....*.*###....*. #
# \ ..**.......\ .  .......  #
#....* ##. .*...*. ..... ....#
#..... .. *.. ##....* #.  #\ #
#.. ..#*.. ..**. .....  ...# #
#. # ....#. * #.*#...  ...# .#
#. . .... # .......# ........#
#**. * *..*. #...*   #..*#.*.#
#......#...##.#......*..**...#
# #.#..#.......#* ..  .... #.#
#..*. .......#** ....*. .. **#
# .. ... . *...#..... *.*    #
#\....  . ......#* .. ....\..#
#####. ###..##  .*#**... \ .##
######L#######################