##############################
#\.... .* .....# *#  ........#
#\.  .. .. * ... ...\  ..##..#
#. . \. . ..*...  .#....\ .*.#
#.*...*. #. ..  .. .....*..*##
#.#*.*. .##.\.#*. .......*..*#
# . #.  .\. .....*..*... .#. #
#......**. *. \. *.*.#..... .#
#*...  .#.*.*... #\*.. . \.*.#
#  * ........\. *...##. .    #
#.*.#. .......\ . ....     ###
# # ...... #. .** .......* ..#
#.......... #...##.. * *.#  *#
#..\#........#\...*....#....##
#.*\\  . .* ...  .. #.*. . . #
###...*..*. ... . ## .. .  * #
# # . \.....*..**.* .. ..\.#\#
#....#. .* ....## .....*.  **#
# #.*.. ...R.\## .. .* .*.##.#
#. \  #.#*.#.#  #.\.*  *.. ..#
#.. .. # .. .\*.**.#*#*#.....#
#. .#.**. .**.....*..**... #\#
#... ....... .. \.*   *.*....#
##.... .#*..\. . . ....\.....#
#.#.* .. . *.....  .#.##*.*. #
# *.**...#* .. . \.....*..#..#
#   # .#.  .#  ..*. ...*..\..#
#... . ... . *.#*\... \...*.##
L.*\ ....  ....#.*.. .##*. ..#
##############################