##############################
#.....* ......# ... ..*  ..* #
#..#. #.  .....#.#...*#......#
#*.. \. ##...\ ...*  ....... #
# #.. . *. .#.... .  ..** ...#
#...#..#.#.*..*....*...*. .#.#
#...* ..###........*.....##*\#
#   #. .*..  .  \#.  #.*. *..#
#. ... . ...* ..  ..#.  .. ..#
# .\\.  \ * #  ##   .  #*.. \#
#..*\.. .*.*....\. *..\#..*.*#
#\\*# \.** *.#.#*\  . .. . ###
#.R\**....#\.  .. #.*.. *.#..#
# ...  #...... . .......##...#
#*.....*.\\#*..*. #... .# ...#
#... ...#\. .....*  ....   ..#
#..** .\..#........   #.**...#
#*#...*..#....*..  #. .* .. .#
#.*.. ....\..\#..........   .#
#..#..# ..*..\.. .....#.....\#
#..#... .\\...  .*  .*.*#.#*.#
#. . # . ....##*\. # ... ....#
#.#.#..*#.... ......# .#...*\#
#..# #...\.#   .*..*.... ##..#
#*... ...*# ...#.# ..\#\.*.\.#
#.......  ..  . ..   #.#.. ..#
#.*. ..#..*.**.#. . ..# .....#
#....# ...\. .*#*. ..... .. .#
#....\..*.*..*.....* ** *#.. #
##########################L###