###L##########################
# ..#* ** *.....*..*.*..\....#
#. .. ..... .*#*. .\... #....#
#..... #.. . .#.**.*..#.. .*.#
#.. ..#.#   .. .  ..  .......#
#.\.*.\#\.. #.#... #*... ...*#
#..## ....*..*.   #.\...# #..#
#\*...#. #...... ....#*..#.#.#
#.... ... # .\*##.... . # . .#
#.*#.#*.*.  *.  ...\\. ...#..#
#\.....#..... ..\..*.. #..#..#
#.   ..........#\..\.... ..*.#
#. .. *. .#  ..*....#..*...#*#
#...**.#   ........#..\. **..#
#..   ....  *..... .\#... ...#
#... #. ...# .*..*#\\.*.....*#
#...##....... . ......#  ... #
#..#.* ..*.# ..  .\#....**\R.#
### . .. .  \*#.#.* **.\ #*\\#
#*.*..#\..* .\....*.*. ..\*..#
#\ ..*#  .   ##  # * \  .\\. #
#.. ..  .#..  .. *... . ... .#
#..* .*.#  .#\  .  ..*. .#   #
#\*##.....*........###.. *...#
#.#. .*...*....*..*.#.#..#...#
#... **..  . ....#. .* . ..# #
# .......  *... \...## .\ ..*#
#......#*...#.#.....  .# .#..#
# *..  *.. ... #...... *.....#
##############################