##############################
#. **.*.... .\ . #.... . *# *#
#.#.. #..# . \.#..*... #... \#
#..*. .\...... *  ... .##.#. #
#*.*. . ..\.*..#* .#\..   * .#
#.##**..*#* # .. \.#*. .*....#
#. ..*** ...#.....*..... \#..#
#. *\....#.  ..###\.\.. ..\  #
# .  . ....*#..#..\..\...* ..#
#.#.#*.... \*.  #*# ..*#...  #
#.. .. ... .*.#..\  ...#R*. .#
#***  ..#.......#.      .   .#
# *..*.# ..# . .\.. ... ... .#
#.....\ . . .. .... ... .....#
# . ......##..#\..**...*...\.#
#..*.*. .**.... \  *#.#..*#*##
#.........*#..... .. .....\  #
#..\*.\..........* . ..* .\.*#
#..\..*  ....\. * #. .#\ .#*.#
#. ...#.. .*...... ..... .#.##
#  ............* .#..#..#... #
#..*. #*..* .. ..** .....\...#
#\... ..##..# *..*.#*.......\#
##..*.  #..#\.. .#...#.......L
#** #.....*   \ #...\** . ## #
# ..........#..*. . *..*. .. #
#....\ # .. **..#.*..*......\#
##* .#.*. #*... . .  **...\..#
#* .\.#.... . #*\...  ... ...#
##############################