##############################
#* *... ... .... ...  ... \#.#
#*. .*.# #..\..  .  .   . .*.#
# ....  ...* *.#.\.......*#..#
##... .   ..*\*. ..*..... ...#
#.#...\*..#. .#.*.* ....\.. .#
#.*............*.. .*......#\#
#  .*.#...\*..  ..#  ... .#*.#
#... .... *.... . ......\. \*#
# # .#.....# ##.\ #.....#..# #
# .#*..\ .*.....#............#
# *..#.\... .*.\...* .....  .#
#..###....#. \ #  .#......\###
#  #*..................\* ...#
#.......#  .#...*.. . . .##. #
# .. . *.*#*...##.  . *.* *###
# ..  \. ...#. ........\*....#
#. #.*.*.*....     \ #.*.. ..#
#\*... # .#*.\\..#........ . #
## .. ....  ..** ..*.... **.*#
#*.#... .#.*  .\\\. . ......\#
#.##*#...*..#* *.. \ ..# . \.#
#.*. . . . .. #.*....##.# .. #
#.. #..*..*.  #.......\ #....#
# .##*. . .*.. \ \* ..  . . *#
#  #  *... ..#* *......*....*#
# . ..\..\\.\# * \.\......#..#
#... . *. . .. . ... #.* R \.#
#.....#..## . ..* .. *..#.#..#
#L############################