##############################
#..*..... ...\. .. #.# .**..\#
#. .... ..\   .*....#*...* ###
###..**\.\\ .... *.#*#..*.*#.#
#**.\ .....   .#..# ..\......#
## #..#.. .*....** .# ..* .  #
# ....##.. *\R.. ## ... . #..#
# *...#... #.#...\..*### . ..#
#*.. .#.*\. ..... **..\  . * #
#.# #*..   .*..#.*\ ......\#\#
#..*. ..\.. * ....*.#..#...*.#
#. #*.#\... .... .. **...*..##
#. .#. .\ .*.\...*##\ . .## \#
#....##.\#... .....*.. ..... #
#  .\. ....*..  .  \  # ..*.##
#.**...* .*.#.... ...*\. *...#
#\....# .#...   . .#. *\  ..*#
#.... #  ... #*. . ..... . . #
# . ... .... ...# .\..\.. ...#
#. ...  ...\...  ...  .....  #
##\ \ ...#...*  . . . . *#* .#
#.. .#.#... #\#.. #.    . . .#
#.*....... .*\. .....#.\...*.#
# .. *.. . ..#.\ .....*\.....#
# *. ..  \. #\.. # .. .......#
#..*.#*.....#.. ....*.\* ..\*L
#.#....*.... \..   ... ...*. #
#*. ....\#....*#....#.* .... #
#.*..... .. ..*. *#..*. *#.*.#
##############################