############L#################
#\.** ..# * ...#..*..##.. .*.#
#.*\.\*.. .*#.....#. *. . ...#
#.#\ .*.. ###.*...   #.*\ ##*#
#..*.. \ .. ......#.*. .#...*#
#. **# .\# ...#.##   .. ...*.#
#..... . .\\.. ....# ..#  *..#
#. ...#.*. .. #*. \  #.. ... #
#.. \.....  ..**... .. *... .#
#.\.  . .*.*..\. ...\. .\*...#
#....#...* .#.. ..#..* \..*..#
#*.... ..  .*  *#.. *.\.. ...#
#.**\ #. * *\*\ #.\.. . *.####
#.  .... \*.. ..#..#\\..* # *#
#..\\ .. .\   ..* .#*. . *...#
# . . #....*..*.# .\..#   ...#
#\... ..#..  #*.  .*..#. ....#
#..\  .. .#..*\#\.#.*.##.**..#
#. *...*.#..... .  *. . . ...#
# .**. . * *.......#. #... #.#
##. #..\*#.. .\....... * *. .#
#.*. ..#**.. .*...\..\*...*\.#
#..# #...  ... ..#... .. . ..#
#  R..* .#.#..... . .. # ..*.#
#.#...  ....\ ..*.#...#..# .##
#\*..#.. . #.##. \*.# .*. # \#
###.*#*..#...*.....  .. *\.*.#
#..#*... .      . .** ..... ##
#...#.. .*..\..#* .*..*. ...*#
##############################