################L#############
#......#...\ #..\...... .* .##
#.... . .*....#...#.\ ..*... #
#\ . .#.  \  # .\.# #..**...*#
# #. ...#. ....* ** .... ..#.#
##...... .#....... .....#.  .#
#*# #*..... #.#.#....*.\....##
#....*.. .. ..*... .\...\ #.*#
#.#.#...     #*\.*.*..* # ...#
##.* .....\*....\#.. ...#. .\#
#\..*.#\.* *...  ..  ..\. ..##
#......*...*.. * *\*.* .* .#.#
##..#..*. ...*.*. .... ..#...#
#.\\.#...*...#\*#.\.*.#   .#.#
# *##..... \.*.\ ......*  #..#
#.*. .#.#...*# .. ..** .. ...#
#..#*..\*.. . .. \ . .. .** .#
#. ..   .. #. *\ \...# .. .*.#
#.. .. ...  . \...* *# *.. #.#
#..* . \#.# #*...##...  #. **#
#...... \#. ## ... .##\ \.*..#
#.\. ..  .. ....*... ...  *..#
#  .....#.. . .. \*\*...*....#
#\.....*...*......**#... ....#
#.. ....#. *..\...*....*..# .#
#..#...# ...* .#. *.\........#
#..#..*....*...\#*#...#  ....#
#.   .## . ... .    *  ..#.. #
# # . ..\...*. ..  .  ......R#
##############################