#########################L####
#...# .#..*.*... ....\.*#.####
#. **  ..#\.. .\... .#...#..\#
#... *#  .# ..#. #........*..#
##.#*... ...*.......... .\* .#
#..#..  .#.\ *........#  .\.\#
# \... \.....*.#*...\.  .*.*.#
#...*.  R*.*.. .....*. *. * .#
##*.. \.. .* .#......*.......#
#.....*..  .#*...#....#..   ##
# .. \.*\\.*... .....\.   ...#
#\....*  .....\*# .\#.#.\ ..##
#* *#*.* ..#\\.##.. . *......#
#.*.. \.\..# ..\*....... . \##
#... ..*#\....#..\. .#*.  *..#
#. .#....*..... #..#.#....  ##
##\ #.#. #......\...... . *.*#
##.  .*#.#...*......#\\.*#*.##
#..* *. . ..*. \\   * .*..* .#
##.#.#.*.....*..... .*.# .#*.#
#. .. ..# ......\*.#.*.....###
# ..*.#. #.*. .*** .#. .. #..#
##.... . \..  ...##.....  ..*#
#.......#..\...#.....*.\..\###
#.. ..#..#... ... #. \....*..#
# .  *.#..  \... .......\..\.#
#. ... #. .#...*....* ##. .. #
#.. .** .* \ ....# ...# .**. #
# .*.    *##*. .\...\.#...  .#
##############################