##############################
# *..#*.. ..*...#.#......  # #
# .*.\ .  .. .. ..*\ .\# .#..#
# .   *. .. ....\...# ..#.*..#
#.... \...\. *..*..*.# #.**###
#..#*.#   .   ........\...*#.#
# ..... . *\.  .  *..*   ....#
#.  # .\..#...*... .#.\......#
# .* .* .#.#\ ##.... . ....\.#
#...## .  *..  .. . ... .*...#
#.#R ...*. ***....* .#. #*...#
#..*#..*......*..... \\. ....#
#...# .#.\*. .# ...\*.. ..\..#
#...*.#...\...... #.* .. ... #
##..*.. *..* \.... ... ...  ##
#. *..\.... ... ..*#..\ .....#
#  .\.*.......#.#..**\.......#
#.#*. \ ... #.. *.**....#\.  #
# .. ..... . #..#. .. .#*.#..#
#  .\... \*..*\. . .#.. ..\\.#
#..* *##*\.. #...*.......##* #
# ..  ... .. #*..*..# \*..#..#
#..*..#.. \..**.#..#... ..\..#
#*.....*...#........... ..*  #
#.. ...#*.*.. .#*.#...*#..*.*#
#..# *.#*\..... *#*##.......##
# ..\ . \...*  ....#..\* #* .L
# *.#.... ..# #\..   ** *..*.#
# .#.#  .\\\.#. ...*.# \. \.##
##############################