############L#################
#. *** \#*. \..#....\...\*..##
#.. ..*...... ..\..\. ....*..#
#. #. ..*......* *  ..##.  .##
#\. *.. \. \ ..*..*.. . \\.. #
#.. ... ..# ..*#..... ##.. ..#
#\.*...#\.  *...#.....*.....##
#  .. \*...  \..#.#. .\ .##..#
#*..### . .  ... . . ... ....#
#.. ....#. *.  .   ..... .***#
##.# ......*#*..\ .*..... ..*#
##.## ...*.* *.*..# ..\.. ...#
# #... **#.. *  .  ...\...*..#
#..   **...*##.. .....#* #. .#
#.....#*.*.*  # *............#
#..........#. *. ....#  #....#
#*.*...  **.... ..... .\#\.#.#
#**#... *..**# *.... . *.. ..#
#.#. ...#.. .\ ..... .# ....##
#..  ... .*..\ ......*... .\.#
#.......* ..*.*.  \.. ... #* #
#.. .#..# .. \  #.* . .......#
# ..#  *.#.. ..   .#. *\....##
#.*#.\..#......#....*\#...*..#
#.. .#......* **...... *. . .#
#.. ..... .  .. #........\  *#
#*\..*.# **...#...  ..*   ##R#
##.# .  .. .#\*. .. .\.\.\..*#
#*...... . .. . \*#* .\ #..* #
##############################