#################L############
# *. #. .....*..* \ ....*..* #
# .. \.. . .\.\*..*...*.*..  #
#.. .......#\......#..  #...*#
#*.....\..##.#..  ***..*  . *#
#  #...... .....#\#.\*\... . #
# . ..... .. ..... ..#... . .#
#....#..\.....#..*  .....#...#
#... ..\. *.* .*##....#. ..#*#
#*...\R.*. *.* .##... #. . * #
##... *....#.....* ..** ...*##
#.....*#.*#. . .#....*. *....#
#. ....#* .... ...# ....#..#.#
#.. ...*....* .. *...... \...#
#.... ...*. *.. ....#..\.\##.#
#..  .*... . ... .#*...* ..*.#
#..... .. ... . #.\#.*. \..*.#
# ......\.#. .. .\\.*.\.#..*.#
#.. ......... *.. #....#..#\.#
#.# . ...  *.##..* .*.* ..\#.#
#..*..#..\  #. .... *...  #..#
#\.#.. ........ ..*.\ ...\.\.#
#...#*. .\.. .#... . #. . ..*#
# #*.  ... \.#. \... .** .#\.#
#.. \  .#.*........  .... ...#
# ..###.#..... ..* .*#.## .*.#
#   ....... ***#.. ....*..#..#
##.\.. .  .*\. ......* .#.. ##
#..##.\# * .. . .\.#.\. ....\#
##############################