##############################
#..... \.R....... ......  .. #
# .*\.. #*# .#.#.. . ..#*. ..#
#*.... .  **..*##.  \ ..... .#
#... .....# *#\..... .# *. .\#
##.\ \..*..* .*..# *\.. ..#.*#
#* #..*#. *#.*.. ..# .\..*\..#
##....  .\........#..\... # \#
#. *..# *.#.....\..*  #..*#.\#
#. ** #.  *#*.\.\..**.. *. ..#
#..\# . *#.#....#\\ ..##*\\..#
#\..*. *.\#.....\.##**.  ...##
#....\..# .* *.* .* .\..\.*..#
#\....*.......*.##.  .*......#
#. ..*#..*.* \.#*.. ...  #...#
#.*# \.. .\. \#.  ## ...# #\*#
#.*. . .*...#.#* .*.. ..#*..\#
#... ..#. * . *.#....*..... .L
#..\. ..#.. *..... .. ...#...#
##..#..\..\...*\..#.....#*#.\#
# *\ .*..#. ....#.  .\ \#. *##
#....#..... ..\.#.. \ *.  *.*#
# ..#........#....#... \..#**#
#.....*  # . *#. .\*..  .. *.#
#. ....\ *...#.#.\##.*... ..*#
#. #. ..... # * ...#... **...#
#**....#*#.. ....#**#*. .*..*#
#.# ..\...... #* .. ....#.*.\#
#...##.\..........#  ...\.*.*#
##############################