##############################
#.. ..*.  * . ..\# ......*##.#
#.......*. . \ ..#.# ...* .*.#
# *. ......*.... .#..  .* .. #
#...............* *.  #..*.  #
#.# ......... *...*. #. .*. \#
# \. .#.#\. .  . .\... \. \.*#
# .##.#... .. *#..*..*....\.\#
#\*.# \.#. .#.#. #*. .#...##*#
#.#.*......  ....* . .....#. #
#......  \#..# ....#  ...#.#.#
#\...#. #........##. .#. . ..#
#...#..* ..  .  ..#..\..#*  .#
# \. .  .. ..  .**.   #* .# \#
#...#....... . .   ..#. \* *##
#. .........\.... .... .. . *#
#..\..... .#*...\.#.. .#.*..##
#... ... .\* .  .. .*..  # * #
#.*  *.. * .#. ...\.#*# \... #
## .. \..**.#*....# .#. # *.\#
#....*...   #....*.#..\....\.#
# . ..#... .. ...#*\.##..#..*#
#...\\.. . .*.. . ... ... .\*#
#..\.*. .  ....#.\.....#.....#
# ..*\#. \...##. ...# *#  .*.#
#..* ..#.. .*..* #.#...#*... #
#\.   .. ##. #.\#........ ..*#
#......#. *..##....#.. .....*#
##....R #*. .# \#.*#..*...*..#
#####L########################