##############################
#.#.#  .R.. ...#.**#.. *.....#
## . ...*..**.. .\ .... .*.#.#
#...#  #*.....  ....#. ....###
#. .*.   .*... .... *..  #...#
#....#*..   .#.. .*.... #. .*#
##..#. .* .. #  *.*....  ....#
#.#....... *..## ... \ \..#. #
# ..   ..* .. # *.##  ..*\\*.#
## *. #..\*.#... ..... . ...*#
#  #.\..* #*.# ..\ .*..##. ..#
#.*.*# *# .#..*#. ..#........#
#.*.*\*..* .* .....\ .......\#
### .. ...\....# .#.....#....#
#.   .\.... .. #*.*....* .#. #
# ....\.....  .... . ..#...*.#
#..*. #....  #.......*#.. ...#
#...#.# ...**\.. ...\...\.  .#
# .*.#.*.\** .#...#.*#.# ...*#
# \.....#.. .*.  *#.**.*..\. #
# ###. #... ..#..\..# . .  ..#
# .* ... .*. .........*.**# .#
#..### ..*#.#.\*.\. * . .... #
#..\ .\..* .#..#. ..........\#
#*.... .. ... \ #* . # ..*#.##
#..\ ..*.\..* ....*. \. *....#
###**  #.. #.... ... .. ..* .#
#.\.. *.#\.*.....*.\.    .##\#
#.*.......#..#*# *..... .**  #
##L###########################