##############################
#..\\.* #...\. ...\#.\**  \# #
#.\......*.\#...*#*#.. ..#. .#
# .  ......#**\.#...  .#. **.#
#. #...*. ...#* .*  #* *#....#
#  . .* .#..  ....\ .....#.*.#
#.... .#...... .... ... . *. #
#.*..*.# \   ..  **  \....*..#
#*.#*.#. *  ...#.#. ...#.. \##
## ...  . ..*. . .##**. ..  .#
#... \......# . .*... #. .#.*#
#.* \#....#... .*..  .**.. . #
#... .*... ...# ..# #* . . * #
#..\....*.*.#.......*#.*..  .#
#..* \***.##*.# ##....*   . .#
#..**. *.  \*.\.\. ...\. # **#
# *..*..*.... *# ....#* .. # #
#... \  .....\.  .#...#...*\.#
#... .#.# . .....\......#. ..#
##.....*.*#.#..#......***.*..#
##.\...#.*.*....... * #......#
#...*R. ..#*. # .* .. .... .*#
##\..\. .. .. *..*#**....##.*#
#   . .....#...*.  #.. . #\  #
#.\..* \ ..*.#*.\.* *.*..*. .#
#.... .#.#..  . . .*..*# ##*.#
#....# ...\.# ... *... .#.  .#
##\.##\#\......*.**.*. ..\.* #
# .#.*..# ... # *.#.. #.... .#
#############L################