#####L########################
##....R #*. .# \#.*#..*...*..#
#......#. *..##....#.. .....*#
#\.   .. ##. #.\#........ ..*#
#..* ..#.. .*..* #.#...#*... #
# ..*\#. \...##. ...# *#  .*.#
#..\.*. .  ....#.\.....#.....#
#...\\.. . .*.. . ... ... .\*#
# . ..#... .. ...#*\.##..#..*#
#....*...   #....*.#..\....\.#
## .. \..**.#*....# .#. # *.\#
#.*  *.. * .#. ...\.#*# \... #
#... ... .\* .  .. .*..  # * #
#..\..... .#*...\.#.. .#.*..##
#. .........\.... .... .. . *#
#...#....... . .   ..#. \* *##
# \. .  .. ..  .**.   #* .# \#
#...#..* ..  .  ..#..\..#*  .#
#\...#. #........##. .#. . ..#
#......  \#..# ....#  ...#.#.#
#.#.*......  ....* . .....#. #
#\*.# \.#. .#.#. #*. .#...##*#
# .##.#... .. *#..*..*....\.\#
# \. .#.#\. .  . .\... \. \.*#
#.# ......... *...*. #. .*. \#
#...............* *.  #..*.  #
# *. ......*.... .#..  .* .. #
#.......*. . \ ..#.# ...* .*.#
#.. ..*.  * . ..\# ......*##.#
##############################