##############################
##.\ .\ #.*... .#.\\\.  #.#. #
#.*..* **   ..\# #.. ....#.* #
L. *# *\..#....  *...\ . \.. #
##.......##*#* .....\*#.* #..#
#*.*..#*...#.*#. ..*.*#... ..#
#  *.. ...........#...*.....*#
#..\.. ...#..#.**..\ ..#..*..#
#..#..*\ #..*..*# .. ...  .. #
# *##.......*...# ..\*##* *..#
#.\\.. ..#. . .\*..*\ ...\.  #
#..#.*#. .. .#..# . ..... .. #
#  .\#....**.* ..# ... \ .*#.#
#.......\**..#.#.......*.\.  #
#..... \..#*.. ... ....\..* .#
##  ... ... ....\ *..* ..*..##
# ... .. *.# ......\...#.*...#
#..\.. ..*\... #. .*\.#. #...#
#.... .\\ .....*......*..#*..#
#...*# .#. *....*** .*... R#.#
#...*. ... . ..  ..*  . ##...#
#.\.... . ....## \#.#. *. *. #
#......\.#. ...*...#..\. #  .#
#....   *..*  .  .\* . ..... #
#.#*...\........   .   #.*#..#
###**.# #.*..*..* .\...\ ....#
#..*.#.. #...\.... .. .*   . #
#..#. #\. \*.. .. ..  . \.*. #
# #  ......#.#...*.. ..*#..* #
##############################