##########L###################
# ...***#. ... **.....*......#
# .#*#.#*.......   ...# ..  ##
#..........#... ...... ......#
#...## .#**.. .*#..... ..#...#
#.# .. \.#..... #.# .\ ..* . #
#..* *  ... .  .*###... #....#
#.#.... .......#.......\.#.  #
#   . *...*\\..#... *\\.. .. #
#... . * *..... .#.\.  #.#..\#
# ....*.#..#*.* .... . \.... #
#......*..\*# . ..*.....  R. #
#.*\..#.*# .*\... # ... . .# #
## ...#...... .. .. ##..#.**.#
#\ .*.. ..*.* #.*  .....##.#*#
# . . .\.*..\ .. .  #. #.  ..#
#  ....\.. #  .#..*#.. *....*#
#....... *  .....\... ..#...##
# .....#... .# *.#  #. . \#\.#
## .. ....\#. .. ... ...  . .#
#...*. *.* .*.. ..##.\#.....##
#*. ***.*.*....\* #. .*... ..#
#...#...*........# \*...# .. #
##..**.....# ..... #.....#.. #
#   . ... . *..#. ......*.#..#
#*..*.  \. *..\.\..#.. .*...*#
#. .#..## ..\\...#  .#..... .#
#.....\\ ....*..**... * .....#
# *#.# .\\*..   # .. *.. ....#
##############################