##############################
# * \.#..  #...*...... # *  ##
#*#.# ..*..#....  .# .... . *#
#.. ...... .\... *.#...*...*\#
#*.... . .#..... .... \# *.. #
#..#\ ..*.\.....#...* ..#.#. #
#.*.......  ..**.\. #\.... ..#
# .......# ..... #.... . ....#
# \....\.  .. .......  *\.*..#
#\.\...  ... . ..#.....  # .##
#..\*.#. .#...#.\\.#.\. * . *#
#.#.. .*  .*..*.. .. ...# .* #
#.  .. #....... .....\.# ..#.#
# ##  #.# .#. *..#.......\..*#
#. *\* \ *#....*# ..*...\. . #
#....#*. .. #.#..#.*...\*.. *#
# .... ..#.\\.. ..*#..*...#..#
# . ..* ...*.# ..* .... .#  .#
##.....#..#.....# .. R#.#. ..#
#.\#\..\#....#..*..#* ...*..*#
# .....  #.* ....\ .**..*.. .#
#\. .  .\*.#.#...* *#* #. #.##
##.#..\.... .*... .....  \ # #
#..... ....*....#*.. ....#*..#
#.. #. ...\#\* ..*..    *##.*#
# ..* *...\... **#.\.... ....#
# #...#\.*.#. . *##  ........#
#.\.*\ .* \ *.#.. .#...#\....#
#*.*.*.*.....\ \..#..#. ..\..#
##############L###############