##############################
#...*.*...# .##..#. ..#...#..#
#*.\**. .  . .. ....*. .. ...#
#.#.\...#...*....#.#... ...  #
#. \......\ ..# .... ..\*.  *#
#. ..#\*......*# .. ..... . .#
#..\..*.* .. ..* #*\*. .\..*.#
#*.#* . ..*..# .# ..#* . ..* L
#\ ..*#*. .... ....#*R\ .....#
###. .*..*..*.  .*\... ....*.#
#  .##.\ ....\...... .....* .#
#\..  #.  .#..# . .##.#. .. .#
#*  \ #...*.... ... .. ...#*.#
#. **....*..\ #.#..\\... . *.#
# .... ... \.... .. ..*#...#.#
#. \....\...*#. .. *.........#
# .. .  ... .\..*..#..#\.. \.#
# .. #..** . . #\......  ..* #
#*. ... . ..\.. ..* .#.#.#.. #
#...# ..\#   ... #.. #*  .##.#
#.\..  ..# ...* \ ... ......*#
#. #. #.  ##..# . .....*#*.*.#
#.... ....#.....#*...* ......#
#.. .#. ..#. .* #. ... ..# * #
#...*..    ...#..*#. .#.*.  .#
#.* *..#...... . . * # .*..*##
#.. **.*# .#.##.......#..... #
#..*.. ...*..*.. ..  *... #..#
#.....*. # *#.*..#..##.\.....#
##############################