##############################
#.... \#.. ... *.\#...#.. . .#
#....\. .**.* \..*...* ... ..#
#...#\ *.#.*#. .... *# #.  ..#
#. ...\\  .##..#\..#\...*... #
#*...*\\#*. . \*..  .*#.*.. ##
# #* ... ....# ..#..# ..#.#.\#
##. ......#.. .\.....  .  . .#
#..#....... \.#*.*...   *. ..#
##*\\...#\.. .*#.....  #. .. #
#.* ..\.  * *#.** . ..  #*\.##
#... *...*.#..\. *.*#. \..#..#
#.\..*#*..... ..#...\  ...*. #
# .....*.. **.*...#....... .*#
# .*..#.* #..#. .*... . .R .*#
#..*#......#..#*.#....\..#*.##
#..\..# \....**...#.\.#.#* ..#
#.  .#*.**.*... .\.* ....#.. #
#.#.#.*#....* ... \.#..# ..\.#
##\. .*.#\..  #..\. ..*....* #
#. . #.*..... #....\#.. .. ..#
#.*..#.* # .*.\#.**.  .. *.. #
#. ..  #..#.*.##. ..... . ..*#
L#\... #. .  *\...#.......#. #
#.... *...##*..#.  ...\..#\..#
#...... ... ..#... .#...*.. *#
#..*.. *.* #.#....* .. \ \.. #
#..\.... . .\#.#... * \   ..\#
#*#... #.* *..... #.... .....#
##############################