##############################
#...#...#.....#........#.*. .#
## .\ *..# *. *\.#  *..*..*  #
#*..#... . .* ...#..\...#..#.#
#.... \. .# .***   *.#* . .*.#
#. .\ ...* . ...*. . #.*. # .#
#.\...#....*#..... ... .. ...#
#.....\ . ...... .*...   ....#
# . ... \ .*.*...  ...... ..##
#... *.....#..*.\ ...... *..##
#......   .* #..\.... .*\ . .#
#.\.#..  .#....*...#...#.....#
# # . .#.. \#. ...... * ...  #
#.#  . .. .....#\*. . .\.. *##
#.. ***#.*#. .\.\* .. . *.. .#
#....  .. ..##....  .    ....#
#..#. ..\......*#....*....* .#
#* #.* ..\...#.* ... *R#.*.#.#
#... .. #......#.....#    .. #
#.. *..# ..*....*...\*..\..*.#
L\#.... .\. *...#.....*.... *#
#. *..*... # . .#... ..#.....#
#..*...... . #...... ..**\. .#
# .#  .#. .. #.  .......... .#
#\* #... .#  .. ....#.\ *.\*##
#.... \... \..* \#.*.*.......#
#.....  ....... ....*. #. *..#
#*. . \... .. ... . *..**#.# #
#.#\.  *..\.. . .*..... ..*..#
##############################