##############################
#\..*....#. .....# ... *. .#.#
#.. .*.#.. #........*.* . * .#
#*.\.. .* **#**...*.  ..#....#
#*##..... ...#...**.#\. \. ..#
##.# ..  .#... ...#.*. ...# .#
# \  \ ..# ...  ...... .#. #*#
# \.* ..#. . \ * *.\...*\ ## #
# #\.##....* .#*.  .\.*......#
#* . #.. .....##..... .. ..*.#
##.\#.   ..\*#*..*.....#.\ #.#
#.. .#...... ..#..*# # ..... #
#*.* .  # ....\... .#*# #.. .#
#*..*..*.....#. # .  .... ...#
#.*#*.#.. ......*.#. .#......#
#.. * ... .... .   \.\.#.#.#*#
## \..#.  .. .#..............#
# *....*# *. *.*..#...\.*#.  #
# ..*.... #. #  . .\ ..#. .*.#
#..... * .  .* ..*.....#*. ..#
#  *.\#...##.#..\..#   ......#
##....\#*..*..\..*.. .. ..  .#
#... #.. ##\*\.\.#\ ..*..\.# #
#.. . .\..#.#.# *.*..\\..#..##
#.* ......\ \ #...\#..... .**#
#..\#..\. ......*...\...#..*##
#.... #.#........#....  .... #
# .. #......##. .... . #* ...#
#.*. .* \#*........##R.  . ..L
##############################