##############################
#..... ....# .....* *.# ...#*#
#\..   \ * ...#.#\. . ....\..#
# ..\ \ .. *....#.# *.* ..*..#
#* ..*...#. ...#.. ... ......#
#..\#..\...  .#..*##...* ....#
# .#.......#...\*  . .# ...\#L
#*.. . ..... .##.*.#..#  .. .#
# ..* ..  .**.#\.*. # *.#..*.#
#.. .. ..#\....# .....*.# . .#
# *....*.. .\..#  ..\#.*. .\##
#.\.. #..#.\ ... *....#*.#.#.#
# ..#.... *.\. ...*.**.*#.  .#
#.. *#.#.\.#...**....\ #..\..#
##.*#..\....#.*#..#......#*..#
#*. R. . ...*. .#..# *.#..*. #
#*. .......#...*.** ..*..... #
# .*...  \...#.. .....*#*..\.#
#..#..\ .#*.* .\..#.*...* ...#
##.\*#  .. . **.#* *  .\.. *.#
# .. .#  .....#*. ..\#...\\*##
#.. .*   ...*.*#.\ .......#..#
#. .  .  .....\. ..#...... .##
#\.#.#.. #..#.. #.... ... *# #
## ..*.#*.  ..*\ . .*#\\*...*#
# ...*...\#..\#..##.  \\... .#
#..  .# #* .... .#*.#.* \#...#
#.. ... *...*..\ *.**. .\....#
#. . ..#...#\.* ... ..#\ ....#
##############################