##############################
##.... # *  ......*.#........#
#..**#  ...*.. ....... ... ..#
#...*. ..    ..#.\.. *.*.....#
#..*.#    .....#.*\.. .  ... #
#..#...   #..#..\ .\. .....\\#
#..#*.. ..*..  #...... .#...*#
#*.*.\.*  .........  ..*.....#
#*.#..\. .... *..*.. ## .... #
#.* . *.\.\*..#*... ......#\##
# #*.... #..*.  . ..\.*. ... #
# ...* .. ...  ..* .*.. \..*.#
#. .. *....#.......#..#..... #
#.... .#**.. . *.....#...\.. #
##... .#*...*  #....#... . *.#
#. #.* * . ..*\.*\\#  ..*. ..#
#..\* .#..\ ....\*.*.#\*.#*# #
##*. .*.. # \. * *..........\#
#.*.#*.#... ..#\ .* #... # ..#
#..*\.. *\ ...#.. ....  .#. .#
#.*.## .# ....*.....***  .#.\#
#  \\..*...*   .*.  ......  ##
#.* . #.......#*.\\...##.. \ #
#..\.* .. *\ \ ......*  ...*.#
##.\.. ...\. . ... .*......*\#
# #.  ..#.\... \*..#..#...   #
#.. *#..#.#    \......\.#..\.#
#... . \...\*   . *.  ..* ..*#
#R#.#.* . .*.. ....*.... ...##
################L#############