#######L######################
#.#.#\*.\. .*... #..*  *.\\ .#
# .\.. *#...#.......#...##. .#
#*. ..  . #*.... \*..*\ .** .#
# .#.#...\. .# *..#...*.. . .#
#.* . ..\....##.* .. ..*..#..#
#..#* ..\#..* .*.. . . * .*..#
#. *..# . ... ..* ..##.. ....#
# .# ....  *  .#..#....#. .. #
#.  *..  .##... .  ..*..\ ...#
#.#.#..... ## .* #.**.* \*\..#
###.\#... .*..*.*.*.\..*#**..#
#.#..#*\. *.... ....*.. *. .\#
##  .. *...*.#*......* ..... #
#*#...# \. \. . ..#*#..... ..#
#*#  .*.#...#.....\. ..*R\ ..#
##..*..*.. ..\#.## ........* #
#.\. ..\  .. * .....  . .#. .#
#.\.#.*##*#\.\... .#  ...\.* #
#..*.*.#.*. #  ####.*\#  ..#.#
# *#.  ..# .. .....*..\. # .*#
##**  . #... \.......#*..#*..#
#\ .. ..* *.. *#..\.... .  ..#
# ...   .. .#.#* . ..**..... #
# \ .* .*.. .... #*. *....*. #
###..\*.#. ..\# .*.##....*. .#
#\ .#. ......#.  .  ..#. ....#
#. .........  ..\ \.#.## ..\*#
##.\.*.....*..\..*#\......#. #
##############################