##############################
#. ....##. .\*  . ..\*...  #.#
#..#.....*.....*#*.. .#......#
#..  ......*.. ..*. #. .*..*.#
#.*..#..... *.\  ..  .*\*...*#
#..# #.*.   .#**.. ...  .#.*##
#.... .. .. ..  .. ** .#. .  #
#...  ## . **..#..# ..#\ # #.#
#. . ... .....*. . .*.... ..\#
#....\*.. ...*..... ... ... ##
#.\.. ...##...#.#...#........#
#........ .. .*..\.\ . . ... #
# ..\.....*#.   .#.. .\****.##
##. . .\#**.#.....# .... . ..#
#..*.. *..    .#.....***. \#.#
#  ... #.... ....* * ..#.#.  #
##.*...# #\ ....#.... .. . \.#
###..\ .. .*.\.*#. ...... ..##
#**.......* .... *  ..R...*. #
#... ...# \.#........*# .. ..#
#*.*.#. *....#. ......*.#* ..#
#*# *..#....* .\\ .. . ..#*..#
#  .... .. \.\... .... ....#.#
#\.  ...... ....  ..*.*..**\.#
#  ......#...  .\. ...*..* #.#
#.# .  .\#..... ........*##. #
#  *.##.*.*..  *...#... .....#
# ...  *..#. ....*\....#... .#
#  *.*.\. .\.* ...*..#..*..*.#
#############L################