######L#######################
#...*.\..#** *. .***.....#..##
#. *#.  .. ...# #...#.. ... .#
#..#..*. .\.\ ..#. *..  .. . #
#..*\ .*.  ..# ...*###... ...#
# . .**....\#.... .....*..#*.#
#.. ....*.#..* ...  \**.** ..#
#.. .* *...*  .. . * .. ..####
# ..*#.....* .  *#*\ .* . #..#
# *.#..*....* ........ ..\...#
#..\* \... #...* #* ..#...*\.#
#*...#. . ..*. .#*...#  #....#
# ..##.\#.....# # *.  .. .*..#
# *.. . . *#.#*#... *..*. #.##
##...... ... ...  #.... ...*.#
#. #*.  .\*.*. # #. *.\..*##*#
#..\  ... ..*\.. *......#....#
#\ # .*#\*.#.\#.*. *#*. ... .#
#\. *..*.**.#*##  . .\ # *. ##
#..... ...#......#....#...#.\#
#.. .\.*.# .. . .R.#  \ . # .#
#.\*..*..\\... .*..#.. .*....#
##.......# .\**  # .. *#*. ..#
# .....#.. #  \\.  . ...  .# #
#..... ..# ..\.....** .*.. *.#
#.*. \....\   .# ....  # ..*\#
#.. .......*.. .. .....# ...##
#.. .\... *.* *.\  *. .. .*. #
#\ #..*...# ..*#.    .  ..\..#
##############################