##############################
#.\... .#..##. ..**.#. #.....#
#*  . #...#.* *# *..\........#
#\.. #.#...  .\.*..*.. ...#. #
#..  ..\ .... .* ..#.#. #....#
#.  #. ......* . .## .\..#\. #
# .. ..*..#......**\# ..#\*..#
#....# .. #\...#.. . #.\*.. .#
# . ..#........ ..#  .*.. .# #
#...#. ..*#......* *.*\*. ...#
#. \. .. . ..*.*....\# .#.*. #
#*. ....\* ....... .# .. .  .#
#..#. ..*.. *........# ......#
#\. ..\*. ... ......\...** ..#
#.. * ..*......*..... ..###..#
#...*. .R....#.. * ...#.....\#
#.*.#.*.  .  ....**.\.  ...*##
#......#*....  * \..*..*..#. #
#...#  .  *.. \. .  .# .. \.*#
L\.#**    . ...#.  ... ..#...#
# \  ... ...*.#..*..*...\*.. #
#***# ...... ##..**.#*. ..\..#
#*  \. \.#. \*..... .. . \. .#
#*#...* ...... \..*  ..*   ..#
#..# \*...*. ..*. ..\ ..... *#
#.....* .*.\  *.*. ..... ##..#
#.*........ .#.. #. ...#...\.#
#..\  ....*..# *#.\. .......\#
#.. * .*\ \ ..\.........*. ..#
##############################