##############################
#.#....#... **#. . .#.......##
#. #.  #*  .*...#. .\ *#....*#
#*#.....#..#.#*. . #  #.....*#
#...* ..  .* .# .. ..*\.##...#
#. \.#....#\... *...*\.#.....#
# * . ...\* .#..\ .\........*#
##.\....*\  #....\\ ..# ##  .#
##.\* ..\\    . *.*#**... *.*#
#    #.#.   #..#* ....... \  #
# . .  .. .# #*.R.*.. .*.#...#
#*. .#\ #..** ...\\#...* . # #
#*... ...#. .  ...   . ..##. #
#.*..*#.#\.........**.*.....*#
#.... ... ..# #*. . ..#*...#\#
#. #...... .. ..*... .*.... *#
## #.....\.## .** ....#.. ...#
#..   ...  *#..* .. . .\....*#
#  * ....\ ..*\...*\#...* \.##
# .. # .. #*.#..*......##*.. #
#..*...#....\.#  #***.  .## \#
## .\.#. \\*. .**# ......  #*#
##.  *....   . .*...#*.#.....#
#. #*#. ... #*.. ..# .#..... #
##....\#..\..##........... . #
#........ .......\ .*  ...##.#
#.#  ...\.\  .. ...*#. ... . #
#* .#  #.#...... #.#*..* ..# #
#.*...... \.. ..... . * .*. .L
##############################