##############################
#...#..  ....#.*#.  \. .#....#
#. . \   .. .** ... .. ..  ..#
##\..#..# ..#*..#  .. .*  . .#
# \# *.....  # ..  . . .... .#
# .*.  .........*#\ .......#.#
# \.   **.. ....#*#.*. #. #. #
#..* #..... \ ... \.* * #\...#
#.. *.... .\#**..*.# . .\....#
#\*. * ..*.# ..\ #.# .\\.#.*.#
# .#. #....... *  *. .. . .  #
#..\..  ..*.\# .....*..**..*.#
#.. #...... .*.#. \. *\ ....##
#.   .*.... \**...* .. .* \.##
#.# ...*#* ..\..\ .#....*..*.#
#* ...#\\.....  ......#.\# \\#
#.. . .\ .*..#..**  . ..#.#.##
#...# #  ... .*.  *.. . #\\* #
#..*R ...# .#..\.#*. . .\...##
#.  .\......\........... ....#
#..# ... ..*.. ..* #. \... .##
#...#.\.# ..\*. #.*... #.... #
#. *.*... *# .#. .*....*...#.#
#.. *.....#*... #*.... .*. ..#
##.#.*...#. .. *. .#..#**.*..#
#..#* .   . *.#.....#.. .  ..#
#.. \..#.#.  ... ......*#. . #
#.  .# *.. .#*..**.... *  #..#
##... .....\  ... ... ... ..##
##########L###################