##############################
#\..\ .##*#....\.. *. .. ..\.#
#..*.*..... . .\*..* .  *... #
# .. *#..#..*..*...#.   .#.. #
#... ...#*..#. \.#....#.* .  #
#*#.*.\ # ..\ ..*.#*#  .... .#
##. .#. .... ..  # \. .*.*  ##
#..*....#*....# #.. ... .....#
#.*.#.R...*#..#\\...* ..*   .#
#..  \* ..... ...#..#.*. . .\#
#. #**\. .. *\. .*.\ ....* ..#
#...#.##.. ##..#  . .\. .*...#
#.*..*......# .. #\*... ... .#
#......#.*.  ..\... .\ ##*.\ #
#...##.*. #... . #\*.  .... .#
##*..\..  .#*..* . #. ....   #
##. *.. .*** .#.\. \.# .#  .##
#...#.#..#.. . .  *. *...#.  #
#.......   # * .**#  .#.....##
#  .##.\. ...#....\.#.   ....#
##..#..#\*.  .. *#.......* . #
# *.###..  # #.*.... ...#....#
#  #...... *#*.\  *..#...\  .#
# #   ..  # \...#. * *# ...#.#
#\.......... *#. #.#....... .#
#.**...* ..  #..#. * *.. . \.#
# ... .......  *.....*... #..#
## *.#*#. .... * . .*..\..*.*#
##\.  * #. ... \.*..#..*....##
#######L######################