######################################################################################################################################################
#    #*.#   #.*..#.. *...*...*.. #.*..#........  ..#..  .*.#.. ..* .#.*. **.**. . .  .. .. . ... ...**. ***\*. ..#.. *\.#... .*\ .... .#.* *##.  ....#
#..\....    . *. \..* .. \..\#. .#. .*# *.##*.* .. .  ..# .   ...*..#*#..\.#*. ...#.... ...\..*..* . . ###*#\.... .#....##...* .  .#..#...  #.#.*.* .#
##. .*.*...#.* #*.*.\.# \ .*#...... ...#..*.. *.. # .*.. . ..\....#\*.......*  *#.#\ ... . *.......\... .\..\**.. ... *. .. .#*  .. # ..#...... ....##
#.## *... #..\.*.....# ..**... \... \ .....\.. \*\**\##*...#*#.\.. ..*......*#.\*...#.**. ..*.....   ... .*.*. .\ .*....#...*.\\#.*.#**....  \# #.. .#
# \.. # .\......#.#**.*.. ..*#.. .# .....# ..\..........#*...   ##..*.#. ...  ##\\... . ...**#*..#..  ....* .. ..* \..  .**.\ *.\ ...#  *.*#\#..\  *.#
#.*.....*** # \ . \\..#.*..#...\#...## ....\.*..#....... *\ # .#\.. . .#.  .*..*. .* ...*\..#...*\* *... *.........*. .**..\ *\.\.* . ..\*.. ##...#*.#
#...\ *.# ...\ ... #..\*....# #.....*.. ...\.#\. . .....  ..\*# ...*..\*.*..*.. ...** .....#.*.... . #...\*.. .. #. \.#..*......*.  . * \ .*......\.\#
#.. ..\*.*#. .  .\ ...\...#. \.*.* ..* .#*  . ... .. ..#* #. .... #.#. *.\ ..#....\##\#. ... ...  . . . .......... ..# .# #... .... ...* ...\..#  *..#
#...*..........  . .. ....\...#....*.*. \# \ ..\ .# . ...#.* ..*.. *#..*.*.\*#.# .****....#. .*#  ...  .. *.. ....#. **. *#.... *#.*. #  .....*.... .#
#..........#...  ...##...\..\....*\*..*.....   *.# .... #...#..**\..#*. .. .*  ****.*  . *\..\....*.. .*.*..* . ... #*.\ .*.    .# ... .#.. ......*#.#
#.*\ .  .*.#... #.. #.* ..* .... .. \*..* .*#. ** ......\.. . ..#... #  *.*.. ...#...*##... ..#.#...* . .*.** \...\*......#.*#.. .. ...... \*\... .\##
##...  ...  # .\.#. ..*.... ..\....\.... ..## .*..*.. ..*.....  .#. ...#..... . \. ....*#*..# ...#. * ..##*.......\......*....*.#*# \.**. ...........#
#........ ..\.#...#.\.#. .\.#. *. #.# *.**. #*.#...  *........*. . # *.*. #.*. .*#... . ... .* \ .# #\. \..* # *...#. ....  ...#.*. .. ..* .#*.... ..#
##. .*..*...... \ #..\##..  * . .*...... ...#.....#*.  #  #*.*\.** .\...\.*.# ...... .. #.#. . ..\..... ..#*.*.....\...#.  **..*#. \#.#..\.#. ...##.##
###...*. .#.. ...\............#   #..... .#..\.#*..#*...\ ****\ ......  .......... .\.#...\#*.# *  #....# #.##\*# ... ... *.**\  #...##..  .*. .*.. .#
#.....\...*. .#. *** * ....  #*\ ....##.*....*   *..#.*. ...*...\##.# ..# * .#. ##*..  #..*#. .#.... ..*..\.... . .\.. ...\ .. .**.*.  .\.# ..... ..\#
#.. *.*.* \.\..#.. *.#*. ....\. .. .#\.... .. \#...#*.#*.# . \# .*.. *\#  *... .. ...#. .   \*. *###......# \............*#.  \*.##.  # * #..##....\.#
#  ...#*.#.* .. .#.*.  . .\.*## .\... ....#... .. .. *....**..## . ...  #...\#\#.*.*...*. . \. . ..#*...... ..\ . ..#*\..\   *. .\*#.\\* .#...\ *  ..#
#.#..... .*. * ... . .. .* .. .. \ *. #.  .#.#.. . *...### #..\* #.......\ ...  . . ...    *.. . ...\ .*.. # .. .#.. .. ...\..#. .. #.....*  ...#.*..#
#...#.\..\. #*. *..# .. ...\.. ... . # ..#. .. ##. .. .....##. . . ..*...# .\\*.*  . # *\.... ...#.\.  ....#.   . . #.. #.* .\ .*..#.*.\  #. . .*\.*##
#...#.....##..** ..*..#.\\.#..#.. ...#..\......*. *.....   .....#..... ...*..... \.#.. \. ....**\*\.**# ...# .... ..*\ .*..#.  .....# ......# #.#.# .#
##*...#. #.#...  \#\*...##...# .\.. .\\... * ... #...**. #.... .*.... .....# ....# ... #.....\.*....  ....*...# . .....#....# .*.........**.\..   ...#
# .*#.\ ....* .  ##* .*.. *.... .*.  .....#. *.\# #.\ . \.#.. .... .\.. ....#.#*.#..##........* . .\. ..#....*.*\ *..* .#....#\..... .  .. \. ..#*#*.#
# .#. #. .... .* #...\..\..\. ..#.#* #...\....... *...  ...*..#*...#....*....#..**.......... .**#..*.\*.. *.. *. .. . .. .*\.# *** #.*.  #. ....  #.*#
#.#..   .**\#..\# ..#.. ...*...*.# ** ..... *#* *.*.. #... #.#\*## ....* ...\.#.\... . .*##..#....\...   .....*..#..** ..#\.#...  * \..#. #  .##.\# ##
#...#.  \.... ...* .*. .. .* .#. ..... .\.*\..*.*\*  ....\.*. ....*. * .# ..... #..*#*.  *##\.\*.\*...\ \... #\.. . ..*..\.\.\ .....#  * .  . .###. \#
#* * .# . ..\\ #.... ..#\......*.***.\\ .....#\ . .... *..#*# . *.  ..*....#. ....#....\. .. .   ......##..# \ *.#  ..*..\ #**....  #.....  ... \# .##
#..  .\ # \.* .*..... .  ....#..\ ..#.#\..... .#.  . . . ...#.# .... . ..#..# .. \.#...# .\* ....*.# ..  .  \#\. # ## #.. .. ..*##..*#\. *. .*... ...#
# .\. ..... \ #...... . #... # ... .#.#..#...  ..\...#..#...#. .#..*.. .#.##..##*.  ...... ..#.   *.#.  ...#..*###...*.###........*....  ..*.. * .. .#
# . ..#\..\. ..#* # ..#. ... *...... .#.... #*... .**.*#*.. .  ##.* ....#..#.#....\.\* ......*....# ..**...*#*.\  ..  ..... ...\.......##... .  . **##
#......\  #...  . ***.#...*. # .. ..*. ..*...#*..\.....\*..  *  *... ....*\ \. .*.. .. # .*.*..*.....#.. .# #..... \ . . .#...##.*.# .....*\.#.....#*#
#. ...**\.. .*....*\.....##.*.... ..#.....  #*...*\..  .***#**. #.* . *. .   ..*\. ...## . *. ..#*...* . #.\# . \..#*. ..*.#.# .. ......* \...# .. *.#
##...*#. ..*..*.*...  . ..# .\.##*. .#.*#.* \.\ #. . .*#...# ..\.* ..#...*.......#..\* .. ..\ .*#*..###......*#... ..*..**.#\... ...*. \.#.*# .. ....#
#..  ..... .*....#..#.#.\.#*\..#.. # * .... * .....................  ......\*..*... .. .......*.*#\.. ..#*\*.##..* .. . ..#..*..*... #\..*..\\.. .   #
#**. ..#.*.....*..#*.. ...#*. .#.*.* #..  #.*\ #...#..\.......  #.*#.# .*....# . . .. **....*...**.... ....*.... \....*..... . *..* ......#.\*\ *  ..#
#. \.#*..#...\....##...* ...#.... .#*.*....*#.*\ . *#.  .. . .#.   #  *....* .#    .. .#.......#.  ..# ...#....#.. ..*..  . .  ...#....... .#.#...\.##
# ... **.\.* . ##.\\. . .... *#. \\ . .#..*.#. . ...*..#* . .. # ...* .. \#....# *. \#*#......\* . ..\. .    #\ .... .#.. ...# .\##.*\. .. *#.. *.#..#
#...  .... .....#.*....#  .. ......\..# *....#..... *....\.*  ...#\ ...... .*  ..#\. .*.# . ... \.... .*.*... *.. ... .*..*...*.. .......* .\. ..*. .#
#* ... ...##*.*. .\.. .... ......*........#   \.....\........ ..* ...#. . .. *#  \.....#..#*\ ....#. #. .......*.... \. ..*.....\#. .#... ..#*. ..#..#
#*.. .. . #.\##........*. ... ........  \  .**  .* #.#.#. \#  .#...  .\.\ ....*.\..  ..*.......*...*.*   ..  #.... ...  ..#  ** .#....* ..... .  \.# #
# #....*... .. .. . *.. ..  .. ...#..#...*\**.\.\... . ..\..\#.*#.##.#. * ..* #.. *... #.. *..##.#\.. ..  .*..*..*.   #.... ....#...... ...\  #.. .# #
#.... ..# .* .. .... .... ** .*.#.*.#..  ##.###..#   * .* .*.\.. ..#  ....\...#*.#.*##..**... ..... . . #..*\.**.*........#.....*.*..* ..#.. \.......#
# .. #..\  ..#*...*..... .. ..# ..#* ... .#.......*.\  ...*....\.#..  ..\#\... ##.*  #.. .\ .. \*....#\  *.. ..*.# \..\#. ..*.#.\..##  # . . ..*..#.##
#. #... ..#.##. ... #...\... ....*.. ..\.*.   \..... ....# *.............  . ....#\ ...\.#. *#..*\#.*\.\....\  \\..#.. . ......#*\ \#. .. .#* . ..#..#
# .  *. ...\.\#.   . ...* \. .  ..*..... ....#.** ..... # ... .*.#..... .*...  \. ... ..... . .. \. .. . \.#.....  *##*. ..\*\.\...... #..\*\...#\.*.#
#\..  .\ . * .*.\..*..  ... * ...\\ *.  ..#.. *.. .. . .... . . ...........\    .. ..  . .#. .\\. .... ..*#...\ ##.#..*.*. *#  .*..*.#*...*....#* .\ #
##.##...... .  ...\. ...*.......  *.  ...\....##. ...#*#.*.........\.... .#* . . #.  ... ...#.. \.\\.*...\ ... .\.#..   .*...**.** * ...#.. . ..*#...#
#.#.* .* \. ..#. # .*.   ..* .......... # .*  .. #.... ......... .....*#...  .  ....\...  .....#... \. . ##.*. ...#..... ....\*.##..*..*#\ .. *.....##
#. *.#*.......* \*.# .. #...*\##* .#** .*#\*...... .##.#\ .#.\ . ..\ ..#..# .** # .#\. ..##.*#. . .\. .\..## .......  .*##.  ........\....#.*..  ....#
#......#. # .. ..... .. *.  ....#...#...\. ....#.\....  #. *# .*..*.  #......*.... .#.#     ###.. ..*... .. # .\ \. . ..  .*... *. #.. ..*.#.....   .#
# .   \.... ....*....... .*#.*. ..*  ...#\#* ** #.#*.\ *.*.. .....*.\  ... .  ... ......#\....\**.#.. \.. ..\.  .. \..  .#.*.#.#..*. .   . . ...* * .#
# .... .#....* .*...#.#.*....*. *#.. ..#* .*.# *#..*.#*..* .#. . .  .##.* . ...*..# .\.\...*... # #...*  ..  ##* ........ .* . ..........*.*. .*.*#..#
#.  .# ..# .** * .......#.# ....*...\ .....*.*...\#\# * ...#..#\..#..#\..  ..*#..# ..#.*...\.##...\#. ....*\*.\......*.#..## # . .. .*...  *...*##. .#
# ...*. .*.. *  .#.\.  *..* ..*.\. *.### . ..\* \..*.... .*.\...*. .  \..   *#.#. # #..#...\.*...# .# #. ...**.. .#..  ...  .....\    ....\  .  .#.. #
#.#. ..# . ..*.# ..*\..\ ....*..*\ .. .....# . #..#\..\\*.#.*.....#\..#\.#..* ** . * *.**.. .\.. * ..*\ *.. .#..\..\ . . . ..*...*..#. ..#..... \. .##
#. .#..#. ..* . ...#......  .   . \.#....#*..#.\.* . . # .. .\ \. .... ..*...*.  ...\ #    .....  ..#.....\ ...\.#\..##. ..\. ..  #*. .. # . .\....\.#
#...... .. #*....\....#.. ... .# *. ...#..  ###.*.# ..  .....#.. .. ..# #*..\. \#**..#* ** \##.*....  ...**## ...#..##..* *..... ..#. .\#. #....\...#L
#*..\.\..\...#. .\ ...*. . ....\*.# ...... \.*#* . ...*.. *# .   .*.#.*.#  . . #..*..#. ..\*..# *.. .....# ..#.*...*..\* . ....\...*....... . #.  ...#
#.**#...............*..\.......#.*#...#..\\.#....#.*...*#.. . .... . ...#.. ..*# ... *\#....  .#*.*.#..*\\... .*\*#\\.#......\.*..#*. .......\. ..  .#
#.......*... ..# ........#..... ..#..*.\..*...*..  *##*. ..*#....*...##.*#...  ..  ##.* \**...*........\# ..#.# \.. ...*...  .. *....****..*#...*.#.##
#*...*.#\... #..\...* . ..*. #\.#....\\ .#..##..*..#*  ...* \. *..\. .*. ...#*...*.# .#.... ...# *. .* \\. ...*. .  ..* ....#*....*..\....\.#. . .  .#
#.*.#.#....**..  ...*  .*#.\. .#  \.. .... ..* ... .\... ...*.*# \........ \#... *...*\#..* \. .... ..*#*#..\..  \#.#** .. \. ..*. *#..##*....\# ...*#
#. ..* ##.*.. #\ .*....  ... #.....\.# ..*\##* .#.  .#...*..\* \\.... .#.#....# \....*\#  ....** ...#   ## ......\# .*.  .  .*....... \.**.# ...*  ..#
#..*...# \.#..\\.\.. .\....#....  \... # .....*. .. .. .. ....  .*.#.......*\ \\   .......##* ..##......# ..  ...#.\ .. * .. ..#.#. .. .. .#.... ...\#
#..  * ..##..#... *. .*...*... *.. \..* .# .  .**.....#\............  ...# .. #.....#.## #. ...... # #.... ..# ... *. .#.... ..*...\. #..*..*## . ...#
#...  \\.. .#* ..  ..**#....*#\  #...*##... *..  ..*..## ##.... . ..##.. ... ....\*. ... ...   \.#.#. .*. ..*..*.  * ..# ..... ...# *.#.. .... ..#.*.#
#..... .*.#.#.. .**.#* ..\.**..*...#*.*..*#\...#*.#... .  *#    *..*.*\..\..... . ....# ..\.*.# * .... *.*#..\. ... ... * ..#. .\...# ..  ...#. .....#
#..#.#... .\.** ... #..  \..*.. \\.# ...*..* .# .... .*.* ....#.....#.....##* .\*...* *#..#..* * *#*. *  ...*.#....#.. .# . ....#...*..* .***....  . #
#... . *\.#.....#...*#  ...   #.  ..# \. ..*....#..... ..... \*...* .. . ..#* ........* ...... .*..* \. ..... .. .. *.. ....#..#..#..#*\*......#....\#
#..\ .. \.  #.  ..  ..** .#  . ...... .....#*..##.......*..#.#.#. .. *.*\..\ .\*.#... # .  .*#... .#.... . .....# .#*.. .###. * #. .#... .**..*.*\.*.#
#. #.\*#. ....*.# ..*.......##...... #.*.. .......# \#..  .\*.\ . #. .... ...* . .#. #.. .\ .  ..*. ...... .* #\.*.  #. ....# ..#*. ....\... ... .*.*#
#.     .  \... ....*.\.*. .*...*#... ..##. .  .##. #.. . .*.**....*.\#.. ...**. ..\ *.*.. \*  .#.....*...#..### .. #.. .#\...##....*..\.  ..#.....*..#
#\...*\....\.. ...#  .\...#..*#...* . ....... ...  *..##.. ..*.....*.*.**. ..**#*....**.. .. .\ ..# ..  .*......... .....\\.#*#*#.\...*.*... ....*...#
##.. ....##*...#...  ... ..  * * .... .#..# ..... *#.*.. . # #.*#.*#......##..#.. .\. ..*.. . . ...# .**..*# .\#*...#.. ..#  ... ..  * *. ..\. .*.. .#
##.\......#   ..#\.*#..... .....*.... ... .# #.#.   .. #*. ..**........\.\*.\**\...##..*..* *.# ... *.* . .** . #..#... .. *.\...#.  .. .#**  #. .#*.#
#.. ....\ .# *..* .*...... ..#.#..\\ .* ..  *. ....* ......*..\ .... .. *   .*.....*. ..**....  *..#.*. . #.*#.*.*...  ......*.  ..*...  .... . ..* .#
#.##\ .**.#...#.*.*...#....\#..*.\#....*...#\... ....\\  \.. ..#..# ......\*.#... ...*.*\..# # . .   .. .......  .#.. ..* ..\. ..# .*  \ * ...*..\..*#
#. .#.*\ ..\.#..*\*.....   . .\ ........ #.#.* ..*.\...*..........\  .. #. ....  ....\ ... #\ #......\..  .. *#.. .#.#..#. .* * ... *..#.  ...\..*## #
#.   .  .#... *.\..#..#. .. \.... ......   #....#*. .. .**.# . .# . ... .... .#....#. #.. .  .  .  .**.* ... ..* #.\ .....*...\ #.  * #\.... ..##. ..#
#**\ #.. .. * .*..\\ . .#    * ...*....... . ..#. #.*.*...........\... ....* *.... .*\. ... ... ...\... #   ##..\\#.*........#. .\....  * .\*. **..*.#
#. ...*.*.. . .# ... .#. .. *#...*. ... ......... ....*. .*.#  ....*.... .#... .\**.......  ......# . .#.*.. ...*\...*.\...\#..##..# *#..#.... . .\\ #
#\.* * #*..  . **.*.#  **#.. ...... ...*# .# ..#*...... ..*.. .*....#..* *.  *...*  .....* .#*.   . ##........ ...*.\.. ....*... .\..*........#* \*#.#
#..*. .. *# ... * *....\ .. ... #. .\ ...*....#...*. .....*...\.. .  # *.*...*#. ...#....... ..  . .\... ..#*....... .   . ..#.  .# *.. . .  * .#* ..#
# .....#. *. .... .*...\. ...... *\.*.*\ .#...... \... .  *.\##..**.#...\.... *..# . ..\.#*. .#*... .#.#........# \ # ....... .. .\\..... . ... ... ##
#... .... ... ..#....  ..\.\... .##.* ....*.....**  ..# .*.. .*.#.  *.#*.... ...*#.##.... ........#.... .##.. ..  .. .\ #*.#..\ ........  . *#... ...#
#.*.... .... . .#*.*..  .#..* .... .. ....# .*..\..*...  \ .. \... ##. ...........#..#..  ..\.. #\.\. ......#*.  *.#. . .\*   ...   ...   # . #* *.. #
#...* ..#.. *\ .*...*. ..*.## . .*.. ..  . ## .....*# .....* ..**.  *.......#. ......  .* *.*....#. .# \.. \.... *#.*.# #*.. #.*.#..**\.* . .#..*##  #
#\ ...... #. ....* *.  ...*..\#....* .\\.....\ ....  # *.# .\* . .... .  ......**\.*\\. *.. .#.\#.* ....... . *..#...*\  .*.....#.*\...##.#..#.\...  #
# .#. .*.. \ #\  . ..#. *....*.. ..... .. . .\.#\.\.#*  *#*... ..*.\...\.*. .. ...* ..  * *#... \... .... .#\.*.*. .....*\.#..\....  # .*........ .  #
#.#...*\.. ...#..#...#.. .*. *   .\.... .....#*.*. ... *.# .* *. \.## .###... *.***.....#*#...* . #. ..## .... *..# * ..##*.\.... .....#.  ..\..... .#
## .\#.\ ..... ... .. .\ ....\.*. .*... *....* . .#.#..*... .. ..\.# *.## . * ..* ...  *...*..#..  ..*..  \....*.. .. ....*.*. . \.*.. ...  ...#.# ..#
#...\.* .. *#..*.. .    #* .\   ..\.#.* . .#\*.#  ....   .##* *.... ...#...\..*..# \#...... .##.#... ...... ..*#...#*...... \\... .... ..\.# #.  .*#.#
#..#.\.**..*#.#....#. ...#. *..#. ..... .... *# ..##  * .\ . *.. .  # *#.. . .#...#...*\#...\*...*.. .   ..\.#.. ...\*#..#. *....# .*. ..  .  .... ..#
#. ...  ........ ... #  .....* .. * . #...... ..*\....*.##........... .. .....##..  ....... #*\*... *... ..\* #. .#.  . *.  .#. . ..\*.* #. **...\*\.#
#. .. * .**..\#*......    ..# . . ... ..* . ...*. ........... .. .....*.*.... ##......** #.. ..#. ##\..\. ..#..*#.......... .#\.. ... *.*#.. . ..... #
#...*..*...#.# .....#. .#*..**.#...   .. ..*... ...* ... .** . .* .... *# . ..#. #.*#.\ ....  #.*...*#..... *.#.*..*\ ..\....*.#*.... .. .*.  . \ . .#
#....*... .#.. ...##*#. .##.  *\ #...*. ..  *...  .... #*.\*.........*.....*.. #. . \##.....# .. .\..* \. .**. * .. .. ..\  ..*....*..#.. .\* * *#...#
#.... #   ..#*.. . #.*  .. . #.....#*...#...*.#. ..*. . ..#... . ...... .....* \..*....#..#.*..# #* *..  .\ ....#...#.*  \.* \*... . .\. .* ...\..# ##
##. .... #.*...#* ..#*. . \#.\\#..*....   # # . .. ..#.#.*...#*...*.......#*. \..*... .... ....\**......*.  ..*..*.. ..*...#*.#..\.... * \.   .. .*  #
##\*..**.....* .* .... .*..#*    \.**##\...*..\  .  *.. #\ #.... *.....\..* .. **.#.... #*. * ..#. .*.#...\.. #. ...## .... .. . * .#* . .. .\....\.*#
#.... .#.* *. .# ... . # \\ ... .  #. #..... ..*. #....#*. ..#..*\........ . . \.#*.. ..# #.*...\..#...#* ..**.#...*#  \.  #.. # . . .#\ . \.\ ..*...#
#*. *... . ..*  .....\.....*. * #     #.   *. . #.. ... ..* ..#... .. .. . * #\. #. . .. *.. . #.  .  \#\ .. ....  **....  ## .. *.*....*. # ...#\   #
#\#.**..*...... .....*.*  ..*..*. #.  #..* #. .#..\*.\\#...\....#.  ....** .\.#. .... .  *.\.\# .#.*..... #.    .......... *#  .\ .#....#..* ..**. ..#
#...... .... ..#..*..... ..#. .\..#\....#... ....*...... ... *..*..........#  . ... .. \ .  ..*..  ** *.#.#. * #  #. ..#..*. .* \ ..*.\#.. . .. #....#
#...#.\..# .#.*. .#..**#...... ..# .... \...... #....... ...#\. ....  ..\* ###*. ...\#\\..\. . .... *\\.*#.\..**..*...........\ .. .#...# .#. *..\.\*#
#.. .#... ##... #.\*.* .  \..##*. . ...*.....#.#. ....*...\. ..\. ..\...*..  . ..... .##......\...\.*....*.\*....\#...* .*.*.**... \.#.. #...*...\.**#
#...* .*.*.. ..  ## ...\..   *..*  ###...#..*..... *  ..* #....#...  .*#*...\*.... ..* #.*#. .\#.*..  .*.*.. \.#.#  \ .  .#.* \.* .. ...\.. **.#. ...#
#...*.#.... \... .  .*. . ....#..*..#..*.... .. *.. .*......#.*..  *#.#\#\*..# ..  .##*#.*.... #.. . .. ..... ... ....#.*...... *..*\   ...... .... .#
#..##\....... ..## ...\*...#....* .. ..... .#...*.  #..#.\...*.*. .....\#...\#\.\......#.*....###. .#*.. ... .*..# \. \.#*..\*.....  . .*. ..     ..\#
# . ..*..  ..*...........*# .....*....... ...\...*..\  .... . ....# ..# .... ..# .*..#..#. . .# * ....\**..*..  ..#..\.........\. .# .#\.#. ....  . .#
#. # ..*# . \*..\*..*  . ... \...#.#....*..*..*....*...  *.**..  ..\\. *.. .#*#. ..*.. ...#.*..*......  . ..#*#... # ..#.*\. .*...... .....*.. .#....#
#..#\... **.\.  #.*#.\ \#*.   .# .##.#....#.  *..  .. ... \ ....*.*#* ... .*# #..#.. . ....... ..... ...*..\. ......**#...\......##...#..*. ..*..#.*##
#\....*.. #...\  .... . ........#\ .*..\.##. ..*#..*. . ......* .\... *.# .#* #.. *. ......#..#......*......*..... ... #....*.   *.#.... #..*.\.*. .*#
##. . #. .\\...# ............\##. .* *.. *#.#.  *. .......#.\ \# .. ....# #\.. ...# *........*# .*..*.*..#..##. * ........ .*#.......#.\ *.*..  .*.\*#
##. ... . . .. ... *....# .**..#...#. . # ..#....*#*  .....* . #.\..... ....# ... #.............**.... ....##\*. *..\. \...#    .#.. ... \ *.... .#*.#
##. .. ... \..# . ...#.......# ...\.**.. . .*. \...#.\#.\.... ... . #....\\#. #*..#. .....#....#.. # .  ##\....*...*\..#  ..*.**....##.\ *.. .... #. #
##.... *.....**.. #\.......... .#*...\#..* .\...\ .. ..##. ...*. .\... ....***.*.# #. \..# .#* .......\\#.. #...#.*#\#.*.*. # ..*# . #.... #.\  .. *.#
#. .  ##..  . ......  \ #........*..# *##*  .. .*. ..... ...##...# \.#.#..#.  ...* .  .\ ... \.*\\ .. ........# **#   *.\... . #. .... ..# ....** .\##
## ##.*....\.#...#...#....*.  .#..* ..** #... ...*#.... * .....*\ ..#.* ..\#*.***#   . #. .  ......*...#..#... .#...#\#\....\*....\*#. .*.\.# *.\#.#.#
# .. . . .  .. ....*.. \.  .#..**  .#..# .. #.#..*..... . *.. #... .#.*  #...#......#. *. ..*\. ....   #..**   \.*....... .*.. ....\. #*\#  . .*.....#
#... .## ..*....#\.......... .*.#.   .\..*. ...**. *....*.#.*... ....\...#..# .\......   .......*... ...#... #.*. \ .#.#. #...#. .#...*. .#.. \ *. .##
#..  #....... . . .....\ *.  . .\. **..#.#*.*. .   .  .\*   . *..\#.**... .... ** ..#..* ....# *.\..#.  ......*.*..*.. ..*......#.... ..#...... .....#
#*..  .... .# ...... . .... ....*#*...*.* .. .#.**...\.. .*.  .. \.#  \ . .. \ ..... .. *\.  #*....... . ..\..  .*. ....# # .*.......  *.#.......\*. #
#. .. ..  .*.. ..*.... ..... ....#\#..#*.*.*  . ...... .. .* .\ #..... \** *..*...\ *... ...  ...*.#\.\.#   ...* ..*.#.. ..... .. .... ... .....\....#
# .. *.  .......*....   ..\ .. *.. .*\ . ...  .#...\#... ......... . . *\\ .... ..#.\.#.. *. #....#.#.  \\\... #.*...\ .  .*..##..##....##\.. ...*...#
#.**\.* ...... ...*. ..# \.\...\\ .#.... #.....#....\..*..... .... *.. .\.*#* *.. .* . *. .#*.... .* . ...*. *......#...*\.*...*.. ...***##  ##..  ..#
#.. .\..*....#. *...*.\ #  .. .#... ..... ..#  ..#  ... *..\...* ** * #..#..\#.  * *.... \#....*.*# ..##. . .   *.\.#**.\\.#....# *#**.... .#*. ...* #
#....\..* *.. . \\.#.....*R ##....... .#..\#... . ..#..#*.. ..\.#...#\#..#..#....#... .. # . ..\ .....*..\ .....*... ... ....\...\..* ..*.....**.. # #
#. ...\ .. .*#.*..*.. *.*...\.........*...#.. #..*.*. .\.\  .. #.. ..... .. #*.......\ .\. ...  ##\.\. .#\*#..#.*....#*. *#..  .. ... ... \. \...*  *#
##.#.*.##.*.. *...*.#..\...#*..... . . ......* ........ #*......#.  .*..\#. .#...*.....*.* ..*.*..\ . .. #. #..#..#..... .... .....*#..\ ... ...*.. *#
#....*.\  .*....*..#....*.* *.*#.# ..## . .. . ..*.........*..  .*\\.... ..*.*.#. . .\.    .* . ....\\ .*.*.... .#. . *....#  * .**. #\ ...*.. ..#...#
#..*........* ..**\... ........ .*. * *#.#  # .#.. *.   ...... ...#\ * ..\ . *...\..#..#.. ..*#.#... . #... **...  ... . *.*. .  ... ....  .#\ .# ...#
#*\ . .. *.. ..*.*..\..*..#. ..*#..* \ . \*.# . .....# #.. ...#...#. *.**.....* .....#.  . .#...  # . ..\#.. ..... .#* . .* .  #.... ...*... ..#*#\..#
# #.#... \\# .*.. ....*#....... ...*.#..# *... \  ..*.\.\... ..#.#...... #. ..##.. ## ..#. .#.\.. ..* .*\... ... *  . *#....#. ## *..*. ## ....#*..#.#
# .* .#.##.. .\....*  .. .#  \..\ ###............*#...* . ....\..\......... ..*.. ...... #.. . ...  ... ....#\.    *. .\.*. ...#...  ....#.#**.. . ..#
# ...\ \\.. . \.....#.\. #... \#... #...#...**... .. ...* . ..  * . ..... #. **...* . * . .\.. .**...*. * \.#* . .. ..*.# \ .  #.....#..#*# #*...\..##
#  ......*#...#..#*..\..*.\.**...#\*....#. #..#.......*.*\. .... ..#*# \ ...... \..*#.. * ....*#.\*#..\*..*. ....*...  .. #.  .. .....*.. ..*\...#*..#
#\\.... . #*. #....*..\#..\# .. . # .....   .#.* .....*.#  *.. . .. \........ ...#. .# .*.\.### .. ..*..\\..  ..... ...**#.*  ... .\ *.#..\.#...  ...#
#..#.# . ...#..*....\.... #.  ##...#... .* ..  ........\#......*..\.. *... * ..\*##..* *..\....*.....  *. .......#.. \\ . .*......*.#.... .  # .\.*..#
##.\. .# .. ...\.  . . ..*. ...* ... .......*  #. .#*.# ..  \*..* .. ....# .\#..#..\\   #.  .*   ...*.\\. .  ...... .. . *. *.....*..#.*.*. .# ... . #
#  ...#..... #.# .......... ..*..* *...*..#.. .... \... ..  . # #..##. *.*. ..  #.....\ # \. #.*. * ... *...* # .  \*.#\* .*..* .  *. .#...**. *.  # #
# #..#...#. .... .  ...#*.\#..#* **. *. ...#.#.  ...*...*  *.....*. .\.  ....\..... ....\.....#*#...\\. ..\.....  . .# . *  *.\**... ... ....\.. .. .#
# ..\.... . *.*#.# ...  *...*.#.. #. ..* ... .\.. .....** #* .. * ..   ... *. .**......#**.**.#.#...# ...... .*. .*  .#*. .#  # *. ..\. .#.\..#\*....#
#*. . #.....\*. *.#*...# .*..#..\ ....# #.....\.#...\.# *.....\ ..  ...* *.. .* ..*#..#.... ..\..  #........... \*.#... \ .* . . ....*...# .\# .*.#..#
#... . #. ... . .*. ..# .. #...*...*#. #... #.*.\* # *.. .. *.*#. .. *.. . .....*. . ..*#\*#... *..*. . . .#. ....*.   ...# ...#...  . .\....* .#. . #
# *\.\... * #..##*.... .\.. ....... .. .\\..  \ #\\...... ...#. .* ... ... *...#.  .*......**.#..... # *...\..#.  .. . * .#.#....#\...# .# ........ .#
#. .# .... .#.*.\*.... .*..... *......  .##...*......\.*.. \ .#....#  . ...  . ... #...*..*\ .....*  . *\...\.......**\..# ...  .#.. ....*..#.*\\ #..#
#.. #. . *#\ *. .#......  * ..  **.. #... ... ...# #  ..\*.*.*.........# *...#*..  ..... \. *. # .*...*.#*... .....\.  ... .. #.#...#....*  . ##. ..##
######################################################################################################################################################