############################################################L#########################################################################################
# .#..#..*.\.\. .* . .*.. . .*.\. #.*\* *.#...*#.. ...#..\\..**#..  .\..*.. .**.  \.. .....#   ..#.... # ....#.\#.#*.\. ..\ .#. .... #... ..\..  .*..#
#.*...\ ..\.* .# ......## ..\......#.. ....*.#\. ..*..... ....... ..\ .#\..* .. ***..## ...*.. ...####...\.......   #..## ..#.* . ...#..*...##.   . .#
#.. *.. *.#.  # #. *..#..  *... .. . . * **.*... ...** ..#..*...*. ..*. .* .#.  .### .\..*#*....... . *. .  ....# ....**........ ..*. .#..*.. .  .\ ##
#.#.. ....*..\.# ...*...   .*   \...... ..#.... \#\*.#*..*. ....*.* .....# ....# #..\.... # ..... *. .....   ..\  .##. ....*. . .\..   ...*..#...###.#
#. #...##..*.. .... #.\\#........*.#.. ...* .. \* #\  *.#.#..  .  .. ... #.*.. . . .......#..\   ##\.. *# .#.  .  \.....*.  ...  *.... . .........\# #
#.*#.\.**....*. *..\.#.. ..#\..  *. #..*.##......*... . #* # ..*.... .. .\*.* #**.......  ....... \... #.. . .*. *.. #..# ...# ... .. #. #...*.\..##*#
##..  ## .. ..*#.... .\.#....... .*\..#.#.*#.... ...##..... *.*........... .*. ..#.\. \...*...#*.. ....\ ..... . *...... ..*.. ... . ... ...*.  .*\..#
##.#. .... .. ..*\...#** .. .. *\. #*...*.........\*.. .\.... *...# .\. .... *..#.. .....*.*\..#.  ..#..  ...\ #*. . .. ..* .....###*...... #.##... .#
#*.\...# .*# .#.#..*..*  .*.*   . ...  .  ..*#. #........\\# . .. * .......*# *....#  . .\.*..** ..# . .#*#..... ...#..#....  ..**...#. **##\.*. .. *#
#  .#.*...# ....#.#....... . * .. #.  ......#. .# .... .   \.#*\ ..#. ##.# ...#.*#..*.*..#.#.#.#......\\.... .* .*\.....*... .#.. .*  . ...\.. ..    #
#..  \..#... .. .*  ...#..#.\#*.   .*.*..*....**\#   . ....#.\  ..#.  .#.... .*...#. .. .#.\..* .#... ..  \.. \*... #..\.*.. ...***......#*..*. ...#.#
#*...... #. ...**.  .... . .... ...*......*\*** . ..* \.# .. ...#....*#.*... .   . * ... . ..*#..  . ..# ** ..*...... .. . *#..#\. . . ** . ...#...#.#
#*.#*.. ## .*.. .....*#..*... ...   *..#.  ...  ..##*.....  . . .#*..*.. #*..*# . ........ #*..*.. .#*..###...*.. ..  ... ...\ ..*.\.. . ...*  *.*  .#
#...* # ...**.#..\.. ......*  ... .#   \#  *#.#.... ........ ..... .... .#*.*. ..  . \ ..*.....*..**.. ....##. ... * \.. # .... ....*... .   .....#.*#
#..* *\ *  #.  #  . ....*..* .     .#*  #........*...#..\ ... \..*..#..*.*\.  *. ..#*....* ....*..#* ......\..... . #....##.#*..#*..\..*.\. ...\ ....#
#..  #...*#.   .. .............. .\.*.\# ...... ...... ..\.....#.....*..   .#  ...... .... ..*....*.. . .\..**. ..#\ ...* .. #...... ..#.\..##.#....\#
#  ..*.#**.#*..*..*#...... #.#\ ** . # *...* .* .. .#..##\. \. ..#.. .*... .. ..# #. .*.#*. .....\*..  . #. * .   ..#.   ...  .  #.. ...*. ....#.. . #
#.#. ....\. .... * ..*.**. ..\.  ..**. .. ... #\.....\*# .*..#...#..#*.. .... .. \.\ #. # ...* ...*.....* #..*   .##.......* ..#.*\#.\#* .*    . *. \#
# *.....#.*.*.. ...**. .. *\*...\. ..... ...#..... *.. .*...*    . .#.... .#* .#....\...* .#..... \...*\ .. .... .  .\...*\ .......\.... * ...#...#.\#
#...*..#. ......\....* . ..\#.#*... . ..... ##..#..............\\...\\  .* . ...#.....*..\.#....*\.... *......*.......**... ##.\.  \  #...# .... ....#
#. ...*# ..*..#\...* # .*.....   ...# .*...#...\..* ....*.  .## .... .. ..#.  .  #. ..# ... ...#.  .. #......#. ..#. ...*.\. .#. . ... *#.... . \....#
#..\\\# .. *....*.# \.........#..... #..\#. *\.\. *.#*.*#..... *#. .. ... ... .. ...#..*  #.\.#\... #. .. .*..*.\.  .*.*. .\...# ..*.\.#..#*\... ... #
#... .# . .....*. ..* .* \.#. ..*\*\*.*#  . . *.##\..\...\.### . ..# *.....\...\ ..*..#.*...  .*.  *.. . #..*. ...*  ....\... .... .# ...# #.  ...##*#
#..  .......#..##.....\.....\....#.*#  ......  .... .*.. .*#*..*. . .\  * .*#..  * .... ....\.\#*...  .. . ....  . ..... .#  ..#*..  .......**. #.. .#
#.. #... *   .#..   ...# .*  .. . .. *... .#... . *\..* . .*#.....##*..*..*.# .. .  #  ..#*....... ...*..#.#.#... #.. *.#. # ....#.# ..  \.....#*.#\##
#*..* .\.. ..... ....\.\.....*#**...  ..\....#...*....  ... #.. . .. * #.##.#*..#.....*..*... .\.#  ##* ...*..... .\*.##* .#*.\.*.*..#...*..... ...\ #
#  ...*....... # ..   .# ... .....\# .\#* ..\ . .*... .. .* ...\# . ......#.  #.##.*.#  \..#. .... . .* ..* #\...*#*.*...#..\. *......#....#*.. . .#.#
# . ............* *.#........\\...  * #.. #\.\..#. #\... .*... . .......*.*..\\......   .\.*.* . # ...##...*... .#*\#..# ....*.   .*. # ...  .......##
# ..... .*.. ... .*.....  ......*\*#.....#*.. . *...#.#*##*..# #. .*.........#.**.### ... ..*. .....*   ......*.. *. *# ...#.*....*   \. .#....#.#.. #
#.*.... ..**.#......***..#..\#*..#....*.*... ..*.#...*........  *...... * . .   .#...\\..  .#.. ..\#. .. ..\.. *.*.   .  . #.*.....#...# ##.... *# ..#
# ....**  #.*.#..  .....*.\.*\.\\. **..*#.  .# . . ... .#. *.#..  \*. .#.. *.. * .  ..*  *\ . *.#..*..... #.#*.. ...## #*.#.\.........** ..... ..... #
#..#.  ...#..#.\## #..#.. ..... \.. . *** ....#.\#..*..  #*......\... .. \.\ ....* . #..#. #.....##.# ..##. . ..*..... .#*.# \..  .* . .#..*#.\# **  #
#. **.*.*#...  .#..*..\  *. .#. #.. ...\..#  ... *# . *....  \.#.......*.# . ... * . .. ..\. .  .. ....\...... .. *.\ . . ....*..#.*#.  *.... *......#
#\..#..\#*.. .*. .. .....*.#. .. .. ....... #.\...\....#. #.#  *\#...# **  .#.\  * . #*# ..*..#.** ..  . . #.. ...#..  .#.  .** *#.#* .##. .##.. \..##
#...#.#.##.**...   *. *. .#\.* ..    .....#...*.*.. .*..##.........#  *.. . .*  ..#.*.. ....  *....\........ ...#* .....  ......*... .*.\. .\...**.\.#
##.#.\.. *\*....*#.*... . \ \... . .  . *.. . .*.....  .. ....... *....# #..  . ..  #.. # .\..#\# ...\*..*. .*. .  ** #.## \....\ # ..##...\. .. .#.\#
#* #* . . #. #.\. ..... \..##.... ..  ..#.#*. .#..*.... *#...***\. .  .\.. **...*...#*..\#. ... ..... ........#. .*..#. .... .#  .. . .\.#. * ......##
#.*.\*. ... #* ...  *...\ .  *..... ..*#*... *...*.. \. .. .. *. .. \..*...#. .......# . .*\....#..  \. ...#.  . .*.*.#*. ..\. . ..* *.....*\.. .##. #
#* ...#..## . .\ .. .....    .\ #* .#.*\..  .\.##. .#.\\..*..*. .. #. #... ..* .....\......\\.#  #.\ .*..\  *. .*    ..........##.. . *..#...#..#\...#
#.......\.. #**\# #.....\......\.. .......... .#.....\..*......*..   .....  *\.....*# #*#  .\#*#.. ..#... .\ ...#... ...*...# .*.. .**.*.*\..#.\.#...#
#*.   *... ..\.#.#*.# . *..#...\. .#   ##.*....     ....... * .... .* .**.#  \\ * . .*.*#.#. .\ #.*.*.   .#* *..#**.. .  ..*.......\.....*\.*  *.#..*#
#.. ....*....*.... ...  *..... ...#.....*# .*..  .. \ *..*..*.. .*.... .........**.....#.....*#..*\    .........#.. .   ... ....*....*.\..#..  .\#...#
#...\* ....\ .#.  ...  ...**.. ..#. #. * .#    ...*...#.#. .*.... .#... \.*. *..*#.\. *..#. #.....#*... ..  .* .#..*\..\.....#.. ..#..\ .....##.# ..##
# ...... .*.\.. # #*#.\ ...#. .*.... . . #. * .#. \...#.##.*\*#*#. *.**..* ...*.......\*........... #. .. .. ..  #..##\ ..#..#*..\.**.*.*.#... . #.* #
#\...  . .##.*.....  .... .....\ \\...  .#..  ..#. .... .# ... # ..* .#\ ..*.. ...*.##   .\..\. .*... .... *..#..##*  .. \*.....  \*..#...#.*#\....\##
# ##..* ..*\.#*..#. .....* .... .*\ .. ..\#.. ...* .#*#.......* .*.. .*.*.*  ..## #...* .*..... ......#.\. .#...* .. ..\.#.# ... .\.*  .....# ... .#.#
#  #......**.\. #.\#... .. ... . . .#..#... ..\ \...*....#. .. .   ...#.#... . .*..* *..  \. ..\...#** .#..   .........*#* ...\...#  .   *# ..#.* .. #
##...\ .*  ...## \.. # . ... .     .#.* .#.. . **.\.#... ..... ##* .\..* ...**..#.#. *.*.#..\#.#....\*....**. .. .....\. *. .\. #.#.... ..... .# #*..#
#.\\#.  .... ......#*....*#..*..\.*..\  .#...# .#. #..... \. . .*.* .. .# ..*.*..#.. .. \.#.* ... .*##.. ..##. .......... ..  ... .*..*.#..#.\ .#.. .#
#... ..*..\.. .#*.\.\.* ..#* ..\... ..#*.#  *..\. *. .\#.*.....** .#.* \....#. ... ... #\ .. ... .. #  ..* .. *#. .. . # # #* .*... ..   .  .. * ##..#
#...  .# *.. .  *\..  .*\.. .#\ .*\# . ....*.. . *.......\* .....# .#.....   . .*#.....  #.*.. .# \ *.\. ..* ... .*.#.*...#.....\##.  .*.##.#.*.*#.#.#
#..* . ..... \ #...* . ....*....#.#. .*. .. .#..*..*.. . ...   ....#\......*.\*. ..\ .. #..  \.. .#*..*R..#.# ..  . ..#*\\.#*..  .#..... .\ ..\ .. .##
#.*.. . *.. # .*.....**..... *#...\...... ..*....*. .#   ..\ #*...*. ...*. \.. .#  . .\... # . . \.*#.....*.# .....\..# ...\.#  .*.. ......*...\ . #.#
#.\....* ....*. ....  #. #......... #\ .#.\ .. *..*.*#.*\...* \ .\ .......*... #..... \.* \\. ..*\\...  ....\##\ *... ...   .#...  ##.#   ......#*...#
#..#..#.#.## \*. ... #* ... ... . .#.. .. ... ..\ *. ..*.  .. ...*......** *  #*... ..# *#..*\......  *. ..*.* *.#.#. \ ##\.........\#...* ...\...#.*#
#.. .*...*.  . .* \  *.*.... ...# *.#..*...*.\...**.. ..*.\.. ... #... .\.  # . #.....#.... ..*..#. ##.*.\ .. ...\. ..#..... ..... . * .....#.  ..#..#
#*\....\ *.. *.*.. . .......\.... .. ......*.\......*\...*#...*. .. *   .#...\ # # *.*. ...... . ...###. ..**..  .\#..... ...  . ...... ..*.... .*..*#
##. # .**......  ..* ..   \**\. . .  ... .#..... .....*..\\  ......#...* ......*.*.... . . ...# ..# \ ...\..   ..\.. ..........*#\ # .#.\#.#.#  ....*#
# .. . ...........*.\... .*........  . .... ..*.*#*. .**..* . \ .... ...*.. ... ##. ...\*..  .#. *. ...#.. .. . #\ .#..* **...... ........* . .. ....#
#..\.*..\.\.*.  .* ..#\..***....... .#.# .  . \.\...\  ..\...\ .   .. .  .. .##. . .*...*. .. . .*#.. #.. . \.......* .\...\..#.#.. .....  #. .## ...#
##. ..**..*.. ........* ..... #..\\.* .  *..*..... **....#...*.\ .#.#.*. *..**. **\*  .*. #\# . *.*##...*. ....\..... #... ..#.  *..**... # \ \ **...#
# \.#* ...\*..... .\.... \ ......  \.*#. .#.....\  . .. \... ... ...\.\.. \. .*.. . ...# ...#.*...#  .# .\.#. ....  ... .#..*#...\*.*....* #.#..   #*#
#*.#. *.*\..   #  #. # *. ... ....#... .. .*# \.....\........... **.  *#  *#... .\. ... ..*.##  ..#\.#  #....... ..\ .##*....\ *#.\......**#... *... #
#. .....#... # ...#.  ... ...#.*. ..*#.. ......*..  .. \...#*\#\.. #.#....*... #*. ..* ##...#.. #*.* . . ...\. # ....\ **#.. .*#... .\.  . #.#. #. . #
#....#.#.  .....*... ..#.*.#.*. ...*....*#....\.*  ....  .\ #*. **.. #.. . .*#.\*.#..... *  * ..... .. .#..*\ . #\ ...# ..*.#.. .*.#....# ..\ #... *.#
#...# .\...# .....*\  .\....#*.\..#....\\ . . ......\  . ....\...*..\.**..*.*# # ...... ..... ...##* #  ..#..\...\.. . # .*\.\.... ....   ....#..  ..#
#.... ....#\...#* \ *\\#..* # \#. .#*.#...**. .... \.\. . *..#.... ....*. ....#...* ..*#.#.* .\#.\*\.*.... \.**.#....   . .... \ #..#....   .......\\#
#. # \.   .\..\.. ....   ##.... #.....##..* ....#.*\.# #.*.....  .**.... .# *\. .  .*##*#.\**. .. ... ....#..*... .#...#.\.\#.*...##*...*....  ..*...#
#\.*.*. *.....\.* ..**. . #..*.**..##..... .   .*  ...*.#.*\..* # ..#. .*..\\... .. .... \.*\#.\#  ..  .  .. .# ..*...#. .. ....* \\ #.\.. .  .##.#.*#
# .\ .. .\..#*...*.*...  . .\*.*  ..  .#.  * ...*......#... *#.....\... .  ...#.#.*.*\\ \ .. * ...#..\*..#.... *.*..*.*.*.#* *. ....\.#**..*..*. .#..#
#. #  .....\... #...\.....*\.. . #*.. #.. .. * . .#.**. #...... .  #..... #..  .#....#.*.\#. .#. . .#..\.. .* #.*.#  #...* . ..#..#. #....  #\. *... #
#.. .\. .#*.. ...#.. ...  #.#.#\. ....#  .... # .   .  ..*.*.. ..\.. .*.....*...\..##.... ..\.....**.*..## .  \\...*.\.#\ ..#*....... ...* ... *.... #
#....*..##.....#\.#\#*...# ...*#***... *.\\....#...#....*. .*.  . *.\\ \\\#.... .. .#.# #. ...#\* ..\. .\.**.   .*...*... *\#...#*...  .... * . .. .*#
# #. .. .....\ ..#...  . ......*..... .. # .*#....\.\.*\  *....\\ ....  ....* .##.. ##....... ...... .#\...  .....*... \.  #* .#. . ..... ...*.... . #
#.#  *.*.##... .\*.   #.  .....  .\.... .\.. *.........#.\#.#... .   *...  .   * .\.*...#... .*#.. *#   ... .*.#. ...#. .  .. #*  #... .... .\ .*..#\#
#....#..#.... ........#*.# #. ...# .\. . . *  .*... #.. \*#... .. .. #..... ....* .#..*.. .* \.. #. *\#. ..... #.....##*\...  ..# ..... *. .. ...*...#
#..#.*.. # ..#....#.. ..\.. ....... . .... \. ..#. .\#. ..  .# .#..  ..\.....  #*.. .... .*......#.#*# . ...#. . ..*. \...\.# ...... ..  . .# ..# ...#
#.*...... *.*#..#.\#*......   .*. \\ .#*. ..... * .#..... .\..........**\.\#. .*##.. *#... *. . ..*\* ....###.*..... # . ...........\. *\#...*. \..**#
# .....#.\ .   ....  .#\. .#  ..#...*\.. .*#..* .#\..* .*\. . ...\.*#..\##\  ....... .#. #..\..\#*.. .#.*.# ........*. .*..#  #*.##.#...  ** ... *\..#
#* . #.#\ ..# ##  .#   #... \.  .#...*..*#.* . . .#....  #.... * . *.... \..  ........ *\... **... .. ..#  ..#.#...... ..#.#.. .... .. .....#.## ....#
#.*.\ .....# .... #   ..## *   . #* # .* ..... .. .## ..\.. *\..#* ..*... .*... .....*....# . ..*..*# . \\.*.#*..*.... \. *.#.#\*.#.\.*. **\.**.* *. #
#.. .#.  ..#. .. ....  *..#. .\  ..  #.#.....#.. .#..  ...  .\. .   .  . #. .. # .\#.# .*.#..... .......  * . *# #.. . #...*.*.  \#* *# *.#.*.#.#.*. #
#...\...\ *.* . #\ .*.. ... .... #. . # *. .#.#...\..*.....  .*. .. .#. .#.... ....  ......  #.. .\  .  ..... ...*.*..*\...  *. . #.. # #. .*.  *..  #
##.*.\ .*. \...#...*. .. ..# ..**\.........  ..*#. ...#....   ... .....# .......* ..*..#.#* ..  . . *\ .*...  ....#*\ #. ....... ..... #. .  .#.##..\#
#*.#\..  *.#*.*.. .#....* .#  #..  .\....##*..\*#..... .............##..#.. #** .. #...#.. ...*\ ...........*. . .*#..#..#*...#. . .*..  ..*.\#... *\#
#.#.. .* .. .....**.....*... . *\. #......#* .#.....*...#...  .. ..#.*#... #*. .. .. ...*  *. ........ ..#*\. ..*#.\. .**.... .....*\*...*\.......* .#
# .... #. .* #.##*.*..*#.. ..... .***..*. .. \.. ... ... *\\##...\.... ..*. *.... *  .#..#..*. .. ....#    . #\ ... * .\....#*. .. ..\..#..    ..*..##
# .*.*.. * .#.. * .#..**. .*.*. .##. .... \.. *# * \.*. ..  *..#..\.#*. **....   ...  ...\...* **\...*.. ...*.#.. *...#.. .*.* ..*..#  *##.....#.  ..#
#... *.. *..*.*...#  .#.#. .......   # .... #.*.* #.# .* .   \...........##*. ... #.... *.. .## ..# *#..*..*....*....\.. ... . .. . ..#.\....*. .# \.#
#...  .#**. ... #..... . ....#. # ..\# .\.\....#...\#.. .*.#. *. . ...*.**.## .  #   . *. .... . . ....#* .. .. ......#..*..  ...#   . * ..* ... . ..#
#*.#... #.#.. .....#\ . ..#.* ..* .#.#***...*.......*.. ...#... .*. \...  ...  #* .#..\*.* .#.  .#*. *...# . ....*.....#\ ...*.....* . .... \#* .*..##
#.. . .  *...*.*.\ **..#* ..#*\.#. . .#. # ...  .  ...  . .*#.#.*. .....#... ..  .**..\.#*...#.## ..#. ** *..#.#*#..... ..  \*...*.*.\ ...*..  *. *..#
#\*....*...*.\...# .. ....  ..  #. #\ .  *..* . * .#.*.. ... ..* . ..\.***. . #. ...... # ..#\.\ .....#*...##. .**.*.   .\\.*..*#. .*#..*.\.*#..*.# .#
#\#.\ #*.*.# .....*. .. . .*.......  *. .....* .  .. .. . *...* *... ..\.*.. ...*.* .#.\..... \* ** ..  \## *.\.#.. *.. #.**. #  *. .......\...**\*..#
# . ...#..#*..#... . \........ ..   #.. . .\#.\..*  ..#....*.\**.**   . .#..  ..*.*.* \*.... ..##.\.#..\. . *..*. *.*... \#.. .  .##...#*.........\..#
#....  . .. *... ..#....*.... .\ # .. .# #....\#....... ..*..#* .*.#\*.#*\.\.*..#........... \.#*..#.* .. ........# ...\..  .**...#.....#.#\. .*.\...#
#. #.... #...*.*.**..*. . .*.* #   . ..#.. ....* *...  ....#.\.\.\......\*.... ... .... ###**.... *.. .*. *......#*.#. .... . .#. #   ..#..* ... . ..#
# .#....*...\.....   .  ...*.....*.#.. ....... **  * . . .. ..**.* .\.\## .#.## . .. .# .*...\.* #\\......#. .... .* . ..*\...#.... ...*. #... .* ...#
#.\........*...#.*. ....  \.# .... . ....*. . .... ...**. .. ...#.... ...\.....\...\.  .*..*#. ##.....##... . ...\#*#.#....  *  .#. . \#.. .. ....#  #
#.\ ..... .... .     . .* #. *..*#  .#........... ..  .... ....*. ....** * #.##.#.... ..  #.. .. \.\ .#. .*.. . ..........\ ....#.... *.#*..... .....#
#...  #....*.\...* ..\* *\.. .*.*...........#.......##....*.*..   #...#.. ...  ... ...\..* #.**.*\\.. \ ...\.*.#.* .#\ .... ..** ##..#..#  .# ...*...#
#.. .#.... ...... *..*. ... \...\.*... .... ...#*.....*  .\* ... .  ...# .#...#.**. ...  .#\..#. .. ..*..... . .   .  ..#...* ....#..*....*.\.*... * #
#...... #*... ...*... .....# *.. .*..* .##.\. #. .#..... .. . \ ........ ..#..#*.*.*...   ...#...# ##*.##..##.*.#.. #... ...#. . ..... #.###...... *.#
#.....*.# \  . ....\. .. .##.  .\#.#. ..* #..##* *\... .......... ...*...#...  ....*..#\#....*..#..  ...**.. ..*#.#.** .\*.....#.#. \. .# #.# ...\..##
#.......  ..#.#*.*.. *.... \..*. .. \..#.# ** .. #... ..*.# **\ ..#.#......*.\.*\*...#.# .#.....#.......#.......  .# #..*....*...#.\#.#.*.... *. .*#.#
# .  ..... .. .*.......\..*.  .. .#..... ..  ..# ....* ........#   *... . .\... .  .*\......# .....* ..  .\.. .*\.\#. *. . *.#.. * #.... #. ..#. ....#
##.#*. ..*..#.. #. .. . .. .#.   ......*#.....*#..\ ......\#.#  .......  .... ...... .     ....#. .. .***\..*#* \...*........\.#   .#..........* \#..#
#....... * .. .......*.   .\....  . .#... ... \ . \ .  ...*..*.#\...**\##...\ ... #.... ...\.***..**.. ... *...  *... .# .  #.* .#...#.*.. .\..... #.#
## ..#..#..   \  . .. .## .....#. .. ..* \. *....#.*.#*#...  *.#.\.... ... . .*.... .##.*... .. .#....*.\.  \.*.\ . .*  ...#.\....*.. . ....*#....* .#
#.\... **...##*..*... . *\ ...*.  . *. \....*.#...*.\\*...*...#.\*..# .***...... *\.\.#.*\..#..* ...\.#...#.# .#..*.#\...#*#. .#. *........#.. ..#..*#
#..\#.  ..  #.*\*. .#.\. #  *..#..\...#. .....#.*##.....#.#\ ... ...*.*.*......* #  .. ....##\*....\..**... .#..#.....\..... * .*.. ....\#..*#..*.*..#
#.. . *... .. \#..#..*...###.\  .##.. . .. *\.## \. ..  ...# . . # \ ** *.*...  ..#.*...*#* #*.......  #... .*. .... ...#..*..\# ... *\.  #....##.* .#
#.....#. *..#.*.. *.... \#*# .**#.*# *. .*... .. .**...#.#.    .. . . *.# . ....... ........\..... .# .....#..#*.# . .........*.. .... .........#..\.#
#.. ...... \.#\..\.*.# ...  . #\. ... \\  #*.\.... ..**. ..#... *.\.\#..  \#..... #    * \.*.. ..\ ...#.*##. \##  ..* ..#...*..  ..#...# .. .... ...##
#.. . ... .    .. ..... *. . ...   . ***...*..*.# .*....#.. .#*..#.##...#* .... #* *.*.* \. ..  ...#. .... . ...*\..... ...\...#...  .....*##\....*..#
#..\..... .\.....**#.. . . * .  ...........  .. .  .# ..#...*.*#.\.... .\ ..*..# ........ . * .. ...\...*..#\# .....\... ..#. \.*.\  .*#.....\.... ..#
##.* ..*\.*. * .. *....* . ... *...  .. \ \...\...* \.......... ..*... \.\**.\ .###..  .*..#.# ..## *.  .**..*\.. .**.*..*#\ .... .. ....#. .*.#*. ..#
#.*##.. ... .*# #. ..#\. . ##  . ... #... .....#\ .... .... .. \\ . ....*.   ....\#.....**.**....*..  *. ...* ......# **... .* \*... . #.... .*..   .#
# \....* #.\. ..# .#.... #....**  .#* ...*..  . .#..# #..*...* .\ .*..  .. ##*.\...*.*.*\  *\\. .. .  ..\ . ..........***.*..*..#.*.. ..#*. .....#. .#
#..#.# .. ..*..#.... *.# ...# .*..*.# *.  ..\####.*#..*.#. \## #*... .. .... . . ..##.\ ... ....#.....  . ...  .##.#.. ..  ....# . . \#..*. .   ..  .#
#\ *. ..  . # .  .... #.# ..* #.......#.*...*..* *\ ......#.. * .#....... ....#....*....  .#.. \..*......\ .....#.#*..\. ...*..*...........#  ** ....#
#**..#. .\..# ..... . .  ...* . ....# ......*..... ... .....# ..**#..... *...*#.. *.#.*...   . ..#.#. .. ...#... #\...#. ..\\.*#\... ..* ..... * ..#*#
##.*..*.*##  . . ....#.. ... .....*. . .*....  ..*...#.\*#. ... ..*. \. #** #...*..... .. \... *..*.*#..  .#.*.#..   ..*##..... .  ..  *#** #. .#.\..#
#. .... .  \# .#...#.......... *. . .....\.. \ *.*  .*.#\ .  .#.. ...*. .*#.  . . ...#   .\.#...#*.* .*...\...\....    ..................*.....*. ...#
#  #.#... .\... * # ....  *.. .....\. .*\ ..# * #...... .\# .#. .*.*.   *. #.. .. ..... . ##*...  #.*.... *#...\....* #   .. *** ...#.....*.  #  ....#
###.* #*\#.........\#....\. .... *\. .... . .  .\... . ..*... . \ . ..*##. . *.. ..**.. * *..#.. ...** . ...*.. . .....#.\.....\\##.  ....\#..*...\*.#
#.#**.*......#  *..#.#*... .# .. .. * .......... .*. . ...* .....#**. ..  ...*. *.*...#.*. ..    *... #.*. .*.....##. . .\.**..... ...*# ...*.*..  ..#
# . ... *  *......*....\..... ... .**#.... .**.   .... .. ..# ...# ...*..\*# ..#..*#*#......*..*..  ..  ..........   * . . .\.\\ *.#*... .... ..* . .#
#.... . . \.*...#.#*.... . #*#\ #*. # ..**.# .*.. . ...*..\#....#...#*. *.** # .....#\.. .  ..*....#.. .\.  .. .*. ..\#*.#**. ..... *... *.#**.... # #
# .\.... .\ ....##   .*. . .. .**#. ..# **.* ...#...\ .##\ ..# \*...*.....#.#.  \.*..#...... .* ..*.**..#......\ *. .  ..#...\ ....* .**..*.. #. ....#
#.. .... . .*.*.#..*..#.\.. ....#..... .#. . ...*.  *... #..... *#. . ... ...*#*.#\.#.\.. ..*#.\\.\... ... . #  . .... .*. ..#....   .\..#.....*...*.#
#.... ..  \...... ..\ *.....  .  .#.. ...   #*...* .\.#..* .*\..... *..\...*. .. .. ....#\.....\ .#..\  # # . #\.. . . *.. ....\..* ..\** *... . ..*##
###..#. .*.. *..\*.. .. . ..... #..#. . ....#..*# ..... ....* ...  ...*\....... \#. .#........#.. #... ..\## ...  .#.\.....  .  ...*.\......* *.#. #.#
#. \#.*. ..\\ ...#  . *........#*.. .*#.\##*.\..*. #. **.....*.. .  ......#*... \...*\.. . ... .#..*.# **.. #.. #   ..#. ...... ...#  ........\.\. #.#
# .#.. .*...# ... #.....#. .*..... #........... .... ...  .#*#*.#.....*## . . .\ \#....*..# .#...*. ...#..#.\* \.... .. *........#.... .**...** . ..*#
# ...#   . #.#.*\..#..#. ......... ...*    .\\.. ..###.   ..*#.. #........ . ..  . .. ... . .# ....*.......\**........*## ..#.. .##   #...##.*  ..*..#
#. ..*\*. ...*\.. *. \..#.#..\ .#* .\. *#... \... .....*.# ...* ..#**......#* ..#*... \.\...#. ... .*#. ..   \..  ..*... .....**.....##.# #  ........#
#.*\#.\# \..*......*....   *...#*...\\#. *.. \#.*.*..*.. *.\*.#...  .*. .* **..\....\...#\*...\. ..#. .... * ..  .#*. .*...#...\...***#.. .... .#.  ##
# *. ...*.......### *. ......#*  \...*. #.......#..  #\#\\**..  ..  #..* ...*.*... ..... ...#**... ..   .. ...#*.*...  ..*....*# ... *.... .*. . **..#
##..\..#..*#.. ...#......# .. *.*#. ....#\ \*..#.#*#.. *.  .*..#.  .*.#. * .. . . .....* ..\..*... .. .* ..*.....\.#.#*.. ..#.  **.#.. .. ..#. .**# *#
#...# ..# .* .#.. #* *..\. #..*...#. ......\. #\ . ........\*...    ....*.. .* .  .  *.. . ...#.*\. ....#* ...# .  #.  ** .. .#.## ...... .\*... . *.#
#..*. . *##.*..\.. .*.  ..*.**# . ....* \*#*..*.\# ..*.\  .  #. .\.....# .* ..*#. # * .. ....# ...#.\..#..#  ..\.# . .. ..... . . ...\\#* ...  *..  ##
#.. **..  ..##..#.*.. *.*.#*..*#..*.  .*........ \*#..#........*. . .#.#............ ...#* .*.   ...# .... .\ . .# #*.*...  .\#...    . .#. *#.\ #.#*#
#*.#...*.....*.....*....*..#*##**# *.\.*.* \*. \#...#.  **# # ......\.#... #...* *.*.......\.. .*.. *.. * ..#......\ # .#...... *.....# .\.. .*..  ..#
#.... *. # ...* #*.*..\.....*#....*.* ..#.. .*#.. .  . ... **... \ # ..#.. .#.\.......... ..*...*. ..\ ..\ ... .* #...##\ *.....\ ..\#.. .....#. *.#*#
# ......... .*.*.#.#***...#.#........#  . .  .......  .**... .* .#*\.#.#.. .*.. #...*..*..  ...*...... . #. ..*..\...#\.... \..#.. \ .  ..... ##.....#
##.\.... .. #...\..#.#.......* .. .*.... .   * ...*.#\... .....\    \.. ...... . .\*#.#**\\. .......#\.. *. .#.. ##....\.#...... . **..*.... #  .... #
#*#.#.*.  ...*... ... ..... .. #\ ..*... ....\..# .. ........\  ..#...*..... .. .*. . #...... #..  *. ..#.#  .#..... *. * *.....* .* .. \ ... .. .\ .#
######################################################################################################################################################