######################################################################################################################################################
# .........\ *.. .*.... . .*.#..... . ...  ...##.  . *#. . **. # ...*#..#.. #.. \....##....\..#.. . .. #....#.*.\... #.\. .*#\..* ..   .  ##... \  #.#
#.... ..#.**..*.......#. .....*   ...... . .*#.....#.#. ##.... #...* ...#**\ * ...\..*.. ...**..\.\*.#*. ...\# . #......... . .... .#.#.........#.  .#
#..#.\....*. #. *. .  ##..*.##** . \\ \\#  .#.#..#...*.*#   ..#.#.. ..# #.*..\\ .\. .#.\... . .* ..  ....#*..##..#.....* .#....*. ..#.*.\*. . .. . # #
#\... \*\.. . .\ ..##.. #...\. .*.. *.\#.\*#..*.#.. * .*.. ... . ..#. . .*... .. .......\..... . ...... .....**... .\.\. ............ #*# .  . * #. *#
#.....*..**.\.....*.#..#.*\. \..  .#.*.. \.\.. . \...*..#.*#.*.##..#.....*.**. #\.#.* \.   .. .. ..  .#.  ##.#.#.#.\...#...*\*...**. .\ ....*#  . . .#
#. .\.# ..........    ....\*. ... .  .. ....... . *...\ .*...*. \ *. ......####...\*.#..... .*.. **. .#.  . #..\ ...  .....*.#......  . .....  ......#
#....#..\.\.* ....... *.......#.... ...  ...\#.* ........ ... .*#.. . *...*...#*\.\.  \#.  .....\... *.. .. . .#. .#\ ..\.....#. # .  ....\ . #  . .*#
# . ... *.... .#* .*\. #.. \.*.*.. # # .. *..*#..\*....#..\.#..#.#*#..#*#.# \...... ..#..  #*# .#.....*#...#.. ..\...#.\ ...  ....#. .#.#.  .  .#\. .#
##. . ..# .*..#. ..*.#..\# ..\#*# #..\. . ..#\..#.##..  ...*#*# ..#.... .. .#..  ..*   .#.......#. .*#.#.  ...#\ .\# ..*.\ . ...... \ .##. . ....*#.*#
#..\..\.#\ #. . .#.#..# .. ##.*... ... ....#..*#.#.*.# ..* ....\\......#...\.##... \.\.. . *..... #..*  *  . .......*........#..* ..#.#.*#.....* **..#
#.  ***.  . ...**.... *.\... . .* *.*##..**..#..#\.#..#\.##*\.\\..... .*#** ........ ... \..  .. .*....* #..#.\ .#..\ .   ... .#..\.# ....*   ....#.*#
#...... .\......*.. *. #\*. .##*..  \..#..#. \....  .* # ..  ....#..... .. ##....... .......\.... *.......\.*..#*##\.*... #   ..\ .. . ..\#.. *#*.. .#
#.....* ...#. .#...   ..*.  ...#.*#...# ......*.*   *.#...#.*..#. .#.........* ##...\ .. ..# ..**..#*. *......*.#  \ ..  .#..... ..... ...  . ##*\...#
# #  . ....#*.*..# .... .#..#.\........*.*\.   #.#....#. ...*  #.\... #.  . #..* .....* \  . .##....*.\.\... \\. .*..#.     . *  \.. .\*... .#*... *##
##\....\. ...#\..... .*... **.  .....\.**..*..#.\* ... *.. \..#..   ....*. . #*** \..*.*\\\.\##...#.#   . .*...... *.#.  ..# ....**.  *\ .##.#.... *.#
#.\  \\...*..#...## ..... ... ...\.* ....#..\*... .*  . . ...## . .*..*\.....#... # ..  *.. ...# . *. . ...*.. ..... ..\ .....\..#\.#*\#.....#..   .*#
#. .\..#.. #. . ........\ # \.*.*. *...** *.\.. .  .*. *.....***#.. \... .# *.... .....# .......#* .* ..  ..  .. \#. .  . ..\..*.. # .. #.\.. #.. \ .#
#. . . ..# *..  ..... ..#....\\ ........  ..#....# #*.#**..# ...* ...* .\\##.......*#........*. .. .*....  ....... ..\*..#.. . .. ...... *.#.... #.**#
#...#. ....#.. ......\...  ...*   ... .\ *.#. ... ...\.*\#\. *.......# .   ..#..\\. ...  #..  ..  ...* ....  .#..  #... ..#\.......... .......\..*...#
# .. *. .**#. .. .\.. *.#\# .\.\ .. . ##.#.....   .... ...*....*...  .....# ...#... ... *.##..\.#...   .#*. #.*.*. .**.# .*. .*.\.\...*#.....* ..*...#
# \#  ....\#....... ... *.*. #.*#*.*#... .. ..*\ ##..\....\.... **.*#...#..... ## .....**.  ......  \  . ...##.....\..# ..#... *# .. ...*#..\   ##\ .#
# ...# .   #. .**# *.. ....*#..* .........#* ...*. .\ ...*.*.* ..\.#. .\ ...*.. \... * #\. ....* ... .#...#  #\..\... #..**...\*\*..... ...#\... *..##
# .  #.#.#..\ . .*#..*.. . \..  . #.\    .#.. ##.. *....#*..  #...# .  .## ...  .. ..\. .#..*#. . \...  *..# . **#..*... . . . **.. .#.*\...#... ..#.#
#.... . .#..*. ..... *.# \.. ...# #...#.. .. #.# \ \...\... ....#  .#.* . ......\... ..\..*.* .. ... #  ..#...##.  ....* ..#*.*. .. \.\ .* .*.... ...#
#......*.\...*#. .. ....*  .  . .#....*.*..#. .*. ..* #.....*..  #\# .#..#..#..##...\\. ....\........#.*... #.........# *\ ..*\*.#...... ..#  . .. .*#
# * . ....* ......  #  ..* . ..... ....#*.. #   . .#\.##.....* .##.. .. . .#...*.. .\.......*.. .... .##.  ..#*.. ..## .# #...** .\. .#........ #. *.#
#... .. .. **.....*   *.....*.* .... . .*.\..  . .*.*.#...#.  \..  .#.*..\ \**...* ..#\.  #\.#.\#*....... . .#\.\. ....*#*.#. # ..  #.*. ..  .*.*.##.#
#... # *# . . . .. #  ... #..#.\..... * \ .. # .#...*. .  ...#...*..#.#.... #....#* *..\... ....  .  ... .#.#.  ... .. .......... #\. ....*# . ......#
#........\. .....#. ..\... .\...*.*  .#\\.....* . .... ..#... *.... .. .#.*.\. .. .. ..*.*... . ....*...##.* #.*.*...  . ....*.#*..  .. *...* #..\.# #
#***#.*..**.# \ .#\ .\. *.* ..*   #.. .. *#.*... #....#.*. .......#.....*#\# .     ..* .....*..\.    \.# ..\.....##.*. #\ *... ... ..##......... #..*#
#.#. . #.....#.....*..*..### ....\##*.*..\.#. ....\#\....\.*#.\..  ..   .. ... . .. .#..\.   #.*....\..#.   .   . .....#..##.....#... .. .#. #. . . .#
#*# #.  # ... ..   .*.#.**...... \....## .#..   ....#.... .. .........  ..#..#..\...*..*. ..\.... . .\ .. **. *... ...*.... .# .*..\ .. .  *\#... ...#
#.#*.   .\..    *   #**..   ...# ..... . ........ .....\# . #..#.... .*.# . .\#\. ..... .*....#. .\...#* \.#.#.*...... ....\.*\.  ..* ....   *\.#..\.#
# *.  .# ....\#. **..*.... #..##.. . *..*# .....*#.. .. ..# *... ..#. #....  .*.*..# ........ ..#...*  #. . # \..  ...**...#. .. ..\#...#* .\ . .... #
# *. . *.\. . #... \ . ..#. . #.# ..... . ..#.   *.#..\ .....   #. \.. .  #. ......*#*...# #....# ..*   ..*......... \*\ .* .# *# ..##..............*#
#.\. .....#... ..... ....# ..##**...#* .*... ..  .....\.\  ...#.\ .##*.# ... .. * \.. .. .\ ..*#\#...## ...#.*....#.#.*..*. ....#.#.. . \   #..\..*#.#
#* ..# .....\\.# .* .  .  \.# ....   .*.#. *. .*..  #.. .\    *. ....#.. ..*.. #..#.\.*#.... ........   \#*...*.#  . .. #.#*.#.  .. *..* ...*. #.*...#
#.* ...*..# ... .\# ..*...#* *. *.#..*........#.*.. . .....*  *..... \.......#.\\*......\.  ...\.  ...#.#...  .  ........      .. . ....... ......* *#
#... ..#... ...#.## *...  *. .. ..* .##**\. .\ #.##.....#.  .... \......# ........*.  .... ...#*. .#..*   #.\... . ..\. .#.. *...#*.#*..* #.**...  *.#
#...  *#.#. .#.#.. # \  ..#....*.. .  ..  .. ....*.  . .*... #.......*##.*###..# . ..*\\\   . ....*#.. #..  .... \  . . ..#.. ....*.* ##.#..  .\... ##
#......*\.  .......#..  .... ..#  ...  .\..* . ...# ... *.#.#.......\*. ..... ..... . #.\..*.  ..#...*..... ... ....... ..#\..#*. ..#..... .. .....*##
#\. ..  .... . . ..*.......  . .....# .. .# .#.#\. . ....  .....\.#** .* .#. ... .*.#.*..#*#...........#. ..*.. ..\.#... .... ...   .* . .\ #. *. \..#
#... .*... . .. ..*.#.#\.\.. *#..*. # . \.. . ...#... ....#.**. ........#*..*.\.*#..#   \*....#.*.*...#*##......... ..\..*#. \..... *#*.. *..\...*...#
#\.**......\*. .#..**...*.... .. .. .# . .. . .*...*.....*. \.. .  .*.#.#.#*.\#..\#. ....#\. ..#.#... ..*##* # *.*..  ... #.#* .. \*... \... \ \.....#
# .\.. .*...  .* ##* ...*...... ...#.# ....\ .   *.... .   ... . . .*......*\\.... .*...... .* .#.##*#*....#..#  \.*.....\ # .. .. .... * \\. .... ..#
#*.\*....\.. \...\ . #.  ..# * ..  .*\. ...*\ ...#..\.#.. ..........*.* \# .#...#..  .##.. #.#*#.. .*..\...  \* #\ ...\.\..\.*... .*  .......*.. .. .#
# ..# # \...#.*  .. .... *...\.* . .  ...*. ..#. ..#. ..#.. ... . ...*..*.  . ...*#.....* *.\..*. *...#   .*... .\..\... .\*. \..*.... .#.\. \* .  # #
#..*... .....# . .#***. ...\....... ..** ... #.\. .  ...\*... *...*.*.#*....*.#*.. .....#. ...#* *. .....*.**.. ...*.*.  .#...*.*..  ## . ...\.   #. #
#....\  . \..#*...*.... .** .. .*....#.*#.##.\**.. ... . . .... . .#*.. \...# ... .##.**. \ .. ..#     *. #.. .##....  *. . . ....... #.......  * #.##
#.*#... . \....** #.** *....\........ ..... ...... ..##.  .\*.... .##.#. *#*#*...*  \..... .  . ....###. .... ..  . .*.  **. .....*...##.  ..\#... .##
#... ...*..#....*#...... .**#\.* .  ..... ..... *.... .  .*. #.* #.# *\.# .#.#\. ..\*. #..#*.... ...* * .. .* ..* # .##.#*...  .\...# .#. .*.#... ..\#
#.....#.. ..\*  . ..*....* ..#. ..#.\.##.**. #*    .........#...#..*..#*.# * #.. ...\.. .*. ....    .   #....# ....#......# ..... *....... .*.. .*...#
#... .**... *.. .. *  *.*..#.#.\* **. ..*  ..\#* #. * .*.\..#\.#. *......*.#. *.#..\..#.*.... .\ . ...# ..#...\....#..*#.. ..*#.... .\  *\*....### \.#
##. ..#. .. ..\ .#. \*\#. ..\..  #...\ .#\ .\ ##.#  ...#..#. # ...*.\..*.\.*..**...\..#.... ..\ ......#.# .\**.. \ .* ....   .#*. .  ...  .. .  #   .#
#.#.*. ..\#.........*..*.. ..#.............\... .. .* .#... ....#.  ... # .. .\..*.#.  ..*. . ....*... .. .*.\...#.# ....#..*.  #*.#..\.  .  .\.. ..\#
##..  ....#..\#..  .. .. ..#..*.*  .. .##.. \.. *\... . \.#...  . ## ... #*..\*...  \..*.. .#.....#  ...*. .....#.*.   .... .. #. . ... .*. . # .\...#
#...#.\ #.  #....#*.. *... ..*........#. .* .#.## .\. . *. ...*.  ..*.... #...#. ....\ *.\..**....  #...#.\# *. .  ...*.  *.* ........*...#..#.#..\\.#
#..*.*.....##.*..*.*.. .. *. .*....  .......**. ... ...\...... ##.*.*..# ....# \.*.*.##  .\. \....# ..*. .*#. \*. . .  . *\#..#* . ...##..#.*.  ..*..#
#. ..*.\...\.*#....#...* ..   ..#.#............* ...... .\. #.**#.* .\...#*.*.\.\..# .*.. #.*#.  #..*....#....# \   .. .#\.. *.\.\..#.\. *.. .*. #  .#
#. ... .....   .. *......  ..\.**....#.   .# ...#**...*..  ...*.#.*#\...* #. ....#.. #..# .*..*.#.#.\.\.  .*#.*.*  .\  ..\.\...# ...#*. . ..#. .  ..##
# .*. .  #.. .... ...*.#. .#. .#.  #*..#*. #... ...#. ..*.*.*.    ...*.\...  .... *.#.. . .*#. **....*#   ...  .*.....* ...#.*...#.# .#*.. *. . *##. #
#\ .## ..#.*. ...\ #...**.\...**.#... ....*.... ..*.  ...*#. #..#.*.  *.*#.#\# ... # #.#**.....#.... .  * #.. ..#.\#.#...... *.. ..*....*#.*.. #.#.#.#
#... ... .. .# .. .#.*#  ...  **..#...#.*  ...*  ..   ...#..*...#\..... .. ....*..* *.\* #.....#.#.* . ..*......\.. .. ..*..#  .#... .#. . .. .#** . #
#. . .#... #. ..*# \..* ..... .#...... . .#...\ ...*.*.##..\..#.  .#*...   ..#.  ... .**.*....**.\. ..#.#.   #...... ...#... *.* *.*.# .#..*  *.#*...#
#. #*.#\..... . ....  ....*.. .#.. .  #. #.. #.#...... ...*  #  .*.*.  .#**.....#... .# #...#.#..#..\  ..*.#*. .#..#.. .*#*... ... .*...\.# .**.*...##
#.#.. * .*. . . #.*..  .  ..\...# #.. .* ..........#..#.  ##\ * ..#.*..#....\.\. .## .*. . ...... ...*#...*....... ...*.#  . . *. #**\.*.\......#\#..#
#. ..\. .*\.  .....*........ .\.#..* .  **... .#\ .... ......#..  *. ..#* . . . *.. *.... ...# # .*#\. #....#.. #.*..... .  ........ ... .\ .... ...##
#.#. *.#.  .. .... ..\.  *\ .#...#.#.... *.#. ........ .#.*\  ..... ...#...\ .\......\ .*.  .*  .......\\.  .. .. #*..#\.#.# * ....*.#.... \ ...# .#.#
# .\.   *..  \..#....#..#...\..\. .\# . \. .#... .....#*... ....#.....   ..... *. .....*# ..  ....#.##*#......\*..*.#. ...#.. \#*..*.. . .*#.....\* .#
# .# ...* #.#*..**\..... .*.*..#.\# ...# #... ..**\\*.  \.*.....* .*.#.*##  #. ... . *.*..#.**#... **... ......\ *.#.#.....#.......# .*.....*#**\.. .#
###.  ..#. . .....#...#..* ..*. ...* \      ...#.#*.#\#.##.. .... ..*..\.*..**...  . ....... .......#.. .....#........ .... . .....**.*#....  ..** ..#
#. ...\. .  ....*...\ \..\........*#.#..\........\... . .\ . *.*....#.* #.*#..#..*..# \#... *.*.. ....  .. . ..*. .....#.. # *.*. ..# .\. . *. # ..* #
#..* ..*. ..#* .*\.....#....*\***.  #......\ #. . *\#..\.#. ..\.#\ .*..  #    . ... ...*....... .\ . ..\.....#*##. #**... ......#....  # .  .  *#*. .#
# ...*.......... # .....  ...*....**.. .  ...#.# .*. ......   ..#.   ...# ...*..*.... ... .*.... ....*.*..* .. \#...... #. .... ... .#.\...  ....*  ##
# .\#.. *.#....#.#... .*. ..*.....**..#.*# .*..# ***.\...*...##..*...#\.#.....*.   ..*. ...#..\.*\#*..*\*. . ...*.*..... ....#.. .* .##.#...*..\.*..*#
##..\#*......\\.***. .. .. .#*.*# *. #.\..#.....  * .# .......*.  ..#*.*  .*.* .\*.*..* .. .\..... #...  ...*##*..#.....*.. .#*...... .*\*.\\....# *.#
#*. ... ... \....... ##.  .. * .# ..*...\..  . ......#*   *..*....... . *\ ...#*..*. ..  #....\ .\\ ..*... .***. ..\  ..##.*....#.***.\... . *.##*.*.#
#... .** #. *.##\#... ..\  #*......\..#.#... # .*....\\ ...\* #..... ...\... .......*.  *..   \.\.   . *.\ **.  . #.\.\ .... .....*  .* *... ..#. .. #
#.\. ..*. .*..*.#*.... *#*.**#\ ...**#...#.* ..#...*..#...... ... ..**..\ ##.*\.....\ .  .#\.\.. .....*\.....*.\*#\#.* ......*\ #... #...#. #.. .#...#
#.   .........#..*. ..*. ##. # . .#.\.....#...*.  .*\** \.  ...#\.#\....*\\\......... .#.. . \.*..*..\.. .. * .\. ##*. #... ..\.... \.* .\.* .##*....#
#.#.*....   \.. #..... ...\#........ #..\*..  \......#  .... *..#........#.. **#  \....*. .#.\........*\#.*.#.#.........#.  .**.#...*# # .....\* .   #
#...#..#.\\...\..*. .\...##...# .....*.....*.#.*....  ....\* ...#... ..\...*...*...# ...*.#\. ....\....\ *.** ..\........ ....   .. ... ..\## #* ..\.#
#.*.. #.     #.\.  .............*. *  * .. .. ......  . .\##..... .  ...*.\.#..  .... .*. .\..... .#....  ..# \*\ \ ..#. . .... *\ *.. .....   .... .#
# .\ . *.\#.\ .*#.#..* \\..\..#*#  .. .. #.....  ..* . #.#.#. . ......   .#.#  ....*. ... .* . ..#.  .. *.#..\ *.*.... ..*....\#* #\...#* \.*#.*.#...#
#. #.\ ...#....**. \..\. *..#..# *.  *\#.. ......\.. . *....*# \.............\... .\#.. ....*.*......  .\. *.....#....*.\# ....# * . \.. \# #..... **#
#  ......... * .....#.  .#..... ... *.\ *\....\. .  *.... #......  ..## .. .\#.#.... \*\*... ... *.....*....*.\ . .. .#.  ..*......#..\... #  ...#.\ #
#  . *. ... # ...  .. #..  ....... ... . *.... .  #..... \.* ..... #. \..... \.. *#*  ..*.. ..#.*#... .. . .. .. .*...##.#...#..  ..*... .#...*....\ #
#.* .*#....*#.# . .... ..# ....*..  .* ......\. .*.* ..* *.. **. .*.#  .#... ....*  ..\*... ..... ...*..*# ...#. #.. .\*. .*#. **..*#..#..\ . *. .##*#
# *..   ...#.#..*. #..# ..  ...\. ....*...\ . .#... .. ... .... . .  ... .. *.#. ....# * .*. .....*.\\. .#...... *. . . ..* . .\.... . ...\#.#*... **#
#...#...*.\.. ..*. **.. .#\..*. . .....  *....#..# .*   .*#.#... ... ...*...*..##*. ... .*. \#. *# .*#*.#.. ...#..... .\##*.*....#  ...#.  ....*...**#
#. .#.# #* ..  *.#\ ..*#.  .*  ...*\\*. ... .....   \.......*. ...*... ...... .. **  #... #.  #...#....* .**.#\*... ..... # .  . ....*.* *.. #..* .  #
##**..\*.#. .   .#....*.....#.. ..\##*.# . . ..  **..** \.....#\. ......\* ...**..\..# \.*..*.\**.......\#*. .\ . .## . ... ..* .\*...#\  .\... ... .#
#..##\.... .**..\#..*. .....*..*#..\.. ...*.. . \...#.....#  .. .#....  ... ..   .. #.*. .\.\**##. ...*... . .#...\ ...  ..*# .....#..#.......  .....#
#.\**. ......\ ....... \*.. .* *.#... .. . . .. #.... ..   ... ...\.... ....#.*...\.. ..   .... ..*.* *#*...#.. ...* ...*#.#..... .. \#.. ...*. .*...#
#\ ..#.. .*... .# #.*....   ....*..*.*.. .....  ##....\   #...  #.#  . #..  .. . \.*\.#.... .. #* .* ..*\ .**#... # .#.....  ....\* ..#..*.*. . #\...#
#*..\...# .\...#...  \. ...* .#..\#.#.*......* *\..*.. **... ##.. #.*#.\.. ....... .#.. ..  ..*..\  .#...... \...* ...#.*\............ .*. . ..\ ... #
# .. .. *.*.*.. ... . \\.  ...  *...... ....\ .\.#   .  *.#..*..#.#* #. #....#  . .*...*.. . \.  .*..# *.#.##. .#.# #.\* ..#\###...*... *#. .**..*. \#
# ..*# ........  .....#. #.*.#.. ...\# #. #.\\.  ... .. *..*... .  ##. .#..\#..# .\. *...#....  ..\...\* *.....*.....\...#. .#.*#..*.... .\... . .#*.#
#.. ..\...# .. ..#.##..  # ..\.#......#. .*\ ....\ .*.*.  .\.. *..*... ...   *. .#..#.\ ..  ..*.##.**.#* ..   . ... .#.#\..*.#\ .\ \....#............#
#... .  .... \..... ..*. ...* .. *.   **.*\.  ............\ ..*  *.#.....###.  * .. *#.* ...\* .*. *#.\ .... .. #. . .*.# .#*.... #... .. #\.*....\..#
# .....  .... .. \..   ..*.. *. . .#*.  #..#*..#.\.... ..#... ## .#*.*#..##... *#...#.. ..*...#..*##* .*..\..* ....#\...\#..\#\.* ..  ..*#.##.#.#..#.#
#...*\.#* .. *... .... ..\....*.........* ..* #.......*.. ..*.#..  ..#*.. ......\\.. . ..*...#.\... . ..\\#.. .. ..  ...  #..#. #......  .*#...... ..#
# .....  . ...# . #\##.... ..*... ##.. #.*..  .. \. ..* . ...... *......*. ... . ..*      #.#....\..# ....\#..\. #.........*  *..#... ..  .........*.#
#. . . .. . . ......*##. .\. .. . ....* ..**.\ ..*  *#..#.. .. #......#.#.. . ..*.  .. ..  ... .  .  ..#*.. ..### .*\.#...   ... .*.....* ..*..*.#.* #
# *. ..## . #....*\.#\....# .#*....##....  ...*.*....  ...#.#*..*.... .# .... .#.....    #.*.... .*.  .#.....\##..**.......#..#.*....\.#..#** #....# #
#...#....  .... #.... ..* # #.  .. \   * ...#.......*.#   ... . .* . # \ . .\.#. ..  ... ....**. .#\ .*\. *.*...*..*..  #.\..\.#  ..   ...* .# ......#
#. .. .....\...... #.#.... ....#.. . .*. . .**.#**##. ...*..\\...   *.#....  ..##..#... .. #.. ......* **..\ ..  ##.\...#.. .*........*....**. .  .*##
#..\  \ *# \..* ...*.. **.*.*\\.. **#...*.. ... . \....#..*#*...* \ \ . ....*. ..... .  .  .\\#......#\... ..**..*. *..\*..\ .  .## .  #...  *\  . .##
#.#.\*.*. ....\..*..#\..# \..#..\*.. .\ .**.. #\*..\#*#... . ..##.*.. . ...*.##......... .....#. \*. .*. . . ....* ..*..\.... .## . ... ..# .....#. .#
#... *.#... . .... .  \ ..* . .  *...#*.....# ...\*.    ..*..... *  ..  #..#. \ *.\ #....\... ..#.  .# .**.... .  .....# \\ ..*.....#  .... .  . .# .#
# ... . ..\. .  .. .. * #*.**#..#*. ...*...*#.# .\* .....#.*.. * .. ... ...... . ..# \ *  *..\.**  .#  . .#.....* .**# ..*.# #. #\ .#......#....  * .#
#\.*..#*. .. ....... ##..\ . ...#... .. #.# ..** . . ..* .. *. ...* .....* ..\.\........#... .*...# .#*....... ..#*. .. #...# .... .\...*........# ..#
#..  \..........  \ #. .....  .#.#\ ..#..*....\..*.#.... \. .* .\.#. ##....... .\. .. ... ..... ...\.\. ...*. *.*........*...... .#..... *.....*.#...#
#.  \.\\*.#...\\ .  ..*. ... . ...*..... #..*.*..#.* ##. ...\..*...# . ... .. *#\ .#... .. ... *.#..... ... . .*\ ....**....*  . .# ...\. ... # #...##
#.... . ..\..#.. .#....* . ...# .*  ..*.\ ... #.. .  ... .#\.#..... # #\... .\..... .... .\.. ..\.# . . .##... ..\\..*.... .\\..\**  .#*..#.*.... *.*#
#* .\ . # ..# . . * .  .. ...##..#*. *.... #.....# ... . \\..#.#\*..*....\# ...*.**\.#. ....#.\ . .*....#*. #.....#. .....\..  . .*..   ...\. .  .\..#
#. .....#.#...#**#. . *   . # ...#.#..\....\.*#.  .\..  .*.*...# *.  ....\.\...*.*....#.#.. #.. .  ##.* *.. .#.* ..#..*.. ... ....#* .. # *..   . \*.#
#...#.#....\....  ...**.  .*.#.   .. ..* .. .#.#\ ...*\#...#...  ...#..###*.... ...#  . . *.... #  .* *...#*.##. *.#*\ ..# .\#*. .\.....#. \ # *..\.*#
# . ..  .#... .*#*..\###.. . ...... #....#.....\... ..\ ..*.. ..... #....#....*.#.# * # . * #.. .... ..##..*. ....#..... \.. ..* .* .. .*..\.*..*#...#
#.......  * ....*..... . \ ..  .. . .#.##....\*..* ..\...* .. *.*#.. . .\. . . ...*..# #........#.....#.\.....  ....\#.*..*  ..#.....*....... #.* .#*#
#  ...... *......## ..** .....*\...\.#...\#.  *. *.##. #....   .#.# \ *.............\..* ... ....... .. ... ...\  .# .*..*\ *... ... #*.. * \..... ..#
# *.. #.\* .*..*............#.* #. .*.  # .###\* *.*#........ #... .......#....... ..\*\.# .#...#. \.........  . *.#.. ......*.*#.*#...... ....\#....#
#....#..##... .\... *#..# #..*..\.........#..*\..*. ..*.... . *..... ..*.*. ...\.#..........\..***.*.  ** ..#. \. \.  ....*.*. #.#.... **.. . .\.\...#
#.#.#\.. .* . #. . ....\* .\.#*.*. . #.*...\. \.#..#..\ .. .... *#....*. **... * ... .#\...#.\..  #..\\*...  .\\.*... .... #....##.*.#.....*.*#.*....#
# ...#.. .* #. ....**...* . #... .   . ...      ....#* .. ..  \#...##..#.*.... ..  .*... . .. * ..\\.#*..#  ...\*.....*. ...* ... ... * ..*...#.#  ..#
#\ ...\..*..\... ...  \....* \...#.... .....## \.....*#..#..... *. #...... #.*... .*#.#* . ....##*..    ......#.#*.. . . * .......  .* .*.*.. # .\.#.#
#.#*##.*  .... .... ..*.*... .. . .\  ...* ...\ .... .. ... #*.#*...*.. ..*..*.#*#.#..  ..#..**. ..* *\.....  #.  ...\. ..... \#*.\.\** ... .\   ..# #
#........# *.. *. ##... .#* . .. .... ......*#*.# ......... ..... \.#.#. #.*......  ... # . ..\ #. #.. ....#*.\**.\#*#..\*.*.#...# \...*.#.. .......##
# .##  ...#... . #. .....   **#.... *. \ **.## #....... *.. ...#.  .* . ....*\ ......*\. ....  #..*... . \ .*....*...*...****.*...*.#.#.. #* ........#
#......... .*.\......  #.*.........\#. #.....#. ..#..   *.......#.#\*...#....#..\.. .. .... *.*  . ... .... .  *..*###* ..\  #..#* \ #..*#... *..\ ..#
#...*.* .. ....**... ....# # ...\..\.#. .\.* *\.#... .##*\. .\. # .##.*... \\*.\  .\**..#\..*.*.#.. .#..... .#... #*#.*#\.*... .#.#\.*  .....##.... .#
# ...\... .##..... #.......# # .....\#*#...# .. #..  ...\... .**#..*.** ......#. #.....\.. #. *.. ..\# ... \*# ..  *.. *\..... *....***.* *...\ *....#
#.*  *..*..\*.  .# # ........ ...# ..*. ..#. #.**. ..*# .****. ..* #............#.\. ........\ **.*.*# ........ ......#   .#*  .\..... #.   ... . ## #
#\*..... # #\... ...#.# ...#. . ...#. .... .  ....#.  .\. .#. ..*.*..... ..... \**. . ...*.#.  *# . *....... ...\...  ....#.* *. .\*.# ...# .  .... *#
#... .#........ \. ... #.... ...*......#*.... . .. *.#.....#* .......... ..* .....\........*#. #.\...\\\....# ....#*.####. \.*..  \*.   .#. \  #.....#
#.**\.* .* . ..##...*  ##..##.. *.#*\.... #* .\..*.*. ..\. ..\... \...#..** #. ##\   ... .. .# ......#..*  . \*..\..##..\.. . #..  *.. ..... *\..*...#
#..# .. ..*.  . ..*. ......\..#\ .. .   .\ ..\..#*......*. #.. . .\ .*..* . ..... ..#.  ..*.. . .\#.....  ###*.\...#.....*...*.*\.\.\.#...   ...  ...#
# .*.............. ..*... ..  \. ... #........ #. ## .*. #. .. *..##.\...... #... #..#.*.# # .#*  . ...***..*... . .#. \. . . **\......\..\..... #..##
##... ...\..   ...**#...... \.* .#..  .#  \*\.....#...*.\.##\.. .... ....  .. . . ...* ..#...**. .*..* ..... ...*..# .. ...  ... .* .#.#\\.#. .\. ..*#
#..#..* . \ .* ** .*.......... * .* .# ...\*# .. \*.  ........\.#.*...   \#. \.  *..  ..   .... ....\.....**.. ..... ..*.. . .. ....  .#...  .  . .. #
# ..#.. .  **.#* .  .#... ... #.   *  #...\. #*.#..... #.\**# .* .....\... . .... .#\.***...... ......\.#..*#..  *. .. . .  .*.. .....*.##***##*.....#
#.#.*.* ..#.*. . ... *...# ...*..... ..\.##.\..*.. *#\ #......*.. . ..  . ... .. . ......** ...# *#*.*...* .#*....#.\.#*..   ..* .. .. .## .........\#
#... .# ..* # .\.  *... ** ...#  *  ..*  . ..*.. . \..* .......\.  \. ....   .....\.##\.\#.  *  .   ...... .# .     ..  . ..*\. .*#....*.. .. ..\...*#
#.....#**.*.*\ ** ....\.. # ... \\ ....*##... ..*.#.*...#....\..*. . ..*...# .*. .... .... .#..#......*.....* *# .....\  ..\..\... .#  . .. .. *....\L
#..\**#...#.#..** ..*..... * .*# .*.*#\... ...#..*.. .# ... ...*.#* .. #. *. .#...***.#*..## **..#\.. .###...#.\....\.*....* ....*...*.#..#*\\  * ..##
# *.\. #.........\........*..*   #.\#*....#..\ #.. .#. *...*# #.......* *\###..   # ....# .  .*..* .....#  * #\*##  ...... ..#..*.###*#.. **. .\...**#
#.*. . .#... #*..*... ...*\..###.  ... ....**..\   .... ..    *..*.# \. *...* . **.#  # #. ..... ... ....*..*.... **......#..  ..#  . .\ #. .........#
#.....\#....  .... ..*......* . ... ....** . .*\. .*.  \..#..##..............#*. .#.\...#....\*..  ..  #...\ ... \.\......#...\..\.....R... .#. \.#. #
######################################################################################################################################################