######################################################################################################################################################
#\... ...\ .*..# #......\ ...#..... #..# .. ...*...\**..... ........\#. .*#. .\ . ..#....# ##.#........** ##.. #.*...* *....#*##.#....*.. ....# #. ###
# .\...#**.*. ...\##   ....... .###.#...* .. ................\..  .#.\*.. #....*   ....#\*...*... ...\*#.*...*.  ..  .**.#*..... #* .\.##.. # *... .##
#. #. .. .*\.*....*........*##\.\...#....*..*.#. .\. .....#.. *.**#........  .*.#....* .. .. \..*.*.#. ..##.*...#. . .... ..*......  . ... ..* . .\ ##
# .#*.... \#.##..... ...... .. ......... .*...**.. #.. .........*......#.#...  .#..... ...#.  *#.*....  .. .......*#..\..*   . *.... .. **..\ ... .\ #
#.*.*..\.... #...#.## ..... .*.#..\.*..  ... # ....*.**.#.*     ...*. *#. . *.#. ...*#...*\ .   .#\*#.. ..  #..#.    .... .. .# **...\. .. \.. ..  *.#
#.. *.*... *.....*  *....#..#....*.\.   \ #*.# .*#.\. *  *. .. .   ....\# .*  .*. * ..\....\...  ......... . *..#.\. ............ #  **. .. *.*..... #
#.  \.*...*....*.#... *...# .. *# . ... \  . ...*..## ...*.\.#.*#. .# ..*.. #* **....*....\.....# .  . #*.. *.. #* ..# \*..#....#. *\#. *.\# ..*#.  \#
#. ..#..\. ...\\ .....**..  ....#.*.. ...# .*. .....*...\ *#....# ..#. .# . #..*.. .... .#..  .*  ... . .#**. .#.....#.# *#...#\.*......\   ......#. #
##.*. ........*..#. . ...\\. . .#.#....\\  . *..#.*... \ ..#. ...#. ...... ...#... .... . **.. .. ....*#.....  .....#...... .....**.. \* . *#\.\. ...#
#.. ... ....#.  .....*   .. *. * ... . #..  .. \....**....\....... .*.. ...*.#. .*..# ... . ...  . \.#.#....**.... .*.*.. ... .. ..... . .## .... .  #
#\ .. ...** ........*.# .. .#... # .....    \.. .* ..*.**.\.....  #  .*..\ .. #.\.*. . . #.   #*..* *.#..\...  .....  . .. ......#.## ..#   .#  .... #
#. .  #*..   .. *.\..*. ..## * #... .\..# ..... ...\ ... ....* ... ... #*..\...* ..#.* *.....\   *.. ..*..\*....*. . .*..... .... .......*. *.. . *\.#
# .#.#.. .. #.* . .#\..*## .........  .......#...*. ....* # .##*... ...**.**.... #.* * *. .*   \. ..\#...\.. .#.*.... . #.  .... ..\ .  ....   ......#
#\\*#. .*\.. #.#....*   #.#.\ ...* ##*.**...... ..*#..#..\#..*.#.....  .... . .. ...\#\...**. #... ...*.\*...#.\..\ ...*.. \. .\..\*..*..#*.  ..*....#
#......\.* .#....#. #.#.#..*..  ... ..\*\ ... *.. ..........\\.... ....#.  #   \\ #*.# ..... * ....  . .... . ......*.* . .  . ..**.. ...#.... *.*..\#
#  .*#\.#... .. . ...*##..##.*. ..  .....\.. ....*...  .. ...*.#*\**.*##.##..**............. ..*..... .\....#.. ...... * #   ....*. .. * *...*\...* .#
#...\\*  . #.....*..#\.#.......*..#. .\.\* * *.#.#  ... *.\ *.. ##..\\.**...  #. ....*..# \...\.....  **. .....\.... #.... .\..... .#..#.*.#\..\.. ..#
#.. ....## .\#\. #*.. #. .#.#.* ..*\.*\..*.\ #..\.*. .** .  *. .......* *... .##......*..#. #.*...*. . . . ... ..**. .*#..**. . \ .*\...#..##\ ...\..#
#.# .  ..*  .. . .#  ...   \.\.* .........*.....\......## ... .**....##\.. ... . . #. *. ..*.. .. ... \. . ....*. ... .#..#  *.. .... .\...*#...*... #
#..* *.*... \. ##*..... *..# ... ........ #. .*#..\...#\#....\.. .*.\ ... ...# *.#. .. . ....\.*...##. ... ...# ...... \*...... . \...\..... *.*.*.. #
#.. *.#*.\.*# . ..## ...*.\...#.. .. .  ..#..#  .*.# #.\.. ...\* .. .#....... .** ...... \* .  .#.  **##.#  . *# ..#..#*....*..#\.*#*#. # .* ..*.#*..#
# * . ... **. ..#....*..* *...#... #  ..# . #.......##...  ....##.... ..  ...#*....#....  ... #...#\*###...  ....# ..... \.*..* ..\*\\. .\.. .\..*.. #
#.. * ..\.*.*.\.#...#.... ... .. #.*.* . .  #..  .....*.....*..\*...*.. . ...*.\..*. ..*....... .. ....\*.. ..#.......... .... ..... ..#..#......#...#
#. .. ....#.#.#  #...*... .   *. .\.. \.... . . .. .*.*.... ... ....##.#. . . ..#.**.*# .#*..    ..# . \.  .*...#....* #  ........  . #*....##\.# ...#
##..... .#*# *.* ...\*. *..*#*.* * .\..*... #. .    *..\ . ..#.. .*. .*.##..*\\ # . #..#.. **..\.#.. . * .. . .#\....*..#\ ..*#..* .. . .... ..\.*.*.#
#..# ...#*.....  . ...*. .....\*#. # ..*... ....# *...\.*. #. .......##.* .. * ..\*.* . ... . ..*. ..#**.  \ ... ...*...#\. #......##  #.*.\ ..*...  #
#\...*. ...... #. .#... .. #***..** ..#. ..... ...#. *.* .*..#*. . .*.#.  ........\*#....##. .*.# *.. ...##.**\......#.. .\#*.. .* .. \ ..* #. ...#..#
#.#...#*.....\...*.*..# ..... .*#...... .. *.#\.  #.*.  *.#. ....# .. ##* ##.  .*.*. .**...*. .......#.#...*#. .*.*.# #***...... .*....#. . . .. \ ..#
# ....#*.\ . ....#. .\..#.#.\ .#..  . ... .... .. ....\.#.....* .........#....*. # ...*. .#.* .. .#.. . #...** #\*.. #  ... .\..\.. .. *  ....* ... *#
#.....# ..#......\ .\# . .. #... ..\......  .**.* .*.....#.*. *...*.... ..   *...# *.*...\.#......*.. .#.. \............#.#.##..#.....  *.. ...#...*.#
#...\\#..*#...#... #.\ .. .. ..#  ..  ..\* . .  .# ..#...#...*.#*.. # *.* .. *#.*... . .. . .*. . ..#.#... *# . ......... .*.. *.*.# .*  \ #... ..\\.#
##. . .\... #... ...** \..... ..*  *...\ ..*.....#. .*  .#. .*.#.# .... **.. \.  .. . .. ...\..#... ..## .* *.\.*#\#.....#..\.# ...# . .... .\...*...#
##.*..\*.  .\ . ...**# ..... .... ..*.....*.### ..*...  \......#  #.\*...#* .***..#. .....** ...#.. . ##\.#. .. . .#...#.....  .\# .  ....* ...  #...#
#....\..#**..\... .#*....\.*..# *.....\..*. #... ..##\#.*.\\ . ...\.. ..#.......#.... .. .  . #..... ... .\\#....##..*.* .\...  *# . ....... .*.....##
#..*.\.. \. .. .#.*..*. ......*.   *.  ....... *#.. .* . ..*......*  .*.......# . ... .........*\*#*.*.. ....... .... ..#*...##..\.\.... ##.\* \..  .#
#* ...... *.#\....  *#. \ #.....#*....**#. ##.\#... .. * *...... .. ..#.#.#.. #   . . .*. * ... . ...\ #.*....\*#.#.#..  . ...*.*.#   #....  ..\.\#.##
#.#..*.. .#..*... \\* .#..\ ....*   ..#**. *... .#... \.\...#. *...\.....\...\.. .* .\ **..  .....*. \*.. #. .  #... . .\.*\ . ... . ....#  ........ #
#.*.# . \.. .*.. .\...#..**.#. .. ..*.*......*...*.*\... ... .*..# \ ...**. .**..  \ .*.#...  . .   \....*... ..*.. ... \. ..* #*...#..  .#  * * ...*#
# ..\### #...* #*.... ..# .#.. .. ..#.........*.*#...... ..##...... ... *....\...#\*..*.*. . ...*..#.. . . .. .  .. #.... \# *....\   ..  .##... ..*.#
#..  .. *#..*  .  \.\.. .#  *.*.#..   .....* #. ..# \.*#. .. ..*......   ..*..#....   ..#**..... #.# .# ....* . #..#..*...   .. .\.*##. ..*.... .....#
#. .  .#.....*........   *\....  .#..#*.*. .....# .... .... \#..*\...  .  ..#.. ... ..*\....  \.#..*..#.   # .  . ......... ..*. *  ***. . ...  .# ..#
#. #..... ....# ....*\.*.. .#  ..* #.# ...#*.\ . . \.. .... .\..   . #.. *  \\#.* ...*#*   .. .  .*   *..#. . \\#...* ..# \#.*... . ....*..  ...* ...#
#*..**\.*##...*.... .*\..\....*..\. #.. .#. . \#.*.   ..# *  .*.*.*.   . ..**   .....*.  .#\.# \.*...#.. .. .....  #  . \# .\ #. . *... ....... .. *.#
#....... . *.....  .#*. ..#.....*.... ##. .\  ..... ..#*.. .#.  *... \.\**. \*.  ..\ .#...# #.*\..   ... . .  ....*..  #. .\.......*.\#....*..  .*.\.#
# * #\*.. .*#* ..**......  \ ##. ... ...\.    .#. .#..# .....#.* #\.#\..#*.  ..**.#...#...\# # \.....\..#.*  .. ..#  .   .  *... ..# \* . .# .* . *..#
#..\###*...#...\  .#**#.....*#.#.. . *.......... .. ..*. #*..#* ..... . ..*\*..**##....   *. .#\..#... *# *. #.... .. .\*....#..\..... ..# .....#..\##
#.*.. ......*...*..*..# ...... * .# .*...##.#     .#.  #. .#.*..\ . .*\.. .*#..  *##..... \* ....#. *.**## .....\ . .#.*#....  . ... . *.#. .#...*..*#
#. .*... ..* . ##. .. ......*.. . . .\\#......  ...#.... ... \\ ...   \. ....*...*#  \.*  * . . .*...##..  .# .\#......... . . ...*.......  .. .#. ..#
# .. ..*... ..*** ..   ..#....*... ..#.\.. ....... ......* *#..   \ .   . #..# #. *\ ...#..... # .#.*..#. *..*...... .. ... .##.. ......# .. #*.#.#.##
#... . .##..*.. ...#.\. .#  ...**.*.*##...#...\ .....#...\...\ .\# #... .#....  *.#\*.#.. .... .. ..   # .   .#...### *.#.. ....#..*#...  ...#  .\## #
#..#..   ..# ... .....\...*... #.\.\.*.#\......*.* ...*.. . ...\..#*# .  .* \\  ......  ..*#.*.* *..#  .. ..  \   ..*.. # ...\*\\.*.****..#.*..*..#..#
#\#..\.   *.. ..#.# . *.    ...* .. .*.... . \.\..*.* #\ #.# ..\. ..... ..* ...#\. .* *...  .* *.*#.. #. # ..#.*..* ... .\#... . .. ...\*   ....*....#
#*#.#......#..* . .**....#.*....\.*..*..#..............*.  . . *  .. . *. .. .   .... .*    .  .*..*#..**#.#.#....\.. ....#..   ..#.. ......* ....*. #
# .. ##.#*.... ...#.*..* * ...... ...#.\...* .  .\.# ..#*.. ... \ .*.**   .#  .##  .. #*...... ..*.. .  ..#... . .*   ...\.* .. .. #. .. . *\.*.  \.\#
#. \.......*  ..... *.* *.# **... \...\..*#...#. .. .#*....#..... \# *....#...*#. . ..*.. .   *.. \.. ... .*#. * . #.#. \# #.#....\.#...........*.\.*#
# .\.# .#.# .... ##...*.\....*........*..\ *..... \.\ *..*#.*#. \... **   .#.  ..# .*. #....#.. ....*. #\. . *.*.*. ...*#. .. #*....\.#\.#*#.... . . #
#....  ..   . ##\.# # #...    .*...#... .....*\.* .. .... \.  ....* \\. *\.* ..#. .......*. .... ... # .. .\.  \..  #\. ..*. #..*.....*#.#.....#. \..#
# *. *. .. . \\.*#.*..* \....* \.*##  .* ......\.# ..** ...... . *.. .* ......\....**  ..* .. .....*. ...*. .*.*..\...\...#..... # ...#.#*. ....\\.*##
#..#   .##\. *#.#.   ..\.. .**...\  ....  #..# \.#.#\ ..... .# # ..  * .# . ....  ..\\...#.#.. .**. . .*\......... .. ...#...* *\..*... . #.. *.   ..#
##.#\... ..*...*.  #\..*..\... ......#... ... .. ..#. *..#..*. .\ ..*.#..#.. #..\. .... \... #. * .#..* # ..*.*...#....\#.. ##*.* .  . ... .  .##....#
##. ..\#  .# ...  # ..*#.\ ... ..#...\. .....  .. # *.#...#.# .\.......*.  .*.. #*.......   # *..*.. .*.. #.#. .*#...    . . ..# \. ..... .. . ..#.. #
#*.  \..# \. .*. #*#..\  .. .#*........... ...... ..*.. .#. ..#* ...\...\.. .....\...... ..*... ....   ...  ..   .\.......*..##  .. .. .# #*.*.#.... #
#..**..\.. #....*...#*... *.... *..*# .. . #. .............\....*#.\**.* \.....##.*\.# .....*. *...*.  *.*...  #\\. .....\ ....  ...   ..###*.* . . .#
#.##.\.* ..* #.........#... ..#* ...\ #.*.. ..  #...*\.. .... .*...# ...#...  *..#*#...........*. . .# ...  ..#**.. .#.. .....#\ . *.....#. . .  . ..#
#.\\.*... \.*\. . #..#*. #. ...... ..#.....##. . . . *#* ** . .  . .... #.. #......\. .  .# * .  ... . .. ...... .  ..* .... . .....* .....*  . .. ..#
#.#.. *..##. . ..... . .. *...\#* ....  . . .* ..*. #.\.#.. . #\... .# #. \##. #*..... ##*. ..#..# ..  .. .#..*\.*.....   **..\*#. .... .  \  ...\ \ #
#....###. .**#..  .#.....****...  ..* *.# ..#. ..*. .....# .#...... #..  \*.\ .* * .  .\ ..* ....\...*. . . .#..\##. * ..  *   . ... *.*.   .\......\#
#.*\ ...#..#..# ... \*......# . . ... * ......* ..#*. .. * \....*. ..* .  .*..# **....# .*. .*.  * .*..* *... ###... .**\.#*.#.\.. *.....*... .*.*.#.#
#\... . ..\..  *..\*#.. * .*.... .......... .**. ..# .....*.. . .*  *\ .\##.  ..#*...*.#.   ..\. .. # *..#\.*..\#. .#..** .... .\.# #...  *# \.....#.#
#\..*.#.#.#.*...**.. ..#.*.. . .#....\..\\ ....\.*.....#*... . .*.**.*.*#..#....\..    ..... .... .. .##*....\\..#*... . #*.  \.  .  . .#..* .*\..#*.#
#*....* ... ...*.  ........# . .\ .. *....*.*. ..\  ....# \.*.. .#.#......  . *.#* *..*# .  * .. .*.....#..#*..    .* ....\.... ...... #    ....*\...#
# .. .. #*. .\ **   *.#*#...# *#*#* ... .....#.... *...*...*##.#.\**..... . .\.\...\.. *.**## ..###..*. .#. .. ..* ###...#....\ .. * \....\..\# #.\#\#
#.....#.#..#.#. .   .. . ..*..\.*.#.......#.......#. ...##.* \.. #.*.#...  . .. #.. ..\ .**..*#* .....  ** ...#.*...#.*..#....  ....#. ..#..*# . ... #
# ..*..*\...*... ... ##. . ..*  .\.. \....\#...\.\.*... #  .#*..*# . ..*#**.#....... *....*.\..... # ..#\#** ..\.* * ......*....#.* ....#. .\..#\...##
#. #.\..*..*.*..*.\.. ...##..#.\# # .*.\.#...*# ... #.#*. ....# .#.* ..\.*.  . ...... .   . .  .*.* .#.. ...#... ....#.....# .......*.... #\*....**..#
##.. ..##.....##*...**#\*....... .. ..\.\ .#. ....... ...\. .\ *..#***. ......\#.*..*..\.. ....#\. .#\.....* ..\ #..*. ..*. ..*. .*.\*....#...##.#\..#
#.\...... ... .  .  *#*. ...*.. # . *.  #.. . .\ #. #....\.#.....  *\....\#\... . *... .*...#.   . \  .. *... *\....  .... \...*... .#... \##\.  ***.#
#..#. *.**#.....\ .#.*.*#\ .*#.# *. .. ... .  *....*........#.  .......#.. . #....#*\*... ...#*..##  \....*....*...#...#.#. .   *.*....... .* .. . .\#
##.*\..*#...#.\..  ....\ ... ** .#..** ..*.#.....*..*..\..#.*.  ## ...#*....#.  *.....#  #..  .#*#.... . .... .* ..\..  .*...#..# .*.\.. ..\ \..*\ ..#
#...\ ... \ .. .\....  .#.. ..# *.. #....#...... .. .*..\** ....#  ...#.#.\#.. *   **\...*... ... ....*..\.#. *. .#\...*......... .*. \ .#.*....*## .#
#...  .\.... \#.....#.#.\ .#\.# ....*..... . ##...#.\.*##*..*\..*#. .. #*#.\..* **..* \.. .#..........* ..*.*.** ##.... .*\ ... .......  *#. ... ... #
#*...*.. ..#*\... ...*....##\.\...\..* ..*.# ....\.* .. * .\  ...\*\.. . ..\ #....  .*..#..#* ## . **..\.. ......# ..# .....*# ..##*... .*..  #.*\#.*#
#**#... #.*.\. . ..*. *..*#.......... *\...  #....*.. #.#*.#..#\*.. ...#  . .*..#. .*.\ ....*.. ..... .#.# ..***....## *\*.#.#.*...##*.  .\ \..*  \ .#
#* .*.\#.... ..#..\.**.\...\..  *  ... . . **.#\. ..\.* .#. #. \.\..# .. *. ... \.\..#.....*.  ...* ..  .*... .#...\..\... *. ...  ....\.#..# . *. * #
##... #....... ...... ....#*. .* ..*.. ..  .. ..#.......   ..  \.#  ... *.\..... *.  . .*#.. ....*. .......... .. . .... ... .*..#. ... ...  ..*\...##
#. ..\. ..  .  .. *...*.......#**. ..\#. ...*..*#.  ...*\..##. .*..#*...*.... ..\ .....*\.....#.....\.. .*\.. ....#.   .**. .......*. ... ... *.. ...#
#. \..*# ...#............#..#... . . .  .......*\....**..* .. . . ..  .. ..*..... ...  .....  .....  . ...........*....... .....  ....#..*.\\. .\.*.*#
#.. . ..\ .\.........  .   ..... .   ... ..\. #**\... ....  . \##... * . * .*# .**#... .\.*..*.......#*.# # * ....* .. .*#..........*....#..\  .*\ \.#
#  # \.. .*..*\. . \...\. . \#.... #. #\.......* ...*..# .#....**# . #*#...........*..... ..#.. *#.*.*# \....#.. ..#.#... .....  ..#*# ..... ..*...#.#
#   ....\... #.#.....*. .#.\ # #\.... ....#.#...... .. ..*..# # *.*. ..  .#.#.#\....# ..*........# *.*. ..   .....#..#..#....*  .#. #*..#\*.  .  .\..#
#..#...\.##\.#... ......*. * .#...... ...\#**\......*.#\..#.. * ..\...\.*........... \\..  . *.... ....*.#..*..........\....  .....\*.... *#. \..*#.*#
#......... .#. # ..#.#...***........\. ..\ ...\\..#.  *......#*  .... *..#..** ..  .#. .#..   .*.#... ...*.\.#  . ...#.#**.. # .#.\...*..#.*\ .*.. . #
#.* ...* #.*.......  #.#   ..* ....**...*. .. #. .* ***.*.. \...*..#*#...*. #\* \* #  ...\...... ......\**\..*#. ##.  #......\#..#....*\.* *.  .#..  #
#.. .. ## *.......#*.*. \..#.\# . .. .\. ... *.. . ....*\  . #..#.. \\. .. .\  ...*..\*#.*.  ...*....*.*...    . ...... \ . ****...\  . .. ....... ..#
#....* #... *#.\...\#. .......#\..* #.*..*#** * . ...*#. *..*...*.*#.** ...##.... ... ...##.\. ...*.*......* . .. ..**.. .. *.*.* .#...  ..* *.# *...#
# ..*** . ..*...*.. *.. .... .\..\   *#. .#.  ..\\ ##*..##.*...\ *##.*... ...# .#*...#..\.#. ........*...   #...... **..  ..#\**      .  .\*...#...#.#
#.#\..*\*.. *.\\# . .  ....\ \.. .  .*#*.*.  ..\..#..#\.#..\.....*  ..*. . *\.  .....#*. *.# #....*#*. .. . ..*...#.# .*... ..\*..\..... .. *... *.. #
#.... . .*.... .\... **...\ ...*....# *...#.. . .#  * **.\ .  .#......#..  . .#..#*.#\ .**.. ...\. ...#. .*\.# ......#...\  ...\ * ......#..  . . *..#
#... .*. .  . . ..*#.*..#. * ...# ..  .  \.\.\..  ..*.\. ..#.*... *....#.... . # .*#. ......#* #.*..# ......#.. #.....* *  .\......\... . ...#..*.####
# .  #......\....##.... . ..... .#. ....\.. ...#.. ... ..  .#.  .....#...*....#.. . \\. #  .*#...#..#.. . .. ..#*.  .* **.# ... . ....#  #. ..#\  ...#
#. ..#*\ #*.**. .....  .#...\.*. ......#..#* *.. ..#..*..#. . .*..*.#....\..#. .....#.#.*\.  . . ..*#.*. ....*. .# ..*   ..#..  *...  ......   .....*#
##..#.\  .. ... \.#......#..#..**.. .\*.#####...  *..#.  .. .. \... ..*.#...*.\...*.. ...... .... *.*#.#..#\\..  . #..#.....\... ...* .*. *\***#.##*.#
# .... ..##.... .*\#.\\..... ...  #.#*..#\.#. .#.# ..*\.. .#*\##....*........  ... . ...*.\. .*...  ...#.. .# #\....*. ..*..* .. .#.*.**..#.*.#*. ...#
# .#***.*.... . .. ..#. \..###.....*. ... #*. #.. .#.\#\.. *..*. **  *....\.*.#.*....#.. *..........#.... *... ...\.. ..........**\....# .. . *....  #
#.\#. .. \.#*..#.#. . .......*....**.. \.....#. . ....#\ ##*.. ...#.... ..... *. ...... *\.. .... ..*.*.#  .#....  ...... .# ...*. *.#\#.. .*..* *.#.#
##......  #\*\  . * .# * .. ..*  # .#...  *.#\. #....*.......#. .#. ...... ** ....*  #*\*...**.* .#...  . ... .*....\*#* ..#.. ...#.*. .*#..... .....#
#...    **.#...**..*..#...... ..#...... .. \.  #....*.. \#.   . #.. .. .#\...#**\\.#.. .  \.*##.. #*.. \..# ...#.**.... \.*.##..*. ....\\. ..**.\* .*#
#...#.*..*.. .*..*...... .\ .\.\# ..****.\..**.*#..## .. ..\  *...... .*...*....\...#. ...... *..#*\.#.*.*... * ..#\....# ...\..\....# #\\ .....*.\.*#
#.#.  # . *... .. #..*.#\#.# **. .# ..***...... ..# . ..\. .# ..... .*....#... # .#....#.  ..*.#. .\#.**. .. *.....\.#....\*#. ...#..  .\.. .\...*...#
#\\. ...*..\......#.#...#.... #..... ......#  .#.*    \..  . #  *....... ..   ..... ....# .*..# .\...\..*.. ..# .. ... * *..... #.  ..*..  ..  ......#
#..##.....  \# .....#.. . .. *.*.  ... .*.\..#.. *\ .*  ...* .#...#*\.. ... .. *.\.**.......... ..\.#*.##. ##**. **. ...... .\ . . ## ....*#.*.. \ ..#
#.  . . ..... .*  . * . .. ...# *# .*...# *##..#.....*.* ##.* . #....  #*. .#. #..........* .\.**.. \..* .* .... ....\.\*...*.*. # .. * ..\......# . #
#..   *..*#...*#...*.\.   .\*.....\#.. *....* *.#.. ...\\.... .. # *#.....*...#..\.*  .#........ \. # ..** .  ...# #......  #.... *...*.   #..*#.#. .#
# .#.... .# .#*.. *\..##.#...# #.#. ... ..  .  . \..* ....  .\.  ..  \#*... ... \*#\..\##*#... #...\.* *.. .*. **.#. # *.#*. *.. . .\ \.#...#..#*.\ *#
#... ...*  . . ..# . ...#.\.\*  ..*#\  #.....* #*.  .#*...\.***# ....#..##.#*. .#....* #. #...\#.  .  ...... \....*..   #.\.... \.# . **...... #\ ..##
# .. .*... ...  #   ...  ...** ..*\...###\.*. .\.....#.... ..#...... #*  ......# .# #.. .   ..\..#....... ... ..#*\.. ...  .*.... ....  ... . #. ##..#
# ..#...  .\ ....... .... ..\* .#..  \#..* . ..*..* ..#\....#   ...# ..**.# ...#..... \.*.#.*.\. ..#.....#\#*#.\. ..... * \..#..\ .   #.. ##.... . .\#
#. .#.#... .  **.#...  ...\#*..\ ..#*. **...##*    *..... \  ##.#...#....*.. #..  .. .. *.... .#\* .. *.*\..  .. ..#\.. #..... . .##.... * .*.....#..#
##....#. #.*  .  .. # .* ..# . .*.** .*.#.. ..*. ..* #*.#...#  *...# .#.. #.... .##.#..... .. \.......*\.. . * ...* .*...# . ...*..**#.*** .. ..\.. .#
# ..*..*# .\.. *.... .*.\..#............*.#*. .. .#....# .\.....*#.... *. * .. .  .#.\....#. .... .*\#...  ....\\....#.\*... . . # .* ..**..#...#.*..#
##..*. .\#*.*..**. .....\.. .#......#..\ .\...*..#......#.#....\.... *..... . * ...*   *....# ..* . . . ....... *......** . ......\. *. ... ..* .#*..#
#....\ .... * ......#...#......\ .*.... ......... *........ ..*....#*....#.. .*. ...#..\  ......#.#  # ... *.##....#....*. .#.* \.. .... ...*\##. #..#
#   *.\.#  . .#.*#**....\ .*.\\ \. ..##.#..* .... . *.\ #  .... .*.*#..*.\. . *.. ...#.. ...*..#  *. . .\ ....\.  *..#\. .*.. *.. .*. ...#*\*.*..... #
#.\......** #\......*....#... .\......\###.#...\ .## .#.\#......#.#\\\#....\......\...... #......*..  .. ..#.*\.\.  .... *. .. .  \\..#*...*.......# #
# * #..#. . .*.. . ......# .. ...... *.#.# .\. .#....*#* .#.* ....  .... ..*..#..\. ...   \.........#*. ..*.  .\. . \#..  . .*.*.\...* .   . ..*. ...#
#......#.....\..    ...*\\  *.*\. ... .......\. \ *#*........ .\\.....**.. ## ....*.#*...\... .*. .*..*...\#...*.....    R.*.#  *......\.**....   .###
#... . *.*#*#.*....*#.. *.#..*#.*###.*.. .#.#....\.\\ ..*. \\....**..\*.##..# ....  #..**\..*\#. ....  \#..\ .##..#*..**.*#..*#...#..\# .*.#....#.*# #
#.#*.. ...#. \. .*#.. ##....**#.\. *. .....*\..*..\ .\.\.*#. \.... .. . ..#. **.......##. ..... *.... .* . .#* * . #..  . #...*....#. ..#*...#.#. **.#
#..#.....*.*..*...\.*... ..*...#..... *. .#..... ....\.... ..#.....*.. .. ....... .....#\ # .. #  ..  ..... .   ..... .  #*  ....*# .. ..*..*. *..\. #
#\...  ..#\..*...*#.  .. \.# .\..........#..\...  ..*\. *...#..... ...# .....*\*..# ..#.. . .. . .*. .# \...\  . * #...*##.##...\...##  .  ...**#....#
# . .**.. . *....#... .#.*.\..*....*.* ..#.*.. .*  ..*   ..*. ..... #..*.. .   \*# *.*#..*.\ *\...*.#*.... ..* #.. ....... \    ..*.#.    .....*. .. #
#.....#.\*..#. ... #.#...**.. ..#...\*. #.   .....*... .#*..\.*#  . . .. . ...*. *.... ..#*. \.*.......#.... *.. ..... ..........##.# .. ..#*# .  .#*#
#.   .  \.*... . #*#.* . .* ....\#.\.*. .... . #*....*##...#  .   #*. *. .....*#.... .. *.... .#.. .... .. . ..*.. *.. ....\.**.# ..*#.. *...*.. \\..#
# ** ... ... .....*.*.. .#*\..#. # .. . ..........* .##... ......**** ..#.#....# **.**.  # .***   .....  .\. #.#*..   ...** ..#... \....#. . ... ..\ #
#.*....#**.#... *.#...\#*..##. #.. *...\  . .* .* ..#.\.*.\. #......\.* *.# .#.*. .#....*.. . . .*........ \...#*#... .*#. .. ... .... . ......*.. .##
#..#.\*#. .\*....*.*... * .\.\.#..**#.#...\\.**..*...#.  ..#.#.. ...... ......   .*..#.\# ... . ...*..* #* ....#..... .. . .*.. * ..# ....  \**. ..  #
##.* #.\#   .*\........ #*   ..*\. . ....\.. \* .... \.. ... .. #  .....   .... ....... .## \\  ... ... .. ## ..*    . #. ... #  \.# ....*....  .*\..#
#..*.. *.#....... ..#. ..**.#.  *... ..*....* .# #*.\ #  . ...... ..#... #.......* .*\.#.#...... *..*.  ....... .#. .\.. .#* . #...*.  . .. *. .***#\#
#... .....   ....* *#.  . ..# .#.#. .....  . .#** .  ..*.*# ... .# #... * . ..*.. .#.* .. ... \ . .  ***#..\ ....  \ ##. #... ##.. .* .... .  .... ..#
#...... \* # .. ......# ..*.#*........# .##\\.    . #.....    ....\*\.  # .. .. ..\. *#.\......*..*.. . *#.......* . *...\.#..#*.. .....# . ...#. *.*#
#.#...*.*#..**...*.. .. ..#..... . ....*... ..  ........*....*..*#.## .*...#. #*\... * ..*.\..#.*.#. ..*....  .....*...*...... *\#...\ . . ...\..#*.\#
#........*.* ...#.  .  ...# .* **..# .#* .\#.*#.#*...# #  .# . #. .... . # ...*... # ..#* ..... \.  .. .....#.* ... #..\#*.\ ..*#.*#.#.* ......\ *\.##
#*\*...... . *.*..* .\..*.. .... .*  . . . * .#  \.# * .#.# .# . ..  .**.. *\.\\.*\.  ##.*#... ..*\. ... . .. *#*. **.  . .. .. ... \.# ...*.. *.....#
#...#.* *.**#..  .\..** ... #.. .. .. #... .#. \.*#.*..*....#. . .. .\* #.....*##...  .#..  .#..#*.. .*..#.\ #..#.**#  ... .*\... .*...**. ...*....###
#...#**.....#....... .#*.....*..*. **.*# .. .*...#.\.. #.....\#......**.\. .  * \.\......*..# . .. .#.#........ .*.\......#* *..*#\...** ....  *.....#
#*.  . .#.* .**#. .........*  \ \\.. .*..*. ......**.*.   * #.  ...*.* *. .#.\..#.....\\# . . #. #*.... *## .   .  *...*..#.....*.#  . . .. ... #\.*##
#.\..*#   #.*##.#. .... . . ..*...  \.#..  ... ..# . .##.... **\. ##.......#* #..#.* *... . *.......  ..**..*#....#\.#... ..*  . . ..... *.. \# #....#
#*.... .# * ..*..*# . .#....  .*..*.. ...#..*.#..#... ..\....\\     .. ....#..*......#...#* ... .  #. . ##***.  *. #..# *\.*.#...  # #..* .. .... .* #
###################################################################################################################################L##################