######################################################################################################################################################
# .#. ......#.##.. ...#  ..*.  ..#.*. .** . . \#...  . ...*..*...........\##....*.\. ...\ .#.......##.*\...... ..\####.# ..*. ....#..*    \.#   *. ..#
# ..#\*....*...#.. #..*..#. .... ..* .. .#.. ...# ... .# ..*..* .......  ....#  * ....*. .# ..  ....\..#....... ......  .... .*.. ...\#.. \.. #...* .#
# \ #... ..\.. .. .....*#..* \ ... .\.......# .#.*. . .....*....* ..#.\# ..\ #. \.**.....#...#..... *. ... ..# ##.   ..#.. ...* ..#.* .*...#\... .\. #
# .. ..\.*. .....*..##.#..#  .....  .. . .. .  #*.. ... #.\#..#..  ..  . . ..\#  . .. .*...\\...*.....**.#.**#. \..... #    . \.......# .......\. .###
##.** . .... .*.........  ... ...*..#  ... #.* . #. .#*......*.*.* .#..\ *... ..#.* ... . .#.\. .* .. .*..# .\.... ... ...#  *.\\.**. ..\..# .#. .\ .#
#*...#.*\..  ..*\*#.\.#\#  #\.#.*#..**. .........*.\  ....\...# . \ . .* \....* .* .......*.*. *..#.*....\..#.*..*#.  #* #....*..\.....# .. .#..# .. #
#..*. ..*.. ......*.... .    .\\*..#.*.. *..  \.*.#... ## ...#.##.\..* #.....*\ ..#.#. ..*\\ *  *. .*#.. ..*...*... .*#..#...  .. #\....\. .#....#...#
## ...*#......* .*. .. . .\.#.. \ ........#\.. . ...#.. ....*\.# ..*.\\. ...\* . ** ...#... .*....  .. *.......# . .....  ..  .**.# .  #\..  ....... #
#  . \* *..*. ... #.\.#..*.  .. ...*#\.. .  ....\. ..#*. .\.....\#.. ..  .#. ..#...*  .. ......*.  #.*...# *..  * . ........ ... .. .*\#.* ...# .  .*#
#  .#.*.#... ..#*\.*.#...*..\.\#.. ... ##.. #. ...#.. . . .....*.# #.# .\.##.#.....#*...#  . ..*.....  .. #... .*#\. . . .. ....* *...\..##.......* ##
#  #.. ...## .....*. ##..\... .. *...*.#. *..\*  .  .....#....*.#...\. ..\* #.\.    ... .\..**..##.*.*....#. .. ..\ \. \ *..*......*..#. .*. .  .. .\#
##....#. ...#\.. \  #..*.#.\*\ ...*.. .*\. .#. ......* .**..  *...##..#....  ...*. . . *  ..##....#..... #. \..\\..........#.....*..*   ...#. .*\.## #
#. *\. \.... .. ...**..  . \  ..*...\...#..##\. ....**** .#..#. .#*.*...... *.#   ... .\.#.....\#.*.* *...... **.....* #..  ...# # . ... . ..#..* ..*#
#** ..\  ....#..#.. .*..... .#. .*... .*# .*.#* #* .   ........#\. .*. *  ...#.*.. ...  .\# .#.#  .. . ..*...... \. #*.. ... . ...*...*\\##....*...*.#
#..#*. .    \. ..# . *  *\.#*.# ...*.#.... . .... ...* # . .#. \\..  . ...#.....*#* ..... ..*..*...#.#  #.  ....  #. ..... ....  *...*.....*\#.#  #. #
#. *.#...  #..\. ...*    #....*..*...## ..... \. \.** . .... \  .....#.#...#***\. **.##*. .... ... ** ... #  #.\#  ......#...*.*\..**........  .*.#\.#
##\... .\...#. \*.#...\## *...  ..#...... ... ..#*....#..\\.....\  *... ...\ .\....  .*.*.#........  ......#.#.*....  .#.\ .*...\...** ..#.. ..#.***##
#..*.#\   ...##.* . ..##.. ...#**..##\*\...*. .\ ......... ....*.* *.. ..#...**.\.**....  .  ....# .....*#\#  ..*.. .#........*..**.\....*.. .  #....#
#....*\#...  ...***.#*\*...... *\..*#\... .. .*..#....\*#........... . .*  **..#\...*.*.*....#...##.......*  ...#..*.\..*.......#..#...*..*... .* ...#
# *\.*....##.\.. ..  .* .#* ...*. #......* .# . *  .#..\...*.**.  .##*.*.  #....  #....*.... . .#*.#. .........*...... .... .. *..#..\. #..\ ........#
#* .#.... #...\.*# .....\...  ... ... . .............. ......  ...**.#..\......... .. .. ##   #..#**..\*.**.*.. \ ..#. #..... ... ..... .\...........#
#..# *#\\..**##. * ..#.*.. ...##..# .......... . ...#. ..#*... .\** . *..\...#.# # ..    ... .   . .  ...* ..\.  .....\. ..   .\.*.. .*.\.\. .. .#  .#
#.. ...*... ..#....  .... .#  ... ..* #.* .... .   ...*\...\. . ..#.  *.*.........*\\. .. .\ .  .   .#.*.#.\ *..\ .... .\.\.. # ..\..*#...#...# # ...#
#. \..*...... ...  ..\#.\..\ # ...\. . .... \*.* #* *#. .. ...* .... . ... ...  # * .....*  #.. #...* .  . .... #..#..#... ... #.*.*...  *....** .\* #
#*\ * ....\........*.\# .. .....#..... . . .. ........... ..#.#....\\... ..... . .#. \#*....*#. *#. .\. .. . .*.*.. .... .*...\ *.......#.. *....... #
#...*...#\.*.\ ...\ ...*.......*####... . *..\.... *.#*. . ..*...*....#..#.  . . .......*.*. ....# \.\....\ ..#........* ....\. R..*.#.#.\\#..\.* ..*#
#..*..#....  . . ...\#..\**...... **..... * .. .*. #.  . .....\.#..*.  .*. ..\.   . .\.#..... .....## *.#.. .# . ..*......  . \. .# ... ..#.  #..# . #
#.\#.*.# .\..#*. .*....... ..   *.\.#  ... .  *. *........... . ..***  #.. ..# \ * ...*#.. .\*.#*  .*..*... ...  ..*... #  . ...#\**. . .*  ...*.....#
#*#..#. \..... .#\# ..#. ...##*#.\. .*.. ..... ..\.**..*  ...# #..#.. .#.**.#...*#....  \**\ .* * #\ . . .#*...\ .\.#.. ....... #......\ *. ....#....#
#... ..#.#..\ .#*.#. # ...#.. . .....#... *#. ...#....*. ....\... \..# ..# ...\. .......#. . . ..*.\ .*.. #.#.....#.  ...* .. .....*....\..#.*##...  #
#. .\.\.*....*  \  .... .*.*.....###....... . ...#.  ... #\# .#..* * ...*.*.#* .... . . .. * #. #\.#   *\.*.....#.##...#*....*\#...# * .#. #*.*..*.* #
# ... #.... ...  .. ..\.#. .\....#... ....#.... .*#.**\*. *..# . . .\ ..#. *.......# ....  ...... .. .#....*.*.. #...#..*#\*..\......#.\.... . .\...*#
###.....*.*.. * ..\\. .*.#.* ..  *.* \.*....*.\ . ..#..\ *.*.. . .#.\ .......\. .*..*#.*... .   .#..\   .#  * *#.\ ..**. ..##. ....#*.. .# ..**  ...*#
#....#.. .\..#.#. .  ...# .*. .... ..\...#*#.*\*...*..  \.###.\.\ .......*..\#..*.. \# ...\.\.*....*.  ## . ....# ..\..*   *\ ....  ...#.\#.. *#.....#
#*    ...** \......*..  **.*..... #*# \....*.. ..#. ..*..  ....\.\.##.... ..\....  .....*..*.. . .#.*# .\. #...##.*#... . *.#.# .... **# * #.*...* ..#
#...\.#*...\.#...#.. ..  *..## *#.  *.....#  .* .*#  \..#..........* #.  ... ......\**.  ...#... .*.*.  ...## ...* .*.#.# *..*.... .* .##... .  .#.. #
#.*. .#.**.*. ..#\  ##\.# .\.....#*#. ...#..... .*... # ....*\ #..*..  #.   ....... .  .......   *..#   ...#....#.* *\ ......\.. ..# \#.......*.....##
###... . .*..*..#..# .\... \### .. .*.#. ..... .. ....#....#.\.  *#*.\......*.......*...\ ..*.#.....####.............#**.\.*# ...* #* ..........#   .#
#. #... . ................. \....*...# . . .\. . ...#.#..#..\ ..# #....*#.#. *... *.\.. \.    ... . \.... *.*....\. ..#*#.#.*...#.. #...... .* * #. .#
#.*.....#\.* *  *.. .\....\......#. ..*.\.  . ..#*\#*. ......... ...* ..#.....  ..#. .. ...*...* .# .. .#\.....*.. # .#  ..*.  ...... #.##..... #.\..#
#....#..*#. .*..... #...\....#.*... .... *#.*..\ #.\ ...#..\.#.*.#.*....... ..# .. *..... .. .. ... .. *...#.. ..#* .**#.*# *.# ... #\ ... *......\# #
#.#*. ..  .....#. #... #..*..... *.#.*.# \##..#..\ #.. .*  \*. \. .#...  .#. ..  ...#*# ......... .#..  ..... ..###.   ...*.....\#.. **..   .#.....#.#
#.#.\.\\ \.*# .....# .*.. \... .   .*.. .*.. ...**.***.#. \....#.. \**#... # ###..#... #. ..#.. * . *.*#.......*...... .  ..*...#... ....# ...#.. ...#
#.*......  ####.......  .*....#.#\**##. **#. ... .. ... .#.#.#.#. *. .*. .. *\.. . ....#....\ ...**#. .. ..* #..  ##*\..#.*   .#... ##..*...*.. .# ..#
#.. .\*# . . *.\* .#...*.#.#  *#*. \..# *.#. # . ..*#*\.##*..#**. ......  .#..*.......* \\#*** .... ..  ..#...\. ...... ....  . . *.  ..*.#   #... . #
#.** ..\..  .... \ . ....**\. .*.\. * .\ \#.\.*#...* .* .##.*.  *...#....... . ....#.... .* .#....#.\..........**. . . .#. #... .#  .. ..#.  ..\\*\*.#
#  .\....\***#.# #..#*.\. . #.... .#\... ....*.#..# *. #\.*......* # .#.#..#....#.#......#..# .* ..  * #. #. ....* .\....*.. ##. ...# \...*.#. ... ..#
# ..*.# . .*...* .. #. #.**......#..  ...\...*.. ..##.\..* ..*.# * *.##.#.... .#..*..*\..\*  .*..  . .#..#..**...#*..\*..* *.......... ... ... .#\#..#
#.. \... .# ....*. .. #  .\  \ \*.......*.#..   #.\..\..*..# ............   ..**  .. *...... .\ . ... ..*. ...*. ..*. .**. *...# *.*.. * ... .. .*\.##
#. #*.. .# .*.#....  *.#***. ...\ .. ... . *..... .#.#.# # . .  ...#...#  * ....#..*\ ...\ #.#.....  #.\... . .. . #.. #.  .... .... ..#..... ... \. #
##. *.... ... *#.#.*...... ...*....#*. .#. ........**\*\. .**#.  .*.... #*# *.\ ..... ** ....#..*.*. . *...*  .*.*.*#....*...\. .*..*.......#\...#..##
#. .\... .... .*#* ....\.. . .*.. ..#**\.  \ . ..#...#.. ...#*\..... ..\.... ...*.. ...# #.#. .. ...*...... .#\.... . .... ..#\.#.....*. ...*.*.\ .. #
#. *#.... .. * ...*. .* . ...#.. .......#.* ...#.#.\# ......# .#.......#..*..\......... #*... .... #...\... *. .  . \..... \..... .. #...........*.\ #
# ..#......... .*#....*. #.  .*. *.\ ....   .. * .  **.\  *.* .. ## * .. #. .\. **.. #..   . **.. .....\..*... .....#....... .......  \*.**.#...#....#
# ..*...#. ...#..*.#...  ..*..#\.#.. #..#.... .#.# *. .\# .*.....\#......#.#. *... ..  .* **  ...# # # #.....#. . ...#.  .\...* #\ . #. ...\  .* ..*.#
#.# .#  *.#\*. \ ..#.  \.... #***....*....*..#...\#... * ..# . ...  *.*  . *. .*. .. . ..*.. .#. *..#*..  .*... ....\# *.** . .**.#...\.**##..*** ..\#
#* ..**  #....  .#.#. #...\.....*.... \. \ .# .*. .**..... ....* .#  .. .....\.*.... *\.###..\#....*\...... .\.* ......  . . ....\*....  \ ...  .. .*#
#.. ..\.#.....#*. * . .#. .#....*... ...\..* ..... . .*#..*..*....#*....*   .....****. . * .# ..*\#.  *...\#....\.#.. ..*# *..... ... .... .   #... .#
## .#. ..*. ..**..*##...*#**..  ##... *.#.*.*. ..#*..#.. .# * .....#..#\..#.*..#.......*... #...**..#. \...... * ..*...... .*..\  .*....  *.  **. .\*#
#. .*.#\  #....** ..#......###. * .. . . \........# #.\*.. .#\*\... . .**. .. . .#..\ . \.*.* .. ....... # .#..*..\ ..#..*.  ......... .....\.. .*. .#
#. \#  *... ..**.\..... .#  .. **.....   #\..  ..\ .....\#. ...*... .\#.**#*.....  .#. .*. . *. ...#.#..*\...* ... . .#. .  .. .............* ....#.*#
# ... .#.... *\\.##\ . .#\..#   ... # ........... .. #.. . .. *  .. #*.\...*\.. . .\#*\.  * *... . *..#.....*....*\ .*..#.*.\...\ .  #.\ . ..#..\*.#.#
#...\ # .**. .. . #*....**.  .#  \. .#..#*.\.* ...*..\..\. ..*#\ .  ..# ..*. #....*....*................. \#.*. . ##...*.... ..*.#. ..#. ..*. .  # ..#
#....#\...*#. *.\.   #*..#.*.##*#..#  .*.# .....  .. .*..  ... \...*......#....#.....#.* . .. . *. . *.#*...... *. .. .\. . #.. #.#.....*  .*#.*.....#
#**..#.. .\.#.*.#*.#.....#.......*.. .# ...#.#.......... ...*.\.*. ...  ....... ... *....*\\.... ...*\.... .  ...\.\ .# ..\\...*...*..#\ ... .* . *..#
# .# ...# ...  .#. . .. . * ..*.* .* .\..#........** # #..* .\.......*.#*.*..#\.\...*   ..... .....*..  .... .#.*....\ . .#..  *.  \##.....\.... . ..#
#..\.. *.*.. #..........#.. .* . . ##. . ##....\.\.. ..\. ......#..*. ...*#..   .*. . # .\##  ......... ... *. \#. . .\....#..* .. \\... # ..# . ..#.#
###*.*..### . \.# .....\.. . .. .. . *.. .  .....  \.. ...# . ... #.#.  \... . ...# #*#*..# .#........... \ #..\*...#..##.* . .*#...  ...*\. #. . . .#
#.*.*. ...*#.*.. *..*. ...*..... #.#  .#.#  ......  ## .....#.. . #*..*.#*.........#.... . *.  ..*.... .. ......  ....#..\* ... \.*.**...#. ..\ .*. .#
#*#..#.\ .. ... .\ .. .... *  ..*.. *...\.......*.# #\\# #*.#*.....\. .......... .. .# ......*.* ..........*#.# .*... .**..\   ##... .... .*. . .. ..#
#.....#***  #*. .# .... .*............. . ... ..##.....\. .....#......*..*.\ .  ..**.*.. \####..*. .\......#\\ *... ..#  .. \*.......*...\...* .*.. ##
# ... .....*..\.# #.....* #..##. ..*. ..\*.\... ....*....###* .... .. \. *..*.#..  .\... .##.. *#..... *.\**##...##..... ...*\\.. \ .* .. .... .  .. #
#*\... *\*... ..  .\#..... .#..*.*...\.   .# *......   #** .#..#.#.\... ...\ .....**.....*# .... ......*.*..\...   .\...##  *\.##.#.\.#. ...#*..*...*#
#*.... . . *.#*.**.  *.......#.\ ....# ...\\ ..#.#. .  ... ... .. ..#.... #* \ ..#........... .....#*   . ..*.. ..#.\.#\....  *..... ...#..  .. .  ..#
#.#......\...... .....#....#.##  .\.*.........\*  .. . .... ..\.*...##\...#. *..*. ...... . \... *.* .*.## .....*#\.#*.#....*.#..  *..  ...*. .*..* .#
#**** **.**..*#...\.\. #.\..#..\ .*. .* .*.. .   .. ..**.\ ..##.\. .** .*..\...  . .. .#...*. .......  \ # \.\ ##*.#.* *.#. ..*\##.. ... .. \... .. .#
#*. # ..##   . .#.#.\...#..  .#....#.. *. ...  ..** .*# *... *..  ..  .***.**#..*.** .....  ... ..* ..#. #.*##.*  .  * .# .\.. #.*#**...*. .#.\ ....##
#.  .#.... .. ... \ *..#.#...#. ... #. #*## .    *...#.*.  * ..#\#....\ .*#*...#. .#*.. . *.*####  \  \#.* . \.### .#..*..  *.*......*#**.... ..*.. *#
# .*\#* .#*. ... .# ...*.. ..#..*.*. #. ..*#.\ .  ..*.#* \##... \.. \.*. #.\.. .........*.....##.#\.*\.. .....#.....**.*.\*.. . ...#. #.. .\. .* .#..#
#..#*\... *.\*..#...* ..*\#. *.*\..   . \..#... .#.....  #. .. \ ...*.. .*.... ..\. .*..*.**.... ...*.  . ...\  .......*..*.... .........\.*##.*.*...#
# ...\ ...*#.#..# *  \##*...\....#.. *#\. #.# .#. . .# ..*.. **. .\ ..#... .. ...**.##..\.* #...# .*.##..... ...# . .#*#.. ... *#.* \.. ..##...... . #
#.##....\**. .. *... . ....#. \. ..  .\..*.*\. ... .# # .**. ... .*....#\....... * . .#..**. # ...*.#*.....  .*..*###   ....\#. ...... .*..#....*    #
# .\..**#*........* .#....*.# . .. .. .. .*  .. .#.. . *....##.......... .\#*..#.. ..#..* ..\. .* .... . ......*.. ..#. .... .**... ..#. * .\. .#..#.#
# . #. *#**... \.... ..#. #...\..\...\ . .# ... \\#...# \.. # ...# .*.. *..#....*..# #..\...#...#\.......\ .#...  *. .  #.# *\ .....#.#..#..\.... *..#
#.... . \* *. .. #..#..#..*...*..*.  #....##.  .....\#.* ##*..**.... . #.* . *\ \.....# \.. .....#. .   .#.*#.#......  ......... \.\.# . .#* ........#
#...*...#. #...# ...   .. ....  #  *.**.. .... .. #.....#*.\*#\\.#.#**#.**.... #....... . . .*.*\#...... \# *..  ....\.   ...# .. ......*.   \..#....#
#  .* .....#*  .# * *\#... \#..##..*##.#*#..\..... .\*#*   # .##.#. #  ....*.*.. ...\...  .*.\.* .#. .. \\####........\#* * ..*...* # ..  .*  .#.*.*.#
#.. ..*. . .#.#.... \....* . ..  .....#...* ..   . #...* *..\.. .  .... ..*.*\........ ***#..#. ....##   .....#....... ..  * ..  \. . # .**.##\*.#.. #
#... .\...*.*....   . ...#* ..... .... ...*.#... # \.... *..*.. .#.... .  ..*.. ..*.#   . *....#....* **...***.......#.  ..\.  \#.* ...#  ... .*.\..\#
# . .....#\...#\* . .....##.\ .* ......#. .\..#..# .....  \.*.*.#..\#. \\..*.. ..  .*..*.*#.......# .#.. \.#.. #....# .......*.#       ...\\ \...*.*.#
#.\*.*.#... . .##  *......#.*...*..... *.*.   .... .*\\ .\*..  .# ..... *.  .##   ...... #.* . ..... ..\ ........#..... ... ..#.........\... ..* #*\ #
# ..**#.  ..#. *.\\..... .\  ..*.\.*...\....*. #.*#......#. ..\.*. *..*.  .*. \ ..#  .\*.....\#  #*.** .. . .. *.....#  *..   *. ..*.## ..#.. .*..* *#
#....#.*..\. *.. *.. .\..#...#*.  ..... .. .# ...##..#*\.#. .... . .*.#  . ..# ...*.....#...#**.  .. ..\..........*..*\.\.## #....* *.....#.*#.......#
#.*..*...*.#.  #..  .*.**.\ ......*..\...#. ..\...#\.#....#.*. *.. #  . .\.#  # ....#.....*##.\.#..... #* \\ ##. ##.. .... *..... ..#.\  *#. .##\.#. #
#........#...\. # ...** *.* . .*.*..#* .*#.\..\ # .* ....* #.#.*..\ *...#    ..  .  *. .\  ...*#..#\..# ...### *.. .#.*. .*....*\ * .....# * **.. ..##
# ....*.  .#. .*.*  .\..#.. . ..##**. \....** .\...*#..  .**. . #..* *......* ....  ..#.#\..#...*  *#\.......#*....*..\..*...... #..# ..*... .##.*.. #
#.*..#\.  ..#.\ .#..#*. ..\.* ..**#* ....#..\\ ..  . .#* ....*..#.# *. *....... .. ...\#..  .*. ..#*.. # ..*.. ...**..\...\.*. *.#...  .*\... .. ....#
#. . .* ..*..#. .#...\...\*..*#...\.  .#.\..#..\...##\  ...*..... ..#....#... . .#. .#..*.# ...#.\*. . . .\.  ...... . ......#.#.\\..#. .* ..*.. ..**#
#..\ . . ...  .#.##.\..\*...#. .........*. .. .\ \...#.... ..  ..##.**# . # # ..\  . .\  ..... #.. ..#.** ..........#..*....#.* .. .. . .#... ..#*. .#
#* .  * ...**#.. .*\.* ..... #...#..... ....*...\.*...#.# .#...#. ... .... *. .*..#\.....  .  *\*.*.*. .***  #.. .*. ...  #.\# ..\.\ .*.....*.\#..  .#
#*... .#     \.....  *  \......#*# .#\ #*  #\..*. . .  *. ...*. .# . \..*...*.\*. #.#. #...*....#*.... . \. .*...*.... . ......... \.  .*.* ..\ . #..#
#. ...... .......... #..* \.. *. #.  ... ..\.  . ..\*.#\..... * ... *.... **........... ..... ... ..#.\.*\....\ ..*  \.. .  \  #* .  ....\. \.....  *#
# # .... .* .  .*..*. ...  #  *...... *  .  \....\.. .. ...*\\# ..**  ... *   .* #..# .\..#.. .\.\ ..##....* .* .... \.##. .. .#....#.*  *.*\  .. **.#
#*#. . .....#\.#.......#. \# ..  .#.....  # . .. . . . *...\#\*##... . .......  #.. ......# .  ... *.*\.#*... *.*...##...#. #\...# *.\\.*.\..*.....\##
#*#\..*\. **#.. ........ .......#.*.. *.. .*.\*\#.. .....*#\ .## . *....#*.  . . *...#...   ... . ...   .#**... ..#.#....... \. \\#..#.. .\  .... ..*#
#**.**.*.*..*.##\#. ..*.*... ..#..\.# ........# ##...*..\* .. . . .#..  ..*.#... ....#. ...\......\ \..##...........\..#*... \*. *.*....\*....\......#
#\#.. .....*.**..  ###.....# #* \.**. .. **..#...# . \.  #................#*.... ..#...\ #.. \\. *  .....\\...*.\..#. ..*..\ .. .# . ....... ....#\..#
#*\\*.....**. .#.\. . ....  \.###.... .. .\ \...* #\ **..#..#.\. .*.*..*#. **.  # .*..#..\....*#**...*   .* . .#.*##.#..  .... ...#.*  ##  . *. ...\.#
#..*... .   .#*#.... ..* .#\#.*. *#..# .#... ..... .#.*#. # .... #.\. . #.. #.*.#.... *. ....# ..... *. *..\ ..* .#\.... #....* ....*..\*. .. ... .. #
# .*  .....\. .\..\. .#.**\ \*...##..\*..**. .\  .. #\......#*... ..#..##.\...#... .....** .*.#.# .*#..  *...* #...*..#  .* . . .#...... ....#.*..#..#
#......... ..*.* .   . *...*.#\. ...# .*..**\. ...\ *...\.** . ...* ...\ .# * .*...... ...**#..*.*...#. #*.#.. ... .*. .\*. *#. ..# ... ..... .. ....#
#...\.. .......#.......\ ... # .\.. ........\.#\.. . . \...\\  ...... #...*#. . \*..#   .*...  #* #. ... .........* .#*#..*. ..***....   .....  \. ..#
##   *.#.......  . #    .# ### ...*\.. ..**#. #...\.....##.*..\\#. ... *....*. #\\..  **#..........*.. . .\# #.... *..*.* .*.*.....# .* .*.#.  .*. ..#
#.... .. #.\\..........*...  .. .  . ... .. . .##.. ..#.\..#. ##.  ..... ....#..#.*.\..#. # ..#....... .#*# . # . ...*#..\.....\..#.    ..... .*.*...#
#.#.*\* .. *.#\.\... ... .  #..\#........ .\#*#... \...\..*\  . \** # # # .#..#\.... .#... .#...* ...**.... .\.#....*# .. * *...... .. * . . \  #...\#
# .....\. #.......# #*...*..#.  *.... . . ...#... ..... .#.\..#. . ..** ..#.... *.\ # .*..*.*\ .\.# ##*. ..\... *..\\\ #......## ....#..... .*. .  *.#
#*. .. .#**.. . ..*..\.* *.. * ..* .*. \. ...#. .  ..* .##....**. .....#....  #..*.. . .*.  .* . ...# ..... . \.*....# \.#..#\.*.#. .*  . .\..#.. .* #
#\.*. .# *...... .\.. . . **#..  ..*.#.. #.\ ** ... ..  #.\#.**..... ... ... ...... .\.#\....#... *.  ....*.#\..# . ..*#.. .. .*.*.*  *.* .\ # #.  \ #
#.... *...\...#....  .#......#.... ...*  ..#... .*. .#....*.*    ## .   ..  .....\  .    ..... ... *.\..#.  ...#.#.\#*.\.#............#\..* .\.* .*..#
### #.*.#  .........#*.# ....#. .*.. .......  *. # ....  * .... *. *#...#....*#.... .#.# *#...*.\. ........ *#...... .\....#  *\   .  ..#.*. * .\. ..#
#.#..*.* *..*.  .*\......#\\ #..**..  ..... ...*.# # .... ...... ..  .#.\\... .......*\*.\#..#...\\..  ...*..*.*.... *..  * . \\.*..*..*  # * *  ..#.#
#....*..##*#.  *\# .*...*\. ...#..#...**#.#... ......#  .* ...  ......#..\# .. *... ..*.*.**.. .. ...   *..#...\\. ......#.#.....#...*..\#.... ..##  #
#.. ..\...... *. . \ #..\.\#.. .##.. ...  ...\*.. ***# .\... .\ .... .#... *.....\...# ..#..    . *# ##*..*........#. ..*.. .**#...#* .  .** * #* ...#
# ..*\ ... *..**.  ...#..#.* ....\. .... ..*.*#.. ..  ...... #..  .#.#.#.# ..\*..#*...  ..\*\*.... *..## ..*.\. .** *# \........... ..#..  .*.*  .#..#
#.*#. *... #...*. *.\  ##.\*....#.*. #..*....\ *\..#.#.* ..\.* *......  #*.\*. .#..# . #....\.##*.\...  ..* .*....# . .*...*....\     ..   .... .... #
#* *\*\. . .*..\ \.#  .\ . ....# ..   *.*..#.. **...  ............  ..*.##... *\.....\...\. ...\.**#  . *\*\...*. . *. . #.. #... .*.  . ....*\# .. ##
#\. \....  ..#* .* ...*.*...*.\#...*.... ...#\.... #......\* ...#*...# ..*.. .   #. . .*...... .#....#..  .. .\.. . *.#......#*....  ####.... * .#. .#
#   #\\*.*. #.# *.. *...* ..#.... *..\.\.#*\*.**#.*.. ..  ..*.*....\#.##.# . ..#.#   ...#.. ....*...   \\..**.... ...*... #....#.... .#.. ....** ...##
#. .. ...##.**.#*#\.....* ..#..* ....# ##...\..*#.....\* .......#......*...#.#..\..... #.. \ #  ...\*.*  .. .. .#*.#.# ..... .. \ .*.. ... .. ....##.#
#...*.* .. .#. ..#*..... *. .*.....*##....*. .. .. *.. .#..#.* ...#..# ..\... . ..\#\. .*.... .... .  ...  .....#.... .\.#...# *...*..*....** . ..\..#
#.# ..   *.   \.*.# #...# . ...#... ... ...#\.**..#..  .*#**..*. \ .... *.  *.  .#. \. .\ .*.....*....*#..\.* #..#.....*\....#.#..*.... ..\..*... ...#
#..##.......\.#.. .#.#. .\##*.. .* ..*.....##.. *.. .. #......#...*#*.#...  .***. .*...*. ...*\... .# ..*#. \  .... # .#.......**.#   . .. #.. .. . ##
# . *#  . .....#  \.* ..*. .#.....#..\.#..* ..#..\...* .  . *\. . . .#....*.. . .**....*.#....*  ...*.....#. .. ..#.##.. .  ...*  .#..*.#.*.# .\*....#
#.#.* .*.# .* ## #\.... .. .\.... \.....*.    *...  ... ....*..\ ##..*..\* .. .# #.....\. .   .*.#\  #..\...  #.#.....  #*.  .*....\.....*....... #..#
##... . * ..*.... *.\..  #*.. #..\... ..  .#.#..*.. .....\..*.#.....*\....*  \#\ .. .. .#.#...*....*.\..#... .\...\.\...*..*..*...\ .. ...#.*#. .. ..#
#..#.*\\  #.....\* . ... . .  #.*.......... ...##.. .... #..*.#*...  * \ *..  ..*....  *#*.... * .    *#.# \.*...    ..*\ #..#*.*. ..*#.#..... ..\...#
#*....* .... *\ . .. .*.# ..*... #*...* ..#. ...\.*.* .##.....** *  .... . #.* . #.     .. .\ ##. .\..... #...#.*#*\*.#.#..#.##.. .. .##* . *..##.#**#
#  ..*..... . . ###*#.* .#  ...*\..#   .... .\*. #. . \.  ...\......*.*....*.  .......#.#.  . ..*.*..  . .... ..... .  \ #.. \# .\.. . .#.\..... . . #
#* . #.*.. \..#. .. ...\     *.\.*...*...\..#*. ..#.** ..# .*..##...*.*....*....\..     ... #. ..\   \#*.#. .. * .**.#.. ..... ....*...# ..  *.\.... #
###. \ .\..*.#.*...  #\.. .... ..#\\##\#.   *\...*. .. . ...##. .*..*.. # \ ... *.. .*......  *  *. ..   ..*.....*.. ..#...... #.  .# .*#*# .*..\..#.#
##..\##....\.* ..#... . .. .*..#. \*...*  \. ..  ... ..... \.....#.#.......  ......*.# ##.\.# *.  . \\... **. .......\.   ... #*.\..\..**\.##.\.#*.. #
#.#.#.#..*..... .#\. #...#...  .#..\#. ..#......*..... .\.#.. \..# ...*... #.*\.  # ..#........ .*... ...*..  . *\ .. .*.\....#.*..  ......   .#  .*##
# .  ...#......... ... ..## .* . .. . .  ..* .#.. ..**  ... ..#.. . .#...... ..#*.*. .*.\..# ...  \....* ..#. .... .. *.*  .... *....##......*.\...\##
# *.#\.. ......*..*#*# # .#\. ...  *.*.. ....#**. .*.#.\.\ .*  * .....* ..* ...#*  #.. *.... ...\*. ..#*#....  #.*. ..*\.*..\.....*.#** .. \.. **#.\.#
#.... .. .. ..#. . .\. * \## . .... ..*.\ ...\ #..  *##... .... . #. .\..*...\*...\*. *#. .#..\. #...*\..\\ .  .#.*. . #...\.* ..*.# #..\# .. .....  #
#.*.. #\*.*.. #... *.#.###. ..*. .  \#.#...##..... *#.. ... # . .... ..**..#*.# .\* ...#... * *...#*\.  ......... .## ... .*.. .  ...\. .*.*  ..# .#.#
#. . **.. #\... .\..* .*.  .. *#*. ... .##...*\...  . ..\.. . ....*...*... * .#.*\#. ..    .#.\. .  .. ..\*. . .*.\*.*\#.......*#  ...#......# ... ..#
#..#...\...#..#.\...#...*#\#..#*.. .#...  .#.. .#..... #.#..#.*.\... \.*.....* .. ..#.    ..... ..# *. ..**..\..#**. .#..#. ...  **.....#...  ... ..##
#########################################################L############################################################################################