###################################################################################################################################L##################
# ..# . ......*. *. *..#.*... *..... ...*..  \ .  .....**....#...... .\...  . ..\#*# ... #.. #..\... *.\  ..*...*...#\*#.#* ....  ..  ..#\* ...*# . .#
# . **  .  ........ ......#..*# ... ... ..... ....*#.#. # . .....   ...##..\...#\..*.\...** # .##. .... . ....# ... . *..... .*.\.#.\  .... *...\\..\#
#... .#  . \*. .\. ...*.*.....#* .\. .....#\##\*..#....*#...*# ..\## \ #.*.* ##.#*#.. .............\.#*..* #..*** ....# ....#.*......#   .** ....\#.*#
## ..*.\ .. ......... #.. .   . .. *.....*\ .*... .  .#  .. *...#...\.#..*.\*. *#..* ...... ... #. ..*#.....\.......# **\*....\. .....*..........*#..#
#.\. ###. *. ...#* ..\.... .\. . * # .*.. .#  .*..*\\  .*  . *.* * .. .#..#. .. . *.*.....#. .*.....*.# ... ..##..#. . #*.  .*.* .......  ...#**  ...#
#..*..#...#... .* ... ......* ...  .\......... *\\ *\. .*.. ..\.....\.* .#..\.  ..* #.**.*  #. .*  * * .\. ... ..#..... .... . . *\....*.\..*..\.. . #
#\ . . ...  .. . ...#... . . *.\....*...#... ##.. #*.... *.* ..*.    .*..# \#.#. .# .# ..*.\.#*.. \..* \ ........ . *  #. ..*... .....\ *.. * #.. .  #
#..**.#....* .. **. ....#.#*#.... ....*.#. .#\ .. .#.. ..* ...#*.* *\.#..#.#. ..\..#..*.... ... ..\..\...  ..*#.* *.#. .. ..  \.. **.*....*.*.\.#.\. #
#.\*.........#..**\\*. .....**.\.......\.#..*... ...*.  .\#.... ## .  ..*. #.\. .# .*..\  .*.......... . ..*  ..* ..# .... .\.. .\..\#..  *......#...#
##*.. #..##. .*.... .# .# #\ .  .*...... .*\  ..*   .. ..#. \.*#..*.#*#...........#.#.....\*. ...#.....*#...*....# .\.. ... .#. ..* .\*  . ##....\.  #
#...##*\ ..... ....*.*#  ..* ..... .  .... .*.. .........\....*.*..\... ... .* ..  .* . **...# *\ #. .. .#.#*#.....\ #. ...\...\*\... ..\. *...*#.  .#
##. \..*.* .#\.*..\..#..**..\**#..... #*.. . . #\. ...#\.#. . .. *..##\...*. . ..#...   ...*# \ \.\.# #..*\.##...... *. .*#  .*..*..*  .\*. .. .\.. .#
#. ....   .#\# .. *...#..\. .. .#...#.. . #\.#. .. # ........#... ...\*. .. .. #**....# ...#*.*.  ..*..* ...*.. ..#\....#. .\\#.. ..*.*...*  .\...*..#
#.*....#..# .*.#...#. ...... ...... *#.*....*..\.. *\ *.... ... ...  \.#...***.. .**.*  *. *\  ..*..  #...#.*\..  .. ##..#*  .*... *..*#..*..... ....#
#......##.#.  \\#.... . . ....*\***.# #. *... *..##.. # **...#**..# . ......#.\# #. .  ..\.*...  *.. *.. . #.*.*\..#*...# ....#...  ...#...... . *. .#
#...\.*..  ...#. \ #\\.# ........#..#*#.....*.. ...  .  ..*.. *.# \......**.. .... . .... #. .*.  #*...... #. \. * ....#. ..*\.# *.. . ... .#\. *\.**#
# #\ # .#.  . .#\ #.#. ... *#.  .* ..  . .*..*..*.. ..  . ....## .. ...**... .\#..... * \ . ..*...* .. *.  ...#. .#.*......**#* ...*\**\.##.....*.* ##
# ...#\.# ....  .\ .#..*.. . #....#\*.**.  ...#.. ..... *\.*......... *...... .......... .*#. . ..* ..  .#.\.. ..* #.*.#*.....*. *.. ...  \.#..*. .#.#
#.   *.* .*.. . .... .##.....#.* ..  . .*.. ..  ..#.#...\*...#..  \*#.....# #\#.* # * ..... .... ..* . ....# . *......\. . ....*.........*.... ..*..*#
# . .. ..# ...\ .... *. \ *.#\#\   #*. \.....*#. .....* .#.*\#.*.\...  \...*. . ......#..  \....... .*...# .#. ..... .. .\ .\ *.#.... ..... ..*.. * .#
#.\\...#.....  . .... ...#.  ... \..  . ..\...\  #*........   #... .**........ .....#.... ....#..    ....\.#*. ....  . .#. . \...* ...\  .\ .#..*....#
#.# ... #.# .*# ....\ *...#.\*... *.*..\.  *\.#..........*.*..\.. .# .  *\....... \.\..# ..*....*.. *.. .... .  *....\..  .  ##... ....*  *....#\....#
#.#..# * ###. ..... ... # *..... #  ...\..  ......\\.  \\ ..# #..\. .#.\.. *. .....*..  .# ...#.. ..#*.  \ ...*.  .* ..*.  .. # #...#.# ...#.*..\..\.#
#\*. ...\#*  ..#. ...*..\..\. *...*..\.. .*##.#.  ...#*.... #. ...*   ##... *#.. ..## .*....###........##..... ..*..   . .#\..* ##..*.... # .... *...#
#*#...*#.#*.....#...*.. **..  ....\*.*... ... .....*#. ....*..... ... ...*.\#. *.....#..*.   .  \ . #  * ...#.....*........  ....#*.*..\..*.......*\\#
#. ..*...... ..... .  #..#. ...#. #.\\\.  ..**...*#  .*#. .....*..  \.  ..#....    ..\*...\. ......*.*. . ##...  * *....*. *#.*\   #..*#. ...#.  *..##
#.#\.. .# . #.. .... #..#..#*....\....... . ......#.*. ..*  ...*.... ....* #.*.#..#.....# .....*....*.#...... ..... .....**\   . ..*.\*..*..*.....\..#
#. . ..... #.#  ....#...  . ... .....*.#. #. *. ..*##..*.#.**## # .\...*.#. .\*.... . #....** ...#. .**..#. . .....# .. .*......\ . *  .**.......\*. #
#..*... *.*.*...##. ... ...... #..* .*#...  ...\... *.........*. ........  . **#.  .. .# .....\. ..#.#.*.   *....#.........*..* *... \. ......  .  *##
#. *.##.....\....  .* .. .*# ..#.\. #.\#.*. ##\..**..# .*..*.. .   .\ ....#...#\. #.*.. * **. .* ..* *. *...\*# *.**..\#.. \#...*. .* .#.*.#.. .##\#.#
##..#...# . \*.# .#* .# *.*\... ......#. ...*#. .*#. #..*##*  .....* ..* .#... *...* \*. .*. .#.... . ....*. . \..*... ..  *...#..........  \.  #.*. #
#. .*..\*.........# *.   \..\#\.. ..# .....\...*.*.#*...#.#.  .#\#. .#...#.*  * ....\.*. .*\.*... \. .#\. ..* .... *#.\  .#.......*... ......*.##. ..#
#. ..\#.#.*..\... .*.***. .# .# .*...**....... .....#. ... ...*. .  .. .....  .. \\ #....... *....*. ..#...  . *\ ....#......\.. \. . . .#...*\..*..*#
#\# ...**#.*#.....*.#  **...**. ..#..... \#*. .# .  ##. #*.*.\....*....#...#.... *..*# .#.. **. ....... .*. # *..  #... .*.....#\... #.....   . .#*. #
#.  . ...* *.#  ... .##. .  ..\ .* ... ..#.## ...##*. ....*#..*\\ .* #...  *..  .\#..#.. *# .... .. ..*..#....#. #.*.  . #.*..\#... .... .. .#. #*  .#
#   ....\*\*....#...\.*. .# . #. ....... *. ..\.. #.# #..\ .. #. ... \..\.#.*\... ..##\. *.##.*..*\\. # .\.\..........#.#...\....*# .\......#.##.. .##
#  ..*#..* . ...#.... .*.* \ ... . * *\*#.*..\......... ... *.*.#*.#...* # ..\ #. #* # . *.* \.. .  .\...* . .* ...# # .*\*....#*..*...#.#.....    ###
#*. ...   \ #. ....# #. ..\.#..\ \........ .\....*..###.  *. \.    \.*.* .    .###..\.\..... ...#.. *.*.........#......\..*\ ..... ..... .. #.... ...#
#.**.... .. ...  ...\  ... . *. # . #.#.\  .. .\\.\. .#..  .\. .....*#.*.\.*. .*..* \..#*.\. *..*..#*#\.. .  *....# ...#*...... # *..\. .. *#..*..\. #
#.*....\....... ..  ... ..# ..*..*..  .. ... . ..  .....*... ...#..\...#.#.. #.*..... ....*..* . #  .  *.** .#..#..*. ...***.\ ..... .....\.. .   . *#
##..#*.... *..#   ...\..\**    \...... ...# .*..*. .\ ...*.*.#.   *.\ .#. *\*...\..... .#..  \\ .. #  *....* *#..**.. ..  .**.* ##......*..#\*...#...#
#....*..* .*.. .\  .. # . . ..\.*#......\.*#**..*.. .*..# ..*. *. *........*.  ... .#......... \...\*..*. . ........ .*...    *.\*\.....  ..#.##..#..#
#.#\..*.\....... *# ..#. . ... . ...*.#  *......*...# ...#....... *.. *... .  . .... ..* .#.*. .  .#.... ......... \.#.*...*... ....... \ #.. .. .. .#
#*.#.#* .... ....## .\. *#\.. ....  #.....*.....#*\....\  \...*..#..\\\ .  *.  .# # *#....*..## .#*.... .....\.. .#.. . *..*. ..#.*...*.. ..#.#. .**.#
#*.#. ......\* #.\ .\  ...\....# ..\ ..#..*.... *  .#.. ....#*..# #...\... ... .. ..*#.. .. *. .**\..    #. #   \ .*... . #*....... ..*....... # .  *#
#.##..........#.# ...**... ..\.*.*.*..\#.........*..*\\.#.. ...  .  ..* .#  . .*\ ..\ \.# #. .*.*\.#.....*......  #  **......  ....  ..  . .. .\.....#
#...#..*#*..#..*.#  ...#.#   .......\. ...*..# ....*# . * #....#. ...*. \ # ...... ....\*..#..*. .... ... *..#..*...........\. ..  .....*.... ... ...#
#..#. . . .\#.. .*.#..#.\..#\. \#.#. ......*\......... ..#.*. ....*..\.#....\ #**....*..... ..\ .*. *.*.... \ . . ..*   .* *#  *.# .*.. ... . .*. .. #
#*.. *# . ....  #.... *.. ... ... \.##*.#* .*...#.#. #\ *...##.#.... ... ...##. \**..**.......#..  ..#. .... . . ...* ........* ...*..#. .... . #.. .#
#\\. .\ #. #.#. . .##.....# ... \.....#..... .. . * *. . ...*\  .  #.. #.. . *.\.\*###.* . .\.*\.. . \ ..#. ..*. \*\\*#..#... \# .* #.. .. \  ....*. #
#.*..*..#\.. ......*..*.*. ........... ...* \..... .*... #*...  . .. ...***... ... ... ..*...**\.\..*. *....*#... .#.#.  .*... .*   . ...\... . ..#. #
#\**.\.. ..  .*...\..# ..\.\ *** .. .*#......\.##.#.....#.\  .. ... ..\..\.....#.\* ...* .   \ *... ........#..#.... #*\*#. *\#..* * . ... #* . .....#
##....#. *#*.  .  *..*.**. ... *\...  .# .#*## ....* #....*.*.  \.\\..\     . .  . *...#.\.#.\ #.*..* ...... \ ........  .. . .... .... ...#...** ...#
#  .#...* .*.\..  #.*.*#.  . .***.. .. ...*.. ...#.  .... #***#*.. .. *..\\\.*... . .#... ...*\.#\#  . ...*#....... ##... .\#  ...#.*.# ..#* . *   ..#
#... .*.#..* #*  *..*. ....**.* \..#..#.  ....*.#*...*.. .   .*... ..*....#*.#.  ..#...#.*. .#*.##.**.... #.....*. .#. .***.   \.......*...#. **.\...#
#**. #..  .. #... .. .*.. . .#. . . ... #\ . . .##........... ...#   #.. ...\ ..*. . ....#.. .. .*\ .. .**. . ....\......#.##..#* .. * . ..  .*.  **.#
#*...... #...*. ..*. \#......# ....\...#.*....*\ .. . . *..   ........*.....\. ....#. . .\... #.. ..........*..# #.#.. ..#...*..* *...... .#.* . #.. #
#...## \. .#.. ..........    .#......#...#. ##. ..*  .*.# #....*.. ...*...#\ .*..\#.....* .#...#.... **.* .....*..*## ....*....*... #..#*....    .\..#
#\\ #. *...   .*.#...#..*...  #..*. \* ..# .#. \......\ . * \.. *\ #.*..*.#...  . . ...*.. ...\#. ## \..*.*.. *.\.* \\.\. ..*. #**... . ..\. #.*... *#
#... ..  . . ... .. ...# .#. . ... . ..... * *#  ... * ..*... # #   #..#...  .... ...  ....\.#  *.. .. *\* ..*\.. #.  #. ...\*.#..#..#*......\.....# #
#. *. #**### . ...\ *. ...#.# ..\*..   ..#.\...\. .*\. #.   .  .*......... ..*\** .**.. .. ... ....##... .#..*.. .. # ... *#*#. ...*....\ #*..\ \..#*#
#. .....*.....# .#*. *.#.\. .  .......*.\.  .#......   .*..#. ..#. \*..\ * *..#.# ..  * ......... .#...# ....** .....*###. \.. ..* *...\..\#.. # #\ .#
##.....*.......*... *...... . *\..#......\.  . #*#.....#..*..*.... .. ...  .*.....*. *#.. ...*  .#*#. .\.. .... .#... ..*. .*....\.. *# ..\.... .....#
#*.#. .... ..   ..*  #...##....#......#. ..*\......# .. .  . .......*.. . ...   ...*..*  *. \ *...*.. .\.. .# #.* ...#.*.    ..... .#. ..#.. ...**\###
#.......*.**.\..#. .. . \. . *...  ..#   .##..\.......** *.\ ..*\...   .#.  .#.......#.*... ..\.*.*#. ...... ..  ...  . #. \....... ... ... .... *\* #
## **.*#. .... ..*........#*......*.. ...##.....*.**........*\  ... ..#*...........#..*#...#.* .. ....... ...*...\.*....  .*....#*\... ##. # .. #.#..#
#*...#...  . #.#*..*.\.....\ *.*  .. \.#... .. .....** ...**.. \ ## .   *#.\* .. \.. *..#.\* .*\\.\  .#.   . *......\ ..*..**..*..#..#...*.\.....*.*.#
# ...# ......#...*.... . ..... ***..#*#.#.*...#.\\..  ..... \.#..........#..#.*.#.*...# . ..\.*.#...#  . .. ..  .*....*..*...#.# \ .. ... .***.. \...#
####..#..#.*#.... ..... #........*#.....  .* .  # .  .. *.... ....*....##  \..**\.#..#..##..** ...*....... \. ...#...*. #.  ... *. \ ..#.....\ .... \#
#.*\*  *.#. *##.....#..  ...*. .. .... . .##.......  # .#...*....* ....*. ***\*. .#*..  ## . .. .. .....#.#.#*#. ........*...*.*  . \...#.. .*#.. ..\#
#...\..\.#.#\. ..#.#*****.. *..#*.\.**.....*  . \.........# .*  ..#.  .....\.  #..*..** ..* ......  * ....*#. . ... ..........*..* *... ..... ..\....#
#*.  ..\...*#... .##*#  ..... . \#......#  .#.... *.#...#.*...\... ..#..... *\...**.  *#.*#.. * .#.. . ... . #..*#\..#.#..#.... *. . *... .  .. ... .#
##  *. .#.......#..\.*. .\....... .\. *# .* .#*. *...... ..... ..  ...... #  .#.. .# .*..#.. ...#.. ..#.. ..*..#.*\..*. ###.*.....#\*..   .#...*\....#
#......... ...* #.#.. ......*. ..#. .   #..*...  ...**.*   .. ....*.#**.\.\.. ..   *..#...\. .#. .*  .# #...*. #...#. .  ..*  *.*. #*.*.*....*.\.... #
#...\.\ # ..#*#.......\....   #....    .#.. .*... .............. \*. ...*.*.*... #.**.*.* #.   ...*. \    . .#..*.  .#  .#.#... .......*.#. ...*  . .#
#*.. #.. .#.. .... *...# .  . .#. #.*. .. .#..* .. .*.......... .\  .##...*#. .. **\...\*............ .#*.* . ##.. . #\*\#.. ....... . ..\..*.*..#.# #
#*..*# *..* .\..... . #.\... . .#. ... .#*\.\...# ......\.  .#.**.#...#* ......... ..   ......... \. \ . ........\.#.. #.......... . ....... ....#.. #
#*... ... .. ...#.# . .....\..  ....*. . #.\..   . .. .#.........*. .....\. . ##...#*.#.......#\ ...... *..** ..\ .#..  \*.......*  * .. ..#  *....*.#
#...##.  ......... ..  . .. #.\...\.*  *. .#.\..  *..*.... ....  \#.....**.*.. . #.  ..##. .#* .\.**..*... . #* ..*..**..\ ...*..*...  #..*#. #.. . .#
#. . .....  ** *. .  .#\..#..#... ...*...#.. ....*.#.*.#.\#.....#..#\* .... #* .\.  #...**.... ... ..\... .* .#..*..# *. ..#.   .#\...... *.. . \#\..#
#.#...*.#  #..*. . # *\....#..   . ...... .#.  .#...... #...#  .*# .....# .. .. #.#..*   .\.\....#.#... #.\ ......#.# . *#.  ... .**..# ...\.\\*#...##
# ..#.. ...   ..*.  ##. ..*\..*.. *.....#*..\.###**......  .\.*...\#.*...\*   .*. #*\. ..  .. . .....*  . ......... .# ........ *...\  * ... ...###..#
#.... . ..#.#...#...     *.\\*\*. ... #*...#. # #..* *\...........#..#*...... #..*. #..\...#..... ...#.. ... ...*.. ..... \..... .\. .*#.... ... ...##
##*. **.....#..... .... *.\. #.*.\....  ..... ... ... .\. .*......*.. . .... .*\.#..\\. \.. *\. \..#.#* #..#.##\ .#\#*..###  ..  \ #*.# .*..  .... ..#
#*#..  \... .. ..\... . .*#..#..  ##.#...*. *....\... ..*...#.*.\........  .*\........ ...*.*... .. \. .# # ...... . . ....#...* .* ..* ...# ... *...#
#.\.  #. . . \ .... \*. .  .#. #.*\*.\ ....\. ...*#.*... *#..... .  *..#  . .... .##.. . ..#\ . .  .* . ... * #...* . ..# ..* .. ....*..#. .. . .. ..#
# \. #....#.*.. *\*..     . # . .. . .... ...... . \. .# ..... ..  *.....#..... *.. ... . *.... ...#  ..#..*... .*#.... ..* *...... .\.... .#... \* .#
##\#...* .. .*.. ......  .\.\..# ....... \  ...*....  .\*.*....*\.#.*.... .#.....  . *..\.#. *... ..* ...  #..###.. #...... ..#..* .....*.. .*  ... .#
#..*...   .......\...*...\..\. \ \.* ....... . *. .......*.#..   ...\ *...........*.....#.#..#....... .. .\.*.\#... # ..# ..#. #....\* . *....#..... #
#. #...... ..  .  .... .*.  *. # .. .. .  .........\.*... ... ..  * . ...#...##..  *.*.. .\.\....*#\ #. ...  *.#....*.\... * *\  ..   \*. #.*..  ..*.#
#.#*. #....  ..*#  *  .*. *#   .*#. #. #. . ...* ..  ... .\\** .#. ......*#.\#... ..#*\#  ..# .. #.........#. .*.***. #..#..#\.\..... #.*.#...*\.*.#.#
#  R#...\.. . . . .. .#. .* * .... #..#.. .... #.. .*#**..#\.\....\.. .  *...   *..#.**.. .\**....*.. # .#... **..\......# ........*.\ ......#  .... #
# .... .. *... \* .....## *#.*.... .# . #. ..#\..#. ..#* .*. .* ...\.....  ...*...... \#.#...*#.*...... .#..\...**.**..  \  ..*....*..#.....\* . .#..#
#......*.*...... .  ..\. ... .....*# .  #.... ..* ... *  .... .....**.*.*#..*.\.*#  \.#   *. ... #* ..#.. .*...#.#......... . ...*#  ....#..*..*.# ..#
#.# # \* .. ...#.**. .* #.*#..#....#....#\. .. ..\.  \..* .\ ... *..#..... .#\\. \ ....*. .  ..... . .#.......\..#.*.\#.#................. #..#.. ...#
#.\.*. .. #...#....#.# .. .*#....#. .\\... . .*..*.##*..........*.#....... ...\.#. ..\ ..# . . . ..#.*. . . *\ \.... ...#  ..... .*..*.*.... .#*.....#
#.#....*...*.###.\*. ... #**.##..##  *.*. .\..*.. #\..*#...... ..  ..*..... ##..... *# .. ....... .#... .... ...#.... ..#.*  .\#*.**....*** *..*\*#\ #
#.... .*.#  .#...#. .  .........\\.. .#.. ......#.  .\ .... \...#... ..  .... ..*.....* .......... ..*..  . . .*...... .. ###..* .. . ....*..    ..#.#
#... ..#.  #...\#. *#.....*..#.....*. \....* . ...  . .. ...... **...\ .#\.\.*.*.#..  ...*.*.\.\.....\... .. ..*...\....\.***...#\#   ..\*..... ..\..#
#.......\...#.... ..#\ .  ...*......#.. .*..#..#\.. #**#. . . ..#..#... ...   ... ....\.  .*.#.......*.  .#. .... .*.## *  .... *\ *.#... ..# *..**.*#
#*.*. . ..**. .#.*.... .. ##.\.. \\*  .# ...\.... .....*...*..*.  *...    .\ .#.. .. #.. \## . . ...* . *..*\ .....\.*.. *  .**. * .... #\.  .. ...* #
##..#\#..#**.\  *..#  ..**..*..\. ....* . . \.*...... . ..\*.. # ..#....  ... #.#...*...........\... #..... .. *......*.#... .\. .#...  .*.. \ .* \. #
#.# .*.\....*#*..\..... #...# #.... \.**  ...\ #.. ... *.\*\.# ...*..#..#....... .*. ##\...... \..##*.. ..*... .*.*.. #.... .. ...*.*... .  ..  .* ..#
# .... ..#....# ...#.. . .....  .\#.. .*  * .. ....  .*.....#. . ... \... ..#. #\......*.#.   *##.#.  .*.*..* ...*\. ......*...#.*....#.#...*. .*....#
##\ ... ..*  . . ..... .. * ..\.*.*.#..*.\*#. .... ... . . .  .. ...\\ #..  ........ .. ...*.. .. ..    ....##.#.*\*...#.#\  . ......#..*..*.#... #..#
#. \...... ....  .*.#  #. ..#. *  ...  *....  #. \...#..*# .  *. .#.. ...## .\.....#** **....... .#   .* ..#..*....# .*#..#......# *... .*......*. ..#
#  #.. .. .....#* .#.*.. .* .*#\#. ...*.  ..*... # . .. #*.#  .\...#..* #.*\# ** \ .  \. ##\..*.# ...*.#*.\.# ....... ..*..*...#.\. .. *... #. .\.#..#
## .....* *\.  ..*...*#\......*...  ...\. .... .\ . #... #....#. ..# ..#. .# *....\ ..\#.#.#...   . \..#..   ##.#. . #..*..##.**#\\#.#.. \. . .. ....#
#. #.*#\...... \. ..#*.  ...*.#..#.\.......  .# \ ..#**....*.\.  .\# ### ..#...##*. \.... *.\* .\#.  ....... #. . . .. .*.. \\... ....*. *..*.... .. #
##... \\.# ....*.   . .*. **...# #..   *..... ...*  ..\ \ ..# .#. ..#. .   .#...\.. .#..#\..# #...*# .*. #...*#. *.#*... . . ..**..  ...#.**# .#.#  *#
#...*...\.. \.*#..*..\ . #. ...*....#  .#*.  . *. ..... ..\#..**\\ #.  .*......#.# * #. *\.. #..* #..* *.\.. *.\#  * *..##...*...* ..\ ..\...#  .. ..#
#  ..*\ . .    #..\....*. ..\ ..*....*. .*..#. ...#..  #\.#.... ..\ . #.#. .    ... .#....*.. .*...#\.\..#. .. \.. #. *.#.##..\.. . .*\.## .. ... .. #
#*#.. \.\.. .*.*.....#.#. ..#.... ..... ..... *.....##*.. .\..*# #* ...... .**.  .....*.* ... **\... .\.* .\#  .  ... . *..# ...  \ . .#..\........ *#
#. . . *#.... ...  *.  #.*.. . . \.\.. *#   . . ... .\  *  * *..##.#...#.   ..*...*..... .*.  ##.#..#.# ...\.. \. #*..#...#.. ...#\#.. .. *.*#..*....#
#. .. *..#  #**.  ......#\*.. .*  ..\. . ..\.#..... #. . .. *.... .\.. ......... . .**. .....#\#....#. .. .* #.#... ....#.... . . . ......  .#.\*... #
##.*.*#. \..#.....*..##.. \.....*... ..\**. \.*.\ #.#..*\..\.. ......\ .. ##\*. . ....#.*.....#...*\.. .#......\*.  .#..\ . .......* .  \ *.*..#. *. #
#.. ..    \...#..#....  ......* ...*..#. .#*.. ...\ #.* ..*..#*....... *\*.. . ##... . ....*..\ ... ....\... ..  .\........ ..* ...*. . .....#....\..#
#\.*.....  ..*.. ....#  ##.\.*.#....... *..##.*.\  \.. ......#.. \. .* ..*.\*. . .  #\.#*...#.#..*... ..* ..*#... .*#.** .   ... . .*..\.\ *# .... ..#
#*#.. ...#. #. *.# . *  ..#.... ..* .#. **..... ##... #.......*.\#.. ..*.*. ..  *.*...*.. .. .  ..**... \.....*...\..#*....  ...*... .. #...# *#. ..*#
#**##..........*..... .**#**#\#..#\.#....\\ ... #\.#.  **. .#.... * *  ....#..*  *. . ..  *.. # *.......  .. * ..#. \ .... . \ ... .#\.**\...  * .\..#
#...... ...  \....#. .... \..*.*.\.#.... \.*\.#. .....# ...**#**\.# ........ .\..* *#*.#.#\. .# . #..#.. . #.. . ... #... #. .#..... ....  .. ...  ..#
# . #. .#..  . ..   ...\*...**..... .#.*. .. . .##..#.\**. .....# ... . . \. ..*.#. *..#. #.#.#..*.  \ . *.**.....#....#*.  .\# .*.  ...#.  ..  .*...#
#**.  .....   .# ...##.##..  # . .\ ..*. .. .  ...#..# ...\#\.....# **.  #... . .....  .......*..*. ...  ..... .\...*.....* #.  .#. .... ... .*.*....#
#*... ..# \\...#  #** .... #..*..*.... . ...\......# \*.. #.......*#  *. ....*...\...\.. . .. ....*.*.... ...\#.. .*. *#....*..#...*.*.*.\ \..*....#*#
#* .. .... .#.* \...#....\ *... .#... .*.*.....*.#...#... ......#*..*..    .#.*.... .. *... .. . ....*.#..... .. . .....#.. .*..**\.... .*.*. ..*\#..#
# ... #*###*.**..  ..#\ .# *..**#...**..*\##..  #. #...\##... *.*.# *.#.* .. .# ...\.\.. # *..*\...... ..*..*... ....\ ......#. *#... \ .  #. * .....#
#*##*.. .# #*#..\.# ## \.#. ....##......*.* . .#*. . *.# ..  ...#* .* * .*. ...*.*.*# .. . .. .* . #..**#.. ..#..\ .* *. ........ *## #. ..... #...###
#.. ....\ . . \....*.**.. \.. . .#     *. . . .#... ... ..*...**.. *......... ..*..#...# ## . . .**.......  .*.. . .  #\..\  . ...#.#*  ..*. ..#. .\\#
#..##*#...#... #....  .... ##. .  .*.*   ....**#\.#.*..  .\....###.. ........\.. \.*.\.......#*  .. *.  .##..... #.....#.....*#.*.#. #\...  # . *.#* #
#*.... .*... .#*. .*...##. \  #.  .*.. ..........   \  .*\.*. #\.#*  ......#.. ......* * .\.\  ..  ...##. .. .... ... .....  .. **... .\#.*..........#
#.\. .\ ... *....  .... *  .#.. .# .     ...** .**  \*. ..... # \*.. *..\... \ \....\.......* \*. .#..... .*# ... ..#.#  #* ...  . * *\..*.....# *...#
#**. .  #.##.. ... .....\...* .**..*#..*.# ***.. ...*.. .\*.. \ #. *.#.......... .. .# ....\# #. ...\.. ....#.\.   .\ . ..  ... .#. .. . ..\ # #.....#
#*  #.###.*. ..#.*... .. #. .# .#.\..\  ..**... ... . \##.. .  #.# ..\..# ..*. .*##*..  * *.**.*\#.. ......*# # .#. ..*...#.* \ .*....*.... . ..#.\#.#
#*.#..\  .. #.  #*.#.....*  .#.. *. .. .# .... ..#. #.\..*...#*..##.##.*.\ .. ...... ....#....  ....# .\*. .. ....** ##..... ..#. .#...#..*..\. .#\..#
# ..........*. *#*...  .*...\##. .. * \. .\..... # ..#.*... .....#....\.... #  .\.*#. ..#.  ..#..#...\..\.#   .*...*#..#\#*..##\.. * ...#.....\.. #* #
#. #.. .. .#* .#*.#* ..  *#....**.... *... .......* #. ...#............ ..  *#.#.# #\.*.  .... ......*#...*. #.....#.. .   *#\..... ......#...*  *...#
#... .*.*#*...#.. *.#....... . ..# . #.#.*  ........#*.\.#.. .#. # . *.. ..  ..* ..  # .. ## . . ...*.\...#. ***..  *\....##..  *..#** .\....\  .....#
#. #. \.# #.*.  \. ....**.. #...\.* ** .#.   ..# ..*. ** ##.# .#.#...#  ....*....*.#.......# ** . ..*#* .\*.. .#...   .... .*. .\**#.. ....\....\*.  #
#.*\.#....  .. ...* ..\....*\... .... .#. \. .. ..*..*....*.. .* . ..#. #  #. .*... .* \\. .. ..#**...\\..\.. . #.. ..  .......# .. .\ .#... .....\\##
#...... \.....  ..\. ......\.  \....*. .##.*.. \\ \.  *  \...#..#.#.* ....#. .*.*# ..... . .# .*#....#.*..*. . \.. #.##..##.*. #.#... # .##....*. ..##
##.#...#.. ..\.#.\.#.    .....**\... #.#*.*. .**.*. \  # ....\\ \.  .*. \.#*##. ... # ... *.\..\*.#....### .* .\##\\* \\.  #*.*#*#*.\... #...#...#...#
#  ..*.#.*.*.... \.. .\.*.. ..\...*...... .#..\ ..*  ..*.*.*.. . ..... .**\. ..*. .  ...\ #.\.. \ .*.... *...#.. .#  \. ..#.*\.....*  .\.. .  .. ... #
#....\ ..*.\..#.#...#*. #. .*......   .. #..* ..  .........*.   # ..# *# ...*.*#**. . . #. . .... #.#. .. ....#.**\ #. .\**\ ..\...*. #  # .. \*.\.* #
#..... .\.\.. .*.*.*...# \..# ..*. *.... .*. . . ... . *..........*.\ ...#.*.**.....*.* ...#.. #   \ ... ..*..\ . .#\  *#  .....\##  \... ...\. .... #
#....\#..*.#...#..*......* .*\\...... ....\..*.# .. ... #..... .\* .. ...... . #*..\......\  .#.\ .. #*...  .#...*. \.*. .#  .# ....*.\....*\..# ..#.#
#  *.*.\#* . .\.  ..... * .# .*.#. .   ....  ..#. ... . \.......**\ *. * #. ** .........  .. .*..#...... .# .##.#. . .. *.*\..\ **. .... #..*. .#**. #
##..  ##.\ . ..#...... # .. .. ...#..#  ..   .  . .. ...*.#..#. .*....#..#..#. \..... ... *.....*.  #.......#.............*#. # #. .. .. .\.. ....*..#
# .  .#..... ...# \....... .*.#*.*.. .# #.......\..#.#. .     *..* . .... * .\...# ..... .#.#....#.  .. ..\*.......#..\.*.*  ##. . #. ..* #.# .  ... #
######################################################################################################################################################