######################################################################################################################################################
#.\ * .#\ #  . ... \*...  *# # #* .#\ #.*.  .. .*.# .#.*.*...... . ..... *.*..**.*..#..* .. ....# .. \.#.*. .. . .# .\.. ...  #..#..\... .# ..#..\.. #
#... ..*. .....\.#.. #... ... \ .# ..#..  . #...* * .. *# .#* *..\. .. . *..#.* .  .*. * .**.**.. ....  ..\ ...* .# .*...  . #.*#.#.* ....\.\ .....* #
#*... #\*. .#. *. . ..*\.#... **...#*.....#...* . #.....   .#.*.#.*. ..\.... .. ..............*\ # *.* .. *..#. ..# \*...... # * * **..   .#\.    \*.#
#..*  .......*........  ... ....  . \ . .  .. *.##\   \....*... ... .*..... **...\...  .\. ....#.\......*..*..#.##....#.*.#.....*##.. #. ..*.*.*.#. .#
#.. #... .\..\.. .* .. ##.\....*..  ...... .  .  ## .....# .## . .....\. ...#..... .. \ #..# ..#..... .#...#..# ..*.     . .* ...**.*..#.## .#. ..##.#
#*..... .#..\ *.#.#\... \..#...\\... . .\  .#...##.. *... .*.* . .  ....*#.. . #   .*#. .... ....* .....* #.#.\  .#..* #*...... .#..#. .... ..*#... \#
#... ..  ......  . .... #*....#..*\....*.  ... ... ##.. . . #... ..#............. .#\.#...... *.. ..... ..\.#.... .. \... .....##.*...\.. .#   ......#
#...#......#. .. .  .........#..  ......* . ........  ..* .# .** *...*. ......  .  #. #.* ..*... .\. .. # .\....* ...  **#  ..  ..*. ..* ......##\. .#
#... ... ..\...*.......#. .. . .\.. ..... ..*\...*..# .......#.  \### ..\  .#  ...... #...*. #. ... ..# ..\#..... .... ... *.... ....\ .#..  \......*#
##.#\  ..... .*....*#.  .*.* # ... ** #.. . ..*  ... ##..#..*..#. ...*. .*...#\*.*.....  .#..*. .## * .   ..#. \.#.  \.*.. . ..* **.*\#.*..*.\...## .#
#\.*.. ....*....  #....* * ..*... *.*  *#.. ...... .*. ...##.\..#  #.. *.......* . #*.. ..... . . ..#....\..*....## ..  ##. #...  ... . .#..**..*#...#
#. .  .......**. .*#* .#..#.*......#.#\ ..*...\*.#.. .# .*..#.#...*...*#...\. ..\*.*. # . ...#.. . ...**#.  .... ..*   ..#...*#**.#. .\......#\ **#*##
#\ *#. ..  . \#*.*....... .. .. ## ..**..* #\...#.*..... \.#. .#... \ .. ....#.**..# *...# *\........*. .\. *.#.. .*.......#. \ .. .\.. ..   .*.. .. #
#....\.#...........*.* .. .....   .. .   ..#\.   ....*....*# ..## \. ..\ ..*#* ...\#.*. .#* **.....#..*... *..#..*.. ##.  .* .*.. .  ..   \ ..  . ..*#
#.* .... # .#*# ........ ##..  ..\*.*..*.#\..* . ##*..   *..#..#...#. .. ....#*  #...#  ....*  .\.\ ..*..  #.  \ ......**....*....*.......#  ...*. .*#
#. .\#... ..*\.. . #*. ....   *.. *.#.  # . \ ... # *...#*.\*.*##..#.#\ . ... . ..###*..........\#..\.*.....#  ..##...*\..## ..#. ....*.\. .\. .#\.. #
##.......\.* ..\ ...#... . *#..... .# *.##.*.. * .* ...\. #\.** *.  ...\ ..\*.**# .....  ..*.*...*# .   .# ..#.....\#.*.*..\.*. ..... ... . ..#...\\ #
##  .... **#. ..*\  ... \.\ . *....... ...  .. ... *.. .# .#.. .*# .** .* .....#....##*\ .#.**...  ....*.\*... .*  ....#.*..  #...... ..*  #.  \#.. .#
#*#..#.\..   .*** .#  \#\...#..#.. # ..\. . .. ... *#.\\\..#... *. .##..#.#**#...#.*.... #\ .. .. .  \*\... .. ....*. . . .\#.  *#.\.. \. ........*\##
# ..*.... ... ..  ......#..\ ...*..\.*... *.#..\..  . #  #....\*. \*.   *#.* ..   ..*. \.\*...** .. ..#..*.. .. ... ..**...*##..*\ ... .#..#*.* #*#..#
#. .  .......\.##..#...##. ........\..##  ...* **  \ #.\   . #... #*.....# .# ..* . \   .....*.*...\* ...##... .#.  .. .\#...#..**................\. #
##.*.\...  #..*..##. \. \.. ...\..\ .. ##........ .. ..\#*.. ..#*..\**. *..#...#\...#. \..... .#...# . *#*  ..# ....#...  \. .* .  ..\..##. #* ......#
#.*..# #.. ......***  . #. \..#.... . *. ... *...#*.#.. * ....\.  .. . \ ......#*.....#..\..\#.#. *...#* #.. ...*..#.  ... ..*.  . ... ..  ... ...\.##
#..#.#..........**.  ...*.......*##*......**.# .#.. .....\..#.#.#. .*.. .. . ....*.. ....**.#\ . .#........  #.....\.....#..#. .. \.*.... .. ..#...*.#
#... . ..*..*....#...#....\ ....#  ....*. ...# .*   . .. ....#..#.\*..##\. *...*.*. * ....#....#..#...#*.# \  .....*.*.....#*..#   .*..#.#..*. ..*.*\#
##.. .. .......\..\..*.\.#. *.......*# ...*. \.  .  ...#  ...* ...*..\*..*...*  ....\#.. *\#*##. .   *...\#\\..  *....*.. .......*... .\..# ..#..* ..#
#....\#..\.. .  .\\*..\## * .... *...*. . ..\ .#.\ .. *. #...*. \* .... ..\. #...* #.. ...**.***.... #. .. .*....#..** *   .*# ...*. *..#.. #........#
# ....#*..*\..\...#..  ..*..*** \*. .. \......  ..#..... .*. ..* * *.. .*\   *.**.. ..#..*   .* .*..#.\.#.  ## #. \ .##. # *\.*#.....*....\....*. ..*#
#.. . .. . ....   ..    .. .\. .# ...# . \ .... ...... ....#..*..* #. \ .#.#\...#. .\ \. #...........* ##..  #*.... ..*...  ..**#.#......\#\..**.#*.\#
#.......#  .* ... ..#.#.* .*... *  . .**.*. .**. .#**...*  .. . #.  ..   *..#..# . #..#.... #........\.. ..... *\     #. .. . *..*..*.*  ... . .#. .\#
#\.. ....*.......*. #..*. . *# . ....*.#*....*..* ..  .*.#....  ... .. #...#  .\.* . *...*....*.##....## ...*...\**...* .#*.#..**\.. ...#*\ * .... ..#
#** #*#.*.. ...\#..*. *..*.. *.. .#... .# \.\..*#.... .. .........* #*\..# . ......*... ..* ..* ...*\...*..*.*....\*#*...*.##**.**.  .......\*... #..#
#* ## .#...... .    ... .. ....#.... .. *\ #\.. .* ...***#*.*\....#  *..* *  .#. ..\\... . \ ...*# * ....\* .....**.#. .#*...\.#.#..#..#. .....*\....#
#....#  ..# .#* . ...  .  .* ...#..# . .#...... .***\# . * .* .\ *\  #  ..... .  .. .. \....*\ * *..#**. .#..#.#* #  \.\#.  .*... ..#.... ...*....  .#
#.# ...*  ..  . \.* ... ...*.#..\#...* ........  ...*.. # .. . * * . ..... ....* .. .\#..*#  .#\*.*.\.*#.*. ...#...#.. . ...........*.......##\.. .* #
#\.\..  .. \\*.*..*...#. ## . ... ...*.#..* **. ...*##..# ..*#. \ \#.#.\**.. . .\*  ......**.*....*  . . *.. ..*\. #.\.#...#.*..#. .*.*.. ...\. ..\. #
#.\.\* #*.##\ \#..\..* . ..*... ##*#. ...#.#* .*. #......\ . .#.*\ ...*...........#*.. .....\...*#*..#... ... * ..#.. ..  .  ..*......#*. #.*...  . .#
#.# ..*..  \... ..\ * *..... #...  .#.## # **..*#.*\ ...*.*. *. \.... .. ..#*... \..  ..#*...#....* .. #..\ #*... .#*.#... *..\..*  * ..\* ##.*... *##
#.\..#.*....*.. ..#.. \. \...\.\...... *... ....*..... .#.....#  # \#* #..*..#  ##.. * ...... ..# .\.... . .##..*. .. . .  #...   #.....*..#*.......\#
#  .. .. ..*.**.. .*..........\... .*..* . \ ** . .* * #.*..\. ....  .. \..#..*\....#....#.\\...\.\... ..... .... .#\....\\\*.#.#..*... \.*#.......\.#
#*...*  \* ...###. . . . .*. ...*..... . ......#.\ \# ...*.#. .#... .#.*.\*........*\..#.. * .  .*.  *..... ...\.**. . .. ..#.\.# *....... ...#.\....#
#.. ....*.. ...\ .*.*.... .. *\* ... \#.#...... ..#* . . .\\ ...\# . ... * ...* ..*.* ...  \ .. #.. ..#.  #.#. \..#...#....#. ..#. .. .*.. ... . . ..#
##.#* .\..*....#.#.. .. .* ..  .*....\# .... ...# *.\......*.#\....*.......\ ........ . . ....... ...... .#...*.........  #..*  .......#...*..\*..\\ #
# .\#.\*.......*## .*\......\ . .. #....... . #.....\.#*...#\..\\ ..*.#.. .......*..\.**.## ##.#..#**.\ .*.*.... .*...#.# ....*.. ...*....  *#\#..  .#
#. .* . . .. . .*....*..\.. . ....**....*.*  . # ...*.*  ..   . .*  .*. #. #...# .....#.#   # . . ..#*...*. ....\#* ...\#* ## ..#.#.*#.. ..## \.....##
#*... ......\.*......# .\... .......# #... * .# . .*. ...* ...#......\.*..\.*...*........ ....  ...*.#........  ....  .  . ..........##. ....\..\. ..#
#  **.\.*.. ..\\.....#*.#....*.#.......\...  .....*.\*#\.*. \.*\... ....**. ..#\##* #.........*.*...  .*# ... .\ ..*.*. ...#.......#\..\ .... #.*... #
#.  #.... #.\....#.\.. ...*.....*. \*..*.. .*#**.*... .\\..*..  .\* .. .. .#.....#.... ...* ..*..... .# #.\ **.#\\\..\.... #............\.##\.......*#
#. . .*# . .... .*#.........#*.# . .**\#.*.*.#\..... **... #  ....\*...  ..#. \*...* . .*..#.# #.... ....*.#*... .#. .**.. ..*\*. .#*. ...  ..**\....#
# .*# ....*  .#  .. .#.... ..\\#\....#..\.. ..*#  ... ..*  .*.. .#*. . \ . .#.*.#.\##.  .  . * .... ....#*...*...*#.......*.. *.#.#.#..#..\.#.* ....##
## .. ......#........ \.....##. .*.... ... ..*....#. .#.. ... .   #... ..*.* .. * .\  .....**......  ......#*....*...  ..*.. .  ....*. .#\.#. #..  ..#
#...#.*.......*...   .. . ...\\............. \. . .  #..*. *#*   #\.  #**. . . ..*. ....*... .... * ..*#...#....\.#...# ..#..  #..# *.*\. **\  \. .. #
#. .. .# ..#. . ..\*..*....#. .##. ... ...#..#. ..#***. .* *.  *.. # #. .# *  .*..\.... ...#*#*...#.#.\*. .\.#  . . ....#...#...\..## **..#...*..#.# #
## .. #...\. .. \.... ..*...*\ .. . .....# ...#.*\\.#. ..**...#....*....*..*....... ..#*\# #..**.. .*. *..\.\... ..###... *\ ..... .*...#.....\....#.#
#... . ....#..#.......**.*....#..#.#... . .# .....#.  ...#... ...*. .. ..#*...**#.   ... .. .*#* .\*  .#.\...  ...#..*.......#...*\# .*\.. . ........#
#..#.**#....*#.. ....*.*.*. #.#...* ...  \.\.R.....##.  ....# ...#..* . #.#*...\... .**..\.#....\...... ..#..... .## . . ..*. ..*..#.# \  \ \. .. ..*#
#. .*.##..\\...*\. ...*..*....*.........*#* .*.. ##...........* *...\ .* *. .* . .*......\..........\.\.*   .. \ ...#\..* *.  #. ...#... . ........ .#
#\    \**  . *\ \. .....#. . ......... .#...#.. .*\......#.  . . . ..#.#*... .  .\\. .\ ........... .*. ..*.. . \*.#\..# . *.  .\* .*...#..\*.*.#.#.*#
#.**.#... ..... .*..  *..... .*\ *....* \...* ..*\..... \.  . .#.. ...\\... .. .. ..# . *. * .. .. ....*.**   . *.....*.\.#..*.\..\ .   .**... ......#
# #.\.  ... . . ..\#  *\.#.....#.....  \*.**# *...#...# ....*.*#. . ..... ....    ..  *....#..  .\*.*. . .  . ...#. *  #..# .# ..*.... \...*....*..**#
#.   ...* .....*. ......  . .. *#.\.#.*.....\.* .# .............*\......*. .* .....#..#..#..\..\.#........# .#  ..  ...*. ..*# . .....#.#....* * .#..#
#.**#.#\.. ....\.\...*# \...*\.##*...# #* ..*..#... ..* .\.... ..\...* .......*.. ..#.... . .#..**#.  .. .#.*.\...# #* .*... #. .#. * ..# \.*. ..... #
# \....*.*.. #. .\...... ..##.    .. .#........*..#..***..# #.*.....***.......# * .... .#.. . *.*.....  .* # .. . .**...* #..*#...#\...\ ..\# ..# ..##
#***........ ..  .#*... .... .* ..   *.   .. ..# *.. ..\ .....##... ...#\.*.#. . #... .     \... ...#..... . .. .#. .##..... #.... . * *.**... .#.. .#
#.\. *. .*. .*..#......*.# .   ....#*..* #.## .#\  . *..**...*  ....  \. .\..*#. .....*..... ....  ..*#\#.. . .... . \. .....#..# #.*\.. .*..# . .*..#
#... ..... #....#**.  *# .\*..*. ..*. .... #* .*.*..*. . \ \....*..* ...##....\*..# .......#. .. *..*.. ........* .. ... .\ *.....##...*....*..*.. ..#
#.....* .....#.....*.... . ..#. *\*.## . . ...\..#*..*.... #...**.*#*.\.\......\   .... ## *  ...#*#.\ .....*... .*\.......*#..#.* .  .#.\..\ ..*.#..#
#.* #.*.. *    ..\*...\*..\#. .*.....# .\*....#.\.....*.. . ..\#.# ##**. *...\ .  #* ..  #\.  #*. .. .#.*.. .*#. ##\.#.#*...*...*....\....  ..#.  .\.#
#.* #*#\. . .. .\#. ...\..*...**###. ..... *# .........*. . .... .....#.*\.#....  *.*\. .*...... .. . #.. .* *\..# .#..*....#.# . ..*.# . ...*.. #.*.#
#.. ....\.* . ........ ... #.. .\...# .*.. .\. *.*.#....#. ...\...#.#.......*.. .* .\#*#..*.....#*. . .. ...\\*     \. . . . #**.\ \*. \\.#.\.*.\.* .#
#.. .. .# . ##*.*.\  ... . ... . ..#... ... . ....\ .... ..*\.. #. ....*.....   ...*....#..#.. ..*.  .\...... .....\  ...  .\. .......*\ ...*. ...##.#
#. ..\  .. * .*. .  #... . ***.    . *.\...*... .... .... .*....#*......#....*......* .#.   .#.  \......* #..* ..... . .#... #...#  ...* .\.#....*.\\#
# .#..*.. * ...#.\..... *  .#.. *.. . ...\.  ... .#.. \.*....#.*.. *#...#....*....#*.#.* ##  . .. .**..#....   * #* . ....*...#.. .*...\.\*..*. .. .*#
#. * * .... #.....*   .  #..... ...# . \*. \... .# * \..#. ... ...##....  .*. \#... **.* .......*.. .##   ....  .**..... \ ..*..*.... .....\.... ....#
#  . . ..# .. * .....#...* \#  * .*.\... . #..#*#*. ... .#.. . \ .\*..** .....*. .*#.........*..*  *.   \#....... .....*. .**  #* # .   ... ..#.##...#
##........ .\...#.*.*#.*.#.#..*. ....*** ....\**\*..... #\.  .\.. #.  # . #..#.. ..  #. . . ...#...# ...... . #\# . *#.. *...**#. #...*. #.. . .. ...#
##..\. .\.#. ..#.\...#..*##....\##...*.#.  . ..#.*.....*..... .#... . #  \*  ..\...*....*#.*.\ ..*.\ ..* .\\*.\\. ......#.   .#.#.. ......... . ..\..#
###. .*. .\  .....*# ##\..* ...*..#. * #.*. \..#..*. # . . .\#...#..*.....\*. #.*.*  \. ..*.\*....#*** ...... ....#..# .. ....#*.#....\#. ....*#*. * #
# \.  ....* .   *..... ..**. \...... #.....\...#........  #..#. ...#\.*\.\...  . .#..#.   ..*..\*.....#\* *. .*....*..\.\. \# .#...#...** . .....\. .#
#. .*.......#..#....*.*....*. *#......\...#. ... .*#   ... *. #.... .*..\..  .......... .*.# \*...... #.#..   # \\*#  *#.. ...##..*. .... *....*.\#.*#
#...* .\#......#*\*.... ......* ....... .*#....#..*  .... ....... ..*. ..\#...  .........*.. . .....#.. ....\\ . .\. * .\.#. .  .##....\#... . *.....#
#*.. .#..*....#.... *.   \..*#......#.# . # .\\.     ..\.  .. #.#.#  . ....*  * . .\ #.   .... .. .* *. \#*.*.#.#.#...#*   #.# . *#.....*...... .....#
#....#.....\\..*....#.\*...*.*..*....\...   ..... *..*...\. *\#.  *... . *.*... ....#  ..#.. * .  ...*.. .. ..... .*.....  ..*.* .##. \.....*. \...\##
#.\. .##..#......*  ...... ............ ... * ..*.*.#..... ..#.*.*.... * #... *.. ..*. #*#.  \\.#...    ...# #.\*.*.. \.#. #  ........ #...#.*..#. .\#
#. \.*. ..*\..    ##.... \\.. .*\..*........ . .*.... ##. .* ..  #*\ .* ##\..  .....** *#.\ ..... *........ .......\. ......\.. .#...*  .*...  .#. \##
#.. ....... \ .....#.......**#...\.*.... . .##.....\*..\  \.*.... ......*..#...... ... .. ...... ...#. ....* *  * ..*...## ..#..* *.......\*.## .  ..#
# \.*..\ .. .*  ......* #.. *\.  ....*. .. .*#   ..\.. ..*...\.. . \  \*.\.# ...  .# ...... *.. .#.*.*.#.. .#.\. \\.  #.. .. * .. ..# . \....#.*..   #
# #*#.*# ... .... #*# *.#*..*.  .....#.*.....#.#.. \ ..#* *\ ...*. . .*\...\... .* ...     # .. *....... .....   .. .... *.* ..#.* **..#. .*...*.....#
## .# .#..*    ....#  \#  .#.....  *....* ..#* . *\.. . .. .\.#. * \..*...#.#.... . .. *.... #..\..##.....*. ...... ..  .\......*.\..  .... *..*. .*.L
#.**# \.# #  #.. . ..#* ##  .\.....#....*...\.#. .*   .#  .*....... ** ....... .... .*.# ...... .# .*. . .*.\.\.........*... . * #. ... ... .#...*..##
#.\. ..*.# *   ...*#........\.#.*..   . . .... ..**.... .\.* ..\. *.. .  ** ..*\*.# ... * * .....\ ... .*... #.... ... ... #.**.... .\ .*.\...  #*.\.#
#.* ....  ...\#*  ..*# ..\ \ .. #.*\.# .....#. #\...\.*** . ...*.\...*. #..*...#..# ..#.#.\...*....#...*.\.\#.**.#.. # *.. *. ... .**.. .*.*.* .\ ...#
# .  *....#.*..# . .. *#...  .. .#..  ......\ ..# \ ... .#..*..##* .... .* ..#... \. .\\....... .*.*.\...#\.. ...........*..*\..# ..  ..##.#.... .#..#
##*. .#* .. \  . ..  . .**..#. *.....  ...* #.   .*\.*.. \....   .**.**\..**....#\....* ###.**\.#*....#. . ....*..**... #. .......  .#\. .\.*..\. #.*#
#\**. .. ......#. *.\  ..#....#.*#\.. \.......# .#... ..  .\#. ##   ..... .* .# #.......#........\....\. .. ... \.# .#.#.. ...* ... . \ .\\.  .# ....#
#.. *.... .....\.... ..* * #..... .\... .\ \.#.*#.. ...*.... .#.**\...*\#......*. .#...#.   \.* .........*...*.. \ .. ...*..\##.....*..*.  * *## # .\#
#..*\.#. . *....#.. ....*#**.....**  #..\.  \.\\.##  .#....#..*. ...*...*.*......... ....*.#... .\ . . ... . # ....\...  ..... ..  .*   #* .#.... . .#
#\.*.*. .##.#. *... *.\*..   .#.. ..........**\...... . .\*#..*\ #.* \ . *.#..*..#. #..#.*.. .*.#*.\ . #... #\.  *..#.* ..\#.##. * . . # ...##\ .. . #
#.. ... ##... #....\.*.....\# # \ .\... .\*\.#..#*..#...* ... .*.\.....#.*\...#. ....*..   ....*..** ##.*...#... *.#.... .*....#\.....*..\ ..###*....#
#*.*... #.*.   ... #.*..#.#........ ......#.. . ..#.##..\#.......*... ..*.. .. .*  ... .... *.###..#\.#........*.. ..\..*..# ... . ...#* #..* .#.  .##
##   ...........#....#**..... . .##\\....\..  .\*. #.#.. .* ##..# #..*. **##.. # ..##. . .....#..\... .  ... .... *... ... ..*..*.#..#...##* #..* . .#
#..... .. \ ...\**.\#... .... ....##*..# ##. . .# .....#.#. .....\... .*..*   .\...#.#. .... . *. \ .#.. ...*\.*... *..* . .* . *.. ...*... .#   ....#
#...   *..**. . \ .#   ..*.. ##*... .....#* ..#*... ... *    ...\.. .*....*  .* . #.*.*.\.   #   \#.  \..#..\..##..*\#. .\. .....  .\ *..*.\.###.. . #
#.*# . *..... .\..* ...... ..\. ..\ .. . . \....... ..\..*..  #.# . ..\...\. ..*..*.#.\..#. ...\. ...* .. .. ....\....* ..#. . *..*.....\\# *.   *. .#
#...*..    ..*......#  #*..\.* .. .*.\...\...\.... . \.*#. .##..#*...***#*\ #... ...# #... .......*.\... .#.*\. .  *.\  . ...#..  ...##.  ..\\.*..*..#
#....#.. * .... *.  #..\..*....*#.. *. ..*..\..*.#*...*.  . ..* ...**.. \.*. .. *... ..\#.#..****.......##\...# *#. . *.#  \.. .... #\.. .#..........#
#..*...#... ... ...*.#.\.\#.  ....##  .*.\.... #..... ....... . .\  .#.  .#..... .*\. .\#..\ *.#\# ... .#.    #.. ...   ..   **.*. \. .*.. . .. .*.\##
#..#..*#. \.. .. **   ..#*# ...   \..... .*. \\.. ..*...* ...*..# ..  .\  .#.. . ....\ . ...# ..  *#.* #   ..#. . ....# ....#*.**... ..*..*#*#\\.*#..#
#*...\..*\. .*.. #..\ .\\.* ..... #.. . .  .*#.*. ......*\..#.. *#*.. .... \ .#..###.# .*# .. ..* .. ......  ..#\.. ..*.##..# ....#.*. .* *..*...\..*#
## ...\#\ ..#  \..... *. . .  \..........*.  .... #..#..\.. . .. .. .  ........\.*. .. . #.#   ... #...  .#.\. . ..\#..*.. .. ....* .  ...*\ . ..... #
#.#.......... \.#. ##.. .. . .  .\...\.#. ..\ \#........ * #...#.. # .... .#  \.....*###.***... . ...*  . ..#.*.. \. ......# .  .\..*....\. .*....*..#
#.... .\.#   .... ..... .# \\#..*. *...*..\ \......#.... . ....  ...#.. .#...*..#. ... ..... .##*...... ..\ ..#..... ...#.#*.#.#*..#.**.  #..*......*#
#.*... \....*.*.  ....... ... ...#.. . ..........\  \ . .*.. * .*..\.# \... \*#. ....# .*. #..\...* *.#*.#.. .... .# ...\ * .* ..\....\\...... ...  ##
#\... .*.. .....*...* ..\.....\.#. ...#... ..##*. .......  ..\....*.. * . ....#** .. ....  . ........ ....#. ......*.*..\.. *#.\#\* . ........ \#..\.#
#  *..*. ... .. ... .\.* .....#.. # .*.. \. *.*. *. . ...*...* .#...*..\#*.**........ # ...\ *...  . *. . ..*\..\ . .\. . *.... ....**  .#.. . ... .##
#.*. .\..##.#.....*.... .#.....# # ..##..#. \..#.... ....*.. ..#.#.#.. ......  .*#. #  . #..* ..  .\*.#.. ..*. ..\ .#. .. ..*. ... \##....#..... ....#
#..\\ . .#...*.  .*..\  #*.*.*. #*\.. .. ... .#\\* \.*. #.. ##.\*.*  \ .#  ..# * ...  . #.\.. **.* \#  ..*.#. .#.\. .  .. ..*.#..*....#. ... \ #.. ..#
#. ...\.# * ...* ....#...... .#...#   .#....#......#..#...  ..#.\......  *......\.... \........  ..** .#..*#. ..#....*\**....**.\.. .   .  .....* . .#
# ..* . ..........#.  .  ... .#...# .#.\..* .  ..\ #.....#.# .\#*.#. # *#.... ..#. .. .***..*.#.##*#.*. . .  ..*..........  .   ......#...*..........#
#...*.  #.#*..*..  ... . .... #....*.....###     ... .......*.##....#..    ... ... .. ..\ .........* ##. .# .. ....* .... .  # \*. .. .# .... ..\#*..#
#.. .. ..*.. ... #*.#..*.\ **....... .# .##.*...*.##  ...  . ..* .. ..... .\  ....# #...#..#.... ..*...#.. ..# . .\. .... **... .#..*..\ ..*#.#.#* ..#
#*......*..*#.*... .. *... .. ....*..  .**....*#\\. .. ..*...#\.. .\....#*. ..  .\.* . \. *....  ... .#... **.......#.. .#...## ..  ......\*.*. . \..#
#...*.\   ...*.*. # #.# \..# ...  #*#.  . .*.. #.#......  *....#.. .....*......*. ..*...*\..* #....\..**.. #.. \.*.\. #*\ .*.. .   .*.#.*.**.... ....#
##.*...*.........*.. .........*. \ .#.........  ..#. .**.#.... \ ....#.. ..*....* . #..#. ....*.\.#.... . .. .. ... .* ..#.## #   . ..... .\. #.. .*.#
# \#* #.*  #..*. *.#  *... ........#   ..#\. ..*.. .**  ....  .\.# .   .\.. ....#\*...#...\\\**  .# ...*. ..\.. .*.# \ *#......*   . \... ..#...# \..#
#......  ... . *. #... ....# ...   .*.\ . .\....#...#. .##..**.* ..\...\\.  ...\.#. *.#.....   ..... . . .  .##..#.  #.\.\.... .....#. .#...*.# .*. .#
#.#* .#...#.*.\ . #...*\ .#*\.# .#.. . .#*#. ..\...*.....#.*.........* # .. .. ..* .. ..*... ..\ *\.  ......*..#.#..#* .* ...#  *# ##.....*  ..*#*. \#
#.... . . ...*##*..**...*.... ##. .\*# ..... .#...  . ......*..# # ..*#*..**. ..  ..........\.* ...  ...#.... ... .* .*....  ..\.#*.*#.\. .. . #.....#
#*.#.  .. #....*..*... . ....*...........##*...***. ... #.*.\...*...... *..\# . \## . *.\.\\.. \#\.#  .. ..#..#. ..... . ..  **.*\*# \#. ...##* ....##
###.* *#. #.\ ... .....#...# *. . .. ....#. ...* ..#. ..#. .#*....* .**....*\#..*....\........#  .\##......\*.... .......#*........*# *.. *...\.. .. #
#.*# .* \* *..##... ..#..#.. # *.. .\..#  . **\.....  ..*\... #*.*....  #....\. . .\ ....\. ..\. ..#.... ....#.*.... ...*# * *..*.*\..\.. .\**#.  ..*#
# .*..*..#.\. .. .#.#*..*..... ..  ..\#.*..*.*  .#..\ .\.  .*...\#*.#*.#.*###.\. .\.......# #. #\.##.  *.. #.....  ..#..... . #.\................\#..#
#..*#.. . \  .. *.\.#. ...# **# . .*.*... *.\  .... . \\\\\ ..*# .... . ......#\. * \..  .#...\...*...........**...#......#.#.\..\  *.#*\ .*.# . **\.#
# ......* .\  #...... ..... .... .\#..#......*.** .\. *..#.. .#.....#.**......... *.\ ...\ ..\. ..#  \...#..##.# .* *\... *. .\. ...*\.\*. .....*.*..#
# . *.\.  ....* ..#\.##.\ * \ \.##.#...\.. .#\#..##. ....#*#.\ .. ..#.*.**..*.....#.#.# . ...*#.....# #..*\. ..\..#. ...\ ## . .*..*.. .\..*..... .\ #
#.#. .*.. * #.\.. .....** .. .*\\...   #.. .##. ..#..... ##*.. . .*....##.  .. .\... #...\* ....##..#.*..* .. \.*..*. ....#......... #....# #.. \..#.#
#. #.*.\  ....# . \. # .. ..*. .... .....*.*...*... ..............\ \..*\... #.  .  ..*\... .. *.#* *...*...... ... .... .#**.. ...\\..*...*.#...*. .#
##..#* ..#.. .\ *  .#..\.  ...##.\*#.... . ..#.#..   ...##.#..#.... .  .*...*... ...*.#. ......* .\# ... .\.#..#.*. \... \# ..*.*..#.#. .....*.... ..#
#...\..\... *.##.. # ..#..* ...\..\ .... * ...***#..*  .. ..#..*#.. . .*.*\..... ..#.. ...*....\*. *\##...* . #....*...... . \ *....   #.......*...*.#
#\ #*. \.*. ...# .... . .... *..........# \.. .##*\#.. . #...* ... . ....**.....*.#. *. ....#....#...*....   . .....*..** .# ..*......  ..# ....#.#. #
##.. .. .   ...* ..#*...... *..## ........  *. .# .# .. #.#.\......  .. .  . ...# . ...*.. ... .*.. \. .#. .... .#.#.# .*  ....#\ ... ..#.. ..  .*   #
# .#...\. ... ... .. ...#......... *# .*. *..........###.\ ...#.#.\.. #. .#.##..#.\...... .. .#.. .. #*.# .   .*.. *..*.#.*\ ...#..##*..#.# ...*.. *##
#. *.  ... . *....*. . .... .*....#.... \ \\ . . . .#  ..* ..\..#....*. . .\ *\..#..... ....\..*\..*..#..\.#.\. .* ..... ..**.#.#\\.....  .#  .......#
#..*. #. **.  ...*#.\..#..  *.. *.. .* **.. ..#...#*  \.... ...\.  ...#... . ....*..\.#.#.   .#..# .. .* ... \#\...#..... . .* \... .. ..  ..# ......#
#.... ..*.#. .*.#.#*.\..#...*.#\ ...  #. .. .*...## *#*...#*..*\#.\ * .. ##...\#\ *..... ..* ....*  ..*.# ...  \*##.....\\.##...*. ..#.. *.... *.**.*#
#.... .*.**   ..   ... #... .**.#*...  *. ....*.#.  ..... *... #   ..#\.#.#\ .*....*.... #. .*...\ ........  .*.#...*\\.*#.... ..*. ....*.#.#....#...#
##. ... .*....# .. .... .... #*.#.* ...#......# ......#..*........*..*..*... *#.\...* ....#.\....#..#.\\*.##..# . * ........ ..# ..\   *#*.#\....#*# #
#.. .... ....#.. .  #.  # \* .....#  ....*#.....*...*.....#.#*.\..\# .\.... .*  \## \.... ..*...... .* ..*.....*.##. .*.\......  #*.   #.#.\#...# .#.#
######################################################################################################################################################