######################################################################################################################################################
# . .* .. *.....\.. . .. ..  ...\.*.#.#*.*#*#.#...# ...  *.# .*#...    ..\.... *#\*.**\..\.#.....#.....  #.*\...\*...* .**...*#. ..#.....** ..#\ \.  #
#......# \*.. ....#... ..*.. *\.#  ##.... .. \# \ #.#.#. . \.....**.. * ........\. .. \..##*.\\# ...\.....*. . .*.*\.\#*.....* .#....#* \.*# ..* ##..#
#*...... \ .. .. .   ..#  .  ...........*. # *...... .#...*. ....*.. \.\ *.. # .* ...*.#..#... #.. #.#.*.. .  ...*.\..  . #..\ .. # .\  \. .. .#  ...#
#. # ... ..# .\. ....  ..** #.\.#...\ ..#..##\**...... *........  .. ..  .# .*#. .\.....**#.. .  .......\.*....# .# . .....#\*.. ...# ..* .. *#..*.*##
# .. .* .#.*..  ..*  ....\  .#..#..#..\..*.#... . . ..*#... . *#*..  ....\......*.\ .*...... .*.# #.. .. .... .## \.##..\... ...  #...*..*... . .\...#
#. ...####....... ..*   \ ...* \. # .\ . \# .... .. .......#\.\ ...* ...*..#..* #..**.#  .\*. #.*\#.*   .#...* ..\.#..... .\*.  ....*## .  ...**.*...#
##.**...**..*. *.. *.\.. ..*.\......\..\**.\ .*.#.    ... #..*.. ...* ..  ..*#..# * .. ..*. #.* .....#.#.. . ... . #...#*.....\.* ..#\..#. .....* ##*#
#**... .#. *\.#..#*. *#...  ...*. *...#.#*. ...#   *..#..  .\ \..\  ##. \..  . ***. .**#.*  .#*.. \...#. .#...#.*... .#.*.....#...#\....\ .* ..*  #.*#
#* ... . .  * *.\ *. .\..#. .  . ..........  ...*...#\.# ... .\.* \...  ...#. .##*.# .... \* ...**.*\...*\*.. *. . .**.... ..*....#.. .... .. ..*\\..#
# .*#... .....#.... ...#...\........* .. ##..... * #... \*.#..  . #....*.*. .#. ..*..* \.. ...*..... .#....# #....... #.*..... ....##. ... ...*.*. ..#
##*#. *  **.##..*. .#....... .*...\. #**..*\ #. ..*... .#.... .*..** . .  #. \..*.#.#.... \.. .*# .\*...#..#\.#....*. #\# ..... .\ .. .\#. *...#  #.*#
#. ........\#....#....#.. . ##.*......#...#.# ..\..#**..*. .\.......*......#.......#.#.. ....\.#.#.. ..\... .. ...*.. .........*\.*\.\..##  .\\#.# ..#
#.*#....*.  .. *. .#   .##..  ..\.. .. .. #.... .. ...#. ....\....*\..... ..\*#.#...\.\..# ...#*.... .# .\.... ..##. .#*..*..  \ ... ....*..* #* ....#
#. .#  # .... # #  .*.\. . . .#...## * .\..#........**.... *.* #.... .... ... ... \#. ...  . ....#.  .# ...  .....#..*   *. * # #\.* .*.....*.... \..#
#.... ..*... . .. .....#.. ..\*..#.\#. .*. #. . . .. .. .. ...\..*.... ..#*. .. .. .... .\.. . . ...## . . .*. ....*#*... .... .  ...#*.. \..*.. .\..#
#... .. .* ..........\...#. .*.\..\  . ....*..* .......#.  * .* \..*  . ... . \.   ..  .# ......... ..*...# \# .....# ..... \. .*.. .#*.... .....#* .#
##. #... *.. ## .  ......*.#.. ... .\.#....*   .#. #... . ....##....... .\ .. * \\*...*. .*  *....\ *.## # **.  . .. .*  ......*.#\.. .\. .\ .. #\ ..#
###. #.\.#..*.  . ..#\#..* ... *..*\ . .*.. .\.... \#.  .#\##..\..... ......*.*.... .#* .......*..   *......# .# ... . ..#\..* #..#.. ..\# #.. \...* #
#.*.. ....  ..*.. ..  .  # .....\\... #.\ ... . ..#.#..#.*.  ..\. .... *.\.#. . .*..#  #.... . ...\..# *.**.*.#...  ....## . ..#...#.#.#.# .\..#\##.*#
#.*\\. * . . . *..*.. ..##...# ....  .*..*....#.. #.*##.. ## .. .....#.....*....\.. #..\*   ......#. .*. . ..*.*#  .. .#.\...* *... .** . ..# . ..\..#
# ....... .#... .#\.#....... . \*........ .*\* .... ..*. .*\... \..\. .  .....*.......#.  #*.# ........*.  .** ...... ..#.# .* *... *......... ... #.#
#. *##..#   ##....##\ ... ...# ... .#*....* .*# *.#.  ... .  . . .*... ..#.\. .... \ ...#*.. .. . .. . . .....*. ... .....*. . ..#......# .#........##
# . .....#..# \\*.*.  .. .... ..#..**.#*.#.. .. ..*** .*  .* .. #.*.*#\* ....  *..   ... .*#. .#* .\..\.... *.....*.. . * ....#.#.. # .*........\* #.#
# # .....\....   .....*\.*.. .**... .* ...*... . * .*... #. .\..##...# ... #.. ...... ** ... * #.\. ...*. ... ..#.\. ...* ..###  ..*...  .. ..*  .# .#
#.... *....\#..\.*. ... .. . .##. . ..*.  ....... ..#. ..*  \. .....# . .. .*. . ..#* #.#. **#...*. \... #. . ..* ..# . .#..*\.. ....#...** ... .....#
#. ...\. \ #........  \.# .*..# .#.. ...... ... ....* ***. .*..#...# * \...##....*#..  .... .. .*. #*...*.  .  ...# *\\. . \.\. ..\#.#.... ....... ..#
#.*...*..    .* #.#. \.. .\....*.. ...  . . . ..* ...\*\....# .  * ...  .#.\..# .#... ....\#..\.. ..#..*#\*.\ .. .*\# . . ......#\ ... ......*.*....\#
#.  .....#..\.* .#.# ...#...# ..#.*... . .#...\\.*.. . .....* ....*.*..*... .. ... .... .. *..... .   \...#. .........# . .\.\ ..#....\.#*.. . .  . ##
#....* #. ....*..*..*.*# . \.#..* ...#... ..###.##*...\ ..#.#*..*..#....##\..*#........\.\....... ..# .  . . #.. . .....* .#..\..\ *. *....#. . ...# #
#. #*.... ...#*#....  **...\ #*..*.. *.*....\. .#...#. ..**.\.... ... .. ..#.. .###. ....  *.*.. .  ... ...# \*. .\.  .. . ...  #*\...\... #. *......#
#..* . .#.. .......\.#..#*..... .*# ....# # **..*.* * . .*..\\.  ..#...#.  .*\.. ... .#. . . .*.. *. .\.*\  # . ...*#..\...**. *... *..\..*.  \ #...##
#......##..*. *.\.   #... ##\ .#.*. .\..  ........ .*.. ....# .. . .## #*\# . . * ... ..  .. .* .#. .*...#.....#............. ..  ... #. ..\ ... .. .#
##.*\  ..##   . *.*...#...#.\.*... ........  ..... ..##.*..#.... .  .. #*....#..  #\. .#\* .....*  ..  #. .. .#.  . # .# *#...  .\##.. ...#..**. .*  #
# .. .....*.*.*.\*....**\.\*....##.....#*........\ ..... *.. .. .. ..# * ..#. ..\#.\#\.. #.. . .#.# ......** * .\\ *... .*#...*#..*\.*.......#*.#. ..#
# ..**.*...#.. ..........#  .#. .#....#.# *.#. #** ..#... . #....  .*..#......#  ..*. .# ... \ .* #\. .   .*. . ##..  # .  \.\*...# .. *.\#.\....*..\#
##..\# ##..... #. ..#  .......*\*   ..*....*..#.\ ..#\ .*....#. .......*.*..#\..... \* .  ...*....##*.. # .  ........... #\ .. # ..... *..... * .. *.#
##...#.\#.# ..*.#.\*... ... .**.*.  .. .#...*.. \.# . .  ...*..*. ...\ . ... \*.. .. . .#...*.*#*\ \#...\. \ .. ..*.. ...*.#.. \.. ..  ..\...  ..... #
#..\# .. . *....*.... .*.. ..*....#..... \ . \ ... *.*.**\ ..*.*#.*.##.. .*#.\.#. ..\..*.*. #.*....*# #.*.#.  ##*.  .  ..**#  \.#... .##.#.. \. . .  #
# \.*.*...*. ..* ..## ..*..\#  *. .........\#* .....  .*..*..*..*.. .#... .# \.. .#  . .....*.###...* ..#. #......#\...  .#...# .\.\..*   .#......\..#
#... . ..\. .*..\... ..*..#. ...*... \..*.. *\.#.  ..#.. ..#....**..* .  ... *..*... . .**   ...*..........     .  .. ....# .* **...... . ..*.*....*.#
#.*..\. .\.#..#...#*...* # .\  *\........  .#.. .\*# # ...*.. #..*..   ..\.    .   .  *.....* .# .\.#....** \ ...##..#*.#.##.. ... #\..\.#.... .# .*##
#. ......*###...* #.... .\.##... ... .*.. .*... .\... **...* . *#....  .... . \..\# . ..\.\..   *\*.\  .  ..* .. ..*.....#.. .\. .### * .\..##..\....#
# .. .#\......#.. ..# .. . .. .#....*......*..... . \...*..\. \ #..\* .**.*. ....*  .... .*.. ... .# ..\ *.* . *#  .*......# \.\##.   \..  .*.. ..\.##
# ......##.\*.\. ....##**#.*..#....\ .\.. . \\*\..   .*\*.......... #\.\. .......  . ..... .....*.# ...  .... # . ....*.#*\..... .**....*##.. .. .\ *#
#... #..\# .........#*. ..** .....##  . ##...  *.*\ ..*.*.. *... ...... \ #.\ ..##* *   ..## .....#...#..*#.#. .. * .  ..* .. ..#....*.... #  *.#.. ##
#.. #\.*..* .. .*...*###.  ..  *... .... .*. ...... ##. . ....  #\.*## #  .    ...*#   ... .#..*.. ......\..  # .\ .... . ..*.#. #**. ..  .... . *..\#
#.#\. ...\.#. ....*..**#  \.* . ....\... ....... *#.  .*..\.#........ .. . . .....* .#*.** .#.#. . ... .....* #. .*#.\... * ...  # .#.....*..*.*.# . #
#... ..##  .*..*.. ........* *..  .#..... ..*#....*..#...  .*.. *\*\ . ..\ . .. . ...##.  ..#*#...... .  .. ..... ..*  .. #*.  ......#*.  . ...* ....#
##.##....  . ..*.* #..* \#.........*.* # .#  .*#.##*..#  ...* .... ..*. ..#*... .* .. *.  *  .*. #* .#.. ..... .*. ..... .... \*.*.\.# *.... *.... **#
#* .\....#..*.#.. .#.# . . ... .#........\. . ...  ..#  \  .. #*.*.#......#.*....\* .#**  . ....*. .. * #.*  . #\ .. .*..*#.. .. .#. . .. .... . #...#
#.#.#*.#.....#*   .....*..#*# .*.....* .....\  #..\.  .  . .#...\#*..# .#*..\ ...\.. ........ ....# .#...\... . . ...*.\..  ... ............  ..# .*##
#\ .* #......*.. ..   .. ..#.#* ..  .. ...*..  ....#......#  . #.*  #.*..*...   ...#*.\.\.....*....  #.\.... .#....*..\#... #.......  ........\ ..# ##
#\ ..#....*.....#*....#. .....#*... . ..\ ...*........** ..* \#.  ..  ..*.*#. . \.\.# ......*... ..###.#.. ... *.# \..\\# ..... # ... .*.. ..# .  # *#
#.  ..\.# ...# ... . ..#.# .* ......#. .*. .#* ..  *... * #\..\.\*##**.*.* ...*.#. ..#. .  ..# *...#.. .#...*. .........#.*  .......\... .#.... . ...#
#*.... \.\.#.. ..*.  *....#..\.....#......*.#...#.. \..#...  #\...*\ ......\.. ..# #.. .* . .. #.#. .\ *#.*\.#.*.* .#. #.\.. ..... #... * .......\\#\#
#*.* # #.*\.\.....*.## #. ..*#.** .  . .........#.. ..*..* .\..... ..*#.... *  *...#.*...* *... * . ...* ...\ .. ...*.. *.\* .## .  # **##.#........\#
#.#....#...... .. . ...**... .......*\. . .*.# . \. .*.#.... \...   *.. *. ##. \ *.# .. .. \. ...#.....* .  . .......#. #.***......*..## \.... .\....#
#*#...... .. .. #......... #..#.*..    **.... ............#.# . ..*..#.\*....... *.#..\ \*# . . \...#.*.#\\ .. .. ......* . \* .#... ... \. .#..#.\* #
#..\.. .....*  ...# \ . ........#...*.#..#....\ .. ....#*...#  .#. .  .\ . . #.. .. ..# ..\..#....*\. .\...#.\*..\  . ...*...#.\.. ...#.. #\*...... ##
#*#..... ** #. .. ..   * . .* #.   . ...#.#.. ....\...  ...\.  *.\ . \**#. .#. ...#.......*...*..\.\..\......**. ... #. .# .*. *.  ....*..  .\... *..#
# *. ...* ..*\\. *#...# .#.... #.#.# .\.....*.# .... ..*..\..*.. # #.\.. ..\ . ..*.... .. ..#.... ..  \#*.#   . #.\   .#..*...  .. *...* .. .# *...*.#
# ...#\. ........... ..\\. ...*.. .##  .##.. *..\..\* *\\. .#.... .*.*.*.. .. *.#.... ....*. .\ .... ..# .#... *...\.... ..\. #\# ... ......#.#.*..\*#
#.. ..* .# ..  .... *  .##......#.*\... ...\...#... ...#.....#...... .. *. **. .. * #.. .\*###....#...* .\...#.  ....#.. * ......*.**.*#...*.\***#  ##
#....*.\.. . ... #.#.*.\..  ..*.#...#.   .. *.#.....   .*\..*........\.* ........ .....\.....##.#......*\ .#. .#.# ..\ ..#.. .#  *.*. .#. ...*.*. \\ #
#. . .#....*. #. \\.. .  .\.* *#......* .\...***#.... .  #..*...*.*. .  . ..* ....\..*#.....*#....*#..#... ***.\.\*..  #.. #.# ...# ....#\. . .* .. .#
#. **..#.*.. *##..... *.  .*..\ . .# #..\.*..#..**#  \#.\\\ . .* .# . .#..#....\ ##.*. ......*........* *.*\.... . .  ###...\.# . #. .*...# . ... .*.#
##*\#*..\ *#. .  . ##  ... ... .#.....\.* . ..# ..*... \...\.# .*... ##.. ..... .....  .#\*....#.....*.\*#\#...*.**#..**..     .  ..#*...\.*.* ....#.#
#.*.. ... ..*...  #.... .\\....*. #.\*. . .*... *.#....\\....*\.*... ..#.#\. .##.##.*.#.*# ...*# ...*.**....\........ ..*..... *.\...\#* .*#.\#.. *#.#
# ...**.#.... \*....#\ ..\#.\   .*.....\....* ... #**..* ...#..*.. #.*.#\...#.*..\..  ..* ..*#...*#. . .#.. .. *....\\.#. .......#..#..... \*  .... .#
#..*..#...# \. * ...*..*...# #.#...... . ...#*...*.# #* ...*.*.  ##.\##\ .\\*...##.. ... * .\..#....#...*.. ....#..   ..#........*. ..*.*......#.  ..#
# .#..*....\.. ... .\ #..#.... .. *.  #. . . ..  .. * * . \ ......... ....#.. #...\ *....#..\\.. ..* #.\.......#.. \.  *.*\ \.* ..\ .......#. .\.*..\#
#.. .#.  .. ...* .*#.*.  ....\  *. .....\. .*...*##**.*. .\**#  #..# . ......#.* ...#....\.#  . ..*\..#  #. ..   ..#..  .*.* #*\.. .. .. ...#.....*..#
#. .#.\**# . . **.#.#....  ...... ..\.. \.. \#*...*.**..*.....##. . ##.... .. #.  #..#  *. *. ...*.. ... . .#...\\#* #  *..# *#*\.\.....\**...*#*.. ##
###.*.# .....\.. .*.*.  ...... .\. . \....... ... . .  ....*..*.#.##* *..*\..#..*.... ...*...*#....#\. ..#....... .#. ..#.  ... .* . ..*.**......*...#
#..... ......*.....\.. ... \\..  .. *.#... .#.....*...# ....  .. #.#..#. *#.....  .. ...*.. .. ..#..#.\.# .*. #.. .. .\ . .....# ...  . *  \... ...*\#
# ..* ..*.  ..* *...#.. .# #.. # #.* .#.. * #... .#.\.#...###.* ..#... . . \...\.\*.##.. # ..........   . ## .....* ..\... *.#.  .  .#*#. .\#*. ..   #
#..#.#.  . #........  *....# ..#.#.#..*# . .  * ...#...*...#\  .*...#.\#. \#\.*. #...\ ....#*.\##.*.. ....*.*.#..# ..# *. . # ...*.# .....\##..... ..#
# *\*#.#..  .*..\ ....*.*  *\..# . *.#. #....#. .....*..# . *. .. . . .#....#.. ..   ..  .*..\#....... ..# ... ...  . *.*.  ..\.\*....\ \ ..\.#......#
#... .*\#.* .. ..  .##.  .... * .*....\... . . ..... .\.##...*..*#......*..*...#*... #*.*  *.*. ....*....\...\.. .. * .. ....... **  ##. ..* .*\.*\ ##
# .......  # #.#..###. .. #  #..# ......... ..*. *...\.**.*...\\.  .....  .....*.\....*.#. ..  \...... #.. ....\#. #.* .\.#.* #*....  .... .... \...*#
#\   \#\.. *. ..........#*#...\.#....**. ..#... \...##. .............#..#.*.  ..   ...*#  #*.  .#..*..* ... ......#. .*#. *.. . ......... ..*#.... # #
# .#. . ..... . \#...#..#.....*.*.....  .... ....... ......#.. .. .. .... *..#* .    ..*#....#* ** *.** #..*. .#.......#..##.. #....#   .#.#* .. .\###
#. . ..# .. ....*...#.... \... ..\ \\ . *.*  #.  ...#...\  .#. *..* . . . ...  .*\ .*.... .... .. #  #. #...# . .. #.#.*... ...#\ .*.##  #... ..#..  #
#  .. ..\*..... *.*........\.   *....  .. #*........*..***#. #*.*.\.....* . .. .... #\...#.. ...#..#.*##. .................  .#...###\ ..#..\...  **.#
#....*.. \..#. \#. .#\##*..*....#..\...... .#...#\#\*.. *.#\*..... . *.*.**...\. ... *..\. .. ...##* #.....#\#.*.# \ .#  . \ .. ....#..***\.. #.....*#
#\ #.#*#..##*..*.. \*\  .....#.*.... ...*#.##. *.#. ..*.. ... ... * *\  #...*.\.... *... *\. ..*..........#.*\ .\..#..#..  .. .*.. \.#.*.#... #......#
##...*.\.#\#.. .#.\. #. *.... #.*\.. # ..##.#.#....*....# .... ..# #...... .*..  ... #*.#*.*#. ...*\*#...R*. #.*.*. .##. ...#..   #..*.\.......\.  ..#
#..#.\.**.....*.*......*.#...........\..\.. ..*. . .*#.#..  *......** .# ......*.*.*\.\.. ....****...*.*. * *. ... ... ..*.#.. .\. ..**. .  .. #.*..*#
# #..*.. * ...\.*..\#..... .#.\.. ...* . .  . ##***##.. .#  ...# * .\. .*\.#.\*..  ... ....*.\.   .. .... .... ..#.#\.....* . . \. *.* # .#.* *.# ...#
##. #.. .#. #...#\#.#.#. . .  *.*.**..\.... #..   .#\ ...... *........ .#..... ..\ ..# # #.. *. #   . ...\  # ..#..\  .# .. ...*###. ...  ...##*..*..#
# #. ... ##...... ..#\..* .  .#. .. .......*.*..#.  .#.#.. *.... ..*... .  .#..... .**. #. ......**\.. .#. ..#..#\  . ....# #. * # #\#\.#. ..  .#.*..#
#.* * .....\.....*  ..*. ..\.. ..... ..\#\.# \.. ... .**# ...  #.* *. .....#... .......#..  *\.*..*   .....*#.##.. ....*....*..#. .. .*.\.. .. .*....#
#. ...*#.#..#.  .#.#.......\..*#..*..*#.. #*\.......#.......   ...# *.#.. \.. *. #*.*....#.... .. ##\.#*....  .. ...*#.#..   .. . .. . . ..\ .##... .#
##....# .\.. .#**#...**..\.\. . .... . *.#.* ... \*.....  .**....\.....#..*.  ..*..#*.\.... *.# \.... ...   ... .*. .. .. ..  ..... .*... *..\.*. ...#
#...* .....#.*\*.. .....*. **..... .#.. . .*.#..\... *. ..... .... ...#. #.* ..#. .#\.# ... *... .#.#.  .. \  . \..*.*.*##...*.... ... # #*..*... #\.#
#.***....#  .*...*..*.... .... # .*.*\... ... *. ....*... ....# .. .. ... **.....   .##.  *.. ... \#*\.*.*... .. ..#.\.*  ...#.*\* \*#.\....*..#. .\*#
#..  .. .#.. .....*.  ...** .#***..#*## . ...#. ...  .\....*\. .*\*..  ##. ...\ \ *.#.. .. .* ....#.*.. #..*..... .\... * . .  *.\..*...#.*# #..*#. \#
#. . ..*.#...#... .... # .. .. ...... ..*....#\. # . ...#*.#.*# . .. *\...**..\. \  .*#.. \.. .....#. .#..#  ...#*#*.. ....  *.#.#.#.....# ..#... *..#
### \..** .. *.#*\ . .\ # .*#...##. ..###*. \....*\ #.## ....*..#\........#..... \.\\ ... .*...* * ....*. ..   ...... ... .... ... .  ..# #.#....***##
###*...\.. ..  .. *... .....\. ...*  .....*.. #*......\ * . ......# ..#*... .... ..#....\.#.. ......... ......*.* .*. # . #..*#... .*... \ . *#.  .\*#
#. . .  ..#... ..  ##....\.#.*.*# .. #....##..  .* .#... #.\..*. *   #..*. .... *\.* .....#. *  . ..#*.# ..#*..* . #.\ ....* .\..\..#. .*##.... #.\..#
#.#*..*. ... . ..#... ....#.*...........#...\.#.*.. .. ..\. .#.# . #.\#......*.. .* ..## #... \.* #.*......#...*.#*. #...*.. *.... .#..*. #...*  ...*#
#*.. #* \ ..\.#.*. *....#...#... .....# ...# #* .\.. #  ...* .  . . . *.\\..\. #... .*\\#... .  ... ..#. ....  .\ .. .* ..\.* ...* .#  ...  ... . \###
#*. ..#. **.*..*... ..*..# .... ..  \ ..*.# .#......*\. ...    .*#. * #.  . .*..** ..\*# .#. # ..#... ..\ . .*. *# .....*.*.. ...... ......*#**.*.   #
##..\#.... .#...#.*..* .*#.  #***# ....# .  ..#. ..*.# ..  .#...\*..*...\\. . . \#\ ...# .. ...#..  ..#*## .# . *..##..  ..    .. .#..*. *. ..   #\. #
##*. #.\.#*\.**\..  .*..... ....*.*. ...#. # ..*... .*... ..#. . .#..##.. * .# *.\\... .. ..#.. \. *#.\\#.#...* \#.... **.#*.. . . .. .#..#.*. #* *..#
#.. ..... *.. .  .*.#. .#....*... . ....*........  ....*....*. ......*..*..##. .....* *.... .*. * ...........*  #... ...**. *. .. ..* . .........# . #
#\....#...**..# ... .   .#......*. \.\.#*. #...**...#.##..\...#..*...* *....... ..# ..#.*.\....    # . ...#\* .\... ....  .\.\...#.. . .#... ..   .. #
#...#..#. ..# *##....*.. .*......\*.......* . . . ...#.*.. ..... ........ .# #.. .**....**.  .  . .  . .\ *........ ..* # .... #......... *...\*. ...#
# ...#....... .*...    . ..\ . ....#.\ \ #*....... .  ..\..... ..    ... *.*..*  ....#.. #..**\...*  . ...... .. *.*##*. ....*##  ....  # ..  .....*.#
#.\..  .. ...#*#..#\ ..*. .. *...\* .....#.....#... ..# ... #. .. ..#. ##....#.*.. ..*.. \.*.*.. .*.....#.*. \*.*  . . .* .* .......# .... \..#.  ...#
#  . .*...*.*.\    ...*......  ..# .. *..##*#....*#... .#. ......\.... . *.* . ...\.. ....*..#\...\... #\.....*.. ...... * #.# .....*.... #*....... *#
#.* ..#... ..*.#  .. ........ . #. .*..... #.#.....#..#.. . **\\  \.. .....\.....\. #. *\..\.#......# ..  \....*. ........* ..## .**.*#. ..\....*. .*#
# ... \ \ ..#..#. \.....\....\*........#.. ..\ .## ..# ...* ........# .... .......*##.... .... # ..#.  \ *#.. ...#\ ....... . #.\ ..#*...\... #.. ...#
#.. .. ........ #...\\ *##..... ........#.#. ..#... .... ... #........\  # .\ *... .*#......  . ...#.# .  *#.* #. ......  #....*....*.....**..... \**#
##.\. ...  *  ... .*...\\ ...*..  ...#.#........# .. ..  .. .#*#* ..#.... .#.#....\*.**.  ..#**..\ *.*....*#..........  .....#..  ...... .#. *. .* \.#
#.  ... # ...\. ..*  *# ...#.......  #.#..#\...*    #* . .........\ .*.#.*#\...  *.# ... \ #. .*.\#..#........#.#. #.....  .\.**..#. *...\#.#.. . \ *#
# .**. . .*##.#. .\*......*  #\*.#*\.*##*....# *.*\..\. . \...  *. ....* \.\........  .*.\.# . .......... *\#\\..*..... ..*# #...... .. . *...*...  .#
# .. #.  .## \  *  ..... ..... *# * \..  .*..#.... #..*. . ......  \. .*.......**.*  .....#.... ..#.....#..*.. ...#. ...\. ... ... ..*..#....  .....##
#.... ...... ....*##.. .#...#..**... \#... .. .. ..*....*##.\.#....#..**.   .... .. ....**.*.......*  ..*#..*\* ..*.#...# ...*. ....\. \. .... ..##..#
#.. ..... . ..*.. ..*..#. . ... .\.\ .#... ......  .##.   *......\.#..# . ..*.. #..\.  \*    \ #*... ....\.... \..\\*.*..#. #......... ## ##  .. .*#.#
# ..* \.#\....#. * .\ ..#..#.##........*#.*. .*..#.... * . ..*.. # .# .. .  .. ..#....#. .  .....* ...\..\.*....  ...**\....#..## . #..*##*\.. *\   .#
#* ..... #...   #\.. ....#.#..#\\..\... .....#..... ...*.*. *\..  ....... . **.. .......\....*. *  . ..*.*...*.  .  .. \  .. .# \ *.##... ..*  .. . .#
#  ..**\.#.\ ... .   .. .*.\#...... ...* \*.. .\\..*. .... . * .*..........#   #.. ...*. ##\...\.\.#.. \. ...\. .... ..*....#......*..  .##* ...*. \##
#.\.......\ *.#...#\*..*.\.#.....#.  .. ....#.\\.#....# #. .**.*.....\.**....#.. ..*#. .#.#..*...*#....##*.#.#.. .. .#*\#.. .* #... .. ...* #.\.\.. *#
#*.*....*..**\*...*\.#*. *.*..*.. .... ..\#........##*. \*... *....*...#.*.. ......*.. .*..*.*...#.  .\..#.* ...  . ..* . *.. **. .....*. .\#..#\....#
#*....\.........  \.\ \.\#...\...\. *. #*.# .#.. ..  # \ ...*.*.. . ....## .... ..  # .#...  #..   . *  .....*#..*...*.*..    \#..#\ #....*.\#  .. ..#
# .*..*... #...  #...#.... *...#.   \. . #.*...\..#.......... **#..**.*# ...*... .* ...##..  ....#*..# *.. #. . * .#. .*#...*. ....*.. .... . # *\...#
#* ..# #.\ ... ..*. ..#..\....*.#..*.#...*.#*. . #.#\.###..*. .*#*\....*\  .*..\.#.... .* .. ... ..*  ..#..#...... . .\.**.  ..*.*#.\.*.  . ..\*\.# *#
#. .*\  *  .\.....#*.#......#.... .  .... \ ..... *..*...  .... .\..#.\.......... .. \.\ ... ....  .# *#. #...*.  .  #. .  .\\#*.#.. * ..\....\.#....#
#**..\.. ..\  . . *.... ..*#*. *...   ...#*.*......  *#*.  *.**....... * ... #..*# ..#.#..*. .. .#......... ...##...  . *..#.##.# ..  #.\...#...#..\.#
#.*.*. #.*.\  .... . ..... .# \...* ... # .....\.*#. **. .#.  .#   ... *.#. .*.. *...  . *...... \#\..# #........#*. .*#...\....##....*..#... #. .#  #
#..*....** .* ..*..  #*#........ .. *.  **. ... * . .  .\. . \. .  #\#  #.\ ..*. \..*\..... *.# .. ..  . .............. ...#\. . ...\. ..#.....#..#..#
#*.#..  * ..#. .#.... .. ..* *.#*. .**.....\......*..\ #...... *..\#. \...\....  . .# .  ..*.......*.....* **.. #..*.......*##...*....  ** \.#.....\##
#.  ..# ...*.#.. ...\*..\#  ..... . .#.....# ...#.....#.*.. . ...* #..  #... .  .#...*.. ...#..#..\#. ..#..*. ... ... . #...\......**.*.... ..*.*\. .#
## .#..\. ..***. ##.*....*.. ..\*.*.\..........*  .#...  ....#.. #....*..*.*. *.# .\....*...*. \.. . .*#..*  .  ... #....  \.#...\. #.#..#.##..#....*#
#. .. .. .*......**.. .*.... . .*.*.#......#* .#.........*# .#  *.#\.. .    ......*##   ...... \......#  ..*  ...........#...#*... * #.. *.\... .# .##
#..#.. .*.#..   *.#... *..#  ... ..\*... .#.* ........ ... ...*.*...  ....#..*.. ..*..*....*. .....#....... ... ..\....*\#.... ..... .**..** #..... .#
# \\. .....*   #\ # ..*...*#  ##.#.*  \.**...**...   ... ##.*.#...*#*..*.\... .. ..#. *\.*....* ...#* .... .*.#*..##.... .**#. .\..*\\.*#**. .**...\.#
#.. \..*.\#\..# #.#. . ...#  .*... ...*. . # * #...*# *##*.    ... *. #    .   #.. .*  . ..# ...\# *.. \..#... .#..*.. #...#...  ..#... . ..# ......*#
##....#*#.....#......**\.#..\*... .. .. .###..##   #.#..\...#.#..*.*....\.* .# .. . .....\. .. ..* .. #..........#.... ##.. .*..\.*. .*# ... **..###.#
#...# .. \   .. .#\ ..##..*#.\..*.....#  ..#.  #.. ..  ..#..##.. ........ .*...... \.... *\. ..#.. . ..\..*.. ....# ...  .......*......   . ...... ..#
#  ..**... *#..\# .* * .......# *.#...\....#.#\..*. .\.  .*\*.. . . . \  .*.*.. \ .#...#\*\\.# .  #  .*....#.*#....##. .**#* **#. \#. .\*#.\.*.. #**##
#.. .....*#.#.. ..   ..  .* ..*  #...  .. .*\*..###..##*..\.**.#.........*  .*..#......\.* *.#........*.  . . ......... ......*\\.. #. .....#..*.. # #
#..   ..\....#.  .. ....\...#.\ .* .*.  . ..#..#.. ..*..#... ..* # . # ..\.#.. #  #. # * .#.**.#.. .   ..*....*... ....#...\....... ....*....*.\. .  #
# *. #. #. *. . ... .#*.*# *.#.. . ..  .#. ..... #. #.\......* .#. *...#. ..*...\\. #..* ...*..*. . * \.. .*  #. ... ......*. ...... .\ ...## #....###
#. . .... *  \ \.##... .**.. .. ..  . ...*..\.\.  . .... ..\..##....#** .. *.#\*....* .*...**..#.#...\ . *#.#..#..*#.# .   ...* .# ...  ....#..  *   #
# ...#  ..#.. .....\.... ....#...  . ..* ....*\..* . ...  .\.........# \#....\...\\* ...*\#.. ....... ..* ....# ##..#\... #  *......*...#.. .\ . .#..#
######################################################################################################################################L###############