######################################################################################################################################################
# ..... .*.......... *.\*.......  *...  . ...*..###. *.. *....... .#.. .*#. . .***.....\  ..#..#...# .* . ..#...##.\...*. . ..  ...#. .... .*#\..*.#.#
#    ... # ..*.. .#...*...*  ....#.. *# ..... .*. .. ....#...\ ...  . #..  #  .\ .  ... *#. .. . *#\... . .##.. .. .# .*  . *. *# ...* .\. *#.\ .\..##
#*..#.*..* ..*.   ..  ......  #.*.. ...##  .*.##..\ \.. ...#\... \.... .* ...   .*...*#... ........  *...* .\*..   # #... . ..*\. .. \....\.. . .....#
#.#.* . *.##. ...*.......\#**. \* ....#*#* . ..*.\..... .... .*#*#. .... .. \...  .. .# ......* ..*..##.  \.   .*#..... . .....#. \. . #* ..#. \.#...#
#  .... . ...# ##.\.#*#. .\....#. .......#*. .. .  # .. .#*.###*.  ..\.\. .  *#.. .#. ..... .*. ... ....#..\.. .\ *#  .. #.\.*.. ...*..*.*##..... *  #
#  .# ... . ....... ...\*.  .. ..#..* *\*.. . ...*..*\*#.#\.  ..\ #*\.#..   .#. .* ... *#.#\....*  .. .#...\....#\......#...*....#.#.*... ..#..*. .. #
#*.*..... . . . ...* ......\...#.#  *\.. ... .  ...\.\.*..*.#...##\\...... ... .......#*.*.*##...# ..#. #.#.\....#.\... *#...*. ..* #.\ ..#.. ...#\#*#
##.. ... .......*# .*..  *  *#. .#.  .*. #*.#*.* .. #.#...*..\ *....*.*.\.. .  .. * .. ......... .#.. .. * .*.\ ....*.. .#..*# #.#.\..\.* ..#\ .....\#
#....... .*\# ......*\.. .  .# .. #**.*... .. ..#.... ..*.. ##... * . # ..#...... . .#\# *..#*. .\..*........ .#.  ........ #   . .  .. .*. ..\ ##...#
#.\..*#.\.. ..... .*#..#..\.*. \.. *.. #.*. *#\. ..*.*\...## * . .... . .. ... . * . ...##.. ..  *###*  . ....... *.\  #.. #. ...*.# \.*.#*# .  ....\#
#.. #.#. .#\....  * *#..#..# .   ..... #.#*#. ..*.\.#...\#  ..#.#.*.*......\.\. ..#.. ... .*.. .. ..* ...  .....# #  *. ..\...*. ...**...# ..\.* .   #
##.\.*#..\**... ..#.*... .\..... . .....*\..#.*...  \ \  * . ...\#.\..\*.. .. ..# .*..    ##....*.*.#.....#* .\...*.#.*. .\#..  ... .# .  .  ... .*  #
#.. *. .#... ..*.\\.*..... ...\.# #... #.. *.*..#   .   ...  # . #.  #..#\..##..* .....\*#*. ...  ......#.. ... ..#........#*... . ..#... .\...... # #
#.## #\... ... . .. .*\....  #. ##* #...#..*. \...*. ... ...... *....*. ..  ...\  #....*....##.  .  ...*...#..#.*.....  ..**.#.  ... ...  #..\ ......#
#..\ .......*..*. .\..# ..#  # #.  .......\...#* #.  ...*. #.*...\.#*...\. * #. *. ....#* .......#..#\....  . ....#.....**..#....#...\.*....# # ..\#.#
#...... *#....\..* .. ..... #......  .... *\...#.........  .*..  .. .#... ....*.....   .  *..*.\ . #.*\...\.   ...\. ..... ....#*...#. . .#.... .*. *#
#..*...\. *. .**.*.##\\*# .*.*# ....   #.... \##..... \.. .*..#. . ... ..* .  .#..*.#   ## .*# ..*.*.*..#. \.#\  .... .#*.... ... . ... .. .....#.\ .#
# .\##.\\ #... #..** #..... #...#..##..*. .#.**. # . . #...  . \.. .#...*..*. ..#*.. ...........  . # .#\*.\. ..........*..#.......#*#.. ........\ ..#
# # .. ....#....\...... \  ... *...# \ #    .\..\...# ........##*\ ..    *.. ..\.. *......\..*...... ... .. * *. ..#....#.. .....#....#*.. .  *  ##*.#
#*....  ... .*\.\ # . . .. #.# . .... ..* ...#*.. .. .....*.#.#....  #...*.*#.\ ... *.\.......#.\# .... ......  # . \ .#...*. .* .*\.* . . . ...**.. #
#...  ...#.* .... #. * ...*  .\ .*  ...\.. #\ .. .#.#....#. ...\ *.## #..\.... ... #  # ..... ..  ##...#  ..# #.#.\*..\# ..*.#.\ ..##....*R..........#
#*..*#\.* .. .. ...... *\....*.... .*..*#..#.*  .* .. .## .*  ..**. ..... .*. \#\......\ .#...#....##*...* .*## ..*.\*..*. *.....*.*.# . .....  .. ..#
#### #.  .\\...\ ...*\# .*#. . .*. \.. . .\ ..*#\ **..##...#.. .. ..*.***..**.#..  ..#   . ..#.....*. #. \\ ...... .#.# . .\... *.  . .. *. ....* *..#
#.*..*...*. #..*...*.... .. *.**..# .\\#.#. .. \..\..*#..*...... . . *.... *..*. ..##** .. ...  ..#\*..*.. .....\.  *.   #.*....*....* .##.\.\.#. ...#
# .. .. . #.\*. *..#*.*.*  \..*.....*..* *. ...**....*.....\. \#* . ....* .* .#.#*. *.#.***..*. ..   ...\.\... ..   .... ..   .......*..#   #*.*...#*#
#.\...  ....... .\#.  #.....# *..\.. ......  *.... ..*.*..#*..  ...*.#.#.....*...\. ..... ... ....**...#.. *.... .. ..*.***. .# ...#*. .#...# .# .. ##
##....##.\  *.\..\....#. .... * .# ....*.*.#. # .. . .. * * .*........ # ...# .... ....\.\*.* . ... .*.*.\. ..\.# .\*.\ ... ....*#\. .  *#... *. .*..#
#....##. .#\.. .#.*.*.\. ..\..# #. *..# .*.# .\.. .. ....\...##  *.... ..\#... ..\. .*.\.  *...  \...*.. . . . ..#...*....\..*... .   .... .....*....#
#.....*# .*\#. .*. .*.*.#.\. ..# ..*.. ..\..#.#. ...*..... .\*....  *..  . .....#..##.#.. .. #.\#    . .*.*#\......... ..*. ... # #....#... ..*..*\..#
#.#... .\.*#.*......... ..  .  #....#\. .* *... #.\ #...*... #... .\# .. \*  .*... .*\ ...   *.\..\#.#... \\.#.#.**....#.... .#.* .. . .  # .   .....#
#\. .#.\.*.  . . .*. .. \...* ...*... ....*#  #... ..#.... * ....#...#.... *..#*\*...*.#. .*#.  ...*. . . ..\..*  ...... .. ...\...*.#. .....#. .....#
#.. ..\. #... #.... ..#\...#..  * .\.\.\..*.*.*... ...*....\. ..\# #....*..#.#\#.#. . *.  * .\##\ .  ..#.*  *\*... *. .*.......  . ....*..#*........ #
#. ......\.....#\ .# *.\  . ....*... # #...*.*#..\....#.. .. .\.. ..* .#..#. *.#.. ... #.*.*..*  ..... ...#.## .....  .#....## ......#* ....\....#.#.#
# ..#..# \.*....* .. .*. #*. * ..#**.......*  *..*. .*.\..*. #..#..*...* .\ ..*.\.*.#.#.. ....*.....\*.....*....\.....\......\##.\ ... .#.# .#.... #.#
#. # . .....*  *.#. ..*.. ......*.. ...  .  . .. ...\\##..*##..*## .....#  .*\#..\..#*  ....  .##. .\ . .......#.... # **.*.. #. .\ #...*..  *.#*...##
#  .\..* .... .. #*....#.#.......  ....# .*.*..#  ###..\.. ..#.# * #*..\..* .#...... .... . .* #. ...*.# .. .......#..##..  ....##*** ..  .....#**  .#
#.**.\. # #. ..*...*...* .##.\.. ... * .  . ...\. .*....*......# .## ....... ..*......... .\.*.....# ..#.. .........*. #.. #.... ...*.*..*. *.*... .*#
##.......##..*..\..* #*..#.....*.* .* .........  \.... #*. .. . .. ..#.. .#.... .. *.\ ..... ##\.*....  ..........#.\#.... ... # .......  .*. ##....##
#...##.  .  #..  #..#.....#  ....#...#....*  ..   ...\.. # #\**..... .#     .. #.. ..*.....#.*....*..#...*.  \..#..* ...  ..#..*..*** ... ...*.#.  ..#
#...\..\... .*.  *.#. ##.#.... ... . ...*   ..#..# \..\*#. .#. .*. ...#. \#...*.. ##* .\##...*.. ..#.. ..# ##.\*. ....... . .*#.. # ...#. *\   *  *.##
#\.. .. .*. * .. .#..\.   ....#.\...  *.#.. \*\ .#....*..*\ #*..**\.*   #..*..#.. ..*.#*......*.* ...* *. ....... .... .. *.. \\. . .#*##.* .*# .. .*#
#...*... .....#.***. ...... .....*.*... . \#.#*#...*..*. ... ..  ..... . ... .\.##\.. . .. ... . .###.*. ##* .\ ##.#....**#..##....\*..........*\....#
#. ..... . ... .   ## . *..*..*.. . \ #\*..*\...#.. .*..#...\# \.. .  **...## *\...# *. . .......**. .. ...  .#*# .. \. .*..*. .*#........\... ......#
# . . *     ... . \.. *.#.  ...\.#.. ...  #*.. * .#..... #..   .........*#.....#.*......*.#..* ....\\**..#***\.. *..\*\.  ..#.... .. . .\#.    ....* #
#...#. ..... . . . .......   . ..*.. ..#. *. .....*\.. .##.....#.*. .**. ##....*.. *..#...    .. .. . *.\. #..# .#.#.*... # . . .. . .  * #\   #.* .##
#...*#.*..*.. \.**..*..#. .. . ..*....\.. #. ..#*.#.... # . ....*.  ##*.\# . ..........\ .. .#* . ..... ... .* .. ..*..#.. ..**#  .  .##............*#
###   *. .*.*......  **. ... ... #..\ .#....#..* . *.\.... *..*  .*.... .........## . ...... #.#  ##...# ##....* ..  ...........#*..#...#.\# . .. .*.#
#.\**# .*.*...\.#.* ... ..*.* . .... ..##....#....  .... ....\... ..... *...  # ..  \#...\... .*.* #.... .. .. ..##....##\* ..# # # .. . #.. .*.*...*#
#. .. .....*\..* .... #..#.. . .*. ..*  .. ..  ....#. .....  * * . # .#\*. ....   . #.  #...#.* ...*#  .......*. . # .* .....\*...#....  ......#  ..*#
# \ .*\.*. #..# \.#**...# #*.... #.\.*#. ...\... ..# .... \.#..*.. * ... . #\.. .. *..  ..*..*.*.\...*. \. ... #*.....\...    \.*.*\#**\ .\.# ..\. . #
#. *... #.  * .#..\ ............#. .... ..*# .* # #.. #.......* ..* .#.\#.*... . .. *. ...* .*. *.......* #....*. .# .......#..*# ..\......#  .. \.. #
# .*#..*.# *..  ...... \... ........*.\ .. .\.. ..\ .\....#.......   .\  . ..*\.... .#*.. . .. ..\ #.  \. ........\..*.*. *.. .*.\..... .. ... .#. . #
#.*.  ....#. .*.. ...** \\.\. .... #.. .. #**.... .*#.\  ...*#...#   ..*\.\ \#.... ...\.. ..\\.... .. ....\#\*. ..#.#.* #.*.. .\...#.#...\....*..*...#
#. **.#....**....*#. .#... ....#*.... *........#.#... #\#...#... ....  ...##. # .\\.. ...\ . .# .. \.*\...\# ** ...## .\.  #\#..#..\. . ....#...*. ..#
#.*... ..# ..# .*........\.\.#...#..... .. ... .*. \ .. ...* .....#..... *## .. \#  *.*#....\ .#.. *..  . ..###.*\. *...#..\ ...\..*  #.\*  ........ #
#...*.*.....# ...# .*\#.... .*\ ..... ...# .. .....*... *.... .....*.. .. *  *..*#.#...*#. .... .*.#* ..#.\..*. \...#.. ...... *  ..\.... .. . .## ..#
#.*..*##*.... .....\..........*..#.. ...#....* . .......  #..... .. .\#...# .*\.\*.\## ... ..#.\........*. ... .. .....\ ..... ......*#... . .*  .. *#
#.#.*. . ..#.*....*  .*..#. .  ......*. ##\ .  *... ......   .\*. #.#* * ..* ..#.*...... # ..... #..   ...#  .#.*. .# .....*..*#. .\.#..#. #..... ..\#
#.*..\.  \. .#.. .. .  . .. \*#..* . .* #...\ ..*.#...#. .#*.*...#..*#. #..*.#.#.#..... * .*.... ... ... .. ........*.. ... # ......*.*.\#..*. #.... #
#..**. ...  . ...***. ... .\..*.*..*\. #\...*.\.\.... ....\ ..*.....* . #* .*...  *. .\ ..#  #...# . .. # ##.#..\   .# .  .#. \... .#\.#\  .#. . . *.#
#\.*...*.   .*... **#*.#...# .#...  #.*...# #... #   ..... ...*.....\....#. ....*#.*.#\*. .* . ##.#.# *... . #.... .*## *.* ...#** .  .#.. *.*...... #
#  #...\.  #...... .#. .*..##  .\. . ... ..... . ....#.#.. *...*...\... .#...##...\.. .#...#** \*.. .. *.. .\.. ..\  ......\  .*#\\ .#\.#  \*.... *.*#
#* .\......# *.. .  ##.\.#..  .....# ...  ... .#..#....  ..*.\. ..#.**........\.... ... . #* .....*.*....**\#..##.....*... #... . . #\.    .  #...*..#
#..*...*  .#...#\.# ....**#..*......\......... .#.* ... ...\#*    .......... .. .\ ..... ...\..* .... .....# *. ......*....... # .* #*#........#..* ##
#..\#.#\*#  ...*#.....  ..  #..   *.. ......... .#. .\ ...  .*#*  #.# ..*.#.* . .... .. ..\...\# . .... .\  .##*.. ......\ ...#..*   .  # . ..* .. .*#
#. ....*.#.... ...*##.*\**....\... .#.# \ .    .*.  ...#..#.*. *..    ...  .....  #**..# .*.. . #* .#...* *\ ..  ..*.*.\*. . .##...... ... . ..... .##
#*..#*.*..#.#\..*. .#..  ...#. *..# #\#..  *....*. ....... **...* \.#..#... .#.... .  . .\.*.....*... .. \*#..\... . * *..  #. #\*..  .. #*...*.*.#..#
#.....*   . .**. \..\\.  .. .#.......   .#\..   ..\....\ . *..#.. .\# .. ##....* . ...... ..... ##. ..\*.. ..\ .\#..#.....#*.. \*. #*#*..*..* ..\. #.#
#. ....#* .***. # . \..**\..\.# *.** \#..\........ ..\..  #...*.#...*.  ..*.. .*...*..\ ........ *.*...  .*.. .# ...#.. *.\ *# .....*  .......\*\.\ ##
#   .\..#..  *... ....*...#*#.#*#  ....#.#...#.## .* ....#.*.  \.**#...# ..... ..# . ...*.   #..\ ...\.*\*  .* ..#..*..\.#.... .....#\.. ....#*. \\..#
#. .#..........#..*....\. ... . .# ..*# .*... *.... ......   ..*  .#*..\.#\ . #..#.#  ..* * . . ....# . # \..*. **....*. *.....*.. ...*.#.*##.*#\.. .#
#..#. ...*..#*.... .*..\ ..##. ..* ...* .......# #...*.*.#*#...... ...#*\.......\. ...#\   . .** \.\#.. ...#..\.. .# \...  *.....\ ..#\ \. ..*#.. .. #
##*......*#..#.*.  *. # .# . . .....* #...*..#.#... .*#.....#*. . .... \....... .. .\* . ...**.........\#..... ..**#..\...... .... #....\.. .#*. #. .#
#..*.#...   .*..##  .#* ....\\ \#....   . .\.. .\...#...\ ..\.*. ...   .#\. ..   #.* . .*.\# .......*#*#. #.. #..\.#..*..*.#.#..## \.....#.. .# .....#
# . ......\ ......#.#... *... ..# ...... *\..... *.#..*.#*.\.. .#. #......*.*..\## .*. ... .   .......... ...\.....*.#. ....* #*  .##. *... ... .*.# #
#* *. \. . ...\. ..... .. .* \. .*\# ....*...*...... *....*.  **..#..* #.. #..##...... .\..*.* *.  . ....*. \*#...... .#\ ..#  \ *. ..*.#. .\* #*#...#
#.. .... \.....*...#... ....*#..* ....\.. .#. #. .\...\.*..\.. #.#  .. ...  ..*... \. #..#. .#. .#.# ........\\ ..   .\.## ...... .  .* . .... . .. .#
# .*. .\ ... #..... ....*..\#...*..#...  .. . ..  .    \. . . ...*.. . ..*.*.. .... ..# .#..#..#..* .. .# .\.  \#.. ..#..... \##.# *#  ... ....  . ..#
#   #. ....*.... \#..  .. .\ .*.\...... . #..... ... .\...*...\\#  .*..*..# .*. ..#   #.\ .....  ..#... \...# #.#.\. . ... ..#\#... #*...\ .. .# . .##
#....*..\. . *...  ...#*#...\.*#..#  #\..*#. . ...\.*......#..\.\..* . # .*... ...\........##.\#.\..#  * ...*..*....*#..*..\#\.  ... \..\*\.. \ ...# #
#......# *. \*# \#.*..#   ...*...*#.. ... \..#*.*.. *.** .#....*.*.....#*...*...#.. .* #. *.#.#..*.\  . .#.#. #*.*...#... \ \..#. .... . *# #.*....*.#
# ..  . ..*..  ....  .*.  .  .*# . . .*.......  .#..*. \..*.......*.*....#.. ...#.#......*.* .. . #.* \..*........\... ...\.. *...*...... ..#\*..... #
#. ..##..\.#*...#\ *  .\. .* .\..*. .... *\. *\.*.# *..... ..*#.. . .* .#\ *... ..*.. ..#\*. ..\.... .... * . .  .. *#.##.#.#*.. .#..\# ....\ .* .**.#
#. .#...*.# .*......... ..*.. .. *.. ...#*. .....#.\...#. . .* *#.  . ... ..#. .*.*\. ...*.#..*..#  .....#.\......# ..#.. .*.*..  .*.# .*.... ... *..#
#.. . \*...#. ..*  #..\*\..... **... *. \...#. .. .### . \ *# . # . .... .**\.* . . .  \# .*.... .#\... ... ...** # *...#....# ... ...*#..*..... . .*#
##.. #...\.#.*..#.#. *.. .  ....## * *.  *....   ...  ...*..  ...\..##\........ ....#......* ...   .. ...\.*.*.......#..*. ....\ .*. .. .  . .#**....#
#..*#.. ......#*..##. *. .* *..\*  \\# .#.........  **.. *...#....* ..## .......  \ ......   ......*..#.#*. .....#...  .#. .. ...*##..#.#.........# .#
#..  .. ..*.* .*\.*\ . ..\ . .  .*.. ..*\. . \*.*.......#.#. .... *\....#   .* .#.....##   . \. *  ..##*. #....# ..\.#.. .**.....\*..*............*..#
#.\.. ### .\. #. ...  .. ...  ........#.#.....*. .......## ..# .... ... .#.. ##.   * .#..  .\##.#*. .. # .  ... .. \.\ #..##.#.. *... .#... * ... ..##
#.  # #..* *#... .. .* \..#.. ...*...*..*# *\*........#. *... .  ..*..  *. .*. * ...*.#. .\... .. .*   .#.#..#....#\..# # .#*.*#....*..*....#.#...*#*#
#. ..#... ...#*. ..#..*.. . ..#. . ... ..  ## #..**..#.* *..#.  .*.\** . # .......\.##.#.... .#...\#..*# ... #*\ *.*.. . .... *\..\....* ...  #.. #..#
#.  . #\##*.. .*.....#\ ....*.*  . ..# .##.. **..# # . ....# *.#.\.  .......*# #.*\.\...\. .... .*#.... . . * \.*.# .#.#* .*..\..#..\ **\.*#* #* .. .#
L.... *...\. #*... .... .  * \. ...*.. *.# ..#.#....#.........#***\....*..... #*...   ..  .. \...\........#.*\.*\. .*. .#. #. .#.* #.... ..\... . \#.#
#..##..#*.*. . .   . ... .#*.  ..#....*...\  .. *......\*.#*..\** * ..*\..* #.  .....* .#.... ..#......*\.  ... . ...#\. \*...#...*..... ....**.#.\\.#
# ...  . . #....#. #...*..*.#..*#.#. ..#...  .. ...#..*\.. .. ... .\..#\.  #.#.#*.. \.. ...#. . .. .  * ..# ... #\..... ......#..#....  *..#*....## .#
#***\..*.*....#.....  ..*.*..#....#*...... ....* *.......##... **..#.*.*...\. . . *#.....\...##...*..*.  . .\#....#\###* .. . ...*.    .\ . .* *... .#
##. \.\##. . .... \ ..#**#. .  .*.......##..#. ... .*.#. .. # ... #\ .**......*  ..............\## \..  .*...#.#*..  .# . *....*. . ..*.#..#..#.... .#
#.. ..\  ..\...*.\.. .. \.....#*   * \\.# *..#.... ..*. *.. .  ..# . .\.\.. \.#.\\.. #*.  .\# ..... ..... .. ..... # .*.  .*..   *##..... #  #  *  .##
# #*..###...... ......##..*#*.. .. .#.. .#.# #..#****.\\*.. * ...# .....  ...\.##\.. ...  \. ..   #..#\..  #  ...# **.#.....*.#. *  .# .#.*..... ..#.#
#.........#..##.*.\..* #..*# .**... . . ...*.**#...   #....#\. ..  ..  .\.... .**.* ... ....*.***#* #..... *. *..#.#..\.*\. ..  ..... .*\.#...#  #.  #
#\ . .*  ##... #...#\  . ..#..\. ....#. *#\#\ ..#...#.## .. .*... * ....  *..#....#.*.... . ... .\.*#. .. .. .. .#\.#.... *#.\.  ..# .......*....*..*#
#. .# ...*.#.#*... # .... \ ..  ..#. **.## ...... ....\\. .......#...# .\. #.* ..*#........ \.*....*.... .  *.........*...#\...#.  ... .#  . *. ...**#
# .*\* . ..* ... .. ....* *#  ..#.  ## .. ..  . ..#..*.\.#.*  .*...*.  ..#*..\  ..\* * .....  .. .#* .   .#. #  * ... *.. *.* . ........***#..\. ....#
###..#\#.*\.**...... ..*...\.\...** ....... *  .#\   . . #. .. #. ... .  ... #.... .... ...#..\..    . .*.\\. ..\*....\*..**  . . .#.#  *... ........#
#. ....#..*\ .......#.  *#. .  .\...**. #..... #..** . .....*....#.. .* ......*...  ... ..#.. .#..#.*....\  ....*#..\* #..#.. #..## ..#.. ...*. .. #.#
#.*.*.... #\\..*\ ....#\\#...#.* *#....\....\.*...#\*.#.*. ...*.    .....#\ ..#. ....##... ...* ..#*. *...  ..#  #*.*.#. . #\..\#\**.. \...*...*....*#
# ..  . ..\. ..#.... ...  .  ...\..* *....#..*#..#. \\.# . #..*.   . . .\.#..* ...*\* *\..*......#*..*  ..#. ..# .\*.......... ... .... ...##*...*. .#
# * . ..*... #\ \ ..*.... ..*.##.#...#  . ....*\.* .*\#*.#. .#... ..   \.#.. .*...# ..# .#.\# ....*..#..##..*........*..... .. ..*....# #....* *..*..#
#.\. . .*... .\.** . *..*# #\..#.\#  .. ..#*.. . . #..*..  \**.\#*..**..#. .* . ..\ ...#.*  #*.. #. .#.. ..#.#* . ..... #*. #  ..#  ...*. ..#  .#....#
#...* * .* .. . ....  ##..*.* ...*...# .. * ...\.\#....*#*..... #...*##. . .... #  * .*  # ...*\ ... . ......#*.. ...#.#.**..*....#\  .\ .\..   *..  #
#..#.*....#*...*.\.. #....*....#.....\.   *.   . ...*. # .   ..\#.*.... .   ..... ...  ...#*..*.#. ....#..#.#.. * #... ...  .. \.\.#  .#. *#...  ... #
# ... .* .*  # .\#.#...*.........*#.    .  *....\.... *. .*...# .*.  . .......  .#.....\.*  **..#. ...  #**..\\.  .. # ... # *. . ##.\# ##.#*#. .. .\#
#. ..\...*..\##.#. . #. .# #.##.#.... ... ..*\. .  ....*# ............... ...*.#.. #..*. *.\..***.*.#..*# **#.*# #.. .#   ..\*..* .#. \\..\ ..\.  ..##
##*\  ..*...*.... ...# ..\ . \*.....*. .*.. ..*.\* ...#.*. .#*.... #......#.#   . .....\..\  .  ....#.*\. .. #....*..*#..*..#.. *.  .\## . ..*..## ..#
#..\.#*#...* ..  ....*.......*.\ ... ..* . \..\ #\  *. .#.#..#\\..##..\  ......\.... ....* ..#... *.\... ..*# .  # .. ..#.###.*...\.. *.*.  .#...#* *#
#..*#. . *...\#.....* .#..* .....#. #\*...\......#\...#..\...*.... *....#....... ....#. ...#.\.. . ..*.  . ..........\..##*#. ..\. \   #..\.. # #. .##
#.*.....#...... .*. . ..*...#...\\.# **........#...# . .. ...#. ........**. ..\ *.#.***#.... .\#.#*.    ...  ..#....##  .. #...\\ ..*#..*....*. ..#. #
#. #..\  ... .......*...#.\.#. .\.......*... . . . ...\....*..\ ...* .......#... ...*...# ..*. .. ....   ......*. .*** .....#..*.*#**. .  .. ..*...*.#
#.*#. .\...# ...*#.##....... \   .# . #.. #.....\.... *.......\.  *\.#..\.#..*...* ..\*.... *..\.#......# ....\.  ...##. #...#.. ..........#...#. ...#
# ..\*\\.... .##.* .# .\# ..#.. ....#..#..\.\#..... . ......*..#. .*#*..## .....#.*##  . ..  . .#  ....*\*.. .* ..\* #..... *.. .. .*.#.... .   . ...#
#.#  .. .. . #.*... ...* . **....#..#..* ..\.  .#.. *..* .*....*.#....... ..** ..... .#... ..#..*#.##....  . ...#\ ...  .#..\.*\. .*.# \. . .*. .....#
#  \ ... *..#. ..* .. ..... ...  ..*..   . ... . ......* . ..\ ...*. #   .....#.#.\.#  *... ...*......*. .*..#*..*. ...\.....*#*.# ....#..#. .#.\ .**#
#... *. .* .#\...*.# *.*..*...*#..\.#..*  .*. ....#...... ..*.*.#.. .... *.\.\*#.. . ... .. ...\*  .* *..#*  ...#.\..  .\.#\.#. .. \.**\.#.*.. ..   .#
#. *.\.. #  ..*...# ....*.*. ..*.*..*...*  ...\..**...*.\..*# *.\ ..\.  ....#..  ...\. \ #*..**. ##..*\*..# ...#..*.  *..\... ...* .....   . . ......#
#....*.#... .*...*\#.# ...... ....\*...  ..#* *#. .\...... ... \.#.* #.....*.##. . **..#. *  ... ... ..   #.\.. .*. \...... .# #*. ..  #. ****....  .#
#. *..  # .. ..  .\. \\.. .......* #... \*#.*......*..\*.#.* . .*.\..#\#..#..#....... *.*#..  ##.*   . ... . .*..  .....*# ..#.* ... *......* ..* .###
#*# **....# #..*#.#..* #.. ..... ... . . .*.. \. #* ....* . .\#.##..#... .\#.. .*. *... .#..#.... \.*.. .\...  .#*..... ..#....#.**... .#...\... *...#
#....... \. .**\. *... ..   .#... .* .# .**#......\   ... \. ....#.# \ ...#..#.... ....* ..  ..\\.#*.**......*#\. . #.#.**..#..\.\.  .#. .*.\ . .#.. #
# ..*. ...... . .*.*.....#... ....  ..#\.. ... . *.  ... ..  #\.. ........*...#.\* *. ..  # ..#..  ...* .*.*#.#... \.#..*.. * .#............. .\#\**\#
# ..... ..#..#.... ...... #..*.\*.\\ ....#\# *.#...*#*.... ..\ ..* .*..*.#.....*.  . ... .*.*. *.#.  .*\*....#.#  ...  .#\\. ....#.*....  .\*... *.*.#
#* ....\ .*.\*.. *..* #*. # . .. #\..\.\..... \... ........\ #. #. .. \\. ..#...*.....*..\....# .. . .... ..*... .*.. # ..* ....#\*#.. ...*. * ... . #
#. .....*.#.#.* ..  .....#...#\ ....*.. .  ...*.. .. ..*#. \.*# \ \.......*.. . .\ ...*.\..\\..  * ..  . ......\.\....*##* . .  ..*...*.. . *.   ***##
# .  .... ..\.. .......\.#. .* .. #.   #...... *... .# #...\*. *#. # . ..  .** .\.... # .....*.. ...# ...*.* *....*..#...  .. .. .#*. *..\..  .#..*#.#
#*..*. . ...\#...\..*..#.....# .. \*... ... .\*.... . . \....#. ...... ... .. . *.. . #    **.. #*.....# ..\ ..... .. . . .# ...* *.#.#....#.##.\ \#.#
# .  .#. ..** \#. .. .. .\*. .*#........ .*#. ..\  .#.* *...  *.....##.*# \.. \ .....* *..*#.# ... *\ .#\. .#.\**. \* ..*. ... ....\. .\..* .#*...#. #
##  ..\ ... *.   ..\* #  .. *.. . ....... #.  ..*..\#.# .#...*.\*..........###....  #.\...#....###.#..#\..#... ..# .*.*.#.#.\#..#* .......##.*\#.....#
# ..\. \. .#..\.. # .\#.\.....#. \ . ..*....  *..\.#** \#...*\.\.. .*...#........#. .. . ..##... \ . ..*..\. ..*.......##\..* \*. .  #...#...\.#.....#
#. ..# # *#...\. \ . .\ ...##..\...*\\.#..\.#.....#..  .*. #*#. . .  .... ..  ....#..\.#*...#..#. *#.  *\ .. #\.#*. # ...#   . .   ..#..\... .....*. #
#..... ....  . \ *.#.....\..*\.. .*... .*#.... *\. .#... ...\* .. #..\.*#..  ..###.....  .. .*.*\..*.\.. .\ #. #\.....\..*\...\*.....#.. * \ ...  . .#
##**. .. # .# *#* *.... ....#..... . ..#. *.*.#..#*.* . ##.#...*....*#..#......*....#.\. ...\.*#...... ..  .  ....*#.#. ....* .....*..\\#    ..#. .*.#
#...\*  *.. ..#..\.#.....  #..# #.\..#.\. .. #.*..  .*.. .*.... .*.#.#.....\....\....*. ** ..#*...*.*.\*.#*.*.\.....# . .\......*\ . . ..*.\.... ..\.#
##. #.......*.\....\..# ..........  . .# . ...* .#. ....#.#. . #.*.. .*. .*...\.* ...#  ...*. *.*\.   ... . ...  ...*#. ...* .**.*..\.#. ..*#..#... *#
##....\..#*#.#.#....*\..*...\.. * #.. . .**.\ . . * ... *.*  ..* ..*...\ **.#.#..*.#. .#. ....# .#.. . ..\. .  .......\  .*..\*\.. .  #...##..  ..\..#
#  ...... . .*. ....*.. .* \  ..\*..#. #.. .... #..\#.  #....*#\... ... .... . #\.*...*  ....# #..*.*...  .. #. \.\.     *.*#..... #... ..#*. \# .\ .#
#* **#..#......* *...*...# #\\\ .. . # ..  ....... *..*..*#........ . . .#..*...# ##...*....  . #... . ##\  *# \..*.  #.*.***.#. \* #.*..  . .#.#. . #
#  #...  *.... .* . ..*....#*....#\#  .  ... ...   .\.\. *..*.... \ .  ##. #.. *.* . .. .... *.*\ ..*..*..#  .....  .#... * .....*.*....# *#.#.\. .#.#
#*. #.. .* # .... ... .  . #.. ..#..... *.. ..*.... .\. .. . . .. *..\  .#. \ #\.*#*.*#. .\.###*.. \.\.*.* #.....\*.**....*...* *\* .#  #  ...#.. \ .#
#.##..\.. . .#..\.##*..#.*.#...#..*.*. ..\.. .#......* ..  ##..\ #.#..  .... * #. #. *. .. ......*.**. . .... . ..#.*..\.  ... ......*# *.#....#.... #
######################################################################################################################################################