######################################################################################################################################################
#* #.\  . ..#. .. .#.\##..\# *....\.  ..\.#..\...... .. \ * .. # .#. .\........*.... .#*.  ...\.. .  . . ....* .. \.... *\ .... ..*#..#.. .\.  ... .R#
#...#.............  * ..\.\.##...\##.*# ...\##.*. .#\ #*..* \.  #.**.. #.. \. .###..*. .#.. .\. .  .. .#* \ *\  ..... #*... ..*...*  ..#....\*\.\.*..#
#*  #.# .. *..# ....#.*#*...\\ . ...#. ..... . #...\...#. ...   ..*.\.\\. *#..........# . . ..* .\#**#....*  .*.... \ #.. .. . .#.   .#. . .##...#.. #
#*..  ... * ..\.##...*#.*.....\ .#..  #\.\. ..#. .*. .#*... *. ... ..... .. #*. .#\....*.# .. .. .....\. ..* .   .* .* #..#.. ... .*. \.*......  .#\.#
#.... .#..#.........*...#.  ...*.\ ** *..*.... .*. .....*..#... ...#  #..#...#........ .# .. *..*. #.#.  #\.\\  #*. .....*...#....###. #*#..\..\\....#
# .*#. ... . .*.  *.. #* *.\ . .#\. .. **# .#..*.*  .... .   *.* .#..# ......*.. *. .  ...*........# ...... \*... *.#  .\..   . *.#.#...#. . . .  ...#
#. .#.#* #.\......\....#.  *... ..\.\ . *.*.....  # #......\..\..*..#\#.....**.*............. .. #  \\.\ *.. ..  .....*......*  ..\.. . .. .\  #\# .##
# . . ...  .*#**. .. .*  ..*..*.......\....*.# ..* . *...*.  .\. *\. ..*\...... .#.. \ #...#....#... .. .#  ......#  ...#*...\  .\.. ..  * #.*.\ ....#
#. . .  .*....\.*.* ... .. ... #. ....#....  . ..#.*.. ..... . #...........#**#...*  . ..* \.. .#.  . *#..# .* *..*..*....#..#.*\.. ...*.. .*   ..#..#
#  . .# . #.  ..**. ..#.#.... . ...*. *.....\ .... ...... .* #\. ##....  ....* .....\#..* \\.........  ....#......*........*...... .. *.... *  . \.. #
#.. **.. ..... .# ... \*.#\ .  *. ..*. ..##.*.. .... .. #. . ..*.... .#...*...#**.... #*.....   .*. .   ...*.. * .*.\*...*. #*... ... *\..#.    .... #
#.\**\ ..  ... ...*..#.\*..  ...#.. *# ..#....*. ..\#... ..  *#  .... ....* .#...... ...**...#... ..*.\ #. #*..*....  ##. . ..#.. .... #.. \.. .**#. #
## ..#..*.\...  ##. ##. .....\....    .. ....#.*\....##.*\#...  *## *#..... *.  .##... ....*. #......#.... ....\. ..#...\*\......#... ...#... ..*.#* #
#.#  #......# \.. ...#...#..#.**#. .. ..#  #\.. .#.... .\.*.#......*.. \. .#**.*... *.#..*..*. \..... #. ..*   . \#\. .*......... #..     .#\.*..#..##
#.. ..#.#.*..*. ..... . .....*... .  .*. .. ..#*\....#.\* ...*...... **.#..#. .. .. # ..   .#.#..*  ..*.*..##.* .....*.. *.# \*. \...\#*.*. ..#. ..**#
# .##\. .*... ..\##....#..*..*... .  ##. ...\......# ...*\.. #... *.. ...#.# . . #. * * .... . . . #*..# #.....\..#*# ...  ...... ...#..... ..#.*  .*#
#..#. *  .##..* ...*.#.. \.*#*#. .* .. .#.....*.. ..#..#... *   . .*. *....  .  .. ..#.....\ *\.   # .....*...... .. . ..*\ .  .##. ....*#*.... .  ..#
#  *.*.*.#.. .. ....... ........#..#. ..#.............#   # \*.. ......#\*#...*.....  *.... #.#... . ... .*#....#.. .#. ..#.#...# .#. ....*...**...  #
#. .#.\ #. ....  .\  .. ..*...*.*.*.. ** ....... *.  .\. \ *#...# *  .  #*.. .#. \ ....... # .. *##. ....\.\*\.##*...*. .# .* ...*\*##. *. . *... *\.#
# ..#.. .  ..  #.*..*# #...\*... . ... .*#\\.*..... .\.*#  ##.#.*. ....#..  *#**...#. \. . .  .. .*.*. .##. .. ...# .. .. .#..\.. *#.*.....\..#.   ..#
#....  *\ .#. #..\  .. ... ... .\..\.#  . \\... # . ....  *..*..*. .# . .#.....  ..\..... ...  .....*... \*\. .......#. *   . *.\.. .\ #.*.\...#\..*.#
##.  .*\.......#*#... . ...#... #.#  #.* .. ......*.#..#. . ... ....\ *....\#..   .*.....\   * *.. #...*... .\.\..#. ..*  ..\*...#..\.... .....*.  ..#
#\ *.. ..#..*.. *... *.*#..#\ ##. . \ ..  \.    \..... \...... ..*  .**.  .. .. ##.#*.. ....  . .*\.......\*  \......  .......*. #*#...*..\\..\.  ...#
# ... ......*.#. *...# . #.. . ..  . .. *...#....#..\.. ..\.*... .... .....  .. \.....*##..*. ....... ..* \* .....*\*.. ..#.....*  .#*  ..#  ....  *.#
#...  \..#...#.. ..#..*\. ..* . ...............#..#. ....  ....... . .#* .*#* ..*\. *..  \..#..   .#*....#............... ...#..*#. ...# .*....#... .#
#. .\..... ..* *#..# ... ...\. . ..#. * ... *.**\....#.. ...\* . ......#*..#.*...  ...\\ ....#*.........# ...\...*.#. . ..  .*#..  \.*...#.*.*... ...#
# .*..... . *\...\.*..  . ...* .#..*\.... ...#....#.. .. . **.......##..........  . .....*# .*..\..*# ..#..*..#.*#.#.  .#.\ .*.* .........* ..#.* . .#
#..  .#.... .#.#........ #. ** .  ....*..... \..........\*. ..*..*.  ..*.#.##*..*.. .. .... #. .*..*.##. **...#..#\..#.\.\\.# . .\ \\  ........ ....\#
#.....*  *....#..\\........ #\ . #  ..\  . .*. ........ . ......\ .. .\## ..  #.... *. #.....*...#*.*.*..\.\ .\ .. #...*.# .#...#.....  # ......*....#
# .\..\...# . .#.\ ... .\ \.  .#. *  .\...\.   ..#  . *.....*.#. . .. . ..\.  ..# #.  .... ..#..*....*#.  #........\*..# ..*... \.   \. *... ...  .#.#
#... . ...\....#\#.. #.. .... ..\ .  .. ..#..#.. .# ...# .. ....#\* \. .# ... ....... .#**.#..* *...#..**.....\ \. .*........#....\..#.*. . \\#......#
#.#.##. ... . .... \##..##.... ..#...***.\ #..*....\* #.*..#  .\...*.#*.*.*. . .\..\..*\.*.... .. ..#..#\ . .. #....#* \#.... *... . ..# . ....#* .*.#
# ## ..*.  ** .. ##. *. .   ....... .. .# ** .#... ...*#.. \ ..# #. . ....*....\...#.\.*...*......* . . . .. .\#.. *...... .....*\\*. #.........#.##.#
#.. * .#..  ....#....#..#.#..*. ## #. ..#  .. . * \\#..\..#.  *  *.. .* *. ....\##. ..#....#......##*.# *.#.. .. *.*..*\.**.....#*.#..# .. #.*# ..*.*#
#. . ..*. \....#..\ . ..#...\.**.... #\.*... ... ..#......#. .#..\*#*.. *...#.*..... *..\#\.#..##.\..... .\## . .#.........#. . *...............*#.. #
#..*#..#..*.*#.\#....  ...##*   ......* *.  \.*.......\....*.*...#.... . .... .......  ... .#*..#.#.*....*.# .. \.   .*  .  .*....*.\\.  ..#*.... ...#
# #..*. .#. ..# .*. .   . ..\\.. . . #*#\... .\\... . .... \ *.*.#*#.*. . .#.*.*.#* ..  .....   #. . *#\.#*\.... ........#...\.#. *.  .. .....    .  #
#  . \.. .*.# .#...#*..\.....\ .\ ...... ... ..\.. .*.. *.*#.\  .#.#\*.#.... #.\\..*...*. *.#.  .....*..    .#*.**##.. \  .#.. #*.\...#. .. ..#*.. ..#
#*. ..... .. *... . .... .# ..*..* #....*...\..\.*#.... . ... . *#.*. .\.......#. .. ..*. . ..*.  .... ..**. ..#*...*.  #...#  #.. .. ..  *. . ..# * #
#\.  . . ..#*..*.*...#. .. \ ..#.... . .. . . .....#.*##...*\.. ...\....   ......# . .... #...#*.#..  ....*...#.....#\# ..* ..  ... \#..*... \ .*....#
#.....#*..*#... ...#  ... *..\.... .....#....# .. .#....**... *...  . ...#..* ...##\.. .. ..* .. *. . .   \    *#...  *#\. **.*.*  . .. ..  #...*###.#
#...*..*...#.... ............... #...*.#  .  #**\.##\.*.\*..#* .#  \......\*#.... ..* .. .....#\........ ..*.. #..#.\.#.. * # #\ .\. \ **#...  * . ..#
## .*..#. ......#. ..*#.. # ..\. #.....*.#..\.. ...\... #.*#.. \.. . ..*.*  . .  . .\.\.... . .... .. #.\.**..\.. *.*..\.... \\..# \....##..\.  *.*.##
## *....##. .*....#  *. .#..*.*.#.. *. . . ......##*...#. .*....#.*.. ..  \.*..#..#.  #    ..#.*.**#..#.**#. *  .*.....\..#\...*.....#.  ***....  .  #
# .\..#..# ..**...\\...  ..... **. .. ...#. #\.**..#\.  .\. .. ...#..#...\..*.#.. .. .  .. **.# *..*...*.*.#....*..# .\\..*...#*...#.* . ....... *..##
#*....*.....\*...... .*# ....# #.. .....#\*...** .*..  .....#*..\...\ #.....*.\. .#.* ..* #*.#..*...   .* \ *....\.\.. . *.#.... .  .   # ..*.. #* \.#
#.....#\*......*. .....##.. .. ..#. ..*... ..*  .#. . .*.\......  #. .#.#...\ ....* .** *.*#   .# *....*.*##.. .#..*\ . ..*##*..#...**.. ...# # . ** #
#*#... *....*\# . ..\\. .*..#*.*. \... .... . .....* . ..#*.*....\# ..#..#.# .*.*... *..#. ...... .. ....  .... ....*...* . #..... ....\*..\...*...#.#
#..*# . #.  .**.*.. ..*. .\.\...*# *.  #*...#* #. . ..*..   \.....#. **. ..*. ..*#. \*. *.**.**.. # \. *#..#.*\#......... *.  ..# . #.  .  ....*. . .#
#\...*....\.......#... \ #...\ .#.# .*... *\# .#.\ *.... \... ..\... ...**.....\ .....*   * ....*.#.\ # \ .  ..#.#....  . *...   ....*.....#.  ..  ..#
#...**..  \........*....\.... *#. ....  ...*#.. ........*\.\  . .....**. .#.. * \..\.#.. *\# . \. \\*.....*#* ##...#*.*. .. ......#.** *.**#..\.** \*#
#..#  ....*  ...*.* ## *......#\#....... ..  ..    . #..*  ..*..#..* ...  .  .  #..*......**. .. .....*..#.*.\ ...... ...\...#...#.  .... *....#.* *.#
#....#. .  \.. .\ #. .#.... \*  .#.. ..*. *......\ *....*.#  # .....#* ...# ..\..  # *...  ...*... #. *....*#  \ ... . #... .###*...#** .. . . * *...#
#\....\*#. *.* ..# .#....    .**.# *.*.*# .. ..#...  .*....#.##.#..   ..# .*.#.#\.*.\*.... .. . ...*..## .\ .**.*#.....*#.#.. .....* ....\*\#.\ ....\#
#....*...*... .. *.. .. ..#.  ... . *... .....*.....#... ..*.. ..## \..*..... .# ..... .  .... . *.* .......*...#\ .*.##.#.#\##.... *... .*. *...  ..#
## #.#.. .. .*..  .*..\.#*.\ #....... .. ..... \  ..#.. .....*.. .... ..##..... .....  # #.... \.*...*....#....* *.#*\ .#... ...... \  ....... *.... #
##..# ..*.. *.#*.. *\..\#...... .*.. .#*.....# ## . .\  .*#..\..#.*.*....*#.*..\...*\ **...  \#.*#* ... ..*.*.*... ... #.......... *. *. *    ......\#
#.\.. .. . *\.**...\.. #*........#..... .. .. . #\. #. . \.*.. #..\#....#. .#.**... *..#...  .. .. .#.*##\ .....   *...*..# **.\.. **.*#* ...*   ...##
# .#\## ..*....#..... ........#..*.** \ \#\.... ..* . ...**.. #.....#..*. \*.*....\...***. .*..\*.......#..#...*.. ..*.  * ......  . *.    ..\..  ## #
#.\ * #..* ..  .# .*..**. ##.*. *..#  \.##.....#....#.. .... #..... \..*# ..#..*.# ......\#.. *  .. \ \....#.*.....# *...# # ..#  . \.......#.*.*.* .#
##... *.. ...  ... ..#. .* ..*. .  *#..... . .  .#...#..   . .* ...#... #..... .\ ..##.  #* .. ##*. .   #.# ..#*...#*..\....*.....\\*..*.... . .#*...#
#.......***....#* .. .*..\  ....  .. *\.*.. *.  .# ..# . .*\\. .. .*..**....\..\.. .... ..   .#.*. ...... . .....*.. *\.   ..  .... # #*.* **#\.*#. *#
#..*....... ...........*#* *...   .#*....  . ..  .\...*.*.... ..... ..*.. ...... ...#.* ... .. ......#  .# #. * \* ...... ..\ . ....*......#.. ....# #
##......  ..  ..\* #.. ..*. .  #..... *#.*#*..#. *.*.   *..#*.... . . \.*..*. \.... .....\. .*.\ *..#\  .. .. #*.\*#..*\ .. .. ....*. ###. ....  ..  #
#...  ..  . *..#... . . # *..** .... ... . .*. . .#*#*..* ..*\## ... .***.*..##.#.*.*.. ....  .** .\.** ....*. .  ...#.... ..#\ .*. ..#* *.*..   .\#*#
# . \#. .#....#..*# * .  ...\#.# ...  .*.\. \# .#\..#..*.. # ....  ...# . .....#\.#. .\... . *.\#...#.. \..*  ...#.  .*.. ..*... #\....##...*... ....#
#\....... .\ * **.. .# .#\.... #.  ....*... ...   \ \... .*...  .. **#... * ... .... . .#.*....#. ..#....\* *#..## ...\*. . ..#....#.# * \...... \..##
#\...   *   \ .\\..# ..*.\..\. ..... ...\ .\\ #\. .# .#*..... .*...\  .*\.*..#**. . .... .. ...   . #..*# .#. ....*\#. *.  #  .# ... ##  ***  .....# #
#. ..... .......  .\...  #.*...\ ...# *#.#.\.\# . .* ..\..*..*...#.#.. *\**.\.....**. ....... ......##.\.#*.**.#....   .....*.#.*#.....#.\.*.#  .... #
#. .**...*.*..  ......###...#**##...# ....#.\. .......*..# .*.*.\\\ *. .#. .....*  ...\ .##.*.\..*. \...*....*. *#... ....# ...#... .* .. #....#.#..*#
#*.*. # ..\#\ . ..... . .. ... ...# .#.....* ...*..# . ..    *. .* . . . ..###..# . .... . #....*. .* ... . . #... ..#.#.*....#*.* ....  ..*..##** *##
#.. *#.   \* ... ** ..**.#*......##... ..*....#.....*...#... *...\..*. ..# ... *..#*.*. .. .  ..\.*..# ..* ...\#... . .#..... . .* . . . *..#\# .. # #
#.*...\.#*..##..#.. .. .\. ..  \. .* # .  #..*..\ .* .\# .* *.#\...*... *#.........#.... ..\..\. ..\.**#.##..\ .  **  .....#* *... . . # .  ... # # .#
# * .. . . ...... .* #.....*......#.#....#.# #*\*.. .   \.*...#  ......\  ..   \... .##.. .....*...#......   .*.... ...#.. #.* *\* .* .. ..\.# ..*.# #
#.  \ .. ... ..\.#** #.  .#.*\.. ## ....*.#.***..  ... .*..#* .*.\.*.. ...\......* .*  .. ..\ .. ......*..#* ..\......  ..*\.*\# .....#....*.. .#. ..#
#\  .#.#*....#.\.\ ...#.#.\..#. \. .. .  *...*#  *#*.\ . . .\\# .*  \#. ............#.\... *\.  * . .   .. ***.*#.#*.##.*.\ .. .  #.#.....**... .*...#
#.*. * *.........  .\............. #\.....# .#.. * . *..  #..#*..#. .\....#..*.*\*\..#.*..  #...*.\. .#** .#..*...*.......\ ..#* .#.#.\ .#..#\#.\ ..*#
#.. ...##*. #....\ ....*.*# .*#.\. ......\... .*..\.*.... # ...*. *# . *.......#*. .*.*. . . # * ...# ..#. ...\. . ... \# .   .. .... \ ..\\.. .#.## #
#. ... * \#.*.#\* .*\. .. ....  *. #*..\..##....\.... .*.* ........#. .. ....#.\#...  .....###.#.....  *     * .\.* ....... * ..  ..#* .....# ..#...*#
#.  ...\#.........#\.*.*. .#.## ...#. .. ..#.....#.##.#  . ..\##\.##. .....#.................. \* ..*#*#*....*\\*..   .# .#*...\. .......*#*.#.*.. . #
#..#.#.*.* ..#. \...*.  . ......\#..  ..... .. *# .... . #.. *...# . ... *..  .**...  .. ..#  . #*.*.... .*##.....\ *..\.  \\*......\. .  \.# .. ....#
#. ..* . # .  #.#..#..# . ..#.\ .*. . #.#**#.. ..\ ... ..  \ ...* *.. #.\. ....#.. ...#*..*  ........ .....* .. ....#.. .  \..*.*.#... ...... ..##  \#
#.#.\#...#.#.*\....... * #.  *  ....**. . .#.. . ..... ..*  . ..#..........\... .... ........\**.##*.....  ..*... . . *..*....# ..#.\... ..#......#\.#
#  ... .....*.......#*.#... .#.. #.\.... \\*.#.\..*.. **\.#*#.#... .*.....#  .. .*# #......* .. ... .....#. ..#...# ........*..*..#.. \... ....#...###
#. .\ #   ..#. \.. . ..*\ . ..#..*# .....*. .*#.... ......#* . ##. #..\..... . .\.. .. ....*# . ..#.. . .  # ##.*\.......#*##.. ...\# \.\ ...\.* ..#*#
# ...**....\..* *.* . ... ....###.*# ..#*.. . ...... .*...##....##.#...#.\...    .#.*......... #..\.*. \....*    .....*...  ... \#..   .# *\..#  *..##
#*#....# ..##... ..*..... ..#.. ........ \*.##.*.##.....**.*.\*\.\  #\#. ....*\.... \ ... .*.*#.. #..........*...#*  #... \....  ... ..*# .#..\.... .#
#*...*......* ....... ....  .  #...#.# ... *  .#.*  #..\#\#.... \##. .. ..#.. ..\##*.. ..#.........\......\\...........#   ..**..  ...*...*. .. *..#*#
# \\  ..*...... .. \  ..  .#  ...#.#*# \..#...... .\  ...  \..#.....\#. .*#.. .*.. . ...#....  **#* .....   ..#*. .**..# # . *#. *.**...  . . .#*.*..#
##  . *\#*. **  .*.........#\#.. **##\...#.*...  .#..... . *. #.#.#.#.#**....*\..#. ..#. *. . *.*#..*. .#*...  ... .#.# \. .*...*....\..*...#. . . ..#
#*. ###..##..* #.... #..... .. . .... .#. .#..*. ......* ..... ... .. . . .# ...\.*  ..#.   ...#.\.#\..... .. #\* ..#   \....*.#.*...*\.....\..##..#.#
# *.**.... .*.... *..  .#..... ..*.*.*... * *..#..#\# ..*   #. ........#....  \.. *..........*... .... . #..#.*.....*.*#...# ....##. #.\.*..*.\\..  *#
#...  ..    . ..#....... *.#\...*... .\*# ..#* . *.... . * .. \...... *#*  ...  .... * ... \*  .. .. .. ..#.... ... . # . . ** . \.. . .....*........#
#\ # *.....*.  * .. ....* .. . # ....\... .*.  \ .*. ..   #.\\.. .#.. ...*.... ..*.*\* .    .......#... # .\....## . ..*..... *##. *..#........**....#
#... .#..*..... .#.  . .#........ ...#*......... ... .#*#.. ..  ....  *... ....  .. \... ...* .. ... .\. ..#...\*...*\ .\.*.#...#..   . .. ... .... .#
#....\.. .#  #.#. ....#.\.. .**.... . ..\..*..\#.*....  ....#.#  .**..#*...*.#...*.. ....# \# .  . ............#.*    #...#...*\... .. .#. .....*..#.#
#...  #...... *.... .. .\ \............#.. \....*  # . .*.#. *..\\..#\... *  ...*.. . ..* ..   .*\ ...*.#.#...*.#.  \.##.. ## ...#* ...#.*...*#.. .*##
# * ... .##...# * \.....\ \*.....**.. #*.  \......\. *....  .... ..*.. ... *......*.#.* . ..**...  ... #.\.#\ .. . *.**..*#.\... .... . .#.*. ...  ..#
#\  .\. \#  . ..\.#. .  .* . ....... . .* . .#...#..*. .   #.##. *#  . ....... ....* .... . .  . ..* # \  #*....*..........  ... .*.# ....... .  # .\#
##. #..#. ..*\.\...*.\.  ..#. *   .#. \.\. .. .. .........#.. *#  **\ .*.  .. \.\ .*.  .\ #....* #..\.   .* . .. ....*.\.... # .......... .....# .  .#
#..***......  .*# #.   #**..... .. ..*.#*#. \\  .#...#...# ..*...*  . ... .*..# ...*... ..##*...*  ##*  #.#.#* #..... .#.. .\.. . .\.#\....\..\..... #
# \#\...#... .  *..*. . ..\...* .   #....# ....  ..*.....*.##.. .. ..*. .  ...\. ......#.* . **...#...* ... . *..#..\.*#.. .....#...*..# .\.#.  \...*#
#. \...*..#.. ..# .* #. ..* . .. . .  .. #.\# ..  .... .*.  .    ....\ #..\.\ .. #.\...*....#..*.  *. .. ....\.*\...... .... ..#.*#.\...*.....** .. .#
#.. #..*..*....\.\.. .. #... #... *. .... . .  .*.#*.. ..* ...*.....\##*....\....... .\ ..  ...#....# ..# ...\..**# \....... *.##....#.   #...... .  #
##*..  .. #  #.#..*.   ..*.*. \.\#.#*.. .\.......... ...#\... .\  .\. ..  #.*....  #...#. #.**.. . \#** . . #.*. .  .#.  .\. ..# ..#..## . ....#.....#
#...... ***\..* ..###.. ..  ..* #. ..*. ..... ..#..*. .# ..\ . ..#..#.. #.*.# ..  ..  ... .. *.. ...*....#\*...... #. .... .\....  .  ## .... *.*#\..#
#..  .*.... ... .......* ... ..*. ..  . ..*..\...\#..\. * .... *....*... ......#.*\\......#. . *. ##. .*...##. .##* *.... ...*.#\..*..\....*... #*...#
#* *#.#\ .. ..#..#.....**\.#*.#* ....* *.  *.. . ..*..#.. #. ...  .. .. *  \..\.....  ...... ..* ...#.* ..*..## \\..* .*...*..\\. .*#.... .#.##...#*.#
##. ..\.. . #.......*  *...# ..*.\.#..*....\#... ....#... .#... .  ## . #*\*#.    . .... .. ..#**. #..\*  .... \.*#.*..#. ..*#..#... *.. .##..  .. . #
#.... \... . .#\# ....#.#. .##...\*. * .#..*.*.*... * .. *. .....**.#.....* ...#*...*..#..\.##*. ..##.. .. ....* .... * *....*.* .#. . ... .***..\..##
#*\\#... ...#..... ...\*  .*\\. \*.#...#..........#*... .........#.. .*.*\ # .......#..*... .#** *....... . .#.#*#..\#\ ..#*. ..... *... .... #.*#.  #
#...# .#...\..\.....*#\.#\. .\**.. ..**.  *..##*  ..#......#  #. * #.. .  \#.\*.\#. . ..\ ... ....*..#.*... . .. *. .#..** .. ... .....*...#.. #.. . #
##.#*#.# . ... *. . .##.. **.#... .....##.## . .\\ #..* .. ....#.# ...#*  *...##.#.\... \.#.  ..*.*..\ ..*#\#  . ......* ....*. .  ..... ...#. .*..# #
#.. ..\.* ..*....  .\ . .....\.*... ..#..*#...#..#*..#..*.*.\.*..... \.*..*  .*..*..\.#* .   .*.... ..*. # #.# #. ......\ .##.. *.#.\##. *... .*.....#
#.  # .......#. \.*#*... ..#...*...*. \.. #....*.....**#\ ...*.\.##.*. ........ \ ##.. *.. .. ... ....*.*. .. #.#\   \.. .. .#.. #. #. .*....  #. \. #
#   ..\.* ......# ... .....*................ ..# #..*  .*.  ** ...\.. .. .. ..*. *#.* ....... .*.. ...  ..#... . *.  .*.. ....*..#.*.** \.#..# *.*#\.#
#    ..*# .. .....* ..#*.#... #..  #.  .. .*  .  ......*\ ......    . *\* ......**. . ....#.... .#..#. ....*.\**#. \.* #*...... .* \*.\  .#\..\ . ..\#
# #*..  . ....#.# ... *..#.. ...*.#\\..#.........**.*.\* ### .. ..#. . ** .\*. ..**.. \ ..#.\.**\..# .  *.\ .*.......\# . .\. ..* **...  .....## \...#
#.. . .*.. \ ...#.....#.#..  .#.# .....* ....\..* .  ...\\** ..... .. ##.\#.#\......#.. ...\.#*.*. .. ....#.. . .....#... .*. .# *\ ..#   *  ..**....#
# \...\ .  .# ...#  . ... *.. . ..##. #...*.#*..#\ #..#*.#\.**..*. \.*.. ...\ . . .#.....#. .***....  ..\*.*\.* \.. ...*   .\#.#..##.\...#. . #.. .# #
#...*.*#..* .*...*.. **.  . #.  \. .....\\  *#. .* * . ... ..#.* * .. ..\ *.#  ..* . .. ......*. .  # . .  ...  .. .........#.#... ...  .#.*. . \...##
# #..*...*. \... .***.... ...  ...\...*.. ... .. #.\ .#..\.* .....\.#.#..*.. .# .#*......\.*.\. \ ##..*...#...\...##   \.....*..*...# . ...##.. .* #.#
#....# ....#.*.*..#..... . * *## ..\*\\..\.....* *\.## .\.*...#....# \. .... ..............\#...#..#.*#..*.  *#. . ... .*....\  .. #\ ..*.\..# *... *#
#...* #...#.....#.*\ # .#.... ..  *.... . .*....#.# ..#. .##\ . .*... .  **.##.. .\..... . . .*..*.*...\ ..* .. .#   .. .. . ...*#...* ..\* # ....  .#
#. ......\#..#. .#.#......#.#.  . .... ... ... #.... .. ..    ....\.. ...... ....\...# #..#.  .. .....*#  *.  #\...\.* ..* ...* . *.. ..*.#.. ..**#  #
#.*..\...#.  *.\..........* *# #..  *..#*##.. ##.. .#....##....#\.*...**. .. .#.#..\ #**.. ..... .......   . ## . * . #. *. \.#......*.\.   . .*\.. .#
#... .. *. ..#....*    ...# ..# . *....#*#...##.......\  .....*..#..  ..# ..  ..#.#...\..\.#. .. ... ..*.... *...##.* .*. #\. ..\.... .. ...........##
#. *...# ** *. ... ..\ .. . .*  .#.. ...*#..*....*\. ..  .. .#..*..     . ..\. *....... #*.. #.**..#***. .. *\.##*.\**.*....#\.\    .\.** ....... \.\#
#.   . .  ..*#....\..#* ... ...\*#.*.*. .  *.. ....\.. .#..**............ ..  .**..#.\...# .**\##..\.* .. ..#.##.#* # . ..**.. ..\## \#\\...*##. . ..#
#  \ .. .......## ...#.\. \. .\.. *.\... .. ..\\# .\.. #....# .##.\  .#..\...*..*#... ....#   \  . ... .#* .... ... *#  .....*... *.. ...\.* .# ...# #
L* .. ..* .... *....\.##...* ..... #.* ..* .......*.. *.... .. .\ .*.. \ .*. ..# ......... .#*.... ....#..**# . .#.#. #.*..\.*#. *.   .  #......*\. .#
##.. .....*. #..* . #...\.....\.*.......#.#..... .#.*#..\....*. ##..#*. .. ..\.. \* \.. . ...#\....*. ... .\ .. #....  .* .\ .. ..* .... ..*..  ## ..#
#.* ..... #\#* ...#*..##.*.. .## . #.*........ *.....*.\...#* .....#.#.##.... .*.##*. *.... *..... .#   .  ...#.#. #.*  **. .... ........ .. *\ #.# ##
#...*.*# .\ ##.\ #* .. ..* . . .\.# . . . *...#.#* ...*. ....* ....#.\...#. #.\#..  .*.#.#. . .#.. \*..*.*\  . *. . ....\   .* .\*.#..\..*.\. # .....#
##.#......  #..*.. ..**...* ..#..#.*....*\.... ....#. .#\...*....*..# . ..*..* . \..*.... ..  . *..#... ......## .#.* .. . ......*#..\ ....  ...*. . #
#.... . .##..  ..#..........#... #.. \..#.. * .#.#.. *##\ .. .#\.# ..##\. *#.#. ...  .\...... #..*...# . \*. . .* . .#\.. *..# ...#* \# . #    ....#.#
#. ..\ #*. . .\..\#. .....*.....#\..#....*..*  .....#..*.  .*. .  # .*.... ..*.##.....*. \..  .. .*.\.\ .#.. ...\.\ ... . #......*..#. *.**... ..... #
#.*# ... . #   . . *.##  .#. *. *  *... **.\....*  ..### \.# .\... ...#.#*..\.. #..** .# .................*#\.#\.  ...* . #*...#*#.### ... .. ....* ##
#* ..  ....  . * .. * .*...**.\...#. .   # ..........#. ..# . \#*...**..........   ...... ... ...* \ .*#. ..*  ....# #.*...\ #\ .   ..*. ....  ##..#.#
#*\...\#.  #. .#. ....# \ ... .#\  #. . .#... #..*.... *. .....#...\#*.#.*.*..... #... #**.*#... \..... .\.#.. .  \*. ..*.*# *.#  *.  .....##*. ...*.#
#.. ..\ ....*.....#.  . ...\ .  . ...*#\#......* .  ......\#*.#*...#...\# #.#.... .*..   .#*. .... .. ....**  ** . ......**\#.**#..  #.......* ##... #
#*....... #.*..\..*\ #*.* *. . #.#.#.* #. .  #*...#.\#.* . .#. . \  ..#... ....*. ...\..#. ..*...#.* ..\\# .*. . .*#***  ...\*.*#....\ ..\.  .*. .#.##
#.#..#..*. ... ..\....##.  .. *..  * ..*....\..#..*.*...#* #*.#. ...* .... .. ..  .   .#.\**.#.### *...#. \.#*#...........##  # #.... \* ..#..# ... .#
#.* ..*. # *.....# . #.. . .. . \#.*....*.*.# \ .\....*#* ... ...\ .\.#*\..\... . ... ...#\ ...#.#......  #.   .#....\.... ..#.*\.......# ..\. .#.*.##
#   .....#.*.. *...* *.. *...  *#* .## .   ..  .*  ..#...#. ....#....\\.#. *...*\. ..*#. ..\. .......*.*\*.....\.\...\. .*.*...*.....\#..** . ...**. #
#..\  #..\   \.#.*.  .\ ..#.#.*..\##.*..*... .. .  .....*#.\.#** . ##. .... *...**......*..#.. . ..  ... . #..*#..*. .... .#...#..*  ..*#...  .  **..#
#.# #...** ..#. #..... .*. ..*. . .   ##...*#**.... #.\..* . ....*. ... ......\** #\# ....* *#.##\*.#.\.....  ....*.  .\ ........ ..\....#.#. ..* #..#
#*.....#.* . .# #. *. .# ....\.... *..#.# * . .. .#* #\  .# ...#.#**..* .##.*\.... . .. .... . ...... . .* #....*. \.......\.**.*.  .*\.*..........*.#
######################################################################################################################################################