######################################################################################################################################################
# \ .....* .*.#*.....  \#....#  ##..   #*#. .... *.*. *. .* *\.*. ..# #.# . .*......*...*..*..   .# ... #. ..*#.\\ .\ ...**.*.\ \. ....  *.....#....*#
#...#. ....  ..*# ...\ .........****.\. *#  *.... . .\....\........#..##.... ...#..  .. .*.# .. \##*  .........*..*.*.*...  **. .#....  *.  ....*....#
#\#\.......  .##..#.... .\.. \.# ...... . **.#*.. *....... ..#. ..#*.#. .#...\. .# ......\. #...#.#.#.. *...#. .. .\\\.#*.*..*#..#. **..* . ...#. #..#
#\ ..*. ..**\ .\.. .  ...#.. *..# .*. .*  ..*... \. ....*...*# .. .#...* . ..*.#.\** .  \.  \#... .* ..#*.. .#.   * .... \\....\...# .......   * . ..#
#.#\ ... . ... ..#.. ... .*.*.*.*#. . \. ..\. .....   *...##.. ..#.. .# ...#*.. .\ .......\.**\.**.#.\..#  ..*\.\...#*. .. ..* . .\....*...# #*...*.##
#.\\#. # ..\#. .  #  . ##... * ... .. ......\. #.#... . *...... .*#.....##. *..#.. #... \.......#\.. .*#.** . #\..*\. .\..*...#.. #. ##*........*. \.#
## .  ... .## # .... .. .**# ...  .... ...*# . .......  ##* ..# ..\ .# ....... . ..* *.  \.. .\\..... ...... ...*.. ... ....*#.  ..... * *##.  ... . #
##.*#.#...*..  .... . # *##.  ........\... .#\* *......... \.#  #. .*...  . \#\.......*#. *...... ...... .#... . .  ..*#.... **. ..# .*. *. .....# .\#
#...  ***.*.  . .... ##. \ . ..#.*#.#..\.......  ...\....* ...#*..\  \  .#....*  #....  .. \... . .\..*.  .*...  \.....*.**...\*.*... ..\.*.. #...*#.#
#....#....       ..*#.#.......\ **\.*. \..*...\ ...  .*..# #.\.\....### .   * .. ... ##.... . ..##* . ...\. ....#.*. .. *.... *  ....\# \#..#........#
#*. .... ...... .*..# .*.** .\.*.\##. . *#.*.... ...# .**#* .. ..#........ . ... \. . .   \. \.##.#.....#.......#. .*...#.#...**.*...  #  .\....#. *\#
#....**... #....**. .# . *. .*  . #..... .. . .....*..... .*.. ..... ..*...#. ..# #....... ...... **.#..* .#. .#. . .*. .\ ........ . ..\#........#..#
##...*......#  *#. .##.*..#. . ..... . ...  ..   .......*....\#.#.\. .*.*. .. #.. ..# .# .... .# ........\..#. #.....\ .....#.#...  ....*.#.*.#*..*..#
#* \...   **\....#..*..... ..*  .**. .#...* *.....***#..**...  \.##... ..*.*. . .#...... .....\..  #.. ..#. .*.... .......\##. . . ... *..#\* ...  .*#
##**..#\..*\.....\*..... \#\.*    .....## ..\\\*..#....*.  *...\.*....#...*##. *.. #  .  ...  .. \ .. # ..* ..# \#. ...... #. #.*##.*.  \#....  ...*\#
#.....#.. ... . . .  #. *.. .. ..#*... .  \.* ..#.# \#.#.*.# #...*.....#*.. .....#..*. \ ..#. ....#..*...**\.#*.. #\.#.* ...#*. * . ... . .. #. ..#..#
#..#. ..  .#.#.\. .. #.*.\    ..#. .#...*. . #*....*.... .. #.\.. #  ....#..\ ..\ ...*. ..\ .....*# . . ...*..#. *. ..  .. *. .\\ ...*....\.#.. \ .###
#  .*#   .  ...  #*#.*. ..  .... *.*...*. . .. #.#..... . .. ..*\..##\... #......# ...\# *..... .....\..*..#.. *. *.... ........ ..* .  ..*..\...# .*#
# # \  #.. . .....*..*   ..*....*..#.. #*#.** ..\ #.   .#.....\#.*..#..#. ...... ...##. #.#*.*............ *....*#.....#.* .# . ....#......*.... .  .#
#.#  #... \*\.*. *...#*  .\.** ...#.\ #.. .*.. \.. .#\.#\. #.#*. \. ..# .#.#.. .\  # ........ * . ... ...\ *....#.###.  . .... . *..#..  .....\# ....#
##\ .... *..\.*##*#   .#  #\# ..#* ........*.\..# .....#*. .#.. .*#..#.. .. \.\#.... .... ..#.#.#..** ....... ..*.#... .#...*.. .. # .*#.#.#* ..** . #
# .......   *\..  ..*#**#.##.*..#.*.\ ...* .\#.*..*.... ##. ..*.. .*.. ... *# #.*.......**#*... .#.. #*#.. *. ... ....*#   .. \*.. .*...#.#. ..\ .. .#
#.  .*... * .#*# #...... .*.*\##.*...*. .#.. .. . ...##.# .#.*. ......\...*..*.R. #. \.# .   .# ..**##....# \*..  # *.\..\.\.  . .#.... .. * *.......#
##.\\ .*.  **......*.. . \ .. * .. *. .. .\ ..#*\..# # . \ .\  \.#...... . .#........*. ...#... .*. .  . ..*.#.. . * \.. * . ....*.  .. *... ..*.... #
#. ...  ...*# ..#..... ...# .# .. .  ......##..# ..\..\.# ...\# *.* ... .*.#.**.*... *..*.  .** . .* ..\  *   *..*\ ..#\*..#\ ... .#*....###.*...# . #
# ... #\..\#..# ... .  #..\##.#. ....#....*....#.... ...... ..#*.*..  *#\.*..\....** .* #.*... .#.*.#....\*...# ..  * *.. .. # .#...#.*.. ......#... #
#. *# ..# . . .*.  #.......*# .#... \.....#.\. ..*\.##. *   .#. ... .#.. *....*.#.\ .*..*.. . \# #............#.. ...... ## *...#..*.......#*.#.*...\#
#.  ...\#.#...*.# ...**#\.*.*\* .# .*  # #..  ...*.#.. ..#\ ....   **....*.#....\#...#.#. ..# .\..# #*..#..# * ... .. .. #..#.\.....   *. ...#..  *. #
# ...   *...*. *....*. .  #\ . .. \....*.\... *... .* . .  ..* ...#..\...\*..... .#..*......# # *#*...# .** .... .  ... . ......#. .   . ..* ...##.*.#
#. ....#...*.. *#.#   .#. #.. \* .*\ ...##\.* # #.* . . *. **. . .*. ......* .#. .#.#..... **....*...##...... #....  *. ..  ...*#. ....#  # .#\*\.#*\#
# .......... #*. ..#...... . ...... .*..*.....\..\.\ ..\. .# ..\.\  ..  \...**#. ...##*.##...*....*....\*# ..*.# .. . *.. ....... #.*.    ...#.. ..###
##.#....#  . * ......*....* ..*. ..... *.#...# ....#.#..#.*. ...#.. .. . . #. ...# . ..# .. #. ....*.\. .. . *..* ..*\.\.  *.. ..**##  ...#.* ......##
#...  .*\  ..  ...  .\.# ..#... ..#.... .  ....\..... \ . #.*....#  .. . ..#.... ..*..*.#. \*.*....... . ##...*...... ..* ..\# # **...\ ....  ** \ \\#
# ..*\#.\.... ...\. ... #...#.#*.. ......... # .. #*.......**.*\   *...\.......#...\ .... .*.. ..*...*#\\* . ..*... *..*.#.# *.*......  ....#.  \ ...#
#\..*.. *#.. .*..#.....  *....**......\.. \ . *.  .*..#..#..#. .# ... .....#.# ...... .....#...* ..##*. #...##. .**##.* .#.\. ..##... .*.#.. ..#..\..#
#*.....*.\. . *. .  ..** # .##* \....#..   #...* .*..#.. *#.#.  *#.\*....\. *.##..... \\#..*\ .....#*. *. .. .*. \....\ ..  .....#..* ...#*#..* . .**#
#....  **. .....\\ .....\.*.#.**.... ..*#...\**  .*...*.\. *.*.*....#\.#*#.........*..... #.  ..  ...*.\*......#. ..... #... ..\.* ..\* ...*..... ...#
#.#.....\#. ..*\* . ..* .# *  .. ...*.. . \ ..... .* \..#  #...\ *#\  .#...*..  #...* *.#. .* ...... ..\#.....*......... .. . ..... * ** ..#.##\.  . #
#.*##....# #. \..\...*...*...*..\.. ..*\. ...# .* .##...\ #\*... ...# \... ... *\\ .#.... .#.##.#. ..* .. .. .** ..*.#.#...  ....\.* .  # .\.#.\...#*#
# .#.. .*   #...**.\ *.##. ....\.*..** ...#*.#  . .#\ .*\ .#....#*\\.#...* ...*# ...  .**#.##.......##. ..\#  . ....#.. ......   .* ..#..\.\......*..#
#*..*.* ....*.... #.. .#. . ... . .. .#... .* \#   \*#..*# ....... \. . ...*. ......#** ##*....#... .. ..  ................#  ....#....*.  ..  .#*...#
#*..........*.....*.#*.#.. ..*.. \......# \.#*.\..\.#.....*.#... *##..  .\.\..#...  . ... ...#.*..  *. .* ...\.\. \... .. *.. \#...* # ..*.. ##.... .#
#*.*..#..*....*#.. .. .* .... *   ... ..... \*. # .*.* .. .... ....*.#.#. .. .   * .##   .. . #.   . .#.*.....#.* .***.*..\..... .*.#  .*.. .... . ###
# . .. .*  .. \.*.##..\. . . ...**... #.......*...\# .  ..*\ .#...#.. . *#.#. .#*. #  .....#\.  ... .## . #....*.#..... #. ..*#.*.# . #.. .# .*.\.*..#
#.*.*. .... .. .* **.#.. .* .... ....** ....... ...**.#..\......# .# \...*#......\*..*\........**.#.*.* \. #*. * . .\...*  #.....*...\.##.\.\ .... ..#
#. . . #  ..**. *.\.\*.#...#.  . .# .#.##. \.... .#..#..... ...\.... ..** . .  ..# *..#.  # #...*  #*\#...  ..*#..#......*..  ...#....*...\.#... . .\#
# ......*.  .\ #....*.\# .. .. * .. ....... ... *.  .*#....\.*. *.. .. *.#... ..... . . ...*.#...#...#. \#. . ... .*.\.\\.#.#..\... ...*. ....\* * . #
# ...  ..... ..  \.*  \#..\.. #.#\. .*#. . . ....\*...\. .#**.#.....#....*#.......* .\#.. .. ##.#*... * .*.  #.*....... ...# \.\#.\. .. *. #.. * . ..#
#... ..#*\..#**......    ..*.....## \.#*#  .*...*.*#..*#.*.. .....*.. # . *. . .......*\...#..... ......#* .#*.#. .##... ..**. ..*.\.#\.*...#.\.. .#.#
#.*\*..*..# * ........*..\##.#. .  \...  ...\..\ . ...\...**  .   . \ .. ..# .\\...\. . ..* ##*..  *..\...\.\##....#\..##.. .... *.. .  *. *. ......\#
#.\..*. .  *\.## ......#....*\.  ...#. #.#.....*# ...*#*.*#..##. ##... ..\.. #*  ....\. \..  ..*.##.. .#...\*..**.\ ....\  *.   ..\ .... .##.##*...\ #
#.\ .*..  .... . ....*\....*..*. ......... \....... ..#. *##.....\. ... .*.....#......#..*..\..  .. .....\*.. ..*...\#.*... ... *# ..*.*...\. .#. .*.#
#.#*.*... ...*......*..#.    *..  .. .*.. ...#.... *..#...\# .#.*\ . *....#..*\.. #*.\. **.#  \\#..#*... . ...\ . .. ....... .*.... ..   #\ *...*..# #
#. .*#.*.. .   *  .#*..#. .*....* .. . ....*.# .. .#*. .......\.**.#.\  *. .. .#*#. ... ..#. . ...  ..*.#.. . . ..... ## \* .** ** ......*. .## #\.. #
#. .#\.*........ #.   . # ...#* *.* \# .#.. *... # ..**\\.**.\.. ... ..*\ . ..#*..# #..\.... . .#. ..#*...  .*.. ...##.\.....* \.... #. ..#.. .. .#*##
#*.. ...*  \*.... .. ...#... ####*..*\ #.\.....**. .*...*.. . *# .  #.\..\.. .......*..*.... ###. ..**..# ... ...*. .. ..\.* ...**.#. ...## ...#..  *#
##. ..##.*.*..\#**# .#..\..#.*#*#.* .. .  .* ..\..... ..##.#.#.. .. *...   ...# . #  .......*..*#....... .... *..\ ......*.*.*.......*.... ... *.*...#
##\.  ... ..#..# ... *.# .**#.**.#.*#...# #.......... .. .# ..  ..  *...*...\ .\... *.#. ...#  ..#.* #. #.\.... ......\.. *..\ #. *. *. .#\.\\\ ...*.#
#.*... ..\# .# ....#. * ..#... . #. .... .* ...#.# .. *....\. .... *. .*....#...#..#*.   *## .#..*\..... .*\ #..\\ ..  .#. #.#.. \.\. ..#..##..*.#.#.#
#*.. .. .. ...#...** ....    .# #...###\  #..*\..\. *. .....   ..#*... .... ....... .##*\ ..*.. ......  ...... #.........* *..... . ....#....*  .. ..#
#.... .#.  .. .*#.. *#.. ....#*.*. ..#. ..#*....  .#..*.*# \..\.#.. ...##\ ##. *.** #.# .#\ ....*#. ..** ..*... *.**.....#    # .... . .#. # .....\..#
#...*#.. ..#.*..\.. ....* #....\* ......#.  *..#. . .* \ *.....#. ..\.* \.\\.* *#. ....\.##.\   ..* *. .  ... ..   **. .. *...  #.*.\...#......*# *# #
#. . \ ....** ..  .*...  .    ...  . *.* \....*....* . \..*...  .... ..*. .......* ..\.   *\#*.\... ....\ ... . .#\. . . ...... ....# . ..#... **#\..#
#... ##.\  .*...  .##  ..*  .....*#...#  ..\...*. ..##..  . .....  . .. ...# \.#.... ... . ..*#..... ...#* .. .. *.#..*  .#. .*\ ..#. ..... .#.\*.  .#
#  .#\  .. *..# . .....  ## .. ...  ..###..... .....#...#. . ...... ..#. ...  .\......#. .. . #.*....  *  .*.. ... .. ... * ..... #.# .... . *.#\*# .#
#...*# ....* ........\.#\\...#..#..\.\.*.. ....#. \.#\.#\.....**.*# **  ....  ....#\#.\. \.  ...##    . ....* #.#... ...*.#.... .. #.. .. .#.#..#.#. #
# . ..\.*.... # \\...#  .  .\.. .* ....*.*#.  .*\# .*#. ..#..* #. * *#.. . .**..\ .*... ... ......... *  ....*\* ....#..... * ###\..*.. . .#...... \.#
#.  #. .\#.. .  ...*#.  . .**\..... ... *...##..# . .. ....* . .\...  .**..... *#.* .. .##. . . ..#. .  . .# #*.\.....  .*.# #..#.. . **..\. .* .* .##
#..#* .  *.  \.*  *.. .*..  ..*..... . . ... . *.\.\...  #...   #  ..  .......... #.... . .....*. *. . # .#.*#... . .  *.\   * #.. .... .#*#...***..*#
##. . #.**....#\. . *..*#..... .*# ... ....\...*.**.\.#. .#.**......\.\. ..... . *. \##...\.#..*.*.*..\..*...#.* ..##..#\.##\.*.. #.. *..   ..\ . . .#
#..#.*....  .*.# .... ..*..#.  .#*. ..*\ .# .* ... .....*.. ... ..*.. .#\.  \#  . ....\........*.*... ***...  *#..#..  *#\..\.  ...###....*##.  ...#.#
##.#.......... .\ .. * *...*.....##*\ ..* ..* ...... .. *... .#** ....... ..# .#.#*..#\...#  .*.. #.\.**. .  \ . ......  . . . *#.#..........*...  .*#
#... .......*.  ...#...\   ....* .....*. .#..#.*..*..*....*\  ..  . * ..... ........ . .....*.... .. .*..**#..#..*.  *\......\**.... ....... ..*#. ..#
# . \#.  ...#..#*... ..#.........* \.. ........  * #...#..*.#.. *.....\. ..\.. .  ...... ...  ..\. #.\..##\*......*  #. #.**.\.#.... ..* \# .*.. ....#
# ...*. \.  # .*..  ..\... ##\##  .\....#.\...... .. .. .......#\... ...*. .*....# . \....#..#*.  \.   .*..# *.\.  \. \\...*... . .......*....##...#\#
# ....\...##.* ##  ..\ ..#*....  .#.#. .. ..* *.. #\...# .\*...\..\..... . ... #.*.# #*.. ...#...#\. *..#.*.. .. . #. .#.** . ...*.*.\ . ..* #.##..*.#
#..\\\ ... ..\..* .\....*.#..*.*..... .#.......*. .*..\..##*.  * ....... #..\...  #. .*.. . *..  # #.##.. .. #.... *\* .... .*\. .*. .#.*.... ....  .#
#.  .....*  .. *...* . .... \ * \..\.. .**#...*.. ..#.. \.*..*.**.\#.#.  ..#.\  .....*...\...*. *. .*.. . . .\.....##. ...\ .   # ..... .#.#. *..*.. #
#..*..#..#...#...*. ... ...#.*..#.. . ...#.*...*# \.\......* . \ .. . #. .. ....\..*... .\..... .*..#..... . . .*..... .#.*..**  # *..*\  *. .. ... *L
#.....#.\ . #.\...*... *    ..#.*..#. \* #...#....\*... .. #*#*.. ...*.. ..#. ....  ..\....\#....\.\  . \ ... .#... ... \  . ..*.. *...  .# #..  #...#
#.\ ..... #.  ..*  .\.....\.  *.*.## * .\.*...\*.......*..   .....#.*....*#. . ..\..  .   .#.......#.#..*... .\* .# ....#.. . .. #.*\ #.*......*## .\#
#.....# .*  ...#...  ......*# #...*..*..* .. ...**#............# . ..  . .\ .#\. *.*. . .*.... .....\. .*\\... ..  ..  *.. . * .#.... .. ..  .\. .*..#
#.....*....  .. ..\\*..#.#...*. ......##. *.# ..\. \*..*\  ......* \..*.#..... . ..* *.\... *.....*  .*.\.\...#....*..*\.*.#*.. *.\\ ##  ...# .#  ..##
# ..*  #.. .... . . *#.....*. .# \ .\\.*...*.. . .* .#.. . .... ..\*.*. *.#.#..\*........\ .. ..\#.##.  ......**..#.#.. ..**. ..#..\* # .*.*.... .*.*#
#. \..#**...  .. .*...*.#.##..#* . #*.#.....#..  .. #.. #.. .#*\.#.. . ...\..# *..*\. . .....*..... ... .... * .... .. ......\.  #.#. #....#... ...* #
#.. *..#.....*.\..\.# ... *..#.. \..*.*. .\ .#.*..... .  ..\*..# * ..\..*.. ..* ...*. \. .  #.# .....#..\...##...\ #.\ .*.. ... ...*...*#..  *\.   .*#
#..###....  #..\ .*.. ..*.......*. .. .#.\#..\ *# # ...\. #.#  . ##*#.. #\\. ..#* # .....#......  ..#....#. ......# .#   ..\..  ..#......#..* \#* ...#
# . #  ..* .. .  . .*...#..*\.....*....* #...#.. #....*.....  #.......*.... .#..... \..... .  .....\.. * ..*..........* ...#.*..#........#*.... .##.*#
#...##.#.  .*.. #. # ..#....*\*#.*.* .. . \.*....#.#  ....#... #.  \ .  *.....  #.*  .. . * .. *\* .*.*  . *.*......#*  ..*#*. .#..#..* ..#....\..**.#
#.. \.* *. .#. . ..* .*.. ...\ ..  ..*..\..*....*\... *##  *\...#.. .....\.. ... ..\.. *...###* .\..\..\# .* #.\ ...# ....*. .... .....  ..*.*#......#
#  .\. ...*.  ..\..  ............ ..... ...  .\ . \.#..#.. #... ...#.. ..#...#.#..*...... #...*.# *#..\........#.  *#\#.\.\....*..*..*....*. .#*.....#
# ..#...#.....*....# ...*  .##..........\..  * .....\ .. .. #.........#...#. ** . ..#..#.# .*..\ .#  #. ..#... .#.  ....*.   *...\\*..*. .......#   .#
#.# #\. . .. .... .#. . ..... . ..# . ....... . . ..##.  #..#**... *..* .*\...##\..... . . .*#....#...  . #.. * .# * ..... .*#....* *. #.\ ..#. .  .*#
#..  .*# ..... .......* ..#   **. . .  ... .#. ..*.*#...  ....*....* ... .\... ..  ...#..*... ......# .**#.. .. ..## * . *...   .. .. ...*... .. .. .#
#..*.\  .**...#...#.#....#*... *# ....\.. .  ..\#. ...*  . . . #...... . . ....##... ...   \.#*...... . . .\*..\*...\ .. \ #..#..*..* .... ..*..#.  .#
#..*.. #.....#.#.. ## .*#\\...............*..#  .*.*.# *\..   .*...*.*. ##.***. *...\. \.. ....\*\..##.#**\...#*......#\*\. .* .. #... * \.. .# #*\..#
#\ .# .... #. ..* . ........# .# ....*...#..  .. *..\.#.##.*. #..   ....  . #.. . ......#.   #.\.....#*.\...\..#...#. .\..*#.  ...*.*#.#.....#..#.\..#
#* ..#....**...   .....#... *.\.\. #.*. . .#.. .# .# .\ \  .  ...**. *...*...\## . . **.  # . ..  ...... ...**   #\\  \ .. ... .\.....#........ *....#
#...*...\... .. ...*\...*..\ ...*. \.*.#.*#.#..**# #.\ . ....\  ..*#\ #....... # *...   **.. \##\  *. .. #.. ...\.\..*...#.#..\.#..  ..#  #  .#*.\...#
#..*.. ..\...## ..#......#   *.*.. . .... .. # ..\. #..#.#..*.. ...* .... #.*...*#*#   .*.. .\ ...#..* **.. .. ......  .. ....*...   .\*....*..\\ .#.#
#\#.  .*.. ...##. ......\.... ..*#.** .\.#..##...\...\# .# .\... #.. .\.*.# . .*.*. . ..*. #..\#\... #   ..*..\.* #....*.........#*  #**. .#..\.*# ..#
#. ##.. .....##  *. *#.  ......\.......\ ......* ...*.  .\... **..#.. .#.........*.\*.  ..#. #*  ...\*. .\#. ... ###...\ ..#...#....  \ .#.* \ *.. .*#
#..#...  . .*....**#.*.#. .. ..*#..  .*#.\ .......*...#.  ...* ...\.... # #.....\...\....*..  .......  . .* *......#..# . .    #.....# . ..##  #*. # #
#   #....# #.#. ..\. ..... ..*.*# . .*..#.* .#* . #..... ...# ... ..*... * .... ....*#\*...\. \ .. .. . .*#* *....  \......  .\ ..#..\..\\#.#*   .*# #
#.. . .....#..\ .#* .#.*.\* .\. .*...*.#. .  #\.\*... ...\.##......#... ....*.* ...#. * #..\..*.# .*.#.*##.......#.**#. #.#...*  ## .*#.......\. .\* #
#.\ * .##\#.*.*.*. *.#....*.*\.*. .....*.# .***. *.  \. #. ...\.#.# ..#\.. ..*...#.*.  .  ......\... #.\\\ .*  ...   .# ...\ \.**.\#... . .#.*   ....#
#.. ...*\*#\..#.. # .... .#.#..*.#.#......#.....#...#  ... .*\# ..##..# .... . *#.....##...  ..\... **. ..*.   .#...*#...*. .*.... . .. . *.*..**...*#
#..#..# #.\. #....* .*.. ...#.* .#..*.. .##**... #..*.# *.*.* .. .*......\*..#..## ...#... . ...# ....\...\*..\..*\. . ..*#..#.....*. * *.... #.* .#*#
#.  ... .. .#.#. .#... ... .#. ... .. \*.\..#.** ..\*.*.. #....##.*..\. .**... ....... #*.*.. ...*#.*#. .*.. ..... ......#....#...... ## .... \.\.#*.#
#... . #..\ .............* .*\.#.*.*....*.\.*. ..  *.  . .# *.*  .\..  #.  *# **.....*.. .\*..#. ...#*......* ....... \..   .*.. .\.. #..*.\.#.... ..#
##...... # .#.\#..*\..* ..... \.......*...*\. ....*# .......  .  #*....\ \.* #* .** ..#.....\*..##... ...*...  \.  .\.  #\...... ...........*....* ..#
#. *..*..\#... .. ....   .. . .. ....* * . .....  ....#*..#.* ..#...*....  ..*..... **.*..# .....\. .*.....#* ...#.*......*... . ...#. .*. *..*.##\..#
#..*... #... . *** .  .....#.. #..*.. .....\.... .# ..*. ** ..#.*..... #.  ...#...\..\. *  .\#..####.*.....* *#. .. ....  ....#... .. . .#. *.. .....#
#...#.\** .# .#..#*....**.\.*#.......# .*....#..*........ ...  #.. . \*.# ..  ..  ..........#.# ...#.#\\  *..# # .#..*.....#.. ... .*#  \*... .#.\..*#
#\. . .#.#..  . . . ...#........* ...*.. ..# ......#*.....#... \.... ...\* .. ...#.... \*.   .. *##..*.*#.*..#.#*.. ....##.....#. . .*...\. ..\..*\..#
#. ....# \..# ..*. ....*...*....\.. .*.....#. \.* .. ....  ... .#.#...\ ......*\...#*...... #.......\ .#.. ....  . .... * #. ... #.*#..........#.*...#
#\ #....**... .. # . ..\#* . *.  \.\.. .  \.. ... .  .... .. .... .#.\*.. .#.. #.....  .. *....  ..*\...#  ... .. ..*... .\... .#...*.#*. ........ #.#
##.......\..\...#.*..* \. .\#* .. \.............\*...*..\**.  ..* #...*. ..  . .# .#*...........#.. .  ...... ...*.  # .#\ ....   .*.....\. .. #.#\ .#
#.. #.*.#..*......#  #\. ...#. .#* #. .* .. ...   ..* ....... ..#.. .\ * .*...#  #..#....*\#...*. *#   .#\. ....  .##..#. *  . . . *\ ...\.....\. ..##
#*.... #.....#*.  #*.. * *.. \ \  #.....#...*..* *. ......\.#.... . ..#. ##. ...##\ . .#... *.#\ .. *.*. . .*\.....#.... . #* #**..#.....\. *....*   #
## . *....#  ..##. .  ...... . ..  * ... .....\ .....*.# . . . .........#\.. ..** \.*..##.*.. #.. ..  .. . . .. .. .*.......... \. .......... . .... #
###..... .... . .**.  #..\.*.#.#..*..*...... \....* .\* #... .\\*  *...# .#...\*.. . #.*.... .*.. .*#  ..*....*... ..\....*#.*#\....*\..*... ..*.# \.#
#... .#..\#....... ..... *.# #.. *.#.*.\.#*\.....\**.* ......\.......   .. .*#.\ \. .*.. #.*. ..... .. \*. .. #.....\ . .. . .. ..*...   \.##..*...* #
#.*# ...*.# .. \.  \........ ....#*.#..#..\..# .*..\...... *. \.. *..\*.. *....** *......\...*\*......... *...........#   ##\  * *\*.\\.*..\..\*.. #.#
#. ...*.*#.#.....#*.   ...*...\.#.# .... .*\ #  #.\#.. .*\#.. #.. ....   .*#*....\. .#.\  *..  ..\.\ ....*... *..  .\.... .. \.#...*..#.............\#
#......#.##**#. *..\.#  ..\..... #...*...\*\#   .#.#. .\.\\.*\..\. ..# .\...... \ .#  ....\\ . .\...#. ...#... . .  .. *....#*...#. .   \.....  .... #
# ...*#. . .# .# . .#  # . .. . . .... ....*  .*.#.#.  . ..*...  .\... . * .. *# ... .\.  ..  .....#\.   .... **#.... #\..  .\.  \*.#\  .*..*.. ... .#
#*..#\..# .#.##. **...#...#..*\..*.. .#.  #.... ...*.  .. #. ..* \ ...*..... .**..*. . ...* *#*.. . .. .\...... .** . ......... *..*.. .. .#... .  #.#
#. . .*...*#*.*..  .\ .. . .....# ...* ..*  .. *..#* ..#..#*....*. *. .....* \. . ....    .**... ........*.. #\#.  .....#.*. .# *. #..#.*.# .  ..\. ##
##.... .* \.  .... *.*..\. ... . .# ... .*\\..#. .#...\. ....   \ ... # . . #.. ..#....#.# ..  . . **....\. .**.\. *  .##* .  .. .*\ .  . .#.#.. \*.*#
#.*..... #.. .## *#. ..#\ ...##.. #  .# .  .. ..\..  ...*#.....*\.... **..**#*. *. .#* ..# \... #.\..*.... ..   ... # .# . ..*.*... ...*.\*..*. ..#..#
#.. ........ ..# . .#.. .. .... .#\...#. #* * ......\*. .... *.......#......   ..** \#. .*.....*#.   . .    .  ... .. .   ..  .... #\... . *.**...#..#
#.\ .*.  ....* . . *# ...\*....*. ..#.\.# ..\*#...*\ ..\.*... .*** ....#.\...* #.... *...... #..\. # ..........\.\ ..\.*........... *#  #**. .... \ ##
#\#.  #*.  ..... . . *..#\.\.*. #..# ..#\   *...#. #\#....#.#.....#.** . *## ...#*.. . *.\. #. *. ..... ... ..*.#.#. \... ..... . . .#..#.*\.\*.. *.\#
# ...# . #...#........ .. ##*...#  *...#*... ... .\ ## . #.*.. ..#.#.*#..... ...#...\  #..... ...*.* \*..\.#..#.... #......#.... * \*  .......\.#... #
# ##*#....** ..  *.... . . ...\#...\..  *...\* . ... ... ... ..\#. .. . # #*  *....#** ..#.#  *.\..\   #.*#.*.. *..  *.  . . .*. *.... *..\  #.\.....#
#..\. \....## **. #. ...\\\.* ........#.#..#.... .\....# #..  . ..  .....*  .* ...*...#.....\...... #... .. . #. .#...*. ..... ..\ ...*.*..*.\..\. ..#
#.*. .. ............#....*\ #\*  .*  \ .*\ ..\#....\.*\... #.........#....#..#..#......#.# .#...  ..#*\ \ .....  \**. ... ..\  #.*... * .\*...... ...#
#\ ..    **#..\ .....** .*..*.# *.... .\. .\....***.#...\\..#.##.  ..#..... .. *#..\..#.\* .#.#.*.. #...\ *\..*.. .... . *.\*...... #.. .. ..\.*...#.#
#....  .......#....*  ...*.....#  ..  #.\..... . *... . ... ..* .\..#. \..\\** #....  .. *...*  .....**..*\.*. ....\. .# ...... ....... .\.... *..   #
#.\.#  ... .\... *...#.*.... ..\. .*# ... .*...## ..*..**.. ..* ......\... \.....*.. . ....*.#..* .*#.....  #\. .... * *#.... #..# .. ...*  .... .\..#
#.* *....  .\  *.....#....**..# ... #. *#.......#... .\.... \...*#. **\. \   .\........ *    ..*..... ... ...\*....\....\ .   .. \......\..# . ....\##
#\#. .*  ..\... .#*  .\.....*.. .\ .*. ....... ....#. ....#. *..*\.#..\.\ ..*..* . # *.*. \. . . *#.... *...\..*#..\\. .\..  # *..*.\.# #*  . .....  #
#. \.*..#.  .# ....*...\..#...##.\..*..#*.  ..#*.# * ...... . .# . ....#... #.  . .. .#. .  \#..*..*...*.#. . .\.... ##.. * #*  *..* .#.... *.#..#...#
#...#..**.* ..*.. #..  .*. ..*#.##*#.*....  #....##..#. ....\..*. . . #..... ...*\. \*.#  #.....* .. *.... ..#.#..\   ..*\ ..#... .#.*.  * ........#.#
#.. ...*. *..*\.# ##.# ..............\.\# .\.#.*. ..*..#..#.*. * #.\.......*.#. .*#...* *.. ....    ......\..*#. . .    .* .\....#.* .  \#**.  .... .#
#.#**...\.**... ... .....* #.\\  *.. .##  ..  .#*.#..*..#*.. *# . \..#..  \. #....##..*...#........... .#.\ #**.#. .#...\.\ ...*. . ..\*#.\\ #. # .* #
#.... ...  ... ...*.*.....#*..#.*.#.#..\ ...... # ......\..#......... *.  .# * ..#.      .\. \. . ...* ......*.#.. .\# .. #... #*..*.**....    .* . .#
######################################################################################################################################################