####################################################################################L#################################################################
#.*. ... # \*. # .## \* . .\.... .. .... .. **.... ..\... . .. ..\..........#..#. * .*.\...* .*\..  ...  . ..* ..#.#. *#.*  ......... . ...# ...#. ..#
#.*..# .. .  *.. .\*# ..# . ...*#.. #* *  ....*...*\ .. ... * .*......*#*.#. \ .  *.. ... .. *..\. ... #...*.. ..#...\#\... ## #.#...*.#......*.*..* #
#....*..  . *.   . .*   ..##.  ..#.\..\.. ... #....* .. ..#.... #...#. . #.*  \.  ...#. .#......##*.#  .#. ..\.........# .... .....#.\..*.......#..# #
#. ....* .. .* ........**.**... .. ...*#. .## ... ..#. .\. \.#...#..*  ...#*\***.. .  .*. . .. . ..... \*.. *. .  #..*.\ . ## ..*.* #.#..#...  ..*. .#
# .#...... ..... . . .. .#* #......* .*.#*.*.. .#.... #..###..###..  # ........   .. ....#. \.. \..#  \ . .*...#\*.**.. ....*.. ...*..  .. \... .#...#
#.#.*.#... ..*. #.\. *.*#..#. ..\*#.*# *.....  ...# .*\.\.* *.   .*.. .*.\.# .. ..*.*#.....*... .... .\ **... ..#** .\...... .#  .. ....#..#*.#\.. . #
#..\..*.. .  #.  . . .\. ...##... ..#....\#.......#..**.. .* .....#.\ .....#. .\.*#.# ..#....... ....*... # ..... . .*.## \...\.#...**..#..*...#*..  #
#.. .*.. # # ..#..*  .*.*#....  ...# ...*.....#.. .......\....#.#\.....#.......... .... ....... .*.. # * . . .*##.. .  . *.#.. ......# ..... .#.....##
#\. .#.  #.......#*  ##...... #..   \.. .# ... \#. .*.  ...#.**.\  *\. ..\**\. ..*. .....##.#.*\ *..*.#..#...* ......\.#...#.*\*.  \# .*..###.#...*\##
# .* ..*# ..#..#...\*...#**.. ...#..#. ....* \...\...\*. .. .## .. .. ..*. .* *#... ...\ #..... *.. . .#...\*. *...* ..#  ...*.# .....**. .#.  ..  #.#
#... #..*......\....#. #.#....#...#*\*...##*...*..  ....*......#** ##.... .*. ..#..  . .....\.#...\ . . . ... .*#  .  . .....#.#. ...#.....\......\\.#
# ..*. ....  .. \..*##.\...#. . . . #.......#.  .*. ..##... .. .#...#*  .\..* .*## *..*.  .... ... ... .#\. .......*\ ..\  ... ...\. .# .\.#. ....#.*#
#...*#.\....  \..* ## ..#....\..... .*.\ ... # .. ...*#.*#\#*....*#.*#* #*.....# .. \ *#\.. #......\...\    *   . .*...\..  .. *..#.. .# . .. .....\*#
#....*.. .....  .#. ...\.#*..*. ....\.... ... *.*.  .#\*\..  # ..**...\.* *.* #. ...\ **  ...  .*..*#  . ...\* ... . #..*#* \#.#..... .\..* .\\ . #.*#
# .#.# #... #\.... *.....\\  . . ....** . .#........*.\#. .#. *  . ..# .### .  .#...\ ..#*.. ... **.# .. \..#. \. ......#..*.......... \.#...  ..... #
#.*..*#  ...#\.#.... .* . ... *.... *#. .*#.#.. .\..... . ** # ...\....#...*\...*...*.# ..#..# *.....**# \. *. *. ..\ .. .*#..... ....#...#\#.# *..#.#
#  *.\##..#... .\* ......#. .....#.....*. \\.. .#. ##*\.*......\ . . *.. ..*..#...... ..# ...... *  #.#...   ...*.\ ..\..*.. ...\.\......\..... .* #.#
#.. *..... .... .. .*  ..#  . \...*... ..*.*..#. . *... . ... ##*..* . .*..*..#\** #...\\#.....#...#  .. . .**....#.##. . . .#... ..*..*.. . ..\**.  #
#*  ...... *.  \#\.#\\.*........#. .\# ...\...*.. *#.*#\*  .#.#*\\*.. *.*..*#*  \#*##   ...# .*..## ...#. .#..... .#\  ##*......... ...   \.. ..*. .##
#. ...  ......... \.#.* . .. ..#....*... .#. . ...   ..  #... .. .. ..#.\# ....#*....#.*#* .  #.  .*#. .....#...#.... *##.*.  *\*.*.**#. ##\... #  *.#
## #..*. *\\ .*.....  # .. #..##*.*....#\*.** *.. ....  ..  ..*..   .  ..#  . \.\...  .....#. . .*#..\.*  #.\.. #... .#*#..\*.   *..#..\#  . .. .\ ..#
#. .#.#*. *.*#*. ...#.....*......  ....... *. #.. *.\.*##*.#*  ..#...**...   .#*.*#. \\*. ..# . *#....#..*  ..\* . .. *.. ....\.. ... . ......  # ...#
##..  ..\\. ... .#*.....#..... .\.... *...#.. . #.*. .*...#.#.. .# .#. .#. .....##.* .* . .##.\\*....   *. ..#**..\##...#..#....  .  .... . ..#. ..#.#
#.\.*.. #..*\**..  ..\  *...* .*..... * \.... ...* ..\.*. ...*..*.. \. ..\\#.##..* #.* .. .\...#..#...#. *.* .\#..*.\ ....    ......*.   ....#.....*.#
#....###....... . ......\.  .....#.\...  # .#...#...#.#..#..\.  ...\.# .#...# # ***..*....#............. . .... .*  . ...#. . ....... . .*....# .. ..#
##\......#.\.**.. *.* .... \  .*.# .......\... **.*.#..*\ *..  ...\..*\. .# *.  #.....*#..#... . ...... *.\#*#.... .#.\..#*.......\.... .. *..... **.#
#..*  ...*..# . .#   ........#  . ..*.\\*....#  ...\..*#\..\.\.. ... \# .... ..  .. ...\ . .....#  .. \ .# *#. *. .........*.... . #. #.*.. .....**.*#
# ...\# ...*\....  .#..**  ..*..............#.*...**.*.........   .#.*\.....#.#.....**...\.#..... . .. ##.#.#\  \*..  ... ....*.. \ .....##.*\#...*#.#
# ........*. \.\.# .*.\*  ...* ..# . .. .#** **  .*..#.#..\ ..#*.... .# ...  #.......*.....#*. ..*\\\..*.. ...  .*\  . .*  ..##...*  .*... .\ . .....#
#..\**#**.*..#\..\*. .... .  ...#.#.... .\... .\.#...... .  *...*.  ............ *..#.. ### *. ..*. .#.. ...*. .. ... #. .* ... .....*.#\....*.# #...#
#*.*.. .* ..#.. ..# ..#........*\. .....*...#.#... *...##....#... ... .  #. *...*...\. \# ....# .  ..#.* * .. *#.\.. .#. .#.\\...... .\ \.. .#.*....*#
#..*. .*#.\**..#.\...  \  #. ##...#.... ..\....\...*..... .* \..#... #..\..*.\..** ..#.....* ##....#. . #. **#.*... .\.*.\. \\..\##... . #*.**.. ... #
## #*..*.# #...#... .... ...* # .  *.. ...*.    ....* .*##.#.. \.*  *... ...#*.. .*..*\.  .. * .#.#.*. .......*...* ..\..#....   .#....**....##..    #
#...\.. *.. ....*  \#... .....  . #  *..#**....#.\*.* ... #*#...*...*# #. #.. ...........*.*.# ....\*... *# *...... \  .. .  ...\#..#.#....\. .. ....#
#. ..\#*.. *..#.....  # ....\. ....\.....*.. .*..* .. . #...... . .*\\   .# ...\ ......\..... #.#.* .\.#.* .*# .*.. #..... *. * .. ..\.*..... . .. ..#
#.#...**.... ...\.\....\#...#.  #.*..*.......  ..## ....*..*.#.##..*\.....\... .  .. * \.#\.. #.# .. ...*#.. #..# #.##   **.  # ..# ... *..\..** \  .#
#  . .   .#...  *.. ...#.* . *.. ..#......  .#..\.... *##..##...\*.** .* **. .. ....#.#.*#\.*. . . ...\. ..*... ....#. ...*.. .*.. ....##. .#\ #*.*. #
#.#...\ #*  \#.#. #..*... .......#....... ..*.... .##. \. . * ..**# # *. ......#. .*.... . ..\.#......#..*\ ..*.# *. . ..  .......**#.. ..... .....#.#
#...... .....# .# **...#.*# \.......*.... ..**..\...#....... . #*\...*#.. ***#.... .#..#.#.#.. *.*.###**..   ...#.*......  ..*.\. .. .#.#*#..*. .#...#
# .#.  ...#.# ..#*\.... .#..  \ ..#..#.\.. \\..... .. .\.* #*.#..*..#..\ .#....*...\\.#..#  ......   . .\...*.# #.... ..**.....# *...*.  \.. ... .#.##
#  .... . .... . .*..*...**.*...#.. .. .  **. ...  .\...#.. ..\...... ..*....* . .....*.... . *#. #... ..* #  .. ....... .*...* \. ##  \*\ ....*  .\*#
##.\.. *##..#..\..*.\...... ..*..  ..*..#.# .\. *.... .. .\.*.*.*..  .. #.#..*...\.#   ...... ....\#.*# .**#. ....#..   #...#* . .... ...*. #. #..#..#
#.  #.\\\ \*....\*....#.....\...... .*. .....  *....\*.*## .......*\*.* .. .#.# . .* .... ... . \# .# ..*... * ......... ..**...*.. *.. ...\* *\.....#
# ..   .*... .\.......# .. .#.#*. .. ... ...\.....#.#.......*.* *. *  . \.  *\.#.....*#... . .... .. . .\. ...\* . .*. .....*. . *...# \  .\. .#. . .#
#. *.*.\ ...\....*#......* ..**.. *.....* #...*.#* ..#. ##. . ......... ..\.. ..#.*.#.  *\..\.  ..#*  ....##\ . .. .# .* .##... ...\.\....* *..... . #
#.##....  .. *# ...#.#*..  .....* .##.\*....\\#. . .#.. ..... . #.....* ... .....*...*....... ...... *.... #..**. .. ..#\......#..\\\\.\ ** ... ..#*.#
#.. .  . ..\.. .*.\ .*...*.*\\. ........... *... ..  . ##. \*...*..\ ....  . . .* ##.#  ... .. *# #. .*.....*.*...#  .....\\# ... .\.*.....#... . . .#
#.*.. .#.** #.\#.#. *....# ..#. .. .#.#.   ... ....#. .#...... # . .#\.*#..#..........*# .\*.# ......\\.. *.#  .#*#*#..*... . .. .\ ...* .\.#\.... *.#
#.*.*.\.##*.... . .#.#.*.\..#.*.#.   ..  .#*. ***.. ..# # *..#..\.#.#...    \*.. . #*#\.# .#...**\.\\.*# *..... ... *.\...*  \.. ....\#\#* .*...*. ..#
#..#.*#.# .* ..\...**. *.......#  .#*........*...#. \.*.#.. ....##.. *. .*.....*#. ... ..  .  ....#.#  .. .#....**#...  . *\........ ...... .#.## .\.#
#*. .....\..**. .. .\ .*  .....   . ..  .. ..**\.# . ......#. . .. *..# .**..# .. #.##.*....... *#.# * ..\. \.. .# ..\** .\ ..\. ..* #...*.   ...*. *#
#... *....... ..*.  ..*.. . .\..##*.# .. ..#*..*#.  .. **.. ... ..  *.\.. .\......  ..\..*.........*.\ ..#... .#  *...*. .#...#.... #..*.\. #.  **. \#
#  ....** . .......#.......#... ...#.*  ....  .*.\.#..**..#\. .#*..*.\...... . \ .....* * #..\.....#\.  \.. .. ... ...  .  ......... *...\ ...##..* .#
#.\ ..*........  . .#.#..#.. .*..#*.#*.#. ... *.* ....* . *. #*....*#..... .\ ....*#...  . *..\ ...#.. . ... .\.#...#. *. *.....#\.. ..  ..* . \*..# #
#.#...***#...#.*.#.. * . \.*..*..*# . .. #.... *.....*  . *. *......* . ...#. .....* ..... ... .#..**...#...  ... ..*##* ..#.. #. ....  ..  . #.. . *#
#\.. *#...... ..# .#.\  .#..\*  \ . *. ... ... . # . *..# .... #.#. ...... ..#\.\*..   ...# .. ..*\ ..  *...\\.. ....* . #.#..*  \...#.. . . ..#  . .#
#*. \. #...# #*.#.** .**.#*.*. #. ...#.... * .# ..*.....*\....#.*.. .*..  ........... ..  #.   ...  *..*..# ..*.*# #..*.\***.**..# .#.* .\ ... \#.  .#
##  .####..... ..*. #....#* .\ ....#. *..\ *.#*..*.....\. #...* . .#.*..*.*.* ...\......#..* .  . \ .#\.. ..\*....#.*....#....#.*...*.*# .#*....\* ..#
#. ..  # .......#. ...#..##\.*..*\.#..#..*...#.. ....... .#*. *#.. ..#..\ .............\...#*.  * ..# .  .## *.............. ....*#. .....**.#.\.. ..#
#  ..*..#.#... #.\**... ....\.# *.\  ...*. #*..#*.#  ....... *.# *........ # #...*#.***#..#.*.. ..#. ..#.#....##... ..  #.#....#\\ .....\. ..* .#\.. #
###..#..*..**.\ \..  ...#  *#\..\.#  *.....#..###  .. ... #. .\ ..* ... ...* .. ... ... .# ...*.##*# ..... #.# .*#. *....#...#. #.  ..*  #*..  .* ..*#
#..*##..*.*** ..*.  . .  #.\. .....#*...*#.....#.\. #\\  #...\*.. \..# .. ..  . ........*..#.\. .#..  *.. ....#.. .. *..## \ *...\..#. ..\  .#. **..##
# #*. ###.**.. * *....#.#..**.#. ... ....  ##.*.*.... #.. .* ..\........ .\ ##...\. ....... \.\.*....#..\....*... .*#..  ...#.*...... .** .*... ....\#
#.. \..* .# .... *#.  . .#*..* . * .. \ .*.*..*...# . \\.. *  *.......##* # .... \..*\.\.# ..* . ..*.*\..*........ ..#....#..  .. ...... *. . ...#*# #
#.... ..* .  .#...# .. ...\#**.#.* ... .  ..#* . . .. .  \.....*.. ..#.*.#.\*......*.... ...* ...*#...##.#...   *.* . **.. *.\. #.....#.*. ..... *.*##
#.*....... ..\..\.  ##.... .....*... . #..\\.#*..  ##...*.....* .#.. .....# .#*.#.. .# .....#.*##......*#.... #..  .*#....#... #\\..#\... .. #. \.*.##
#.. #... . ... .\.*....... ..*\   .# .. .*..\ .*# # ..*. *.# .*  .*\..\.*...   *...  #....#  ... *....#\.#.*.. #..#..*. *. .#*..#*  .#*.  .#*...#  ..#
##...\  ...#.#..*. .# .##..... .## . **.\....# .*... ....#.# ....\... .  .. *..*\ ... .* \..*.. ....\...\\*  .... ... .  \..\. .. ...* . \ . ..* *.#.#
#....... . .#. ..* ...** ##  . .. \.. .. ... ...\.*.#.  .... *...  \#.#. . ...*.. \..*..#*. .#.. .#...*.. ...\..**#. ....*#.\\. # ..\. .##........ # #
#* .... ... ...#. .  * \.......  .... #\ #.*....  .......*..... *..# ...# .\ . .. . .. .  .* .. . .. .*  ..##.# .*.#..#.  .. . .  .#..*#*..  *... *#.#
#\...\*#..  ##..*.#...\...** * .\.#... . ....... ... .... *......*... .. ....  #.  ....#*\.. *..\.*\.*..\. #  ...#. . .*. #..*..# \*.. .. #..* ..  . #
# #. *.... ....#. ...*#.*.# . #.....\.....  .#..*.\...\# ..**  .#.\  .#..** #. .#.#... .. .#....#*....# .#. .... * .# . . .. ......  ... * . ....*.*.#
# ..   .#*\.#....*..........* ..  #......##*........  \.##.##...*.. . .#....*. ..#.. ..#.......*  .... . .. .*\*..*....\#.....\. ........# **\ . ..*.#
#.*.. ..\#.#......... . ....# *.*......*..... \.....#    . .* *.*.#.. .\#. .#*.  * ...... # . . ..... \*.. . . ...... ...\..#..*.. #...#. *.* ... #.##
#.. .. ....\..*.*\.\. #.. ....#. . .*...**. ......# ..*.*#...# .. . ..# \#. .*....*\#  .*..  ..\...  #.#.....*........*.....*...\.\...# .* *.. .#... #
# ..*** . ###*..\ ...* ..#.  *.##.... \.#.   # *. \ .\.... *..##**.*... .\*.   . .\..... ... ## ..#.... .  ...\.. ....  .. ......\#.. ..*. *..#. .#..#
#. .\.#. *   ....   ...*. # . .....**  ...\.* .... .*..\.*. .*.. .. .*.#......*...*.  .  .#. .*#.#*... . ###.*.# . # #...#.##.. .. . .\\ .*.....# .\.#
#  #..#.#  ..#..***. .#..*...## #. ... .  .# #. . . ..   ..#\... ...\..#.    #...  ....#\  ...#..*#.. .*..... * ###.. \\.  ... **\..\#...\. .#.*.....#
#*..*\#*..*.# *...... *  ... .. #..   ......* #..\.... ..... .    ..#*.*#*.* #*... #*#..*..*.#... ..\... ..\#.. *\. \.   ..  # ..* . .*  .  *..#.   .#
#.... *... * .. . \. .....  ..#. .\* #. .* ....\... *.   .. #..#*.##.. . .. *..# .*... #. #..# .  . #. .*...*.*. ......  ... .\ .....*.. * ....*\. ..#
# .. ...#..  .  #.* .#. ..  . .... *  *.\....... *.*\... . \... . #*...#.....*..... .............\*#...... . .....*. # . *... #... ... . .\..#.. .\#.#
#.. .. ..*.....# \*\\.*..##.. .* \.#..##  .... .*..*. .#.. . \...*.**. *..\ .. . \ ........#...\.\.  *..  .. \.\. ... \....\.. .. .. ...#.#.*......#.#
#.  . #.* #.. .. .  # #.*    ..  #.....#....#... .***   *... ..####....* .  *..\.........* *..# ..* #. #. ##... # *. .*  ... ..... .*\* #.# \ ... .#*#
#...* .  .#.... ..... .   *. .... ....** . .... #.#. #....*.*#.#.....#...... .#..\* ... .. ..\\\..##.  .. .....\*  ......  ..\ ..... #*. \*.*.. .*..*#
#... .. \ .#.#.\..*#.# ....*#.*.......#.  ...  # ..#\..*  . .*. .......# .*. *.\..#.  \ .  ..*........ ..  ..*..*  . ...  . . .....**.. ..\*\.... # .#
#..***.*. ...#\* .\\\..*.*....# .... .#..\.. ...# . ....# ...**... ..## ...\.. #.#.#*. .. . .. \# .  . .# .. .. *...  .  #\.#...## ..... .#....\ ....#
# *.##*..#*..**..#.   .*....#.*\\ ...\.*#*..\.\*.. ##.#..**.... *.. *#.. .... ....#.....#..*  \.*....#   \....#.....*..*.   ..#.*\.*.. #.. ##...* ##.#
#... # ...... #. .*.#\*...... . # #.R \.#.# .....#..  \..# *\* ..   . \..... .#   . .... ..........** ..   *.....  .#...* .*. *.*..*. ....   ..#.  ..#
#... .##...#  .. *.*.##\ .....\. .*.*  ..*....*...#...\.*..  ....#.*#* ..\... .*......*.. #....\.\#* #*. .....*\.#... ....# ..... .. ..  ....\.. ....#
#.# ..*#..*... #.# ..  ...   *...#.#.....#*.\**...**..... ..    ... #..#.  .#...**. ...   ..... ..#..  . ..# .... ...\*.#.# .**.  ..# .#...*...#.. ..#
#.\*...*.*\.. ..\.. *\**. .   ..#.#*.*....... ...#.......#..\*.#. ..*... ....\ .....*..*.\.#... .\.  * *\.. .#.*. ...#.*.#*#* ..... *..##. * .##..*..#
#.#.#.#. **. .   \\.#. . \ *... *.*# ...* \. .**..  ........  ....... ..... ##.... # . ...#*..*#.\*.\... #.. . #*.......##\.. .........#.# ...  ....##
#..... ...* . .*  .**#*#... .. .. . .\..... .... .\ .. ...##..*\#... .* .. . ....#*\ *.. ..... .#.* .  \ ...\......... *. * *.* . . ... .... \ *..*..#
#..#....#.#  ...*...\ .\.##...   #\.... . ..* # ..... ..# ...#*  #....  ..  . .. \#. #...*.  ...#\.. \.. ...\....*...###.  ...\.\.*.. ..*.#.**... ...#
#.*...... .   ..*..\. ##.. .#.# . .*. .*...*. *\..*... *.#.\....#.. #..\ . . .*...\\.*..    *. .# ..  ...... ...* .#*.*. . ..#. .#.# ........... ....#
#..\ .\. ....... ..*.*#. \  *.... .#*##...#* ... ... ..*...  .... \.*.\**...... .   ...#..\\*# . #. ..*.#.*#......*.#.* ... *.....#....###..#........#
#*\.  \.....#..* . #..#.*.#...*  #\ #..\.. #....\. .*. *  ... *. *... .\.. #..#..\...* \#. ..\...*#.. ...#.......#....  .*...  *. .*.. ...#..#**\#.. #
# ## #.*#... .*#  .##. *.#* *...#..#........#..*.  .*#..  * .... \#.. ..#....  .......#. .#...\#. *.....#. ...*... . ..#**.\  \#..  ..#. #.. .*.# ...#
#. #....  .##..#. #..\#..#.*#...\.*.**.....*......#.\..* \  ..**..#. #.  .#*.. ..... .*\...  #. .....#.*... ...\. ..*\.#.\.# ..* ..**.......  *.\.. .#
#\*.\.* .*##.. *  ...# .\.\\#.*.......#. .... ....\\ .*#.....#.#.. ... \..*. . *.. .  ..#.# .*...*..*.\ #* # ......  #. ..#. ..#.* ....# .. ...*.*...#
##.\....#....\.. .....  \*.#....#.  ..*...# ..\ ..*##. .....\  . .# ....\..*..#..*........ .#.. . * ....\. .   .   ... .#.#. . #..#. ..\\ ..#.##... .#
# .#.\*.... ..... .\..#  .#.... ..*.*....*.# *#... .......* *.# .# *. ... .. .... ...  ... # \..*...* . .\.....#.#..*. .*...#*.. *.... .. .*\. .  ..*#
#.....*...#.... ...\\*....*#.\... * . ..... #.#. ... .##.....#. ........... .\. ..\ ....\#\ \ ... *#. #.*... ...\*. ..#.*... \\....\\*.#...*.........#
#.....#.*..* \..#....# ... . .... *...*\...... .*..# **... *##\\.  # .#* \ *..#.....#.*. \ .... ....*.....*.. \ . .\...*.*.. *#*.\.  ........# \.....#
#  ..\ # ...* . ..#*.. .#. ... \  .. .#.#.#..... ...##..* ....*..  .* .#\....#  .. .\.  ...#...*.\.* \..#*..## ..... ....*.# *  *.*.....\*.* ....\*..#
#..   ......# .*..*.....* .....# .. #.. .#..... * .. \. ..**  ... #.......#*... ...#..# .## .#...#..#...** \ .....\\.. ..#.#.. ...#... ..* #......*#.#
#....#.. \ * .*.  .......##....#*...#....#.... .... .#.# . .#...... .#*.\.#  .*. .*.\ .#.. .\*..* ..  .. .. **.*#\#..#\..*..  ...*........ ... ##.\..#
#........#......\    \......*# #..**. ....  #.... . . .. .# .\..*.. . .*..# .... #. ..*.. .##.... .\#** ... .*..##  #..\ ....*.* ...##....\..#..*\...#
###...   .#.# .\.  .*. ..#.#.  ..#..   .*. .#.. *#. ..*...#..\..#\##\.\..# ..*# .*.. ..... ....*.. ...\\*.#...#..*.. #.. #...* ....\\.. .....*#  . . #
#.. .. ..#.....  .. .#.  .. . ...*.#.##... . .*..*  ..... . #.*. .\* . .\.#.\.#  . .. # #..#....  * **. .........*. .. ...  ...... .# ..# ......#*.\.#
#.. ...*....*.  ...#.  .\. *.\..#*.....  .. #\........ *.*\.*.....#..* \..... .....#... . .*  .... .**#...#. ... . *. ..... \.....*. ....*..*..#. ...#
#... #.. .#..##\*..#    .  .#....# \... . * ....... \ . *... ...... .* .. \. .. .  . ..  \.... **......*.#.#  ..#.  .. ....\*.*.# .. ..\#...# ..... \#
#.. #.*.\**##.. ..\...\.\......  ...*#.  .. *...* .#. ..  ........*#.... .*. ...# .# .#.*. ...* .... *. #. #  ... ...\....* ..##. ..* *#...#...#..*#.#
#. .. ........ ... .....# .#\*\...#..*..##.... .\....*...#.* .  .*.....* .#*.. #......#.....#... \..*\...#. # ...#\...#    .... *.*  #.. . .*........#
#..#..#.\\  \* .*#  .. .\.... # . #. \.. .*. * ...# #.. . .\ ....*.*. .\.*\ *..*.......*.*...#.. .. .* . \.  ...#.....* ... .. .. ..\.. ...\  .# #...#
#* . ..\*#. . .**.\. # ..   *##.#\.. ....#.#\#* . . *\ ...*...# .\.#. ... #........ ..#.. ..  ...\ ...#*... #... ..#\*.\ .... .. # .. . .. * .*..*...#
#* ...*..\.... *.  ** ..*#.##.*..#  ...* .... ..\.. #.. ......# .. *...   ..# \.*\*..#. *....... ..#.    ..........#.. *. .\# * .# *... #.#.....  \#.#
#... #..#.  .#..****...*.* .. \.\........ ..*.   ..*. * .*......#.... \.. .#...* .. * #\.\ ...*.. .*.......*. .* . ......*. *.*...#.**....##..#......#
#\ .. ...*....*\.*..*.. .  ...# ....\#..*..... ..#. .*.*#..*..#\ ..#...# ..#... ... . *#  \*#. #... *#*.. . ..#* .\ .. ..# .*. \.*.*..#...# .   *\ .*#
#..  #.\* .#.#...#.*.. .\.*....*\...*# . .# .*   \\.. #....  ..\. ....**.  .  ... .*.#.#. ...#.  ... \..\# .*... .#. #.\ .. ...# .......*# . ##  .#. #
#...*.*#  #*#.. . .#\ ..*. .#.....*........#..\..*..#\. . #.  ......#..*   ...#.#\#...... ..... ...* *....\.\#.. #.*.# ....   .\ #....#\# \#. ..#... #
#.##...# #.## #......   ..*...* ..*\ ... # .#\***.#*# # .. ..#..*\.  .. .... .\........ #.. .##..#.\...  .. .#..** . . ..#*.  .#...  ....# \.*....  .#
#.#*.  ...... *.#. .*...   ..  #....... . ........... *  #...# \#  ..#. .#.*... #*..###......  \ ...#.* .#\.#.......\.* * .#..\ .. .   *..\.. ... ..\#
#.#.... ..##*....\.\.. . # ...... #..#.    #.#.\....# .. *...\ #.......***.. ..#.\......*.  . .**. *.... . .\ .   .#... ...# ...*..  . #.#.  ...*...##
#.# #.. **.#.  #*..*......... ........ .#... \.#........#........   **.\... ....  . *#\........ ...\ ..#...*... .  .* #   *..* ..... . .#. .#..*.* *.#
#\......#. .#\ .  . ...#*#.\. .*..*..*... ...\.... ..#... * .... . *..... \.*..##.. ...*. .*.*.. .#   .......\# ....  .##\ . ..#*..*......   .*.. #.##
##  .# .*...\ *.*..#*. *.......#* #*. .. *.  ....# ...#. ..... . . ...... .. *.... ...##.\.# .... *#. .  ##\.. *.. ...*..  .\......#... .*.. . ..*#  #
# .... #....# # . .*#  #...... .#..*......   #.*#.. ....* .    ..... .#  *. ....*  .. ..... ....  . \..**.... \ \.**... .  .. ....  *..* .  *...# .. #
#\ ..#. .. ......... * .. ......... #.#\*#.. #.**......\. ...*.. *\..*  * ..\ ....#.#\ .*#.. . ..* ... ....*.. .... . \....\...#.. \....#........\*..#
# ..#...  . .#.... ..*...#.. .*....#   #....#. #*.# ....#..\..#.#\. .*.# # .....* \* ..##..\. ..#.... *. .**# .\\... *.\. ..#\....* .#.  . *.*...* #.#
# .*#.. .. ...#.\**#.  #.*..*#.*...*. . .*  ..*........ .  ..........* *..# . . .. ..... .#.. .#*      \.*.   .\# ..#...   ...  . .*#.. ....**....  ##
#..# #.#. \....*.... . .......*.....#....# .  .. ..   *..   .  *#.#.\ ...  #.... ##.. . ..... . . ...#.*#.#..# #...# ... .  ...**...  ....#.. . *...\#
#...  ..... .*.# ....  .....**#....*..*#.*# .*#. .. ....*. .....#  ...# ....*...#...*.\ . .. *\.  ... ......  . .#.**.....  ...#.....  #. ........*\##
# . # .. #  #* ..#..*.. .***. .. .\#.. *#.#. ..* #.#.... .# **.. ...  *.*..#.*# .. *  . .#* \....*#.#*  *  .. ......#....*.#..... .  .. . \ ..*..*  ##
#.# ......#... ..#. .... .. #......#*#  \#** #.**.. .. ##* ... .. .#..*....\. ...\. ##.* ...  # .* ... **.*.# \.#. #*..... #.  *#. .#  * .* .* .#.. .#
#..#   ... ##.\ ..  ....... #.*\\.\#.*....*#...# .*...\.  ... **.. * . ...  .*  .#.*#..*.*......\.\ ..*. . *.... ... * .. . \*\. ....#.\#..*#.. .. ..#
#. ....# .\ .#\...\\...*.#...# ........##*.  #*\ .*  .. ....* . .......*# .. #*#*.... .....#.  .#* *.*#*\#..*....#. # \.... ....\ .#* .. .. . ... .. #
#..#. ........ .\## ....## \.\ .\*....  ..\.. ..\.*\.   # ....**#.#*.\*..  #.. .... ...... .\..\...*#..*. #..#...*... .*\.  .\. #. \\...\..*.. .#....#
# ......*#.*. . .......\.\.*  .. ....#.. .....# *..*....\#..**.**#..  ... *..\.#.. .......*... ......   # *.*.. \.*.. .**#.\. #.......*\.*.\...*#.*.##
#. .  \..*..#..#..#  #..... .\...##.... .. . ..\. *\# ... .\  .. ...* *..#\  . ...\  #*.#*. # .#..# #...#..... ...#*.* #\. .*\. \*.. .. #..\#. #.*#. #
#...#  ...*  ...*.*.....*  .*.. \#.\. . * .. * ...#..  *  ## .. *#.. *........ .**..*.*..#.\ .....  ...*.##..\...*.. .. ..*.\ ..... .##... .#.... ..\#
# ...  *.#.. # ##. #. .*#  ... #......* . #.. #.. .\*.. .##..#*...   *...#*.......* . ##.....*. # .#. ...*.*.\. .*.*..  ....\\ .*. ...#.*.*.  ..#. ..#
#..*. .. ..  .... **#..  .#. * ...... .. *... ..  . *...# ....*#   #*... .. .*.* #\.... . .. ..#....# *.. ....#... .... #*.* .. #.\#\  ......*#.  *#.#
##. ..* ....*.... *  .# ..... . ..#*....#.\...#...... # ....#... ..  . #.#  .   ..  ..#... .*#\*... ...#...  ....... .*. ..*....#\* .....\..\   .\...#
#. *...*.. .... .*..... . .##.. \ #..\.. . #   \........\..#  #.. .\.#*.#.***#*. #**...\. #.*#...\......*\\*.#  . ..  \.* .. .\*..*\..* . *.\ #... .##
#.##.. #...*..#.*......*  .*.*...  .... .  ...*..*..#...... . #. .. . .#*. ....#*..#......# ...\#.#. .*...........# ...*.*...  .. #*#... #....#..#...#
#*. ... . ..  .\.#.#. .*..  \* . . ##..\. # .# .   . ...*....\#. .... # ..... .......#.....#. #. ...... . .  *\#..\..\. #. .... .. ...#. #.....   .\.#
#\.*.\ #...  .  .# .....   .*. ... ..   .#...*.. .*..\.. ...# ...... *....  .....##. *... . ..*.*  #..    \  . ....#..# . . .##.#.. .\.\ .*... ..*.. #
######################################################################################################################################################