######################################################################################################################################################
#..* *....\. .*\....* # *#. . .* .*...# #..* .....\. . .. .*.*#....##*\.*.... .**. #.. .. . .#*.. #.. .##. ..#. .**. ..***...\.*..\.* ..   .#*..... .#
#..*... *...##.*. #.. ..  .*.*......\.... .#.#.*#*#. .....*# .#. \.... ... .... #...\...#....... ..#\ ... #\#..*... . ........ . .\\.. .*..... .. .. #
#..* #..**.. .. .#..... .....  .*........*...*..  ..#..... ....\.*.* .#\..\*....#..\. **\*....#\\ ..\  .\.#.. .   \..**....*.. ... # .... ...*..\..###
##*..  ...**  .\ *#....#...\ .  .... ......*.##.**.#.*.*  .#...###. .. ..*. ....#\ *..#. #...\\ .. \#  .. .#.* .... .\.... . ..** ...\ * .. #.**. # .#
#*  ...*\.#..    .*#...\*..... .......*.\.*. ..# .*. ...*..#.*..#....**..\ *. ..*...*.. .. #.. ........ ...\#.##  .*# *\.. \....... . ..#...#.*.\. . #
# . .  **.#.#..* **....**.. ......*. ....#..#. ... ....#..#  ..* .*.  .. ....# ##.   ..# # * ...... ##....#\ .. \...  .*......#.  ..  .. #.##........#
#.#.* ..\. *  .*. . #..*\. .#...*. ...##*#. #**. .\.#..**..# #. .... #..*....*# . ...... . .... .. #  .. #..*.. .......#.. ...  \*...\..*   *.....* .#
#...* #*#*#...##. . *#* * \.*# ...*\ ......#..... .... .. ..#. ..... .. .*.. .... . ...#..*.***..#\  .....*..*. # *....  .\\.. ... ..*...*. *. ...#**#
#*..#......#*.*....... * .*.. ..*. .....\...*.*..  ***...* . * .\ *##. \. ...  ....**.#...... .....*.# * ** .*\\.**# *.\.*#... **\..... . ..#....# ..#
#...  .\.. #*.....*.    .. ....  ....#.\..  ... .   # ... ..***. ..* . .... ..\* *..... .#.****#\.  \.. #     .#... * *##.* .# # .. ...... .. ....*.*#
#.. . ..* .* *.  **.#.#....... \#..... *... ...#\.*. \.  .*...\ ..\.*. .\\..*....*. ..#...... ...**...#..#.*#*.*  . ... .........##...  . .   . ...  #
#. .  .*.*.*  *. ..\.# ..... ...**...#.... *........ # \  *.##. .*... ......   .*** . ##.#.*...  #... .## \....... .#..\.*... . \.....\ .. ...#. .#..#
# ........ ..* *#...*....#...\.##.*.... ... .\.. \...\. .\ ..# . ..*#* ......*.. .\....*.*# . .*.....\... #.#. #. .... .# ....*\ **  ..*##\#....# \# #
#.... ... .....*..# .\. . *.  \.\..#......*.....*. .*.* ... . .#*# . .... #.*. ..*.... ....*.. ... .....\.*...\*....#...#.\. .. .* ....  \ #....#..*.#
# #\*.. ...\.....\*..# .# .\* ... #..#.*... .. #..  *......#.  # . . #*#.\ .....#...  . .\ .*.... .* ....\#*\....*...#...#  .......\  . *.. .. #...*##
#.*....... .... #  ..#..... *#...  .*.#.#.. .*.*.#  #*. . ...\.*..... ..\** .. #*. ..##...#..... .  *.\ .##*. ...*.\.#.. .#.....*. #.#..... .........#
#  ..  *.. ..\.#.\.**.. .\.. .. #.*.. ..  ...\\.*.*.  .....# *#....  ...  ..** . ...#   #..**.  ...  ##. ......*\.  ..\ ..*..*#\.\..*. ...*.#... . #*#
#. ..# ...... ..*...**  .*..#.....*.. ... #..#..... *........*#...* * ..\# .*...\#...\ *.... ..# ...#......  .. . ....##\  ... *. ... .  *... ....# .#
#. ... ...  #.*..* *.#... .... . . ..*.#.   \...* ..** ...#.*. #...**.*.#.. ...#... ...#.#.....*#.. . ..#..\#........... .*.. .. .\.....\#*...*.#*...#
#*.\. ..#. . ....... .\.*..*. \. . ... # \ .. . #... \##\ ....... *.*..  ..  .#....... #.  .** ... .... ......\**..\...  ..#....  .# *.... # .....##.#
#..*.* ...*... \.*  ..*# .*# #.#.* ...# ....*...\ #** # * ** ..*** *...#\    .  .*.#....# * ..*.*.*  . .\ ...*..#..\.. ..#.. ... .*...  .*#  .  ## *.#
#*. ...\ .   .  \.*...\.....#.   \.\. \ #\.... .. #.......#. *. \\\## \#. .....**\#. #*. ..*.#\.##*..  .* *.  .. ..... ..#*.*#..... *#\  .. #.....#. #
#.   ..... ...#* ..#.*## .. . ....#.#\. #.##. .\ *. * . .........*....\.*... \#...## . ..#..*#.# \.....*. #... .....**# . ..#.. .#.. ......#.... #.# #
#.........*. *#.. # ..#..#..  .#.#.. .\..... *#..#.\. *  .*#. .   *....     .#. #. ....#*..*. #\.....* *# # *. # ... *.. .#....#...  \ . ..*.\ *  ..##
##  **. ..... .#....... ..**.\........  ..# .#\. .*...... \ ...#......#.. .   .....*..\ .#\...  * \.. *.....  ... ##* ..*\ .  #.*....#*...*\ ...\ ...#
#....... #. .*.\......  ..*..**.\* *. ...* . ...*.#. . #.*...\....\. ..... **.\* ... ... ..   . . ..#..\ .*.**##...**  * ..\.\.* \.*...#.... .. .... #
#*. . \ .\..  . #.. ..#*.. **. .  ..... \...  #..\* # #... . . ...\... * .....   .... # .* ...#. *..  #..*.  *.... ..*.\.. ### ...... .....\......  .#
#. # *.*..#**.. ....#......\ .... .... ..#\*\ . ...#........ . # . ... . ..... *.*# .. .#..*... .*..#.....#.#..**.*#..#.. ...  .\...  .*.. .\..... . #
#..... . *#*  .....  ..... .  . ##.*...\# .#...*..*#..  .. .*. ..\.  ...#..... ...*.. ......*.*.#   #..  ... .#.... . **. ... .....#*.*# ..*  *..#.. #
# #..#..\.... . .... .. ....#.. ........ .. ..  .... ... .. .# .\..#. .  . ... .. \  #......\*. . ..#.....#......#..\..  # #.. .. .. .....  .**\.\..##
#.\..\*.... *..#...*.. .*..*  ... .  . .#..*. ... ..*....  #*  .. ..#.*...*#..#.. #..**..*\.*...*. .\  .*.#...#.. . * . *.*.#... # . ..* .#.* . *. ..#
# .. #*.... .. *.#..#...\\****# .\..\**#.#. . # . \. ##...##...   ....\... ..# .......#..* .  . . ..*. .* ... . ..#...\ .# .#*..#*\#.*.......  .*  ..#
#* . ..#... .**... ....  . #....... ...*.. *.#...* .*# .  *..*...#*.# *. .... .. ......#. *..# ...   .. .#..##....... ........  . .*.  * .\. . ...*.*#
# ..........#.#..*#.....\...# ....*..*..# #..*.... ........#*#. .....#.##**\**..#* \......  \...**#  ....#.#  .  .*..#. . #..\#.. ..... ..  .\#  ....#
#  .*.#.. #.. .. ..\.. #.#.   .. ..\\ #.. ..   *.. . *.*#..   *.....*#.......# ..#.*.## *.\.#...... .\.. * ....... ..## #\. ## ....*.#. # . .  .#.\*\#
#. .#.##.. \..*.  \ . #**. .#\#..#.....*.. .. ....#.#....  .....*.. #*..* ....\ #. ..\*.#.*..\ #..#.\.*##.\.*#...* ...... ...\..\\*...  . .  ....*...#
#................**..*    .*..#..... .#...* . .* .*   ..*.....#......#.... ..\  .  .. # .*#.* ....*.## # .  ##*...\#.*.* .\.. #\  **.... *..#.#.\\#.\#
#..   *.*. #....*.. . .\.#  .... *#.....**#...  .. ... .*....# \*.\..#*..* .  ...#*.*.*.#*\..#.# ..#..........  . \# #\..   .#.* \*.* . ..... .... . #
#.... .\..*  ...*. ..*.... . ..\.# #. ..\##. .\..#.. .\.#...#. # . *...... . .....*......\.\#. #......##.**.....\........*.......**.\. . #. \.   .*. #
#\*\* \.......##* *.##.. . ..*\#. ...\ ..\#...# . .#*.. ....... ... .. .  ... .\. \  ...*\...*#.* .*....*...#.\* . **.# .\.. #\..... ....* ..# ... ..#
#* .  #.##.. ........   . .#...\.. .. . **.##. ...#* ...#....   #*.*.....\#. .  .*.#..*.  .... *.\....*.#...  ......\.. . ....#*\ . *\.*.\ ..\ ..*.# #
#. * .#.#* **# .\*.. . ##.# **\ #...#.. . *..*  #..*\..* ...\. .*. *.*.* .#. ..#..    *..# ..#.\*#.\  .. \*.. ...\...#.\.*......  ....#.  . .. .. ...#
#**...* ...\...#...*... \.  * ..##*. ....  *.#    *.....  .......*.....#..**...  .....#....* *\.# .#  ... # *.. *#..\*.#........##.#..#... .  ...*#. #
#.....  ...\..\.#....#....... ... .#.#* .* ... ..#*... .. ..  .*\. #.. ...*# ...  *....#.#. ..  ...... ...  ## #....**..*#.. ..  .. *\..# ... .\.....#
#....#.#.*. .. .#.. . #*...\..*. ... . ....  ....*......*   ..... . \ ..*\\....# .*.......  ...*.#. ..*..#*.#.# .  ...*..*#.. .. .##......\. ........#
#.....*.*.#.\ \..#.#**#*#..#.  ..*.\*  . .  **.*#.. \. . .# ....#..\. ..... \* #... ...  . ..#.#..*...\*.  . .... ...*\ .....#*..* .. #...*..*..... ##
#. .#..R...  . ..\.  #. .  *.#* ....# ..... . *....*...#. ..*.*. ***.##..* .#..#..#. ..\ ..*.*..*.*...*#....##\.*.    *#.... .\.. #*. .*. ...  ..  .##
#*... .#.*.#.. *.\.*... .#..  .*...  #  ... .*. # ....*\** \**\....*.\....*..##...\... ..\#...  ....#..#  *.*........*.#\.. #...* .... .. .  ....*\.##
#.... *.#. ...#*..  .. .*.. ..*.*....#...*..*.** ... ..#.***..... ....#  ....#. * ..... .\ ... ...## ......\ . ..#..#. .. *...  ..*..##*... ...\ .. .#
# ...  . * ...  \ .. *.#. . ..*. .*.#. \...\ .. . .#  \...* .. .. .... #.#..\.* ..\. .. *...  ....#. #.. .##.#.*.#.*... * #.*#\..........*.*..  .. ..#
#........#*.....* .\ .. .# ...* .. * \    .. . ...#......*.#. .. **. * . #.* .\* ..  ..  #*..... .#.. ..* ...... .. .*\#*. .. \.... #......#.#.....#\#
#** ....#... . .*\.\ .....#*.##. *.#.*...*.**#*. .. ..#. ..  .... . *..*....*.... . ....\*...#.......... *#.#. *...* *....*....\\..##.. .. \#..\..##.#
#..#. .#*... .**......... .. .*\.....# ........ \#*... .#*  ...#..... ##*....#... .*..*##.... . \.##........#.. ##.....** #........ .   *.....# .*...#
# .....*.*..\. #..*.. . ....\ ...*.#...\.. ...*..\*\   ..#.\*....#..#....*.*.*..*#*##.#.# . .\\.\..#..... . ... ..*.*..#........ .. .. . . .\.#  .\. #
#.*......*...#....*#\.*#.\\.  #. *. .. *...  .  \\....\.#.    . **.. .. .#. # *.\... .  ... **..\#*.*..*...# ..... .....  ..........#..** .#.#.  ..\.#
#. ... \.\...\# ...**. . ....* ..#...  .*.#  ...*...\ . ... .##... . ..\*#..\#...  #..*#....#*....* .  \ *..*.......*#*......#\ # .  .. .* *  ..#*.#.#
#..#...  * * .. *....\.*... ...#*....*...\#\**....*#......#.  ....*.#.#.....#  . *..#.*# ... .. \.**. .....#*  .# .#... ...##.*.*.*##* # ## ..*.. *..#
#..  *.  ...*...........#. .. # ..#.\#. **.#..\ . .* ****\. .*..*  .## *.......# * ..#*.. .##  ##..#*#...*\........#..#\#.\.**.. .. ......... . .*...#
#...*. ..#. * ...#.... ... .# ... .*.. ...... . .....*\#\. *.*...*..#\... ..... .. ...*..*.#.. .\* ..... .. ..#*. * \. ...#\*.  ........ *...#.#.....#
#  .##..* .#* ... *....*.\#  #*#  .*\... #..#...# * .# ...\##..*...*.#*. #  ............  #*.**. #. .*\..*#  ....*..  . ... ..#*...*. ... . .#*\ *  .#
#.#. .. *.. .#.#. #..... .  ..  .#...... #.\#.* .. .. .. # #*. *.*.  #....#*...*#*  ...... .. ..*\.#.*....#... .  ..#... ..*#. ##......#..#. . .. .#*#
#  ..  .... . *..#.  .... *.... ... .#. .*.*.#. ##.* .*..#.*...  ..   #* *#\ ....# .**..\* \....#*.\*. . ..\#....... ........... ..*\....  # .  ..* .#
##.... # * .....#\.. . * . . . *...*.. ..# . #..#. *\ .. .*.*. ..*. .##. *..#.. ....... ..\.....\  .#\.# \. .  .. *.  .#*......*. #....\. \##. .. *#*#
#. ..*## .# ... \.#. .\*.#..#..#  *... \#.\ .\ \ #..**. #. .\. ......\.....#..... *  . .\....*.# . .....\ .#. .....*  *..*.*.. .. .#** **...... ... .#
#...  ..\*#.* . *.*..#...\....  \..... \.##..  *......#.*.. ...*...#....*.#..*.*. .#*.  . .*..#.....#....*.*.  .. .#. .*...#...*. ... .....# .  ..**##
## ..##\** **..*..*.***.*#\ *#. .. ......\.#*.##. .\. .*... .. ... #. \. *##. ..*.**  .. .  ..*.#  #\*. .   .* *  ** ....  .#.\. ....*...#. #\\... . #
#..... * ...\* #\....*#.*. #.* .......*. . .#......\ . #\.....#..#.....#.#. ....*..  *#.*.\. .#.......#. #.#. .. .\   ...\**\.\ ..* #.\.. .#.  ..\#. #
#  ..** .*...  .....*. * .....#.. .. *** *.  .\* . .  #..** .##*....#.. .....#... **.. .....#.... .#..\.\..*. . .\.. ..*. .## ...#.... #. ...*##...#.#
## ..... .....#..#...*...  *.#. ..** . *.#..*\*.\.#.#.# #. .. *\.  . #.. # ... #.#  . . ..#... . ...  ...#.....\.  ..*...*.*.. .\.. .#*..*.* ....#* .#
# .  ..#..#...* #........# . ..#  .##.#. .**# # .\* .. . \.  . ..*... ..\*..#..# .*  .\ *.#.#*...  #.*..*..  .. ..*#. . ** ...*. ..  *.*#\.*..\......#
# .......#.*.#*... . #*\.. .....* .... **..#. .*\..#.. .. *..........* .#. ..*. \*.#..* **   . ..*... .... \. ...*... .*....#.  ..\.#* .*#.**..*..\. #
#... .#.. .*.* ..\...#...##...# ......\.#*.# .\* ** *\.. ..\ ..#.**...\.*\\ .*\.... \.*#.\ .\..*#..*. .#..   *.**..# ...## . ....   .# .*...\..... . #
# ... * .. ..#*... ...*. ... .. ....\. ...............\.*. ##..*\.# . *.  #* ..... . ..... \.# ..#\. .. ..  ...  .#.. *. ..*.#.* \..*\* .\... . ..*#.#
##. ...  \.  . ..... **.....#. .. .##...* ...*.\...  .* *..#...*#.. .*..........* #..\.# *.. .. . ...\....#*. .*.\  #.*..\#...# . *. ..   #* .......*#
#....*.  \ . ..* *....  .#. ..... ... .*... .#.##*..* *..... ... *\ *\..##.*##....  .*...\ ..\#. ...# .*..*.  .. ...\.*#....# .....\.. . ... .# #\  .#
#.......#.....*.# \# .. \..\ #..*  .*.#.. .....#\##  ..#.*    .*.*#. .#\..#... .#...##... \.\ #..**..*.#..#.*........ * ... *\####.#.....  ..*..#..\.#
#.*. ..*...*#*..**..*..#.. .#.*....... .**#...    .  .... . .#.#.\...#. .*#*.#.  .......*..#.*..#..\..#. ..*..*..*  .... . *.  .... .... . .*  #.*...#
# ...*.......\*. ...... ....... ...*..*.#.....\*.... . \  ..... .. # ...\..*..\#. # #....\*....*.*\   ..... .#\\*....*.#. .......#..#.... ... # . *. #
#.# .....**. *#     ..    *....*. *.... .*...*. # . *.  *. .\..  *. .#\....*...\... \*..*\ #. .. #... **.\.*  #**....*..##....#** ... ... #.#*.##....#
#... ...#*  ....*. ...#.  **. ###..\. #..# . \ .. #\\......## .  .#.# .#...\...\.*   ##. * \..\ .  ........##..*.\........#.\ .\...\... .#.#. .. #*..#
#\ \...*.....#. #*.* ..# **. .#..*.* ....*...#.\.....  .\#...\.*.# \...\...*......... ......#.# #........#.*.#....*..*\......*.##. #......#.. .#.* .\#
#..\#.  #. .\ *#\.#.*\.....\#.   * ..** ....*# \.#*.. . ...\.. ..#    ....#... ....*.\ .\.. . ..\ ........* ....* ......#... #. .*.....*.\.. .* ...*##
#..* .. ...\..... . ..\. *..*.. . ....*...*..*......  #.#.#.*\....*.   #*# . .. .\# ... ....# .*..   #.. #.*.#......  ..*..  .*...  ...\.# . .# ....##
#. **.##...* .... .\ \.#\#\*.. ..#... ... .. .#*.. .*...\.#.\....\.*.*.*.. .#.. \ ...#..#*. .. #. .#... . #*.\...**. .*. .... .. ... ...#\*\. #  ....#
#.. .. .......# .  \#.\#.. .*..*....#   .##\.... . *.... .#..\##*#. \*.. ..\....# *#*....#\.. .........\\ . .   \.. ...*...* .##.. .#.. . .\ ..#*.. .#
##  ....##.*..#.. .\....*  .. .#.. #.#. .  .. *. . . . .\ .\.. .#..   *** .\#...* ..*   .........*.#**. .... ....\.....* *..#    #.#. **...#.. **. . L
#... #.*.#..\....#.#. *.. #.... .# .* . .. .*. .# ...#.###..\*... .\#*.....* ...*#.. ..*.  ... *.\. .\.*....* .*... *..  .\.. .#. .\\.  .... *..#.#..#
# *...*#.. #...# ... ...  ..#.. #... .#.  .. .  .  ..\*#*. .* *...* .....\........  ....#*. *\##... \  ..*...\.#.. .  . . . ..*   \.. \.* . ...\\ . ##
#..#... .#...*..# ... .**...* ..*... .*....*..  . \. .# .......* ..#*. . .. ..#.....**   \ .. .#...\*.#.#..**.##. ...*.\ ....... *. ..** .. .  ... ..#
#.*  .... .** ...\*.# #.. *. .# . ..#...\. \*\#.#.*..**...*..\..  \*.....\.*  #*...*. .*.*.... *.* . #* .....#. *.. ...  ....#\...# ........#* .\. ..#
#... .# ..*... .\. ...** .. #*\*...... *..\......#.*#...*...# ... . .\.\... ...#..  .  .\. ..* #*#...* .... \ .##.*#....\ .#....   ..*.\.*. .....\...#
# .. ...# ...#.\.\*.* .*........#* ....... \\..# *\#*..   . .#* ..**.....#.. ....*   *.##  ..  .*..#.\.*  .... *...\.  .#.  .*.*...*.# .  .....\.....#
#  .. .#... .# .. ..*. ... .. ....*. ..* .#.\#..#.#.*. #. ..##\.*. \..#.\ #..#. * .\. . .  ...**.. .. \..** .*.... . . . ..**\\*..\* \#.*#   . .... *#
#.  ..##.  #.. *... .......## ..  \ .*#.. *.. .\#...#...\ ... \.##.\ .. .... *..... ........#...   #\.  .....\*.*   . ## #....\## \ .#... #..  ..   .#
# ..#.... ..#.\.. ...*. ...#...#\..# . .......*..#. ..\* \*.# ..  ... ##.#.  #..*...#.# .......#\ \  ..#...##. .. *... ..... *.  .. *# .*..### .. ..##
#. .*.*.#... . . . #..  #.  .#... ...*.*..* ...\.#.*  *... #..#......*#...*.#. ..#.. .#* . \*... .. ...#.#*.**........\ .. ...# .*... .#.\.#.....# ..#
# .#.# .. #..#\ ....#... .. .*.\  .*. ..# *. . .. .  \..## ...\..*#...  \...#*....\...##\*.#*.... .   #.##........  ..*. .##.. .....\# #.... ..*. \..#
# #\#*..#... .*.\#..\#..... .*..* .*.# ..\..** ...* * #.............#..#.\\. .#. * ...# *....  *...  ....#.\.... .#..# #. . ........... .. .  .......#
#*.\# *......\#.. ..##. ...#..#..*..#  . **   .#..\...*\.....    . .... .. .*. .  * ..#..*. #. ...........\ .....#**##\..  . .... ...*.#.  #*.... ..\#
##......*...*. ... *...*.\....#.**...*..\ \# #.   .#. .# ..#..  ... .. .* .#..#.. .... *#.#..###..#. #. #...*......#*# ... . #\*.. ..\..   **.*..*...#
#. ..#.. .  .\...\. #.*..\# #*. ..... .#. ..... .   *..#.. * .*...*.#. ......#... ..#.. #.  .....  . ....#*... .*#.*\.....*..  .... *.....*... ...*. #
#....#*. \. ...*.... \ ## ...\..#........ . # \.....#.*..  \..  * ...**. ****. ... ..* #...    .......*.#.. #**#....... .. .....#...**.*.......# . ###
#.#\* .*...\# \\#..\.. .* #. ..\.. .... #.. \. . ....... *.   ..  . . ....... *..*#..\ #..*. ..... **.*..#...... #...* ...#.# ...\....# ..  .. ##..*.#
#*.*#.#.#.* .. ...*..  ...* .#.  *..# ...#  .*.#....#.#..*.. ##\ .#...*.* ...***...*.... *........... . ....\#*.. *.......##..#. . \\* ... ....... #.#
#*..  .\##......\..*..  . ...\.*.# ... .. *.  ....  . \...#   *... **.*......*..... \....# #... ...*.*.......................# #..*.....* .#. *. .#.##
#\. #.** . \.#... .... .\ ##.*..  #..... *.. ..*#..\.#.......  *...#.. *...*# #*.#..#.* *\.#. ***.\\. ...... ..#**.*.#*....*# #\....#....... ..\\..#*#
#..#...#   .#.*. ... .. .....#*.....\\.\*..*..*  ..##.*.# ...*##.*....#*..*...#.... . . . ...*#.#..   ..*\..\ \\.... \ .  . ......#.....*.\ . ....\###
#  *#....\. #... ...*.*.*....*## ..\. .\.#. ..#. .  .#....*... ...\.#..#  ..#...#. . ..*.#*. ...  # ... #   *.#*.\ .*# ..*....\## .. . *...#..... ...#
# ...... **...* .\****..\.  \  ## #..*.... .#...## .* #.\..# ..* ..#.... . .. ......#...#.* \#.....** ..#. .*..... .#........\*... *. .... .#  .. ...#
#. .*.#.  .*...... .*...#. ...\....*.. ...**.*.....#* .#..........*.**  *  . *...  ..*.#\...\. .#.#.*.....*...... .** ...........#.. # .#. * . \.. ..#
#.... . .# . .\.* .\..*#.* . *. #...*.\ .##.#... .... . ..##.. \\.. ......... **..#.. #. \ ...*... .  . ..........*...*.*. .  ..#.. .  ...\... .... .#
# # ...  *.##.#... #.. ..  *#.# .....#.* #.. . *## ..\*.... #.. ..  .......  .# .*..**\.......#.\..# . ##. ...*\*..... .#...# .**. #...* .#.....*....#
##.... *........#..#.#...*** \... .. *\.\.#.*.#\*.##.......* ..\.# . ..*.. \\...*..  .  \. .  .*.*. .......\... .... #* \ . ..\#.. *\..... .. \#* .*.#
#.*  * .#*.....  ... *.\* .....   . ...... .. ...* ........# .\.. .... .  .... .\.# ..\.*.#.**.*#\*..#. *. ... ......#.. \*.#.#*#..*..*#.*.. ..... .\#
#.  . *.....*..#.......*.#..*#...\ #\ .*..# .... ... .. .\\....\.*.#..*.*......... \ ... . .# *..\#... ..*....*. *....*\..#.....#  *# ##\.\. ....##.##
#..*.*..*.. #.......... .. ....*.###.... ..... .. .....#......  *\.. . .. .# .##\.....\..\* .# ..... \#.\..\.*. ##.\*...#..*.\.   ..  ....#. \*.*.. .#
#*. ..\ .#.... ....\*   .\. .\#.#.. ...* .#.   . . .\...   . \. *\....##..#... .. . *.. # # .  ..\ .. ..*.*... ..#..#.##\. .*#.# .   \......#.*....\.#
#... .*. .......*#*. \.#..*..  *.*\.... *\...  ...\...*. . ....**.........*.#*.... * ##. **..... *.#. \#* .. ...#... *\.\#.#  .*.\.*  ....* ..... ...#
#...... .. ..*....* ....## *.#. ..#.*.# ...#...*.#...  #\..\#.  .  .. ...#.....#... *..\. ..*  .#..#...  *.  ..\#*..\ #*.. ... ..#*....  ...#....*.*\#
#    .*#* .#\*..#. ...#.... .......*....\#....*\ . .. .. *##.......\ #..#. . .....*. ..#.....*. ... .  .....\ \.......*..*.*.*.#.... * *.  #.#.......#
#\.. .#..*...# # ... #...#.  .. .# . .... #. ... * ...*.. *...  .... ...*\*....#. *#....*. ....*.*.# \ #..#......    ** ..#.#*..  ..**.....##.  ..*.\#
#...# .. . #. . ..*#....\. ..#....  *#\#.. .# .#... #.. . \\\. .. \.#.. #... ...\ ..\.*.. . . # #. ... ..#. *....*#..........*#.# #.*..# .... #.*....#
#  ... ...... ...*....#   #.*..#..#.......# \..\  . ...#.. ..# ....# *## * .*...#*.\#.....\... .. *. \...*..\... .*..  ......\  ....... ****..#..*.* #
#...   # ...#*.... #. .  #. **. ..\.*.#......\. *# .  ..#.. ....# .##..... .......... ## .. ...#.....*.#*.. *. ... .  .*.**.....*#\   \.*....#... .. #
#........ .\....  ...... #.. \ \.#.*. . ...*.\.. .......#...# #.*.*...#. \#.** .. *.* .  ... . ..* # #.*. .#.*..... .  .*.* ....*.*\#...#.#..\ *.. ..#
# #. .. . ...... ..#..  **.\..*...    .* ...*##.... .#\.#..#..*.*  .** .... .   .. #. ...#....*. *.\. .\# . *...\ .*...\..*. .*\**  .#. #......\ * ..#
#*.\. .. ..  *.#**...#.# \....  #. #.\ .... . .*......\ ..... \.  #.\.. . ...#. \.. #.. . ##.##.  .... ..*. .  ... ..... *..*........* ..#. **...  ..#
#..... \ .... .#..##.. . .... ... . . * ..#...  .. #...\  ..# *  .  ..#.# ..**......*. .*..* ... #.... #.#. #....  ..#.*.. ..........#. \ .  ... #. .#
## .. *.\.. \ .##.*...\#...... .. *.#*. ......*.#.......\#*  .##..##*...\.*.*...#.*..*##*\.. #.......*. ............  . .\. * *.\  *  *# .*... *# ..##
#.##.  \ #. * .##...  .   ....\..\#..#....#.*...\# #..*  .* . .. #. # * .....**. ..#**.*. .....*#.. #\..... *#.. ....*..\ .  ... ..\#.  #..# .. *.\  #
# .. *....  .......\#  .  . # .. .#..#  ....*#... .*... *#*... .#*....*.* *.......  ..*. *....\  .\.. .\... *....*\  . .*.. .. #. *#...#..* *\. *..\.#
#...*. ..#..... *\..#.*.*....#   .....*..##.#....*\ #.* .  .\##  ...*..\*.\ ... ..  \. .  .*  ....... ** .. ...... ...#.. *. . \.. .  .... .# *#..** #
#... ... ...* .\..*... ...*..*..*.. .  ...# .  .*#\.. .\..#  ....*. ..#*#\.... . ...... #.*. . \ \.. # *.  .#.*.... *.. .. ...##.. . \... \ ....*\.. #
#....... \ *  .#.  \.#*....*....\*.. #.. #* \## *..... ...##.. .\.*.   ... .. \** ....  ... . .\.\  . .  *.#. . .. .##...*. *.. *.#..  .......#......#
#...\\ \.#...#* .....  ..*...**..#......**#..# ..#.#.#.#..\.# .###*   *#. *\ .. *  #... .\ #. \..\ .....\...\.\ . ..*.. ....** #.  ***#....# .*.. #..#
#.... . .*#...*. *.... ..*.*#.# ...# . ....* ..  ..  ........\..#..* .\.   ...#.... .... . **...*#.. .. #.....#... ....... .. .....#** ........* #...#
#. *....#*#..*. ....#...*  \..... .. .  .  ..**...*....# ..#..\#*\*# *.*...#.....\#   ..#. .. #.. .\* . ......* ..* #...* *.. *# #..  ....  .......\*#
# *. . . .. *. #....# .. .#. .***..   ..\  .#\ .*.#. ... #.. .  .##. ..    .#..   ... #..  #\.. #.........#* . .\*.. .\* ....\...#..\..........###...#
#.  #.#...#.#.   #.. \\.....  ...*\#....# .*. *... ....#**.*....#.....*... ..## .*. \..... .#.  \ ......#...#.. . . .**.* #\..\.... ........#.#.....*#
#.*..*..#\.*.*..*... ..*.  .#... . .. ..\....\   . .#.# ...# ..  ..*..\#.. .# \ #.....  .. . .. . ....\*.\ .*# ...#...........\. .*. ....#\#. #..*. .#
#....#.# #.. .*.*.#.   ..\....*#.....  *. .* . ....*..*... *..  \.\ #..\\.  ##......\.\ .\...... ...\  . . ..#..  ...#\... \*.*..\ #....#.   ....  .*#
#   . ...#... *. ... ..# ...#.*. ..*...  . ....#.  ...\....* .....*.....\...*\.. *... . ..#*#**  ....##.....#....*.. ..*   .. *.... * #..*\.*.  .... #
###. . #*.##  ....  #..... ....*\.  ##*## .*\ .\.\.*.... #*. ..  #...**.\...\# *.\ .*...# .#..*..\ \##*..*....  .#\ .. # #\.. . . .\*.....##\...  ...#
##\# ..*.#. # \.......*. * #.*#..\...*\...... \..* ...  .. *# ...*..#..*....#..*\. .. ..... .#.*.... ..*.#.\....*.\. .#.#... ....#.... .##.***  . .. #
##... .*# *  .##....# #...........   ........\ . #\ .. ..#..#... ...\..# .*. \# .## .....#.......... .  *......\. .#. .#\  .....*\.*..\. ..#.#..... .#
# .  *..#*.  .#. ##*. #..*# *#... .*.#.* . .##... . ...*.. ... .#.#*...*.*.. .. . .\.#* ....\*.*...*  \#. ....*...*..*#..#.  .#.**.#... ***.\...# ...#
# #. *..#.# .#**.#.*##.... *.#. #..\ .. . ....*.##...##\.\*. ..#*.. ... ..... ..   *..**.*...*.#...*..... .*\. .##. *\. ..  .... .##... .## # .   .###
#. .\.\......*...#.#. .# .. *... ..#... .... .  #.  ..#*#\... ...#......\\..... #...# ..\.. ...**. ...*.\. ....  . ..\..#..*.* \.. ...#.... \... .*..#
######################################################################################################################################################