########################################################L#############################################################################################
#.* * ##.#.. # * .*  .*.... . .....#. ...  ..# .\. .#* ........#... ..  .* .#.. ..*...* \........ . ..#.. ..\..#. . ..\...#. .#*.*  .....#...#*  .*  #
##.   ...*. . ...  ...# . . #.* *..* ...\*.* #.  .#..*...   \....  ... .. ..*.   .. ..  ..*#*.* *. \ \#... .....*  . ..#...\.*#...#....#...\...  #. .#
## #*.. .*...  . ..... *.*.\ .##.*\\..#.. ....*...*  *.#. . . *. ..... * * *.#. ....\*.#**.....*.** .* .. ......*.#..  .......#... \*.\# \ ...*.... .#
#.#.*..#\...\. * ...*.*...   \...#. ...* . *..\# ...\\.#...#. # .#. ..#.......#...#.#.\..*.*.*.* #...* *#..* \#..\ #........ . * ..#..  *.#.. .#.*# .#
#...#...* .#..........*.*\*..* ...# \ * .  ..#* ...... .  #  ..# .# .*. . .#. .\..*.......\.*... ..* # #. ....#.\.....#..#...*## ..#...#.*.*... . ...#
#\....\. .   \# .... .. .....\.\. *....* ....\ .*.#\\. .*#.##...\.#... ..\.......*..#.... . #* #...\. *. *........ ..\. *## ...\.  ....\ ###......*..#
#.  .... ..#\ ....\ ... #. . \\ ..#..*. .. .##.. .# #*.#.\..#  .*.. #..\........# **\*.\*. .#....* ....*. .. \ . *.#..\.#.#  . .. .\\ ..........  .. #
#.. #...* . ..  .* .. .#. . ... # .*. ..**.... . .# #. *.#..#....*.. \.   .....#* ..* ....  *.....#*.* ..   .. .# . . .\  .... *...\.*..#. \  ...*. .#
# **. #..#.* ... ....\. .#**.....*..*..*... .*.*#....*...# * ..\..\.*...\.. **..  .## .  .\...#..#....... ..*..# ..\\#*...\. *. #..  #...\....   .*#*#
#. ...*.. .#.....#*#..#..  . ........*# ..\#*\..##.. . *\*. .*...#.*. ... \ #.....#. ..   .... .#   .***.  ... ##......**# .#.\....#*.. .*#.*....#  .#
# #.. #. . .# *......  .  ....#...*.. *....\\.*#...\..#....*\..## #. .*...  ... * .. ###   #...*.* #*.... ..   ....*.. #\\ .. \.* #......*\ \.  .#...#
#. ....*.# ..**\\#\...# ..##    .. *\ ..   \ * ..... ..  ..#.*....*.\ . .....#. *.#... ......#.* .*.\.*. ...*.#. .*... .#.*.\#.  ... .*. ...#........#
##...*#.. .... #..*# *..*.\.#....\..##. .#...*.#.#......# #.  .* *. **.#...*#*.***\...*.* #*  #... .... .... *.*.  .. .*....*....*.......... . .# **.#
#.. ...\#* \\ \..*...*...*. .#...#..# ..\\.....* #...#. *.*.#.#.... #....\.......*. .......... .* .#.\.\ . #...... ..# .  \......\. *\. ........ ....#
#...* #..#\.. #.  .. \* ....*#.. . ...* . #*....#. *.....*...**..... ...*...*.#. ...*#........... # *.... ...  .*.*.#......  *\ ...#*.*.* .... .#. ..#
#\.* ....*  . .... ...# ......*... .#\..*\.\.. ..*....# ..   \.#*.#.\. .. .#....# *.#\ ... ...*....\ #.* . *   \. .*\. .*#..*. ..\\.... .. ..*..#.  .#
#.  *...\ *\ . \..*.* ..*.**.*#.*.. .#\.* . .......\ .. ........ .\.# \....# ..  \...... *...#.* ......*.  *.*#..##  .....\\....  ..** .\.  .#...* ..#
##.......*. #.... . .*#\\#. . ...... ... ...... .\..\.   ....*## . .. #...#   *... *.#  **.*. .#..\#.*.. \ *#....*....*. *.#....##.*. ..\#*.. ..\..#.#
##. ...\#.#. \... ..*...# #. .#. ....#........ ##... .#...# .\#.#.* *.. #.. *... ..#.  .**  \..... *.  ...#..#.**. .# ......#*... .*#.\ .. *..* .....#
#*...**.... .* *..*.... .. ..##*.*.. .   * .# . \.. . . ....  . ..  ......#..*..\\##..###.. .*. ...*.. *..# ..# ...  . .**. *.*. .. #...***#** .#. . #
#. .*.\.....\ .... ...*\#.* . ..  *##.# *....... *... ...#.* . *.. ... ....# ....\....#.*  ..\..*... .*..  .\ .#....*...... ..\.* .#\ .*..#.\...*. .*#
#..*...#...\##....#..  \ .......... ...#...# ...  #.#....\* . *.\..*## .. .*#..*...* .. .. *.#.#* ..#.*..*...#.*..**.#..*\##*.#  ...\.#\........#..*.#
## .. . . . .  #\.*...#...*.*\...#.. *.#...\ *...## *.*.  .\....* \. *.. ..  \\.*  \ .\.#....... \... .#.. . #..*#..\\  ...... *.  .*. ....#. .\....\#
#. ...*.....\ ...........*.. #.#*.......*. \*.*. ..\**. .... .  \..  #.*.. .. ..*  *.*.*.. .....\..#.. ..#*. ... ..  .\.#  .* .\..\.#.... #.  .* ...*#
#*..#*.. .\...\.##  # . ..... .....\#...#  ##.  ....#... . ..\....   . .. *.#. .\..*.*#.. .#..\.\.. #.. .... #.#.# # ....... .*... . ........*...\...#
#. .  .. .....*...##.  ..**. ..\.*.  .** .....*\.**..**# ..#. * .*.......... ..#.... #......... ...#.*..  ....#.#..*... \... .#.*  ...#. \.\  . \#.*.#
#####\..#..#. .. . .. ..... *.... ..#...#. . \# ###. ..**. ...  ..* ..\\.*...#.*. .. ..##\  . \.\ .*....  * .. .#... #. .\..\ .. #. *   ..#.  \ .*. .#
#..*\ \..#*#.* .......... ..*# ##.. ...*\* ... .. *...#. *..  *...  .\ #* .\ #.#\.#.#. # .\......... *   ..... .... ..*. ..#.* . ..#.#  .. *.*...*  .#
#...\ ....\....#*# * #.. .....\...*\#.. ...# \ ..... #. \..  .... ..*...#\ \.. ..#...*  ..* .*#. .... ..........\..*..  ..  ...*.#..*.##....##.... ..#
#. .\...#...#.*  \........*...  ...*#....#.. .. \*.# .. .*#.. .. .\*.**....   .##. \... #*# *\...... ..  .*.# ..... . . .#**** .\  .#. .\.   .. . #..#
##.. . . ..\. #.. .\.....*# .  ...\...#.##.*... .* *..*.  ... \.*..#.#... .\.. * .*. ........ .#..... ...\.....*..... .##  ..*.. .*. .# .. \. #.#\...#
#....\*.#. . ..... *.. .... .. \\. .#.....\ \.#. .. *.#..  ...*#* . ..\**.##...#*... ..\.*.....*..# *. .....\... .*.**.. #....*.. .#...##  ......**. #
#.##.* .....\ .  .#.. .*.*..#...\#...*.*\#.*.*..... ...#...*.* #.**.*... * ..*# .... .....*.#.#....#..#**# *..#*. .#. *...#\....*..... # ... ###  .# #
#*.\ .# \ *. ..\#.\\ .. \.\...#......#..#..#.* #..  .##..  ...  ... ##...\...   *.# *..  . ..... . . ........ . . .*.....  ..#   ..... *# . #. .....*#
#..#... ...*...*...\ *.#*..*.. .# ...... .*..  .. .*.*..*.....\*.. .. .#.#......*. ...#. *......#..\...... *...... *.\..**... \. .##. . ...**  ... ..#
#*.  #... .\ ... *. .  ..*#.##.. # *. .. . .*.# ..# .. ...... \   . . ... ..*... .##.\  #\ . ....*... \.  \.  .* ... ..#... *..*.. #  .#....* **... .#
#.. #.  #..\.... .\........... .*\..  \#.#*.*.#*# .\.....#.*..#**... #.....  .*.\ \. ......*. . ...**. ... . .# *...#\ \.....\... \. .........\ ...*.#
# ..  .... ..... ...## .... ..#.**. . . . .... *...\...*   .#. ....*.\..\.. #*#.# ##....* *....* \.# ..\..#.*... ... ... #...\ ... . ... .  **.*.#.# #
#.  .# #\#.#*.. # \.\ .  .* *#....*..  .  .\ ...   ...#.*....*.  .....  ... .  #. . .....#  .. ..  . ##.#.\ .....# .#\. . *.*#.*\.#*#...#.##...\.*#  #
#.* ... ..*... ....... \ *   ..*.. *.. .....#..#*..##....#.*#\# \# .... .. ........\..  .\###...... .#... *.#*..   ......... . #.* ....#.*...  *.##..#
#\.. .*.  #.. ... .#.*.*.  ... .....    . .... ##.# #...## #...*.**. * . ** ..*#\#  .. ....#.#.. ......   . . .. ......*\**.*#...   . ...\#*.#..#* . #
#...  * .*.\.#*.. .\ **#. . .\#..\ .. **#.#.... \..*. .\ .  . ....\.\##...\.*....\ .....#..\.  .# *. ..#*#.\. *..* ..** ......\. . ..*\. .*. *..*  ..#
#. ...........# ...#.#..#.*.\.....\ .*. *.... ..#*#...  ..#*..... ..... #..\......* .... .. ....*.#......**#   . . **.#*.##    ##. #.\.**.# ... .....#
# . ..\. *.#  ..... ...**....\. ....*. ....\.* .\. .#.  . #\. ..#. .. ............. ....#*\.....*\ \..#  .\.\. ..*. .* .# . ....\... ....#.*.# .  *..#
#..... .#...   \.. *.. . . . #......\. ...*..  . *##....#* *.\....*.#..  *..#. #. . .. ...  * ...... #.....#*.....  *. ... *...* #\*\.. *. # *. ... *#
##*....*.# .*..* *\. .\.*\.  .. ..\*.. . *#*  ...*.. ....*#.**.  .\ * ..#.. ..*.. . . . .\.  . ...*. .... .*\#.....*#*#.#\#.. * .*.*#.#\.*.\.. ...#..#
#....   *.*.....*..#....#.......#. . ..\.\..#. ..#...*  #...... ... ........##.#. .. .#....*...#.  ...*#.*.# .  \#..... .. .*\# ....##*......* . *#*.#
#.. .#....\..*\..... . .... #.\ ..#\.\ . ....#..#.#.. .*.... *. ..*.*.   . \. .#..**.#.  \*. .*...# .. *. #...  .  ....# ...*.\. .\ .. .#.* # ......##
#.. .. #.#..\. .. ..*.#. *.......#\* ..\.*#..\. ..*..*...#*..... #.#... ..*..#. ....#...#......# . .........## \  .*\.... .... *. .#..#. ......* \. ##
#..  .*. * #.. ... ..\*..*#.... .\   ..#  .#* #...*  .... *... ...#..\..\....... \  .*#. .#... ..\#..  #*#... ...#...  \..  .\* #.. ...*  \..... .\.##
#. .*\   ...#\.  ..*   *\...  ..#. .....#. \* ... *...#..#.... .#\ . .. ..#. . *...   .. .. .*\.* .## *.\. *.\..*#. ... ......*....... .  .*. \.#. ..#
#..\.#...*#.*##.. .#  ......*... .*...*..*\*  ..# *.*...# ....* #.****  . .#... ........ ..... .#.. .............#\....#*  .....# # ..  .\#..#.* .\  #
#*\.....* . *.. #..*. .......  ...... ...\\...*.. .*......#...* #...... .*..**..\...\..#. ..... .\ . .\...*...\...\*..#....***. .. . ...  .* .\\....*#
# .\* .....  #*. ......\.*....*\ # #.* .*#.#  .\##\.#.*.. .#.... .. *.\ \.*.#....... .....#....#\.#..... ..**\. ..#.#*.......##.... \... \.\.#.*.....#
#. ..  .. ..\   #*.....*...**.......*.#*.*#...\\#.\ ..\\..*......#.\*..\.....*...\.#.  #.....  \ ...... .....*.#.\#\...... *..##...#....  ....*#   ..#
#.. .#*# # *#.*\.#.. .*..\.  .....#*#  #.. *. .. .** ..*..  ## . ... ...*.#\....  .... ... . *.# .... .## # .# **......*..*....#......* . \.*....... #
# .**....#...#.......  #.. ..... \.. ..* #...## .....#....**#.**\ ..... ..* .#.# ........... ...... ... ##..*.#..... ....\ ..*. #...  ...*#....##..#*#
#  .#.*#*.. ..... . .\.. .. *.....# .* . .  .........# #.... #.. . *#.*..*...* .#  # ..  \# #....#.\.. .....\   . **.. . .*#.....*...  ..  #.**\*....#
##.... ..#.#....\\\. . *.*.....*...... .\ #.. *. #   ..*.#......* ...#. \.\..# *.**. \**. * ..*..... .* .... .#...#..\*... *\.#* .. *.#. . # .....#..#
## *..  ..\**. .*. .  . .#*..*.....#.. .*...*. ..\*.#.... #.. . #........ .\#. ...**.#..... .. #*..# .... \ ##\...#  .  \...... .#. .*..  . #.# # \..#
#....*....*#\* #.*#\#.\.. .\....#*#*....*#.... .*.   . ..*. #.#  **.... . ..*.. ....**\...*.. ..#...*\... #.*.* .#.#. .#*#*. .. ......*.#..*#\. #..\.#
#. ..#. .. ...*. #. \.#  ** ..\\..\..#....**. ... . . .\#. . .... #..\\. * *... *#. # ..**.\......*. .*..  .. *.....\....#. \. ..## #... .# . ..#*. .#
#\...\*# *. \\. *  .....\...*#.  .\.. \ \....#*......*.**#  .... *..*.\.#*.. .*\...**  *...*...... **. .#.\ ... ##*...... . #...\.#\. . .....*..*#...#
# .... ......*..#\#...#*.\#... .......###.  .........*.**.. ....##...\#...# .. .#.*.  ...... .. .... . *... **..  ##.\... ..* .* .*.  .* \# ..#\.* ..#
##  ...**.  ..... .* ##.# ..#  ......*..*   # .#  ## .  *\*.. .\ . .*. *#... . *.  .  ....# ....#.... ..*...*....*#. ## .*.. . **.\...\.##.. .#  #\. #
#.*\......#. ... \  ...\...*..*.. # ..*...  ....*   #..*\....**.. .*.. . # .. .*..\ #.#....#..#.  *  .* .. .\ . #  .. .. .... ....   .....*.*.\# .. .#
##.   *.#.. ....#....#..*. ..*\*.*##. ..... ..*. ...\#\ . \* \ .   ..*.. .#...##.\. ...\.... *..   *#..  .......##.*.#.\ ..* .. # ... #. \.. .\*. . ##
#...... .*. *.#. ..*. #. \. .#. ..... .**  . ......  .... *....#...*. * ... ..*.*## #.*.\**#....  .  ..#.. .*. . *..*..#*.... *.# .#..*. .*..*.\.....#
#.\  ...##\...#... ..\.##..#.*#........#* ...  #. ...*....*....#. *......*. ..... .  .*.. #*\.. ..#....#*. . ..#.... .# ...#.*.. # ..#.*#..  ...\.. .#
#   ...*.......  .\.. .\. . ......\.. .#.  .*.  . .\*.#*..  ..#\.. .. .   .  #.. .......... # . .\..#..**.*  ##..........  ...*.#. . ....\..#*.#.. # #
#  #  \...*...*...\*...#. . ...... ... ..\..  ......**\\*..  .#.....##*..#..\*\# .#.... .  *....* \.\  ...*. . ..\.*#... .##..*... .... .*.  ...\....#
#..#..  .##.#.#....... ...  .#\.*# .... #.\.. .\ \ \...... *.# . .#.* .....#.\. . ..*....## .. .\ # **.\ *. #   ..# .*.  . .*.*... *..\.#....\... *.*#
#.#.#.*.... .. . . #......*. #..*... . ..#.#..#. . ... ...#.# ... \#...*...\..#..#. ...##*... *........###...\ ... ....\.\.. .. \**.* ..\......  .  ##
#.. ..**......\  *..*#\#..... #....#..   .#\..* *..... *..  . ..*. ..*#.  *...\.*#. #.... ..#*##\ *  .. #....# #.* \#. * #... ...... .  . . #.  ... .#
#. #....\. ..#........#.*.\..... ..... .... ...#... .\# ..... ..*.*... * #. .. ... ..... .**  ## ..#......#.*. .. . .#* ....****.*.*..* ..\.. .   .# #
# \.* #...  .#..*.#......#..*..#...#....* ... .....\...#.*.* ...\#. *.....*.........* ...*. .  .\..\. . ..# .... .*. .. ..#. .*..# . . .#....... \. .#
#* ........ .#  * ...#.##.\.*.*.... *... .*..#\*# \.. #. #..#*........*....... . .#. ..#..#.**. #*... .... ......#\.*#.... *... ...  .#.# \.. .#*.   #
# # . #\......\. ...#. .#.*# ...\.. . ...* #*.  ...#*.. # . # ..* ... . *#. ..# ......\#....\..#.\ ..#....*\#* ...#*.\#*. ..#*#\ \...*..... .  .#. ..#
##\*.#...*#...  . .*..... #..... .\ # .  ..... ..*#.  # *#.*...  . ... ..#\  ...**..  ....##..  ...   ..*#\...# *...##*........#. \.#. \.. .... .. \*#
#...#\.*\.#....*\.*.\.*.  .#.#. * .....#... .....*#\ .*....  # ..*.##.....# .\... . ....* ..\*\... . ......#.......\..\.#...# .\...#..* *#. ..... . *#
# ** .* ..#.#....\. *.........*.... .#  .......*..\\. ...*.. . . .........##..##... .\..# #**##\.... .#..*.#  ....\..#*..\.\*. ....*...   .*  .*  *.*#
### #*.....#. ... .    . . \.* .#... .. \#*.  \##*...*...\\. .\..**#.\#. . .  . .  #. .\.*.... \ .. . #. ..\.#  ...* .. .. ... . . .*. #..# .*. ... .#
#.*.#.#.....  . ....*.*.*....#......#..*  \. .*.. ...# . ...*. . \.. .  \..*..#.*..*.. .*...\# ..  *   .*.#..#.*..... ..# .  #..# *......*..  ..#.. .#
# . .....#...#..... ....*\ # #.**. .... ..*... .*.  ..\. \#* ..#...... ...* \.  .. * .... ..#.*...*.#\.... .**... ##...*#...*#.. *. # ..... ..... ...#
#**... #*..\..*  ... .. ... . \.*#.... ... #..*....#...* .#.....   .*. . ...*. ... .... #...#.. .#...# ...* . *\..*.. *\.*...*#. ...  .... .#... .*..#
#.#..*. .\.. \ ##**....*. . # *.*...*. *.#*#.. ....*... ...###.. ... .###    #..\.......\\.. .*.\*   ...#...#.. .. # *. #...#* .#\..  ... ..\ # .##..#
# . * #  . #..*  ....* .#\.*....# .\.\. # \.  ... .... ...#..#..\...#.. .....\.. . # . #*  ..*#....  ..\..  *\.... .#.#..\\..  \ ... .#*\ ..#.**. . \#
#. .. ..*  * .. .\.   .*.  .. .#.... .. ..........  ...# \. . ..#.#...\..\.*  **... . ....* .#......#.. .*...#....... ......*.  ....# *.* .# ..#...* #
#..... .*...... ..\. .## #..... ..*.**.#*#...... .  .\.. ...  .. *\* . ##....  .. \... . . #...\  ...\.... ..#..  . *  .  \ *.......#  .#  #*.*....# #
# \..... ....#* ...*#...**.. ..... \. #  .* #.....\...... .\   ...*.*..... \. * ...*\.#..#.   . ..**.... #. .........*. . *.*  #..\. *..*#.....#.. ..#
#......*.. .#.#*.\..  .. .  .  ..#. \ *. \...#.  ..\..#....... **#.*.#.. *.#..  ..*...*#* *......  ....  .....#.\ ..* * .*...............#*...*\ .. .#
#.#  ....\.##..*.\.*. #  .... ** .. .*..##.... \.* #.... . .\   ..  ##.#..  * . .....\ *  ....\ \...#. . ...... .. ...#  .*.........*..# .. #.#.....##
#.#* #. #.*...#.*...... .*..#....\#..*..* .. . .... .#  \...#\..........#* .*. #... ...*.#..#. .\.**. ## *...**#** ..\.*#.  *.#. .*.#*.#....*.#.*....#
#.#.. #***.... ...# #..#.*... . \.. *.**...*.\.*.*...#....# #....*..#\...  ..*......\..  ......#. ..*..*. . *..#. .**# ...... .#.#.. ..... ......*. .#
#.** # ..#*#.#. .  *.\.#..\*..\.#.. *..\... #... * .\. .. ... ....\ .# # *...* .. . #*.\#...\ # .. * *# .......\.##. # \\  .  .......\. ...  ...  ..##
#..\#..*..\. #.#  ...\..  *.*#... ..*##  ..... ..* .#..#....#*.  ..... ...... .\ #.#  .*#.  ......*... . .. * ....#. \..# ...... \. . .  *. . .*... .#
#*. ..#\... \#.*.*.# . *.# .# # #. .....#.#.. ..\# .#...\*. * . .#. *\..# ...\. *#**.....#.#.*...\.\.*  ..*. ..*. ... .. \...... #. *.#. . *\.# ...*.#
#. ..*..*..* . ..  . #\ .# .. ..* *.*  ..**## #..*#. * ..#\.. . # .#...*. .........  .*.# ....    ... #...*#..*... ....\ ..* #..# ... . .*.#.#  .*.#.#
#*\.... ..*#.#*.... .*. ....#........... ..*. *** . \.....#* .*.\ ..\.# #....\..* ..... .....#*\.#..*##. \.#.#..#.... *# . * \*##.. *#. ...#.... . \##
#*.* *  *... .\.#.  ..*  .*.#... .\##.. ....*  .##.... .... ...... * #..  .*.##....#..*.#   .*......#....\ #.... .\\. .. ... *.#.. #..#..#*#*..... . #
#.\.... ..\ .. .  ...*...* ..... *......##* ......#..* .... .#. ...   .....#.. \.. .. .. .. . .*  .* ... *..*.#..* *.. #.**... *... **\... *. # .#*..#
# .. . .\ . .#... .***. .\**...  ..*. . .. *.  . .\. .*...*  ##....\. . ...*.....\..... *.. .. \. .. ...**.*  . .... ... .....#......\..... .....#..*#
#.**#...*..**\##...\ . . *...*.   .\* #... ... .....   *. #.#*.. ... * ....#\  * *.. ..*. .... ..\. ..# .. .*.. ## ..# ...*#.*..# .#...*... .. #...  #
# ..# .... \..\ . .*.... .. .\# .  .##.. #...*  ..... .\.. # .#...... \#....#.#\ . *.....# .*#....*\.  .\.. ..... ......* ..\. . . \#...#.... #.# ...#
#.*.\ \ # . ....*. .*.\. .#. * ....  *...#..\... .  *.... ... *\.# *#.. .*  .. *..\ \.*.. .... ..  ...#..#.# #*......*  ..\...\* ..*......  .*... *  #
#. # ...* \.\# ........ ##** .... ..**#...#  \# .  .. # #..# #....*........#..\ * ** .*  #.# \.\\.# ..#. *.#. .. ...# .\* . \ \ .... \ ..# .. #..\ ..#
#.#  .  .. ....\*...*....  ..... .*.*...#..  \. .*#...  . .. . * \ .#..\. ...#. ..#\ #\..#  ...##.... . #* *.# .. .*. .\#. *.. ... \\. # *.....\\..#.#
#.. * ..* #  .#  .*.#.. \. .  .. .# #.#..* ... * .  .\..** ..........*#..\......... . #\ .. ..# \........*  .# .....#*\.\ .....*#.*.. ... ...*\.. \###
# ..## .. .#....*..#.* ....#...... #.\.##.... #..  .##..\ ##...*.. . .  \*\ ..** \..#*..##...*#**......*.\....\.....#\.#.......# .  #  ..... .... *..#
#... . .\. \. \.....## *...*.*\.....*\.**..#.. ..*.......\*.........#.# \#.# \. . \.#......# .#*... * . #.#\.\...... *... \. ..## *.\ .#.\...\..  ...#
# ..\ . ..#.*.*..\.#.\.. #... .*#. .#. . .# .. . ...#.  *.\. #..*. .**.\ ..... .#.. * # ..... .  .*#..*. .* .*....#...*#....... . .. ... ...# ..... .#
#....\. ..\#..*...  ..#...#.#. ... .  *...  *\*.....*.#.\* .. ..*. ...##......*. \. ..#..\.*.\*....* . .. ##..#....\.. ...# .\..## . ..*..#....#\* .##
#.\........*.#...\. . * *..*\.  ..#.#    ..##* .###...\ ..*...#. ...*......\* *#.#....... .. .\... ..#. #* #  ........ *.# . .... ........   .#\ # .##
##* *\...*...   *.*. .. .*\. \.... *..#...\*....\.  .#.. #.# ...##.\..\. ...*..... . ..\  . ....#\.. #.........#..... .*....   *\....\#.#*#* ...*.  .#
#.. .....#. ..\.....\ .. .. .*.*..........*......#*# \... *\\\..   ....  .*###.....*... . .... #..#.#. .#..#..*..#...*....\   ..* #....... ...\.#.#.\#
#**.  .*#..#.**......#..\ ... .*#...  .....*\...#.*  #..*.......*.*..* . .... .*## .... *.*#.#*##. . . *.\ ... \*. . .....*..*#\.\... ...# \.*.. . #.#
#.*#  .# #. ..  #.  #....  ..##*#\ *.#.#.*..*. ......#.#.#..\# #..#.##... #..\....**....##. ... .*......**\....#..#.  ...*.....*. .. .....* .... .# .#
#...# \...\..*...*# .#...* . .#  ..##  ....# \**.\#*##.\ . # . ..#. .. #\..*\.*... ..**.# ......*..\*....\.. ... # \.... .\*. #.\...... .*. .........#
#\...     ..#.. .# ... ....\ ... ... ..# ...#*...... * ..#. #.....#......# ....\ .*\.... . .\ .\ *.. #.#.. .....##*.#*.#.. ..  .##..#.. .. #.  .. .**#
#...*  .....##*..#.#**.*..\... ..##. ...#.. .....*. . . #* #. #*#.#..*..#\.... .*..*....* .. .#.#....#... .*.. ...*... ....*  .* .#**.*.. ....*# .. .#
# . .*..\.*#\..  *.\.*.#.\..#.#..#.* ..**..... . \.  ..\. . ..... .. ...# .*. *#....\.... ..... . ...\..  **   .........*..*.# .......*......##.#    #
# ***.*...\ .# .  *\..# ..#..... *#..  *... #**#*...*..* ...#*  ..#\\. . .... ..\#   . .*...... **. .*. #..#*..   *......\.*... ..... .*.\\ .........#
#.. **.*... ...#.. . ... .\.. ..###..# .  .#.*.\# .*. ..#*.##*...*.. \.....#.*.. * ...#\ # *..\#... . .. .... ..# .... . . . *\*** #...*##.# ...\.   #
#...*#. .*. *\. . . *#......\*.#..##\ ..#..\. *...*........*......#.\#. .#*.....*.# ... ..#... \..# .....#*...#.....#.. ...  .........#.*...#*.*...*.#
#.....\.. .. #.. ... ..## #*..#.. ..**.* ...   .\.... .. . .#. .#** .\#\.  # ...#...... .  ....#  . \..* ..# *.... \#....*.. ...# .. ..#...  #*.*....#
# *.#.**..\ \. .. ...... ..#*.....*... .   .#.... # ..##.\**.... ..*..\#. #....    ## ...\.*  .....\*#.*.. #\#. ..## ..#...#............. *.  ....*  #
#. ...\*..*.*.... ..#\#*#. *\ .*\.. . \....\.  #  . *...#.\#...\....# ##.\*...*..\##.# *#..#.*..\**.. .# ...\.*#...#. \. .. .. .\*...#. . .. # ..#\* #
#.*. ...*.. .#.* .#.... *..... .\\.**......#.... .  ........ .. .  .. ...  #.....*\.. .#*.... \#..#*.## ..*....  # .. .*#.*..**.  ...*.  . ..... ..#.#
#.\*\..*\..  *. ..\#.\*..*.# ..* ...  \.#*.\# . ..** *#.*#..*\*.. .. ..# * #.\....*.*. \*.. . ...\ .. * . #.  ...#.\...   #....*..#. .#....* #.#.   .#
#.*.*  . .. . .*#**...*.    . .#. \ .#.# . *#.. .. #...* .\..*#* .#*... ...    .. .. *.\  .........*##.. ....#*..*\ . ..#.\... ..*...... .....*..\...#
#. * #...*.. .\.*.#*. ....\.*..*.\. ###\ ..* #..#. #  ..#.....#..*.... *  #\#....#..    ...\..*\#..\. . ...\  *..* ...*.. .#.. *#\.# .... .# \ #....##
#...#. \ ... ..#..... . .....*.** ....  ........ .... ...\.*... ..... ## .#....#** . ##. #*..\ ...\#..#   .*..*.**#.... .  *....#..*.#. ..*  .#.*  ..#
#*#... ...###. . ......* .*.#...#  \ \  .....#... #.. ... .. *...#\..\* .....#.\ # ..*\# \.#*.  #..*........#. .. ..#.#.. ..** #.*.#..\.##*\...*..\* #
## .*.## \.....#** ..# . .*. #. . *#\#...#. # . .. .*  ..*....#.* #. .. ** ..\*. *.  #.\..*.#.#....*. .#  ..*...*.. *.. ..  . . . #.. ... ...\\.. . .#
#  .. ...\....\.........#.\#\....#.#\ #\*  \. ...*.... ..***#.. #. ..... .*.. ...... . .##..... . .\ ..# ...##...... * .#. .......*. .*....* . .*#...#
#*##... .# \....... . #.. ..... *.* .#. .#...**#.\#.#\*  \ ...#..*.. \...#..\\# .. .#. #.\\#..\....   #.*\..#.. . *#... ..*###  . . . . . ...*...*.\.#
#.   ...* *.#...\ . ....  #. .. .....# . ... .* ... . ......... ... **\. ..#.....*#. .  . #.. *.\....#.. #...   * ..... ..#. #*.*......   ##* . * ...#
## * ##..  ..#*...*..*..* .#.....\  \.*\......* .#*#.....*..... *...#\  . ... *...* ..    .  . .. .\..\.#.\.**.....#.#.#. .. ...R  . #.#.. *..#.#.\  #
#..#.*#*\ \..# #. .\....*.*.  #... . ##...#*..#.... # #.\#.. ....... ..... . .#..... ..\*..#.. ...#...#.\ .. \.* .  .*.  ... \ .........\ .# ...#..*.#
#... ..#.   .... * *.\\** . ... .....*..#.#.. . *.. ..*..* #*.. ..\##....\. ..#..*. .. *.#*.  .#.. #.  .  ... ..*. .\......##....  ...#.. . .#.#.#.#*#
#..#. ......\*## .*.  . *...* ..* #*.#.  **.*..*...#.*.*.  . ....  \.  ..*..#*.#. .... .*.........  ....  ..* * ..*#..# ..  *\.... ... \..\..\ ... .##
#.#.#\ ......\*#.  ......  #. ...#..\..   ....\..#. # .*.###...#...**\..  .#*#**\.*.*.#..  .* ..* ...* .   .# .#*...... *.*.... ..*...# ... \ ... .\\#
##.\.# #.#..##..# ..\ ......  #*  ...   .*.* .. . . .*.. *.....*..*.. # .#  ..#.*... #....#. .......#...#..* *##.##...  ...#*#. .. ..  ...*  ..*.\  .#
#...# .. . ....\. . #. *...\.....#.# . *#..... ..  *...#. .....* . ...   *.. .\ \\*...... .. #.*.# \ *.....\. ...**......*  ..*..* .#....  .#........#
#.  .....  .... .*.*\#* ..  .  ...## .....*.....*#. ..#. . . .... .......#*.# .\....... ... .#..*.\. . .*....  ..*..#...*....  ..*#\.*......#.#  #.\*#
#.\. \\....*..#\** .*... . .....# * . ...*.. ...... ..#\\.#*.*#. **...  .......\\ #  ***. ... . . . .... ... * .  . ....\.*...* ..# \.\. * ...\.*....#
#. #. . \* ....##*.**..# . *...*.. .... .. .#..*. #.   \# .#.. ...*.*#.. .#. . . #... ...*.. .........*..*....... .##...... #.....*.  #.#  ...#. ...##
# .. ..*... .. ..# .\ .#...*.... #*.#\  ...*...** .#.......*#...*.. . #... .. ..#..#*#.* . \*. ..   **.*# ..*#.#*.#.. .....#*.... ...*..   \.\*  ..#.#
######################################################################################################################################################