############################################################L#########################################################################################
#.........#* ...#.*.# * . .*..*   ..#.**#.. **. ....*. .*\..*...*.**....#......#.#..  *. \.#...* .. . ##.#. *\.#.\# ...*.. ..... #.#..\#.  ...#*. .  #
#. \ *.#.\. .*.*\...# *. *...\.\.. \.. .. #...*   \.....#. . \.. .. . ... ..\#... .   # .. *..#.#. #...#...\..* .\\#... ...#...#*...##*#...*. .. ..#.#
#..*. ... . .......... ..#.......* ..*..#.#*..*..*... .*.#. #**.* .*.. .  . *..**.*..*.\. ..*...\.. ..* *. \..*.* . ..#**#.\.. #\. .*.. ...\ ...\ #..#
#*.#.  ... *.#..  ....  . .#   #  ..... .*...*. .#.. .. . ...#*# #.\. *#* . #. .##.. .*#. ...... ... ..#.  *.*.#.*##.. ... #*#..*. .... .. .\ *...#..#
#.#..... .......*#...#. ..... #*.....# . ... ..\#.... ..#*  .. .. #.\ ..#*.. *#.* ..... ..#....#. ...#. .\*..  ......# .... *.#... #  ....* .*.\.\# .#
#\....*#.....#*. \#. #* ........  #.  .....#. ...# #..#....**#.. #..  ..#.*...*\...\. . # *..#. ....# . ...#. .*** . #. ....## \.....*\.  .......#.# #
#. .\...... . .##.......*\.*  *..*.* .#.#...  ......**   ...  #  ...# .... .. #.#.\. .# *.\. \. ....#... . .#.# . .....*.* .*. #.  *........ ##..#.\.#
#.#  \#\...#.. .*#...  ..*. .#.. ..\\...*...*.\.  #. .. #*# .# . *....#... .....  *... #*.....* . ..*.. \...... #..\*.#.  #\* * ....*\....*..\*.. *. #
# ... #*.*.# *.# ...*..** ......**...\# ...# .. . ..* .#.#... ...*..#..\ ..##.........*. .. ........\..... *  ...#.  .##.*.  . #. . .*.\ . ..\. *..#*#
#. ..#. *...*.* . .\.#......   .#. .*. ....\.*...\#\..\# ...# .. . ..*.. *...\..... *.....* ** .. .#   # . .* ... \ ....**..#.* \...\...*.....*#. #. #
##... .# ..... ..  .. ...*.  #.... ... #.  .*.....#. .#...  ..*.......#.. .. ..*  \.....*\.. *.#..... #.......#. *....... .#.*##\#..#  # *.*.*..*... #
#.  # .#. *.* . ..#.* ***.##\...*. #.#*..#  .\**....... ..*.\. .#...  ..  #...# ...#. . ....*..#...**\ .. .. \.. .. ..*.. .#....# .. .\*.\.\..* .\...#
#\\  *..\. .. ...*...*..*#    ........... ...*  \.* \.#...... .... ...#* ..  *.  .... .....*..\. #  ..*....   ...* .* .*.. #.#.  . ...  .....   .\ ..#
# .. ..  **#.* *...#*..#.*...\#. .  ..#.#  #....# .* ..  ......... ...... ... .#. #..*..* ..\ .*.. .. ...*#.....#. .. #   *.. . .##...*.. \.#.\.... .#
##....**#.**.. ...... \.  ..  . ........  #.  # #.##\.#.*..#..........*.... \\.*#....\..#. * *#. . *.**.. *\...* . . .#...#.... .# .*.##. ... .*. . *#
#. *. .... .*... #..*.\*...*..* .. *.. ...*\ ... ..#...*..*#.#.. .... .... .#. ..*..... . ..*...*  . *. .. ...... . .*.*... ..#.*..*#. .. ...#.......#
# . .  .#.* #.*......*. #  ...........*# . .... .#.. .#.* ..  #*.#..## **.\\.\... #.**.*  \.....##.... .\..* \  ........*..**.*# \. ...\..   ... ... #
#... . ... *..\*.#  .. ..##.  *...# ..  ... #.....*#. #..*..*.... .. .# .    ......*... *\ \.....\ ..#...#... .#..#. .. .. #.  \. #*.#\. #...........#
#... ..\.#..#..\#...\ #.  .#*. #.. ...#...\*. ....#....# .#....#*..\#...#. *\...#..  ... *.* ...   # . ..   . #...#. .... .* .  . .*......# #.. . .# #
#... #*.#*....... .*.. .#  \... **..#\....#\#..... ..*#.*...... \  . ..*.\. .... ... ..  .. .*\..    ..* . . .....#.* ..  .#....*. .. *.\ .  #. . . .#
#.**#.....  .. ... ..\. ..\ ..*##**.# . * *.*# . #*.....*#.*.\  \.* .     ......   ... .*. ...* ..\..*#. *...#..*.... .#*.... .. ...  .. ....#.#.*#..#
#*... .*......\.....#..*..   \ .....# ...*........*.......... #*..*.*\. .\... #*  ##  ..... .*. ## .\  ..*.# #. \.*.\# ...# . *. ..\. #  .....*.. ...#
#..\...*\#........*.  .....# ....*...*.*  \......#.*##.... ..   .\*.*. ... #.#. \.#. ....##*. .. .. *..\..*.   ....... .#*...... .*\..#.....\..*. *..#
#\*..* ..#... * *#...  \ *. ...*.# *.#*..\.# .. .  .#..\* .....  ..* .....*.*\ .....#\..* ..\#..#.#*.*.  ....  ..#...# . .. ..\#..#.\ #..\....# .....#
#.. *#  ....*.* ..  ..##...#..**.\. ..** ..#. .*....*  . . ..... #.....*.**....\ ..*.. ....*.\.##....# ..\...   . \.......*...\....*\* ..#....#..... #
#. ##. .*...  . ..\ ... ...*#.**...#...... ..* #... .#.*. #.#. \ ..#*.*...*.#... ........  . ..# . ... . ..#.\ .\* . ....#.* .......*.# ..#.#*....\..#
#.#.#  . .. \. #  .......  #..\.. ...* ........#..*#.. .. ....\. ........... .*.\.  #*. . . .#. ..\  *..  * .#*\#.*..  .. . * .. . *. ..\ .# ..#.#...#
#. .# *..  . *..# ..#\ \ ..\ .#. .*..*.*....  .  *. ........\.* .... **. .#*.. *.. *#\....\  ..*..#.....*.*..#.\.....#.. .....#. #.#*.*.**\.# ..#....#
#.*....  #..*#.**.#.. . ... . * ..*#*.#.*. #.#. *..#. * ......*.# # ..  .*\..... .**..*#*... ... .. ... *.. #...  . .. #. . .\.#*#..*  ...*#.. .. .*.#
#.*  .. .. ..*...\ . .*#  \. . *.. \\*.. *.  ... \.*..*  . .... ...#  ...\..*.. \...*... ... ... ...... \.......#\.. ...  **  .... .. .*##.**.. . *  #
#\ \#.*.\...#*.*.*.#... .*.. #.#...*.. .*\. .... ...#...\.*..#...#...#.. .. ... .#. ....* ..#\# ..#.... #.. \..  #.. .#.*. ...#*.*..* ...#...... . . #
# *... *#*..*..... *....#....##\... ..*.*..........  #.  ...*\. \.*.  #. . ...*..*.   .....##.#*##......*.... *.*..*...  ..#.# .. .*. ... ....# \* ..#
# # \..\\ * .##.# ..\# #.#......# #*. .##.   .  ..* . . .  *..##............*.  *.......##.....# #. #*.. **. ... .* .... ..\.#.#.. #.#..##\  ..#.\. .#
# .#....#... .\..#\.*\*.  \\.*.\... .   ..* # .#*..#...*.  ...*#.* # . .#....* .. ........ ... ...\#* # .*...\..........\..... . ..* # .*#*..\ ..# #.#
##.. #..* ...#*.. . .... *.\...*. . #...* .#*.. .*...*.#  ..* \...  ... ..... \. . ...#.#...** **.#.\.. .....#......  .....*. . \*..\...*  #  ..#*.\*#
#.#.. .\.* # *........* #..   *.. ..#.#.. . \. ....... ..* .\..#...\..**.## *   ..**... .#**. *... .#\..*... ...  ......*#.*..R.#.#*.... .*#.. ...*\ #
#.......  ........#.# ...... .*. * ..\ * ..*...  .*\.. ..#. .. .*.#.....#....#...* .... ....#..*.**..  .\.*..*.# .#.. ..\#*.. ...*.. . . .*.*. .*\..*#
#..*. .. .   **  ...*...#.*.#... .#....\...*..  . ....  ..*.#.** #. .#.\*  *#*  *.. ##.....* #. .. ... .... ..**...# ..\*.\.*## .#\ .*#.#.  **....\.*#
#  .##.. .#. . . .. .#\ . . \##.\#..... .  .  . .#.... ..*.. .****............##.*.. . .*.. .. ...... ....... .*... * .*#.\*.  #.  . *...\.....#...\ #
# ... ... \#.#... ...# .  *##...\....# . . ..##... ... #\*.\ ..* ...#... ......    *..*.  .* #. . .##. ..*...#..\*. ..... ..\.##........... #.... ...#
#. ..... ..\* ..*.  . .#.**.\*.........** ..  * *  *# #.\. .\.... ..\... ..* .....* ...#  ...  .#.\\*... #* ..#..*.. # ..  .. .......#... ..........\#
#. ...*.. .... .  .#....#. .*.#.. #....*....... ... ..*.. ..**   ...*.\*...\.....#\. .. .\. ..... ...#*.......*.. \\ ...\*.#.*.#.  .\#.  ....#..#.#..#
#.*.**.# ...... ...*..\  .*.# .....*\....*. ....\*.#...*....\. ...#.....#....*.\.. #..... *.*  ....\. **......*..... .#.....\ ... .. .#.* ...# .**. \#
#.*.*. .   *#.*.\. . ....*..**.\.*.*.  .. .*.#*.\ .\ #*. **#... ... ....#.\.. ..*..* **..* .*....*.## .\*.. . .. . .  ... . ....  ...#  .#....*.. ..*#
#*.. .... ..\ #...#...... .. .\*.... ...#..*.## ..*. \. #... ..#. *\ *. ..... *. *..  \#* \....*....##..*  .......*..# ...*.#*. .\*. #.... ..*.# *#..#
##. ..\..#*.. .. .  .*... ...   .. ......  \..#.. *.# *.*#. . ### ..*\..** *\\..... ... ....... .\.* \\.*.....\.\#..#.*............# \\#*....#.. .  .#
#...\     ..#.......#..*.#.* .\### ..*.#.*..*..#* . ...\\....# ..*.#..*.....\.*. .\ *..*..*  *....# *...* . ..... ...  .#  .\. . . ........#...### *.#
#...#*.  . ..   ..#*..#..*# .. ..* . #...* *.... *# #*...#.. #........ . . ......#. ..\ ..#..#.##.. ... #  ..*....... .....#*  *.........*\.#.....#. #
#\. #\#. ..#.  *..**#. ..# ...#*...#.. ... . #.........*#.*.*.##... .. .#...*.#.\..#. ..*........* #..\  * #..*...  \  #  ......  .*#..# * .... * \# #
#....   \.\..\   \.....** ...  .. \#...*.\..***...*#.#.##.  .#* .##.#.# ...\ \*.*..\.. .  ...*  ... .. . \..   . ... #.  .  . .*. .. ........# #. ...#
#.*.......\ .\ . .. ..# \ ....*\ .*.*\.. ......*. \.*..#.. .\.*.....#.....#.* . ..*.*. ..# ..#.\  ..*.........  *.*.. . ..*.\...... #. \.......*.. ..#
#.*.#..#*\*  \##.. .*... .# . \. .. .. . .*.\. .  ..  \\*. .. . .. ...#*  * ..##...*#\....#\..* ..  ...#.#.\..\.   \.*.*. .*.#*...... ...  *. ..\*. .#
##.... *. .*#. *# #.... ...# .  ....#\.#*.#. *..\.#..# .... ... .  .**#   . .....\...  .\ ... .#.#...# #..*.  \..#..*......  ...\..#* . #....#...... #
#...* .\. *...#.*.....*...... ..*.# #.#. * .*..#.##.. \. ...*.    #.*....#...#............ #.  **..  ...**.. .\\. .  .*..... ..# *\...*........ .# ..#
# \....*# ..#.... ....\*...... #.........## \ .\.... ... *..... .. .\. .#  .\.. ... *.\ ..##...#...\..... ......\\ ....*.#.. .*.\#..\##...  #..* ... #
# ..\.#  . *..**  .. . ...#..*... #*#*\**. .#.# #\ ....#\.........  ...\ ...#*.. **.#  .  .#.. *.*... ..* *\........ *.  .\. ..#.......***.. .\**. . #
#*#***#*....\.. .....*.\ .....*....*.*.. # ...#..#. *..*...\#. .#.  *.# . ...##.\.  ..#** .. ..#.....\. #\.. ...  #...#..# .....* * * ...... . ..# ..#
#..*.*. ..*.......\.*..  .\. \...*#...# .*..**....\... # #... #....#* .  ... *   #. \\\.......*  ......* *#. \. .**#.. ..#...\..... ......# .\...#...#
#.  ...# #.*.. ...*.*.*# .*..  #...#..\ ......  ..#...... .  ..\\ . .......\.*.. . ..*.. ##.#*...#.... .....##.*..    . \ #..**.   * ......*# \. ..###
#.#. . ..*..*.. ...  #.*.#.\*.* . ... ...# #.*#.\ ..\\ ...#. .\.. #...  .# .#..*#\.  ...*... \..#   ..*.....**...*..\...#.*\ . ..*...*..#..#...  * # #
#..##.* .*.* ...##..  ...\*#*..*... ....#.\. ....*.. ..\ ..... *... .. .  ..**#*..   .*   \.*.* ...**.#...#  ..  ..**.\ \..#... .#.. . ..#..#..#  .**#
#..  ...*.. *...#..#  *...#.  . *#..\##..\...*.  .##..  ..*... .   .  .#..  .#.\.*. .# .........* .....*..*........*....#......   * \ . ......*##. \##
# .. \...\ ..#. . *. .\* .*.##* .*..... .# \.  ...##.#* ..#  # ..*..*..\#*  ..   #.\*# .... .....#*......#. #**.*..##.# .\#\ #.. .*#.*...#.*\.#*...*.#
##. *.**#....... . \...##*. .* .#.\  *.#..... .# ... ..*\...#.** .... **....  \. #. **..  #.# \.  ... \..\.....  ...#....##....... #...*#*.##\.. .# .#
# ....  # ....*..*.*.. #... .. . \ .. .  **. *..\**.*.. *...*#..\... .#.*.. *  ##.  #..# \ .#.*. ....*..*... *.. ... # ... ..*.  .. #...............##
#.\#.*  ..* .#..# .\#.* ....... . ..#. ##\.*....# ***.. . .#.* #.#.#.  \....  ....**#. .\... \.*# .\.#...#*.*..* ....  # ...##. * *... . . \\#*....# #
#**..  ... .. ..**... **...#........ .\....*    ...  .. #*. ........*.  .  . .. .*  ..*....\.#.\..#. ... .....\ #.#.# *#. .....**....\# .. \.*..  *.##
#.  ..*...  # ...  ... .*...*.. . ..*.#........ ...   ... ..*. .#...##..\.  .\.*.... ... #.. ...* ..   #....##..#.\#*   . .. ....... .##*.. ...\.  . #
#.*.#....*.....#.....*.\....\.. .   ......#.*. .#..##..*...*.. .. ..... ........ ....##.......   # ... .. #.*.#..... \..  *  ..*.. .. .   .#*##**..#*#
# . ......*.......\..*\ .\.... . . .....* .    \..\. ##..*  . .........\ .#.  .\ ..  *#\ *.*.\ .. ......#*\#..\ ##.*. ..*.** *....\.*...  \..#\ #.## #
#\...#.*. . ...* ......*.\###.###*#.   .. .... .....*..\ . ...*#. ..#. *..# .*\.#. **# . ..#.....\. .#*  ...... .#.. ...* . ...*\.. .. *.### ..\. ..*#
###\#.#*. . ........*  .##.. ..*......\..*. .*.*......\. .#.\#.#* ..\*\  .*. ..\.*..*.* .  ....\...#..*#\...# #. ..  .  .. *#.....#..#.*... #....## .#
#..*##.*...  **..*# ...# ....*... .*. .\ #. ..... ... . . ...* .. **#......... #...#......# .#.. #. * ..  *.   #. ..*.\..#.. *... .... \ .    .###...#
#. .*.\  \. \....*.. ..*\..\# .#. *...* #\. * .  *... . .* ..\....*. ....\..\.*\#....#* \.... .#.#.  ...*  .\.*. ....#....  \ #..\  ..*.... #... ..\ #
#...\ . ...\.*.  ......  ... .*. .  *...#\...* \**.##... ###.. .. .*..#..   ..#. #.. .... .... *#\..\. . \*. .. * . #.#.  ..  #.......... .*\...\ ..##
#.. .#\.\...# #...... .*..*. .. #.. ... ..\..*#*.#*.*. .#**\#. . ... ...... .. #.#.##\.*..*\.. ..#....#.\ *. . ....#.#.*#.  *....##.. .... ...*.# #..#
##.. #......    ##.. ........ #..#...*\..# ...  ..*.#  \#.. ## .. # \.\**..\.  #.... ...*.*\..*....\......... \* ..\ ... . ..*.*. .  .  #..... .. ..*#
#*. . .*##..* .###....  ... ##*...# .  #  . ....** *..  \#\ # \........* .*...#.**   .*.  .....\ *.. *.*.   .* .  .*#.#..*...  ....*.\ *...\..*#*...*#
##*##. *.. *\. .....*#. \*#*  ..*.. . *. #. #.  .\. ... ....#...* .. .\..... ### ....\  .**.*. . *..*#... . **\ ... * \.... .....*\. \.. .. #. \. .. #
#*...*.#.....*. *.. \..#*..# .# . . .** # .*.. .. .. \.#. ... ...##.. #..   . ..**. .*.. . ....## ..*..*...*\.#  .#\\ . . \*.*#......\.#...\. ......##
#..##...#.\..  ... . .\**# .**...#.\ #*.  .... .... ... .#*......... . .. *..#.....#.. ...* ..#  .... . ...... . ... *.....##. . \*\. ...*..*.#.*# .##
#.* .  #..\..#.... ..* ..\...... ..###. ....\  .........\.*#...  .*#....... ....* #* .... ..*..*..  * ....#..... #..*..#*..# \....  .*...   ....#\...#
#.\  *...*....*.....\....* ..#.*.....\..\ # ..  .  \.. .*#..**... *#..# ...\ .. .. **..... .  .. **.*... ...* ...* . # ...#.. *\ ...* .\. \.* ... ..##
##* ....\....#*..#.#\. .**... ***. #...*.\.* . ##.  .. ..... .. .. ... ... #..  .*.... *# *...\ ... ## . .\. ...#. ........*.##.  ...\..*.#.##.#.*...#
##. ..... *. ..... *...#   *..#. .... ....* .#\\..**. ..... ..... . ...#. .  *.... * \..*....*..#\*....\.\... . .. # .\## .. ..\ ..# ... .. .# *. *.##
#*..  .. ..* ..*..\..... \ .\.#..#.  #. ..*... ## .*.... #*#...#*.. . .. ## *.\#\#... ..*... .#. .*.  ..*#. ..#.\#*....    .*... .. ..   .# #*\.. .. #
#*.# . #.*...  . . ..*.... ....*........ ...\......... .# ...  .\#.\#.... . \ .#. .... .#. ...#*. ..#.\..# . .*. #.*.*. ..#*.# ..#  *. . #..##  .. ..#
#*...\  ..  # ..\.*.. #......#*.\. . .*....... ..  .#..*#... .*  \*\. ..#..# ... ..... **#.....*....#. .*   .**\.* .#*.* ..##  # ..... #..\ \  .*#. .#
#... *.. ...**..*\..*\..# ......\*#\*.....   .\ .. **.......\.#.#..#.#   .**.......\ ........ ....*\\. ...*\..#....#*......#. . .  .#................#
#..#*..###..*..#*.. . .##...#. . ...\##.. * * ......**..  ... #  ..# ##.. ..*.*#.......*..\.... \*  .*.\.#.*#.*# *.  ...... ##.#.. ..##.....#......*.#
#.#....\#.. ..*.\.....\*.  .... #...   .... \#..  .**..\*\.\*..\...  .#..... . . ..*..... ...... . ... .#   \ .. ...# .** .*.... .\#. ..* . #........#
# .\\*.*#   .*.. #  .#..........#  \ *  ...\..*. . *.\ ... .*. \..#..\...#.\#.\\ #  . *.##.#. ..# ..  ......* .. #.\.#.. .  ..... .. .. *#..*...#.. ##
#.. * .*....\..\\ .\...#...*..*#*....#... ***....    #.. \# # #... . \  .\ . .....\..........*#...... . ... # . .***. #.\\... ..*.*... *.  . ..**...##
##.. #..#*.\ . .#  ....  * . *.* \.\ . .*\ ....  ..  ##.##.#...#..... ..\...*...#. *# .#.#*...#. ..    .\#... .... ...  #.*.#....*#. ....  .\.#.#* #*#
##.....#....\ ...#.....# .*..\.. ....* .....*. ....#.#..... . *....... ....  \...*...#\..*#.. \. .  .* ..*..... ..    * *. .\..# .......\.# .....*..*#
# *.... .\.... ......*..*.....  # *......*.\...#. .....  . .# .*#..*  *.*. . .#. .* . ... .#\..# \#  . . #. . .**..\#.*##*.\ ......*. * ...*...... *.#
#.*..#.. ##.#....# *. \ .*. .#.* \.#\.... ..*..  .**...  ..\ #..#\.. \*##.. .......#... .. ...#.#*..*..... *..#. *#.  * \*....  .. .... #.\* ...... .#
#\... ..........*. ..#. .#.. .*...*.*.**. .#. *##..#. .... .. .. ...   ..##.......... . ..\......#  .... *.#.....*.#. .....*#**....# .*... ..\.....  #
# . ... *... #.# .\.. .... . .. #*... .  #\...    .#\..  .. ..*..#.\. * .\.*..#.#\.*.\# \...*.. .*..#.....*. . ...#.. ..........*\*# .... ...*.... . #
##..#*#. .. ##... .....#. . ..#.# .. \.**. .... \..#*\..*...*#....*#....  ...***.....*..... #   \. #..###\...\.#...#.#.  #..#....* . ..##\.\... .* .*#
#.## .*..#*.#.. ... ......* . *.*...#.*... *#  ...... .##....\.. . #..#.. .  ...   .\* ..*#......\.* ..\#..*#*\.. .. * .. *.*.. .**..**#.# ...   * #.#
#....#.#..\# \ .. ....* . .....**\#\ ...* .. *.. ..#*.##......*.*#* \...\..*..*.#... #*..\....*. .#.*.#.. .....\.. .#... .\.*.*....... *..#...\ ...  #
#.. ... *. .#. . ....#.\..*.*. ... . ..#.....#.... .\...#. #.  .. .  .\ ##.## ...##.. .........#... .# .....  *. *..#. .*#*\.. . ..*#.....#  .. #.*..#
#. #..... \#. . # \..... .. .. . **.*#\........*. ..... \ .. .  . ..# . ... . \ ..\..*#\.#......*..#.. ....*.#.** ..  #.*##.. ..\.#\.... .#*#*.#.. ..#
# \ . .  ......**. ...#. ##.....\..  ...#. ##. ... ..\*. ###....##...#.. *...  *...#* ..#..... .*.. *###*#...  *.*.#........\*..\..... . .*   .*.\...#
#* \.....# *.*.\..*..*.# **.*#..##..#\...*.\.*.#..... .. ...#....  .#*#..\*.\.#.** ##  ....# *  . . ...#*  .......... .\. *#... ........\#* ... .\.. #
#..#.*. . .##.#\ .# #.#..*.*..   .... . *...#...* .*....\.. .\* .\.. ..#.*.\..*.....   #*.. .. .....  . ..\#..... *#. .......*. . .\.*#   .#... .    #
##*#..#*.*  .#*..*..*.*..* ...  ....\..** ... .\...* .  * \# ...* ..*# .. \* # .\.. ...\*. . .*  ...* ..*\ *........*.#..*..\..... #.....# .........\#
#.. ..#.## ....*. #...\ *.*  ......... .*#. .*  * .. ...* * ..* ..# . .. .#.*.... .#.....#.* ..*#.#... ...*. .. .. .....\. .* #.. .. . ..*.... .*... #
#..... ...*.*\.. #.. ..  #   **..  .....###.#\\\....*....\.*****\#. ###. ...  \. .*..  # .#\.*#...   \.   *.. #*** . *...*... **.. . *...*# #..... ..#
#.#..\ ...#.*..#... .*...*  . ...\............. ..#  #..# . ........*# .*.  .. . ....*  .  ..... .*#...#.. .. ..# .. . ...\.* ..*#... ..* *.. .... ..#
#......*..... ...\..........*...  .#. .. ...***. #.. ...\...*# ...##..*..##.....  ...#*...\ ....## . .#.*..#*.#*#.\\.....  .   .. #* .#..# ...#.  # .#
#.. * ....*...##**....*.\. ..  \..# ..# * .* .. #..# .* #. ..* ......##..*. .##*\*.. .... ..\. ....*.# \\.....#..#. ... ... .....#...* .\... ..   **.#
#..\. .. ..*.. *..\....... .#.. .\ .*.* .\.   ..  *\.. .**#....* *...# \.*..##.*... #.\*.#. ....... #..\ *...*.#.*.* . ..\. .*.. .***..  . .\*. *....#
#. ...#\*\*\...  .  ..#.. ## .\..*. * ...\..*. ..... .#.\*...\.*.**..* ..* ..*...*.   * #....*#*.. .#.....* .#...# .... .. *#..\ . *..... ... . ....\#
#*.. . .*..#.  .##.....\*...*.#**...\. .. ....#.. .....*** ...#. .*  \#.*..* *.....#.#** ##.. **..... .\ . .#.. \ ...... .. * ...##*...*.#\..* .* * .#
#* ...\#..  ..  . . ..##.\*\\..#..#...........#  . #..*..#*\\#.#..# * #.# . \ .*...*#  \.....#  .... #....... * . ..*.*  #. \..#.*..*.*......*..\....#
#.. ...  .\.**..*.. . #.#\ . ..#*.......## ..\*.. #.#...... .... .*.. .#.\. ...# ..*..*.#. *.....   \.*#.. *#...*.#.#*. ..\.\..* #....\.  #.\ #.#. ..#
#....# .**.#\.. .# ..*.\. ...#  ..... * #..\#*\.*.*. ..# *#.. \*\..#...  .. ..  *.......*....\*#*..... \.*...* . ...# *.* .* *.*.\   .#  ... \...... #
#..*......#\\.....#.*.......*.*....# #.  ... .\.\..\...*#..#.. .#.#*.#..  \ .. .  ...#.**.  .#.. . *\.....#.. .. ..##\#... .. ....\.# . . ..\.* * .. #
#. .\\.\.*.#....*.#*.**.#... .#. * .###*.....#. .  .. \. . .. *  .#.... ....### . ..... .* .  ..\#..##....... .\.*#...... ..  .##*.. .#*.#\\.#.....* #
#*.. # ......##..*. ..#\ ..# ..*  *.**..  .#.....*#.# .##..# ... ...   .#.#*...... ......  ..*.. .*\. .........#.**.. \ ...\.#.**..\ *..#.. . .*..*\##
#.\#. # #*.#.... . ..\. .. .##.#...\*....# ..\#...\...*..*. *..... . . .. .. .  .#. \ *.\..  . ..###\.... \.. .\\ ..##**...*..#.... #.. *..  ... .#*\#
#* *#. .\.\.#. ..\...\...... .........# #.. ....##\.*....   ..\.# .# . ......  .# ..... *. # . ..#.*.#....... .#.......  ..#.* ..\\ *.... .. # ......#
#.#...\....*.* ..\.. *...*.\.*\.. .\..#... ## .*...*.*.. .... .*..#.  # *.#.  . .. . .. *.*.\... .. . ..#.. ....*.. ..  #..# #. ..*...#..........*. .#
#**.*...#... .. #\  . *......*. ...   . ..#.. .. *# .#.. .#*\# *...#** . .#. .*... ... .. .. .. ...# *..*  ....*...# #* #*.  ..#. *#.*\#. .#. ..*..*.#
# . .  ..  .. # *..## .#.#..*    ..#\..# *....... .**.. .###. .  ...*\...#...#..* . .# ...#. #.. \.. * .........*...#\.    . .. ..\. ..#.*.....*. ...#
##*. *#..#..   #.*. ... \*  . ......*  ... ...\**.. . *  . *###.*..  \...... *.. ....#.. ... .*..........* ..*.. ...* . ....#.# .\.*# ..*\..#.#... ..#
#...** ..*.*#..# *.*## # .\. ... ...\.\.. *  ....\... ...\. ...\\..*#...#\..... .#...## .....* . . . .\*. #.  \.*.#*. ..... ... ..*..*..\..\.....# ..#
#.*.*.\#... .. .#\..*. #. . .\... . \#..\ .\.. \..* .\.*.*..   ....#   .. *. * \.  ...##.#. ......#..# .*..*.. ..........* . *.\. ...... ...#.\.. ...#
#..\ .  *. #.\... .... .. ##*# ........ ..  . #.  .*.#*.....#..\. \\..*##....#  #....  . .#..*....*#... *.. ..*\.\#.#. #...#. .....* .. .#   ..*.. ..#
#* .#... \.##  . #..**\  ..#... ...*. ##..#....\..# *.. *.*. ....*.*. ...\*..#.\#..#..#*..#. *#\*.. \.\# .   .#.. ..#.. #\.*# . .  . .# .  ..*.*. \.##
#   ....* *#.... .  . .......  #. ...#...*\\. ..#...\. .. ...\.*#...*. #. .#.. .. ....\..*...# ...... . .##.......*...#.. ..  ..*..#.#.#. **..#  **..#
#.# *\. .. ....\. \..#.**.*.\ . ...\....# ..\ .. .. \ #\....... *...##\ *..#.  #.#.\\. #.#.. ...... ..#* ..# ..* \ .#.# ..*..#  ...*.##...*.   .. ##\#
## .\ # # .\#.*.\# . ....*.... . ... .  ..... .. ......#.#..#.\ #.. ....#  #.#.\ #* ..... *..\    #*.# ...#*...*#...\...\\.... ..#..*.....\. ..*.... #
##.. *.....\.. ...# .   .*   ... .#\ .* **....*..*...  *....... #\   #.  . . . .#...*. ...*. ..***..\..*. *.  * *...##\**... ... ... ..\*..\..  \#...#
#.. . ........ *..#....\*..# ..*.#.*  #........##*............ *# . .  .   ...*.. ..*\  ..\. . #.. ..*  ... .* .  #..#**.. \..# . ....* \..*..#*#.\ ##
# . ... ...... #.#  .**.  .*# ..* #..    . .\ .**..*# ...# ..#..........# .  *.  ..#... .**.... \..... . .#\ #*. . ...*  *  .##*.....*. * . . #.....*#
#.... #...*. ..  .. ..#. ** #.........*...##.# ......*.# .. ....#*.. .. \.  ...#. #*  .. ..# ..  ...#.. .* .* .* ..*.\.. ..*#*..#. .... #....  ..*..\#
# .#*.*  ....*  ..*....... #..#. #. .*.#  ..  *..*.. *....### * . #*. . ...... .*##.....  #.. .....#.\\. . ...* .# *. ....#...#.#.. .*\.. ##.#.   .###
#..# ...\.  . ..\#... .#... # ..... ........* ........ .#.*..*.*#*#**. ..*#.. ......#.#..*..\......\..\....#.......**.#.# .\.... \.. ....\... ..  ...#
#*..   .\  ....*#*..... #.  *..**....#*.....   ..# *.#...*..##** . *# \...*** ..*..* . .\.#...  ...... . .. ... * \ ..*...#......#* .  ... ......\ .##
#*..*.#.. .* .*..*.\*.. ..  .*\.* ...........#.#.. ..\ ........ .. ..#*#  .. ....#  .*.#*....*...**\.*.  *.. #.*... .\ .*#.\  .\. .. .#. ..  .. ..#..#
#.# ..  ..*.  .#...*...*##.....#..  . .. .. .*. ## ....\........#. . .*.\. .*#.#.#\ .....*# .  .#..* ..*....#. #..... .*...#. *...*..\.# . . .  .*..##
#. \...\ *...*......*......\...*........# * ..#.**..  .. . ...  ... ..# ....*.** #   ... .. *.*#..# *. .*  ..*..... ...*. #....* .....*.....#..*.  ..#
#. .. **.. .*     .* .. ## ..**\  ... .  . .*. \* .  .. . . .\....* #\.....* *...##. ..  .*. .. *.\...\.# #.#.... .. #. * .  .....**..*...\\#.## \.. #
#\#..... \. . ....\#...\\*.... .  .* .. *   .   . .   .. # #..*..*. .. .. \ \......... ...... . *...**.# #.. . # ...# .\ ...**..........*...  .....# #
# \..\  \.\  . . ..* #.  .*   .\........* ...*... #. ..#. ....#. .#*.#..*.*##....*# # .#..#..... # .......# .... .*.**  *...##\ *....\.# #.# \ .#* .\#
######################################################################################################################################################