######################################################################################################################################################
#.#.\.##..#....* #....\..*#....#...*......\.. ..#*....  .  .. ..#..#.*#..* *.#...*...* .   ....*.. *..... \.#...#..*\... ....*.. .#.*... .. ... ....*#
#*............*.*.#* .. ...  . \* . .#. ..*.   **#.**....#...  ....#..* \.*.*  *...#..*#.#.#. ....*... ....*..... .*.#*..*. #.*.#....  *..... .\... *#
#.....*#..##*##.#.....\* * .. ...* * ..  *.... \.......*.... . *. ..* *#.\.  .. *.#...#*\ ..  .#...##.... #......\..#..\.  .*#. ..  .\  ....#*  # ..*#
# .\\ . *.... . ..#.. .#.*##..# . . .## ..*...*..\...**#*#.... .# ..*.  .. . ..# .\. ... .  ... ..#......#...... ##...  .. ..#...... # ....... ......#
#... ...* ..#....\.\. * *\*.  # ... .  . *... .**... *  . \. . .\.*.\.. ..... #.**#.* *....#.#..\*..*....   #\*  #.. .\   \.  \.. .* ..........*.  \ #
# .. *..  .....\*.\ . ...*...#\.\.....#...\\ ... .. ......*#..  #... ..... *\...\#. .. *#\ . \#\.#... ..*..#* ......*\*.#.#.. .\..#.#.\#  ..#.* #....#
#  ... ..# . ..  \\.#.... .# .....  ##   .  .\\.. #...# . .#...\....\.\...*....**...... *.. ...#*#*...*.. . .#.# ....#.#.# *.\\ ..  .*.#..*..  . \\ .#
#  ...\ .\*   .*......*.#..*. ...**...#.....#..#.. ..# . ..*\*  ..... ...\# .... . ... ... ......# ..#..#...... \.#  *.\* ...... ..  ....#....   ....#
#..#.. #\... ..*.*. ## ...\......*.... ..\.\..#\***.... .*.\*. ..... ...........#  #..* .*.. ... .. ..#. * #.. *. .....*#. . .*  .*.#...# .... ...* .#
#   ... .. .* #. .*...*  . ..*#.. ......**.. *...#. .. *.  .**#**. .........\... ....... ..  ....\#  ..##...*.. .....*....... . ..\ #*. #.*....# ...\#
#. ...  .*..*. .\ #\ *.......#*.....   ....#.#.# *. \..\#.... *\......*...*...*. ....*. .. ...\\.\. *#. *.#\........#*. .  .###.\.*#*..\.#.#.*.# ... #
#.....#. .....#..\\..#. ..... # .*.*. .#\*. \....*#  .\. ...*. . .... *.. .....*.  ...... ....*....... #..*...  ...   .. ... ...... # .*. .  . ..\...#
# *..... *.#.....*..\.#. ## ##..* ........#.#. #..*........*.#.....*. #  .  **.....*.. \ #\....#....... ..... ..#. .*.*.* ...\. . *...\.## ...\ ...*##
#..*.....\..  . ..... .#.  ... *#  ..*  ...#.  .... *...*.\....  #..#\.## .### .. #.*# ... #\* . ...# *# ........  . .  .#*#....... #..## ..  *......#
#.. ....# .*. .#..... *  . ..\... .  .. . .    ... #*.. ..\....\.  .##.*.# .\.. ...#.....*..* ...##... ... .*. .. ... *..*.....**..\ . . . *..#..#.*.#
#. ..#.*.##\.*.#*.\. .. ...**..* .#.\..##.... ...\\.# #.##..*.\..##.#..  *.#   ..# **. .#.#...#.\#.# . ....#..... .*#.#.. ..  .. .... .#..... .#....##
#. . #.#..*..*  # .. ......*.. ..\  #...*...**.  ##.**.#. *...   . *.. ..#.......  * .... ....*#.\.*....#..#..  .#.*.##.*. #.# .#.. .. .  *.  .  ...*#
# # ....*\.. .#... . **...*#*#.... ..#. \..   .#*.##.#.  * *. . ...... .#*......#.\. .  #\...  \..\##.  .\......  ..  *.*..##\...#...*.* \.*.. #. .#\#
#..#. . .......# .*   #\\.. .. \..#* #.\*.. . . .. .* . .....#.... .. . ..* ..\ # ..... .*\... ...... ... .#.#..*.**#\ \# ..#.*.\..*. .. ....#\ .\.**#
#\.. ..*........* ...*.\* . ..\.*  . . ..**\. .. *.. ..# # .* *.. ....\...  .. . .\\......\ ...#... \.# .... .  .. ... ...\*...... ...# .....#.......#
#.  ##.\. .*\*.#..*.## **.#**. ..  #.....* *.. #...\ . ...#....\...*.*.#...   .. .#.   . ...   \. ... .... .*.#..# .* . . .. ..# .**\.  .\...#.#.. ..#
#.***..... \... .. .....  ##\ ...\ .   .  *..  .\\ . .#\\ \...  *.# .\*.. ..*..\#*. \*. .. ..*. ..   ......*.\*#\ ...* *..*#. \..  #.###....**. ....##
#.. #.. #* *\ .*\.#  .. #.*.*# ... \.. .....*\ .*#.\...\.....#.*##...##..#.  ..*. \*.**..  ...#* .. *\.\..\.... \*.... .. .#* ...*#. ....  *.*.## .*##
## ......*.*.\.\#. ....\..*..... *....#*..##. #*..#..*.##.* # *.##.. ...*  \##.. ...*.  *.*...... ..*.  ..  ....# .\. .#.*.... #...* . .. .*#  *\* .*#
# .... .*..  *....#.*........##.  .\ .#... #..##.\..  .. ..#.. .##.##....... ** \..... . *.  *\. .*  #. \. .... *. ..*...*......  *. #.. .... .#\  ..#
#.  ..  ..***.#.  *#.. ... ....  . . .. .. \*\...#...#.#\#. \ ..#... *   .  .#** ...  .\*#.. ...*.#. .. .# .#.. *#. .\*\\ \..\. . . ................ #
#.. # *.....*. .. \*..#.......#.#  . *... #....*.  ..*..\.... ......*.\ #... .#.#..\. . ....  . *.. \*..*  ....* . *.. ...  *...... .. .*  #......*..#
#... ...*...#*....#..#... .\#.*....*.  .\..#\ **...*..*... \\..#..*# .#..... ....##... ..  ........\*  ...#.*#. . ...# ..*..............\ . ...#..*.*#
#... . . #....# .. . ....*  \...*.....  *#.#.##...........#...#.. ...#..*..*..#.. .  *.* **.\\#.# .\.....*. . ....*..\. ** ....*. ...\.#.. #...... #.#
# \...* #..  \ .. ...\..*..#*. .. \..#.. .###\\.*#\..# ....#.... . .....*. ** .. ##. ...**...#.. \..*. * .......**..#.\* *. ... .**..#*.  ..# ...#...#
#\ * #.*. .#..#...*.  #*..... #..#..  \#..*#.\... ..*. ....*...##..#.......##\.\........ ... ..  ..\\. *.#.......... \.## \ \.....#..#   . ..*.. ....#
# *#.\..#....#.*\*.. .#.\#. ..* #. * . .##.....##*.*. .  ... #  *..**  ..*# . .*#*.\\. .#...#  . *..*.... \ .#. *#.#* #*\.  . .. .\*. *...\......*.# #
#*..*..*...\ ****\*... .\...  ..... .* \*....  ..* # ...#..\..*\ .**..*#  #.##.  .##.\\  . ... ...#..#.\. .   .. ..*....##.*#...* *# ... ....*.. . . #
# ....*.#...###...**. .\. .##...*....... ...... .*.... .. ..*  .... ..# .. \.. #..#......*...\* #.... *.....#\. *.#.. .#... .. #....* \.*..........\##
#.*.... .  #..*......#. ....*.* ...........*#....#...... *#... ..... .. .*. .. ...... .*.. .\ #.....*... .*. **.#.# . ........ .#.\.#* ...\.. *.... .#
#\.  #..\*##*  . . .... .*#.#.# # .... *#  .**.#.*...#...# .# .*..\...\#.*..... \*... .. .**# # . . .#........#\\*.# . . .... .  ... #.. #*  .*..*...#
#.*...*... * ..........#\*......*. .. #..# ...#.*....#..* .#.....#......##.. .\*### ...#. *.. .*....##..#   .........*... ..... ..... ..\..**.# .*.*.#
#*#.#....#...   ...*..\*.##* ....* .. .. ..**...\..  #\.. .... .*......*... . .*. ..##...#....*....  ...\*. ....*.*.. .#  .. .\*.......#.\*..*#\ ..#.#
#... .... #. . .. .*....#... . .....*.... ... * .*.......#.. # #.. ..\ ...... .... # #.....*..**..  ... .. .... ...\.. ..**..*\#..*....* .* ...#. *..#
#.....    . .. .. . # ...# .#.  #\*. . #*.*. #....*.\.*#. \*.. .#.* *.. ..*..#...*..*# . *.....#...\. ......*# .......# . \.. ..#......... ... #...* #
# .#......*.#.#\# ....*. #. #. *..\*    \ . .. .\. \ * .....\#.#... ...\.#.... *.\\ ... #\..#..*..  .   ....*...#.*....\  .\.#... . ......... ## ....#
#*..#..  ..\**......... #....#*** . .*\.. \.  \\#... *.*.\....  ...*....... .. *...\. ..*   ....#*#.\.... #\ * ...  .#     *....*. ..\ ...... *\.....#
#.# ..  ..*#\*.*..... #. . .. #..\.  ..*.*\..#.*  *\  .   \.*.**.*\ *.......  .... ..  .#.*.#..*. .**.#. .. \ .\.*.*.\ *....  ...*. ... .#  .*...#...#
#.......*\. ..\. ....\.#......... . .***.#. ...*... .#..*# ... ..\.. ..........\\.  # *. ##. .* .  ..*.   ..*..#...*.#   .. .....* .##.\##*  \\..##**#
#.......\ ...*...#\.\#*..**.*\.*#   *.#...#..##.. ..*...* *.....  ..... ....\.. #*....*#. #  .#..\*....... .. ...\  .* ......\#.. ....... ..#*. *...*#
#..... ..**.. .**...#*.. ..*.. \.* ...#*#.#.. *...... *.*#*....*..#.#.. . ..  ..*#.  ..#.........#*\.... . ###*.# ....*#\*\#* ##  ...*. . . .. .#.# .#
#\... ..   ..  ...  . **.*....#..* .... *..    ..\\ . ..\ ...*..#\. . ...*. #\. .. *.# * .........#.. ...... .\*.*... #  . ... .... .*# ##..* .# . #.#
###.. .#. .* .*. .#. . ..#. .#.\*..**. ....\..*. .. # #..  .  .#.. \.   .. \.*... *#*..\...  . #*... ....#* .......... #* *. . ..*. \ . #.#. #...#.*.#
#.# .....*............. # ... ...#  .* #..#..   . \. .#. ..*.*...#. *... ....  . ...*. ..*#..* .#....*..#*..... #. .#. .# \.\.\ ...\..  .*......#...##
# ..#.*.#.. . ..*#.  ...#*. ......*#.*.... ##.*.\#...#........ *#... #.\*##   *#.*.... ... .#.*...\. .. *#....*.*...#. # ## #...*..*..... * ..\ . ..*#
# * #...\...\*\. ..*#.. \.*.*.....##..*.**.... .. ..#...# ..... ... * ..#.#. ..... * .# .... . . .*#\ . .. .*...*...... .... ..... . #\#......**..  \#
#   .**. #......#.   .  \*..*..#..*... \.....#...#. #...*.... \#... .. .\. \......... .# . .....#*  ..**....* .#..*.. . ......... #. ........* ....  #
# .  .....#..  .   . #..*#.. ..*......*.    # . . ... ** #*\.*...# *..  ....  .# . .*.  .*  ..## *.... .. ..... . *. ..... ....#.  * ....**..... .. .#
#.*. .#.. ....##....... ... **\ .  .\.\* .....  .*..**#... .. #  # . ..##.*..*.## ...## . .   .. .*.  *  .*#.  ..#.\\..#....  *.. .*..#.#* *...  . ..#
#..\\.....##* ... . ......\....\.* .#*...  .. #.. .....*.*. ....*#...#*#.\ .#.#..*.. \#. .*\..\.. . ....\.#...*.. .###..  ** .. *.. .. ..# .*..## **.#
#.....*.. ......*........ *.. . . ...*..\..#. \. ......#. .  .. #*....*.* .**.#.*   .#..# ..*.*#*#\..##\ #.... .....\..  \..\ \.# ... .   ...\... ...#
#..**\*..#..*....\.#\ #.. **...    .*.*\....* . \..  ..  . \.#.. # ## . .....   #.. .. ....#.... .\..*. .*....\*..*#..*   .   ..  ..*. ...#*.  ...#.*#
#*# .* . # ..*...*..\. .*....#.. .. ..... \. . #.#... .. .*#...##.. ..##.. .#.*...  . \**..*..... . .. *. .##.. #. .  #\#\....#.. ..... * ... . .  ..#
# . .  .*.   ..... *.#. ..#\..\.  #..* . *.....\..   .\. **. \\.... .**....*......#... .... .  .* .... .\#.. ..  #... .***# ... * *..##.#*#.\... ....#
#\.\\ *  ....\.*.......... .#..*. *....\\ ....\#.. ...* .*..#... ....##...#.. .*.....##  . .\* #. ..#. . .\.*..#     .\......   .... ..#....\#...#\\\#
#..\ . #\ \.. #\#.....** #.#  ...* .. . #..... .  .\......#\.*.\.*. .#**.*.#.....  .#\.  \\ . ..#.*. .  *...... .#. ... *.*. ...\\.*\. # .\.....*... #
#.#..\   \ * .\\# . .#*  .##. \\.*. #*#*.*. .**.# .\.\ ... *#.#.* ..*. * ..  . .##.... ..*... . .\#.\#..* . ..#.#.*  \ \... ...\ ...\..\.... *..#..# #
#....... . .......\ \..#..#*##...**......*.#. \..\ .#. #**  .  ..  ..*...#*.**.##...*#.*. * ... .*..  #..*...* ..#. *. \...#.    *#. \   #.*#...#.. ##
#.  ...*.. ##.   ......... *. ..#\*..*. . #......*. .. *.*.  ..   ... \.*#\.* ...# ...* .\. \#  \  ##*\ \.  ..\... # . . .\.#... #..........**.*... ##
#. \..*#.*##.... ..\.   ... .*... ...  .... ##.*#.. . #..\.#.# ..#..#.. .*.     \\....  .....#..#.*##..\ .........* #..#...  . .....*.*.\. .# .#....##
#...* ..** ...#...#.  *\. **#.*\.\*#......  ... \ # ... #...# .. . #.#\ ... .. .* . .*.... . ....*#...#..#.... ...#.#.*. #. #.. .. .  .#.\..  .. .**.#
#...\. ....  #.... .. ##*..  .. ...*\... . ......#*.#* * *..... .* . ...#......#.... . .  ..\  ... .*...   .    *\ *...... ...* ..*.. *.# . ... ...*.#
#.....\ ... **  .*##.#.#.## .*.#.#....*..\.  .. ..*... *..#  .*..  . .. *....\*..#. ...# . .. . #.#.#..#....  . .. ..*.*...#..\....# .*..#. ....*.*  #
#..***..  #...\.*.*.. .......*  . ........  . #.*##  .# .. \. .. .....# \.*.. * *.#.*. *...*.. \..\##   ....\..*. .. .....   ..\..  ...#.... #  #.* \#
#\*.##............#.... ...\.\.# .*.**....*.#....\* \# #..#..\*#*....#. . . .....\...  *..#.*...\.....* ..  ..#\.... .*... *. .....*\. \\   ..#.. .*.#
#.#.\..#...#..#. .. #..... .. . .... ... .....#...\...#*.#.....\..##..# . #...\ *..#. ... ..... .#.*..*.*.# ..*##.. . ...*. .\.*...* \*\  ... ..*#.. #
#... ......* .. .. .... ...... .** # ..#\*... . ..  * ** #*# #..#..#\*.. . \. \. . ...\.#..#..  . ....# . #...#..# \ \* *. ..\..* .*\.#.#.... .. *. .#
#....  .*. .  . .. ..\... ....# *##.# .. .* \.....\....\.......  .. .  ** . . . . .. **. .....*.#..\.*..*.\\.  *.#..#..*.#..# .*.. .#.# .. *....*...##
#..# .... **\ ..* .\*.. ... \... . ..  ..*.... *. .\....*... ..*...  ...*\ ##...#....... . ...*...#..*.*#...*..\..#.\. *#.#...*.. ...#.# ....#.....#.#
#. #*.*.....#.#.  # # ....#. ... .* .  ..#*........\*#. #  ...\\# *..\......*#... ...  .###*. #*... *...* ..#.....# ...* \........ ..*# .#...##. **#\#
#*. ..\.... * .....#.......... ... . . * . ..#.. ## . ...  **..*.  . # ..* ......\... .*#. .\..## ...#*.\\.\.\.....##. . .... .*#..* #..*......#*.**##
#. .*....*.*.#. . ...##.... .  \ # *.\*#.**.# . ......  #\ . ....##.#...* *\ ....\..*.\* ##. # . \... #...# \.. \  .*  .... #.. ........\..\.#..\.# .#
# \ ..#..*.#.  ... ...   . ##..##*.  . *.. . \...\*.*#..  .\... ...##..#..# .. .#....* ..\ ..#*.*  *.\.#\# #. .#.. . .. .*.** .*...* .   #. .#. .....#
# ...##..  . ......#*#.*.... . ..   \ .#..* #..**.\... ** .  .. .*...*....*..#...#\. .#.. .#. ..*. ...... ..#*.. #...  .\.#..#  .#..## #.. .. .#.....#
#.#.. ..\..... ..#\.*.#.. *. ..#..#. . ...  ...... ..# ...# ..#* .#.* .**#. .#. ...*..  ......*# .#*#. ....*. *## .**.#......#...* .....* ...#   . ..#
#.*.........*.#*..** ...  .* ..* #..* ... *...#......*..#\.... #....  * ...\...* .**.....##.. . .....#. *\. .# ..... ..**.# ....  . ...\. \*. #.. ...#
# ..   .. ..#.#. .*. . .. .  *.#\\..... ....* .#. ....*  .  ... *...# . ..   ##.....\ *  .*.  . . ...#..# ... ...#..*..... .... \.. . #.#\*#.* . . ..#
#.. \.. ###* .* ....  . ..*.... #.\ \ .\.\  ..\.#.#..*\ .#. #*  #\  ...\*##....\......*##...*.*\.....\.*.. .. .\.##..*.##.\...*.  .* * ..........\#*.#
#. .  \#..* . #.#  .# *....*... * ... *..#.  . ....*\**.. . #.  ..## *.#.*.*.# ...#..#.*\..# .#.... . ......# ..# .  \.. *#....... #.. .#....* .. . .#
# ....* * # *\# .\.........\....*  .. #.... .#.\.  ..\. ..... *.... .......... ..*..... * .*....*#.\..#* ...*.....*..*....##.....*... ..  *...*.*.* \#
#.. #.*.# . \..   ...##..** .*.......###... .#.* ......... ..**.##.... ...  *\ .....# \. .*.  *... ....\.**..\#.#.#... *.*... #.#.... ..#...\....#.#.#
#.*\#.... #....... *. .*#.. . #.# #...**\..#...#.\.*#.*\. *....\. \..#*...*. .. .. *..   \..## .. .. .#...... ...... \.#...... ...#.\....#*.#* ..*.*.#
#. *. ............**....  .#. .#...... . .. #\.*  \ #.. *.... . . . .#  ....#. *.#.. *.\.* ...#. #.#.* . .\. .#.*#.*.....#...##..#..#*\.......*.* . .#
#.....*.*.#   ...#... ..  .#.... .....  ##..\.***.   .. .*.. .***. . ..#...... .#.. *......  ........... .. #... .. ..#.*..\ .#.* ......#. \.. . . ..#
#.. .. ..... *#. *.# ..*..* .#..*  .* .   . *.#.*    *.. ....  ....... ..*.. #.. . ...#.*\..*..\.... ....*** .*#.  .... .*. .... ..#. .* .\..*..#\\#.#
#*# .# . . .\..... #*. ......#.....*. .# *. . .*..... . ....*.... .# *..**# . ...#...#.... .. ...#...\\.* *...# .# ...\. .... ...\..#*. .*.. *...#..*#
#.*. .##...\..# ..*.* .#.. *.#.*\.*..... . *#.....#. \*.*. ..#*#....... ....#.. .\.#.. ...#.....#* .*.#.    ...#..\.\   #. .... ....... .*  .........#
##.* .#.. ...\...* ... .... .  ..\.\. \*..#. .##  . . * #.\. ##   . #.. .... ... ...*.*. *.  *...*.*.* *........*  *.... ..*..  ...* ..# ...#..**   .#
## .*......# \*.  .\ .#\.... ........#.*#....*.  ... \ .#. *\. .....  ##..* #\.*.*...  .  \#.*.. \*#...  ##. ..**. ..*.#..# .. ..#...\.... .#. \#.*..#
#\.**  .. ..#. . .*.#*. .....#...  ..... ... *. ...  # ..........\#.#...* . . #..\ .....*... *#..\.. .*....*#\...#. ...#*\.*. #.#....* . #...  *#. ..#
##.......  #*#  .**.#.#....#\ \ .. *...* \. . *... .. .\# ....\.\...*. .#  ...\..*.......* . ..*.. .. ....# .\ . ... ...   . * ....... ... . \....*#.#
#.*. *# ....# *  .... ..\# * .. # ..... #. ....*....**#  ... * ... #....##.#...*#. .... . ... ...\..#..** *.... ...  . \...**. ....* #.#.. .#... .#..#
#.#...*. ..*. ..*....\.   . # ..*  . .  *.## .# . \.*.*#..  . .  .* ....\.* ..\\..# .* *...#.**#   . . ... . ......#... ##..... ...*#...... .........#
#.*** . ...... ..* ## ..# * #.* ... #... ..#..  *.\#  \\.*.  .. .. .#.*.\..... \....*.....#   .\.*# *. .. . ........  .*..... .. *.... .#.#..#....* *#
#* ... # ..... .#\ .. #...*.........*  .*..#  **#...*..#... # *# ...#** . .... .#.........#*\#. . .#..*  ..*#.## #.#.. .. .   *...#* .. \*\ ...#. .. #
#..*\..... .*......*..#  **. . ..# ..#.\...  ...*. .**. *...*#* ..........#..##.. ..*.. #.*.#.......  .....*..\...* *..*\.  . ..*..   .#.#....*...*. #
#...*.   ...\.......#. ..*. .. .\***...  *....*. . #.. #*...#..* . ... ... ...... .... .* *\#..# ..  ..#... #....##...#.\.  ..\.#*.*.....\.\....#...\#
#\  . .  ...... .*#.\  .*.*# \. \*#.. .  ..*   ## #.* ...... ..*...*.... ...**.... # #....##....#**..## ....*.........*....*.. *.. \...\*.......**.. #
#. .*....*.. . . .*\ .#.\#...... ...  .. #.#  ...* .\..#....    *.*#.**.*#.\#*..  . ...\... . .#.## . .\#... ..#\... *... #.#.. ...#  *.. .... #..*  #
#. .....\.#.\..  ...... ....\.. .#*..* ............#.  ..... .......\..#. \..*\.** .#.....*.\#. .\. *.. .*\**..##*.. ..#  . **.*.* .. #   ..#..\.....#
#......  ..*. ... .. .#    #........ . # ##..\#*. ....\.. ..... ....... .......#*.....***....*#..... ....**.#*#. ...# .......**..*..*. . . .#.\#.. ..#
##. **  \.#..# . . .# ....\.# . .*.* .. *.#..*.... .   \*.... .*.#......*\... .  *##..*#.\** ..# ...\. *.. .## .. .# #.*.. *.#. * .  ....*...*. .....#
# #\..#..#.  #. *...  .*.#.#*.\# #.... ..\.. ... ... * .# .. .#*.#.*... ....#.\....\ # ....*\. ...  ... . #.#...#... *... . *\....**.# # .. .#.#..#\.#
#.* ...* #..#..* #.*. *.. #...#......... #.*.#..  . *...... # .....*.. .......*..*..#*#.. * ...*\*...##....*...*...*.........\ ..*.........# .... ..##
#. ###.....\. \.#.....#. \ . .... ......#*... .. . #.*.. # ..#  .#* # #..##..#.... \#  ...... ....*...# ..*. #. . .#........*  *# . .\ ..  ...#... ..#
#*..#.\.*.##  . **.\..*.. #  .#.... *.......# ........\.... *.#*#. ...\...... .\**.\#.\* * .  .#.*..  .#...* .*.... **\..*.. .#*. \ *#.. ...\*  \..#.#
#. .\ .\#.*.....  ... \ \.\.*.. . ..\.*.. ..... .*..#*.* ..*...*#.  ..   ......#.##...#. \.. \*.#*...... ..#...#. ... ...*#*..  \..*.\ .....#..*#*. .#
#.... *.... .. .... *.... .*.....   \. .\#.....#..... #. .#...... .\........#\#.. .. . . *....# . ..#.# ..# ... .....\.#.......#   .#.....* \....*...#
#. .\. ....* *....\*.*\ .*# ....*...  .. ... ...*\. . *..#.*  .\ ..... .#.....#. .#...* ..*..# *#....*.. ..*.\  ...\.... . ...#. .##.*# ..*. .\. #..*#
#  .. . #. ..* .#**......#. . ..# .. *. ..*# . .##.. .... #...*#. ...*.\.  .....*\*. ....* .... .....*#....#..\..... *..\......*.#\.#*....*..*.......#
##... ..... .....*.*..\#. ....\.........*...#.*. . .. *. \#..#.. # #....*#.#. #. *...\. .. ..#.* ....  ....*..#*. .* .#...*..*..*#..  .   * .... .#. #
#. .#  . .    ......*..  #.*. *.*.. **...#. ...#. .... . *...#.**...*.*#...\*..#. .. .#. #..*. . .\. ...#**.....  . #*#.... .*. ..#....#.#...**  ***.#
# .\ . . . . ....*....... . ...\*. ......*.\...... # .   . .....#.. ..\.* *..#.* ...\ *. ..*... .\.*..\. .*..  #.  .*.#...#* .* ...  ...... ...#..  \#
#..#.#..#*  ...* .# .. * **. .* \. \... .*. *....##...#*..... .##.. . \....#.. \...... .#..\..\.....*.  . .\.#....##.. ##.\. ..#...##.....#. .\#.....#
#...  #... ..... .#.*. ........#.**\ .*#. ....#. .. #.... .. ....*.. ..# #.. ..  #..  *.#... .\..#  *...... .#.\  . #.. . . **.***... ..... ...#.*. .#
#.#. . .. . #***....*.  ... ...*.#   ..*..\ .. .*#..... ..  #.#* ....##. ..*\.*#.... .*.*.# .#.... ....# .. .#... ...... .. \....... ...  * .*.....  #
#.\  # #.#  #....* .*....#...#. #... *.*  ...*# \.. \ *..##. . *. .  ###. .#.#  . *.*.*.....* .*...*. ..* .. .***......\#. . *#.. *#*#. . *....*##. \#
#.* . \ \ #.   ..#........ # .... ..#..##.........*.........* ..# .. #....#. .....#\ ... .#.. ..\\...*.  ...* .*...#...#.  ..... #..##.  .\ ....#... #
#. ......... \. ....#.. .....* ..... .. .......  ##.. .  *..#.. ..*..*..\..#*\. .*.\.***.  * .\.\.. . *...#..\..*............*#.#.*.* . #.......  .*.#
#...* .* ..*..*.. \. .. .# #.  ..  #....... .......*... ....  # #. ... . ...\... \.#. . ..*.\.... ..\. ..# *..  # ..#.#..... .*. ....\*..# \##.. . ..#
#.* .**..........#...#.  ...* .....  * .*.. . ..\ .... ..#. .. *. .....#...\ ..*... ....  ...*.*... # #*.*  . * .#\. . **.# *..\ #..#...  .* . .... .#
#.* .## # #......#..#..  ....*.....* ##.*..#.*..# \.\...*.\.##..\ *.... *.......#...**..#..   *.. .. ...*   .\ ...*..#..#.*. ....#..#. .#..\#\ ......#
#.*.##***.* *.. .. .. .. .. .... #.*.....\... .*\...\...*.. ...#.. #.....#....*. . ..... #..* ..\ **#.  . \.......* .. ..*#..\..*#..*.. .. ..   #*.. #
#*.*....*... ..\. #... . # .. \... ..* \..\#.#..#.. . # ... .\...\.*. . ......... ..\ .*. ...  ....*#... ....\......*\. #..*..##. ... #. .. ..#.. *. #
#\....#....# . **.*..... ....*.#.\*#\. #. * .. ...   *.\.#...*.\   \..\*\...  .....   *..#* ..\#*.# *  ........ .. ...... *.#\\..... *.. \...*.  ....#
#..#...# .. ..... ..\\.**.. #.. ..*..#.......... ...###.\..* .*. ** # .#\.. .... ... ..* # ### .*..  \ ..\..*...... ..* #.#\.## .**  #.  . .*...* .#.#
#.....  ...*#..\..# \#...*.. .*..# #.......#..#..**..\.  ... # # . *.#... . .  .  ..#. ...*.\..##..... . #....*..\*..  . ..... . .# ...*.. **\ .. ...#
#...* .#..*.*...#..#*....\....*...#. . ##...#...#. #... .#.\ ..\.*......*...# .  .\ .... .\*   .*\ ...\..# .. ..##\...# .* ......\....... ..\..*   .##
##..\...**\... .*....#. . #.* ..#...*. .* .\ ..#.#.*. #.# ... ...#. ..#.#.*... .... .. . ...##.. . \* *# \*#. .. #. .#....####....\#*\*.*.#..\ ..* . #
#  ... .#..*.*.....*......#....  ......\**. ..#..   ... ..#. ..#...   ..#*......#   *.*.#..*##. ..*..*# ....... ..\ ..#....# #...  .\.. .  . *#..* ..#
#\. *.*...#.. .#.....#.*.. .\. ..... ...*.. *.### .......###.*.#*. .   .* *... ... . #... *\\..... .... .. \#*\.*. .. ... ..#.  .\  ##...... .....* .#
#...*.#....\**. ..##.. .. .... * #* ..\. .....#.  \.. .*... .#.\ \ ..#.  .#*.\#\## . #......* ......  ...*.. ...*#.   .##......*#..  . *..*  .#... #.#
#.. #.#.....# #.#  .. *...  *#*  **....#....\ **  .........*....  ...# . .  .. #*.....#.*.  *.. ... *.\.\...... .*.#. .*\ \... #. # .#. #\.# ..#..*\.#
# .... .#...  #*...*.#.... ....#..  .....  .....*\...  ..\... #* ...#   * ....\.#.. .  ..#\.#... ...*...  #......* ...*.* ...*..* ..  ......##....\..#
## .... .  .\. .. .*\. . . .....  ..#...*.......*..........**..#..\......#\ # .... ..#\* . .*. * .. .*....* \...\# \.  #... ..**..\. *. ..*.. .# **..#
#..\ .#.. ... * . \# . ......   .. .*.... ...#..#...#...#  *..#.*.*. .* #.*.** .R#...* .#. ..\...  ...** .*  \..* ....* .##.  * .. #.....*#**# . \ . #
#..*.  . .*#. .  *. *.. #.. #.*..#. . .... *....... .. ..   .** ##  *#..#.\*...#...#... * \.....*.. . .*.**.. #..    ... .*...\ ## \ .\...#*  ... .#.#
#* . ... . ..\.#.....#.\.##. .. ....   .. # *... ...# \.. \. .. . #.#  *... *#. *.  \.\..#....  .. ..# .  ...   ...*..# ..*.  ...* .... .#...*.* *..##
####.. \ *...* .\... ..#. ...#* .*. . *#\#.. .... ...#\. ..#* #*..  ##.....\.#....#\... .*# # .#. ... .* .#... \  .#.. ...  .#..* .. ..#.*...# ......L
#...##*. *. #..... ..#*.. ... .\#.....*. #...*..........**.#.....**....\*. \......\.\ .. .*....*. ..... ....##*..##*  ..*.*...# .. ..###. .  \...  ..#
#.#.  .*... *#.**.* . .\.#.. \#...\#..\.\... ...#.  . ..\  .#. #.*##.....*.#.\*.... ...\.*.* #.*\\ ..*.*  ..*..*. * .#.#*.#.......*\ ...... \..##\ .##
#.*#  .......\#....##*   *.#*  #...*..\.. ..#.*.  ##. * ....  *.* .....  . #... . ...*.. ...\...\\.... ...#. ..*..   . *...  ..**  #..##...\##...\ \.#
# \\... . ......... # ...  . ..* .* *.*#..* \* #*..... . ....*..#. *. .. . .... *..*...#....# *.\** . . ...\. .#..*.. .. \#.....# . .*#...... . ....*#
######################################################################################################################################################