######################################################################################################################################################
# .#.#.#\*.\. # .* . . #.  .....\.#*. ...**.. ..*.#. ...  *...*.# .* ..\...# \....\ ...  ..#. *\ .. #.*#.......* #.#....*.. ... .  ...\...  . \ . ####
#*.*.#.....#. .\.#...*##.#.... ....  .......# .*..#..#.. ...#\...* .. ..*....#.*##.\.. ....*.......#...\.\*...*... ...\* .. *........ ...\. .. .*\ .##
#......\** *\. .\...\**....#**.# #.\.  ..\ ....#..#*... . #\. *.. \#.#  *\*..\.#...   .... .\ \\*.### ..*. . ....# ...\.. #.....*..\ *...*...# . .\  #
# .\...*# .**...\  .. .  .. #....# .##\.*.*.*. #. . *.*...*..\. .. \.#\.*#*...\..*.\.. .#. \ .. ...\..*. *. #....\..#*...\..* #*#*....*.. .  ...  ...#
#.##... ...*. .   .#..# .....#\.  \*.. ..*\. .... *. . .#.. .*\.\* * **  ..\ #*...... ...# \. * .*..##.#...*..  .... .... ...#....*....*......#... .##
#.  *.*\.#.. .*...***#. *..# .....###...... *.*#.\. .##..*. *...* *..... #.#. .\.*..   #.#..#.....* ....   .  .*.\\. . # ..*\...**..\.*..  .\.*..... #
#.#. * .\..  *... .* .....*#*....# .*.. ..*..*#* #...... .\..  *...#.....#.. #.*......*. .*....*... * ..* .. .. .. *....*. ..\.\... .\ . . ....* . *##
#.\. ..... ..*..*#...#.....\.. .. ....* \.*.. .* .# ..*.    . . . . ..\ \...#\..\ \   .*.  ..... ..##.#........*..*..\... ...#...*.\.*.  .#.\.... * .#
#  ....... *.\. .*..*... .**.#.*...#........*.** .. *. ..\.  \\. #\  . *#.*\*..  ..  .*.  .....\*.*. ... .. ..# . \ ......#  #.   ##\..  *. #. *.\.#.#
#.. ..*.. . . ...#....#..*\. ...# ..#.#. .... .\. .. **.**#...\. . ..*\.#.\... *#. \* #*... .#.*. ...  .#*. ..#   ..  # .  \....*.*##....  #* # \.. .#
#.... .. . .. . ... ...* .*...  #... \* .  . .#*.....\.  .**......\.#.. \## .\ .*.  ..##. #..*. . #.. . .... *.# .#.*. ...*...#........*.. #  \. . ..#
# *...... ..*...*.  **** .#..*** ... .. .\.#... .# #....*# \.#* .#.**#.. . .#. . *  .##  . *##... .  .## ..... .#.#...\.  .*...\ ...**##.* .. ...*.. #
#*   *.  #. .. #   ..#.. .. .** ...# ...\\\*. ... ..   ....#...... . . ....#.. # ......#...#... .*. #......* .  .. ... * .......#..#. ....#  \* .*.#.#
#...** *..........  .. \.*.. .*.. *.. ...#\.##**.  ..   \....... \    ........#...* ...... .#\...\*...*. . .. . ......  *# # *#  .\.#*.. ...*. .  .#.#
#.. *.#. .. .. ...   .#. #......# *\**.*  . \.*..#......**.. .#......\...... .  ......  . .#*#....*...  *#..*....#... *  .\ .#...\... .* .. \..*.. .*#
##.....#\.  . ..# .#. \.*. .* #. .  .  . #..#..  .... . ...*#.. ..*.. \.#*...\....*. . ........  .*.....\\..*# .. .. .....    .\#. ... ... . .#*\..\.#
# . ..\...*. #..*###........ **. ..\..#....*..** .... . ..*#**....#......\*.# . #. .*. .. ...\#...*#.. . ...*# #  .    ....#.. \*..\#... .#...\ .  ..#
L#. .* #...*#..\.... #...\* ..*# . ...# ....*.....\.. #\..\ #..* .#*.**. .. .*.  *...*.   *....#. .*....#**  * .. \..##. ..#. .*#..*. .*\.#...* ..  .#
#  #\..*.  .... .#*.#.#..\..\ .#..# *   #. # \#.... \ ...\....... .#...*.*.*. ..# . . ..... ..\ #.*..*.... . .\. #.  ....* .  .\*\.. .*\....*. #...*.#
# ..# ..#...\  . #..*...\  ..#..  .. #.......*... .*.  .#..#.. .# .#.  ........ ........\ .#........ ...... *\....\##.*...*.*.... . .**.. #.**. *..###
#. **..#\... *..#..\...*. .\. * \.\ .  #.\*.**  *.. . *..#.. . .......#*. .#... \. #.    *\ *.... \#.. \ . . ..*.*.*\..#\ ......\. \.... .. ..#.*.. .#
#..... ***##  .... .... *.. ...... .... ........  .\**.*...  .....*. .. *...   ..\.*.\  #.*..*.  .\.......... .#... . *... .... # . ...\.....\.. *..##
#. ..... ## #..#*. ..*# . **. . .....* . .. .... ...\***# . ....*.. ... .*.. \.\ . \ #.#.* ..#..  *.#  ...#.*..  *#  # .....#. *...... ......#..# ..##
## .*\.... . . .*. ...*#*. .....#..*..\..\#... ......\.*\# *..... ##..# ....... .# ....#.#*.# #. .\.#. #.. *..**..#. ..#\...*.....* ... ... ........*#
#.*. *  ... .*.... # ......#.  ..*. #*..#.#. .*\..\..#**.  ..... ..*...... .... .. . ... #.. .. ..... ..*.\..  . ....\.#..*#....*. .\  .. ......  *.##
#*..*..\.#.*... \.\# ..*  .. ....... . .*..##...# .  .  ....... .*#. .. \ #*.....***..... ....#*...  ... \.#  #.\.....*. .# ...*.. *.  \ ... .#.. ...#
#..## .....#.  *.. .*##...* .. .\ \* ...\.*......#  .......... .. ..\... .....\*.# *.. * ..#*  .##... .. . \. \ * .\...#..\. .....#*  .  . ..#... .*.#
#\ ... *.\#. ..*...## *R *.. .#.  .#...*. .. .*... \. . .*.. #.*..*.*.*#.*..##.# .  ..\...#...#\.\ ...... # .. ...*..# ..*.\\  \.....# .... .*.. * #.#
#*.....#..  . #....# ..    ***.#*.#..*. .#\ .... **..  \.*.#.*.* .\............ *\. . .. #...#\...##..#* .\#...\\ # ...#.* ## . .*... ..#.... *......#
# .*.. \*...#.*....*  * ....*\.  . *.\.*.. *.... * .*.. .#\.......*. * #........**.  ... \.. * ..  . .*\ # .... . .*#... *...#..*\##.* * . ..#\....**#
##...  ...#. ...  ... * ..\.......  ... ...#.. #  *.....#.... . .\  .. .. ..*.. .* .*... ..\.......*....  ...*.. ....... #... ..# .*. *..*.*.. ..\.* #
#.#.. ...*#\.   .... .. #.#..#*..  #.\..#..*. ..**.# **. #.##.. ..##.... .#..# ...*..#.. . .\.#  .. ..# .   ...... *....# #.**.... .#... . ..##.....*#
#....#*#.  . .. ........\......\... .. ....\..*.....#**. ...... ..#..... *. ##*.#  .........#.. ..*# ... . *..#. #...... #.*.......  .*..  *#..  .  .#
##\*\** *.\  .. *..#.#*.  .#.. #....#...\\.....#. ... ......# .. \...\\#...*.#......   .....  # . .#.. . .#..#  ....##..........#...... ........ #. .#
# # .* ..  . ... .  . #.. *...*..\*# .* .#*. \.   ..#...#..#.**#... ##..... .  * .#. ..\.# \ . *\*.#... #* ......#.#.\...*..... ...*...\. . .. \ * ..#
#.. *....* # .#....*.... . ..... *..#.*...*. ...#..... .# ...... ..##....#.*.* #..#*..\.#....*.... ... ... . ......# #..*......#.. *..........*. ...*#
#*...#*.....*.**. . . ...\ .*\. .#.*.  ........ .*#....  ... .......   ..  .*. .##\. *\ *.....  .. ..#\....#.# *## ..*..\*. \#.. .......**....##..# .#
# .  .# ... .###*.#. *#*\... \..\..*... . #*..\  # ...... .......#*.*.**\\.\.. .\#.\.*# ...*\**..* ..\.. ..\   . *.. . .#...#...# *.\ .\.....# .#.. ##
# . ..**..........    #..\\#.. .... ..*#.*... #.... *.  # ...... .*.**..*...# .\.#.*.#   *.. .  ..\#.......\ ... \...\..  \...#.*#. ....#. . ....... #
#.# .# . ... ..#.**  *.. *.#..* # \. .*.* . .. .*..#... *#..# . . *..  . ......\. #... ....* *..## .* .#. . .   ...... .*.*. ... ..... #.. *  .*...*.#
#**.. .# . .#..   .\.# . .....  *. * .#. ...#.#\. #..#  ..* .*......*.... # ..*.*.......#*... #...  .#.   .. *.. ..# *#.*#* .*. .....#.. ..*..* #.*..#
#*. .\....\.#.\..... .\#.#.*....#.... # .. ....\...\  * .\. . .......#...*.*. #... #. . ... \.*.#.. .... .  #......\. *\.*.\ .   ..... ..*...* . ...##
#*.#.. .....   \ . .. .\*.. .  .\..  * ...#. * #...*. ..\.. .#.\..  *..*...* ...\.... . #.... .#. . *  ** .. . .#..\#*  ..# . ..    .....\...*.   #.##
##*#.#...#...*............ .. .\# ..*... *.   ... ..  ..**#.. .*.*#..\..*..#*#..#*   .*.  .* . .## .  # ...# ..* *........# . ..#... ..*\.\..#....#* #
##**.. ..*#..#. ...\. #.. \....*....* #*....#... .. ....*...\#........ . . \*.#*. .......#\..\..* . ..###  . . ...  \ ..#... .*...  ...\......*.....*#
# . ....* *   .  #. .*\. ... .\....*.*#.**\ ..##. .....*\.*  .. . #\ ......#  .#.* ...*.. *..#. *..##.**..... ...#..##.# #.**\\##...*\...*.## #.  .#*#
#...#*. ..* .*.....#.. *..  ..**... ....*.  *...*..# .......#* .. ..** ..... ..#*..     **..  . .#  .#* ...*## .* ..###....*  .## \ *. *..#.*. ..  *.#
#  ...... *.......*.   .* .# #. .. * .*\.#.....#.. ..*.*. .**#.... ....\ \#..*.. .* .#  ..  #. ..   .#..\.# ....\\*. ..  # #...#*. .  ..#..#. .....\.#
#. .#  . . *......#  ...#   .\.... .#\#.#...*#.*###.*.*....... \...*...  #. ... #*.. ..  ... *. #.# *.*.. . . .\ .. ..#.....  .**#.  . .\ *... .#.#..#
##..... .. . *.........*...  *..#..\  ..\\*... .*...#......**. .  .*... \. #.... .... *..# *....*..... .. . *## ..*.  .......#.\ #.... ... \.. .*....#
# .* .\ #*...... .**......*#... .. ...\..*##.. *... *.*...  .....*. ...#  * .#*.. . ..........\..#..#..#. .*... *.#....*#.* .. # ..*... ..* ....\.*..#
# .#.**... *..* .... .. .* .  .*.# .\..\ # . .. .#*......#.##...*.... ##.....#. .*\#. ..* *... *.** .*#...*..#. . *... ... .#..... ..... *..   .#*. .#
#.. .#.\*.. ... ...  * ... #*..\ ... *..... .... ..\...* ...*...... ..*. \*. # .  .. ....**. ...*. . ...... # *...\.#... .#*. ..#........ . . # ..*..#
# .. .. .* .    #*..# .*..#....#..##.*  #..*......#......*.. ..... #..#. #..*.... .. ** . ... ...**.# .\\\\ ... . *..# .....\  ..*...*..\ * .*.  #...#
#..#.. .#.\. ..*..\  .#.......\.\\\ ...#.*#...*. . ... ........#. .#...* . .#...\..#.. .*. ...*   .  ..# * .\......#......*.. .# . *\. #  #. ... *..##
#..  #.... .\  * \*...\ .... .  .....\..* #*.....#*.#.... *..* .. . .  #.. .*  ..*.. ... #. .. . **.. ..#.#  .. ... ..*.  . . .  \....*  \ .. ..  \*.#
#.*.#.......\..*.  ...*...*.# ..*.........** .   *#   \ .  .#. . .**.. .#..\.#* .. .*.*.# ...# .......   #.. .   ... \..*. .*......#.  . . .. ...  .##
#   . ..\... . ...\  ............ ... .*........ ...#.. . .......*.##..... ..# .  *  ..* .#. . .  #.. *.# \.....  . *. #.*. *... .* ...**.  *..\ ...##
#*... #.....#.. .*..#...\#...# .# ##.*.. .\...\.. ...##... ..*........... .*** . ...#... .. ....  *..*\*\## .* ..*. *...#.#. *..*...\..*....*.\.\#.. #
##  *.* *. ## .#.#*   \\  . .....  *...  . .\*..\ .**.#*\. . ...#... *# .. .**.. *.*.... .#**. . .. .   ... .*... .... \..#..#. \..# ... .#  #..*. *##
#..#...*.\...#* *...\.*. .  ...**..#...#.. ** *.*#.* \...#.*.\.\*..#.. .*. ... ... # .. .\...... ...# . ..  .#*#*.. . .. ......    .#..... ........\.#
#..\.###...# \.  ...##*. ..\*.. . ###...#..\ .... .....#.......*.. ... ..\ . *#.# \# .... ...#.**. ..*. .. *\...**.......*. # *.........**..  .....#.#
#..\..#. # ...... ##.#...... ...\. \.....  *....#.. *..*. \..  . .\.\.#. ...\ * .#. .. .... . *#.* #....##.#*.** ..... .**...#... **.. \   ....\.  ..#
##*..  .***\.#.*..*....*..#. \.. .*. ......#.#. .\ \## \ .\ .. ..#.* \.*.. *... *. . .#...\ ...   ...\....**. ..\   . .*... .*.... .*.##**. ..*.#.*..#
#. ..     .*...* .....##...# .# .#.. .*..#. .. .#\.#.... # #.... .*.**.\.*. ... .. .......\*.*...*.*  ... ... . .... . .. #*#. ........\ . #....*...##
#.*....#..#...#...* .. . ...*#... .\*.* ..# ..... #.....#...*... .. .*.*.... \* ....\#\....*.. ....\\ #..\..  *\  ... .*..*. *.#. #...*.*#..... .....#
#...\.\ .\. .*.*.. #.. *.\....#..#.#....#..*.. *..**...*  ...#...\  . .#*..... ... ..**.. ... . . .#*####.....\ *...#..  *\*.**... ...#...*.  .*... .#
#.#...*... *.. *.*#. ...\. .. # ...*\.\...\...... .#.* .* ...*  *...* .. *....*.***..#.\*. . #  .... **#... ..# .  ....##..\ ... #.... .#..*... ...  #
#..#\#..\.... . . *........ . . . #\.... \\. *.... ..#..\....*.\ \#.* *.....#.#\#* *..#.#\ ....# \.*.. ** .*....  .#. *. *..##..*. . .\   \...*. ## .#
#... #\.* ..  *##.\*........ . .##. .#*.#.*.......#. ... ..\..... .. * . #.. \... *#..#. ...#.## #  #. **  . ....  .* ...... .\.**.#..\..*. .***...* #
#*#.**\*#.*.. ..** \.*..#.*** .... .#  . .*.*# \ # #  . * .#. ......*  ..\ ...*..#. .*.....\. *. .   ..... #.#.*.##.*.#.* . \..*.  ##* ...#.#. .# *.\#
#. \ ... .....#... *.*  .. . ..#....... ..#  . ......#. \*...#. ..*#...#.....\ . . .. ...#... . ..\.#*...* \..\*\ ..*\**. .*\ *# #.. *  .. #..* . ...#
#.*. .\.. ........ .. ##... ... ..*..#. ...*.*.*#.  \.#\#*.#.*..... ..# .. # ... .\## ..* .. ..  .\...#* \*\#........   ... *......  . ......## *. . #
####..*.#. ... ........#*\ .  .. .# ..  .*.*........*.#. .....*..  \\#..\. ..  #.*.# .. .. .*#.#.  ...*\  * .*. .... .. .#... ........# *\.*.  * . ..#
#... .  .... .##.  ..#. .....*#.#...* ..#.. .\.....  .. ...#. ..\....\. #..* . .#.*\.... .....#..**.#..*... .....#..*.. .#........ ..# .*. . ......###
#.. ...#.  # ....... .#...\#.  *..#.......\.....\*. . ..*#...*...* .#...\.**  ..# \ ..\. # .\ .  ..# . .**.* ..*\...#* .#   #   . ...# ...\.. .  #. *#
#...\#. .#*  .*#  ....#. .......* #..*. ..#....#.... .....* .  **   *#.....#...#\  .## \..#.* . .. .. ..#*    **.#.#.**..* *#.. ...**...**...#*#.....#
#..*. *.*  ..  ...* . .*..*..*..* .*.# ..*.. .....#...  ... #... .#.#.*#. \*...*.. # .*.*..   . *    .. .\...  ...... . .#...# ...\ *##.*#. ...\##.. #
# . *** . ....*.*..# .**.#... #..*.#. .... ....*...#*.*..*\.* .....  ##.........  . .....# *.*.* ... \\... .  ...#*...*..###*.....#*.#. . *.. ..*..*.#
#..**\.. ......   ... \..\..*....##\. ..* ...*...#...**\# ..#* .. .......*..#..*\*.#..*...*.\***.. .  * \\ # ...... *. .. .#.#. # #.\*. ...... . ..\##
#..... .#\.#..\*..#......\#* . #  . #.\...... *.#......\*..    *.#......\*  ....*.#.. *\.*  \  . .#.. ..#   ... .. .\.#...*. #*..\..\..... *.##.....\#
# #*.  .#*#....**  .*... \*#..#.#.. *.*. .  . . .... ## #......# . \ ...***.**#* .  .#\... . .#*..*#   ....... \\  ... ......... ....*.. . . ...*..#.#
# #......\ . ..*#.. . *. #.......... .#.....#*..*.*. #*...\* ... ..*.  . #. .*.*  .. .......*.\...# \...\.* ... ..*\# .*.  .*....*...* .. # ..  ..#..#
#  .... #.#  ..*  ....*...*..#......#......#.*.... .**......#. .#\.\# #. .###\#.*.....#.. .*..    .# . .#.. \..#.... #...#..........#\.... .# . ..* .#
# ...  .*...# ..  .....\.#...*.#..   #.*..#.. ....... *#* .**#.*..*.*##....* ..*.*.. .* .\  .\.\ ..\ .\. ** *.... .. .*... . .*#  *.#*.... ..## .** .#
# \ ...#.. . ... #.....\.. .\.*. .# . . ..  ..#\* .#.\...   *# .\\\...  .* ..# . ..\ *.*\.#.. . *\\.  . * ...*..*...###. .... \#*.*. #.#*.....*. ....#
#\* #   .........*.........*.. # .*...# .*.. *# . .......**#.\.   #...  . #.... ...#...#.   .... .. .\.*. *....* .. ...**.*.....\.. ....# .....  .*..#
#\*.\.#.* ...##. . .#\.  ..... # #*\  .#   #..\. .* ...#.#  .  . .. \....\.*\#.. ..   .. .#. #.....\.\*##..\#........** ..# #....\ ..*\*#*.. .#. . \.#
#. #.#. . .. . . \.#. \.*.....# #.*..*  #  ...*..#. ..* \..#...#.#. *.*#...# #* ..#.....#*.. *..  ..# ...# .\ # #.. ..... ....*....**.\......... ....#
#.. .. #.  ..#..#.*...\.... ... ... ..*..\ .**#  .#.\*.. .... .#. #\. ..# ..**...\.  .\ .. ...# .# .*.#...   .#...*\. .*...#. .....  ... ...##\  ... #
#..*..#.. # ..\ .... # .#. .#\.\. \ .#.  ...# ... . ... ..#.#  . ....*#.... ..\.*  .*...#...\#.. ... ..*. *........\.....#*  ..  .. \..##.\\.*..*.#..#
#.. ... ..*......*...*...# .... .....#. ..#.#. .# .\.#* ...*..*. #* **..\\  #. ..*#.*..#.#.. *.. # \*. #.. .. ...*...###....... .. .. .\ .... **.....#
#\. ..# *..   *..# *..*. \#.# #.....\ ..\ \. .. .. .## \*... ..\ .#*#\.....##.#*. .#  .........*. ... . ..#...  \  *\...#* * ....## *...* *. \. #....#
#.# #*.#..* . ..#.  .\..*. ..#..\...\* ... .\\. ...*...*..\.#..*. . #.\...* .*.#....*.. ... ...#*\....#. *...#...*..  ... *.\...\\#* .....*.\.. .....#
#.#. .  ...#..\##  .....##\...*.#.*... \....##\.* \*\.#.**# ..*..*#.*.....#........\#...#*.*.**..#*... *##.  *..\  #  ..\ .\.**..#.*. .#.... ..** ...#
# .*..*#... \#.#*.*\\\ .*.....#..## .**   .*.\*#... #**.* ... *... ..*... ....... ..*\...  *. #.. .#.. ... ..... .*\.*#...*....##.... ....**..  *...*#
#. ..* ..# \ .#....*..\*. *... ....*... .#*.......**.#..* *.*....\. \.*.#.#. ... ..# *.**.\. \. .*........ ..\.\...#.....* .**.# .. ..... .*.*#... .*#
#..*\.#..  .... ..... \#.# ...** . . .   #...#..#.. .#.. .. ... ...*. .* . *.* .#*  .... ##... #.....## #  \. .*.  #. .*.... ...#... ..# \....#\*#..\#
#. *.#.....*...*.* ..\.*.#.*.#. *. ...\ #..... *. . # . *#..... ..*.#.......#  ..#.. ...#.. .\...* . ...... .#......*. ..##*  ...\.* ..*.. .*.... \..#
###.#*\*.  #.* ...  ..\ ..  #.. ...\..**....  # .. #.\ ......\... .\..*.#..\..\*..**...  .##  .\..*... . .*. .#*#....##   .  ...*...#* .*.*....#.....#
#..... #. * ..*.*.*  ..\# ...   ..* #. ..#.#...  . ..\.  ... *\##.... .. ....... ... #... ..*. .......  ... #.*...# ...*. .# . ...\\........#.**.. ..#
#....\ .  *# ...#....*. .\..... *\#..#.# *#  .#..#. \. ..\..****.\......\. \...\. ... ....\\... .\* .  .#.#.. .. #*. . ......  . #..#.. .  \.....*..*#
## .. ##  #.** . . ..... ...*.**..  *..... ..#........*.#\...#...#..#..*..#... .**    .. . .\.# ...\.  ...\ ..*..\ .#. * \ . ... *....*.... . .  *#..#
#...*..*... \**........\..... .#. *  .# .* \#  .*.\ .  * .\.. .. .#.#..   *..#..*..*.. .  #.*....\.... .   \.#.*....#..*.#... ..#..#*. .#...*..##....#
#*...# ..\ * ...  .\.\#.\. ....# ...*#. .*.#...# ...  * ..*#...*.*   .. ......*...#.#.......... . ....#.  ... ...#.##. .....#.##. .   ....\. * . .* .#
#..  .*# \...\ .. *..*...#*..* ..*. .#.#..\..*##* \. .*...*..\...* #..#. #.#.... .. # #......*.*........ \ *.*..*#. .*. .*.     ...\*.....  ...*.... #
#. ..  \.# ..\... ..#.#. ...\#.. .. .*\... *.#.##..#.##.  ##....  .. .. ...\#.* ......  ..#.. #.. .# .#. ..# ...  ..*.  . .... .##*. .....     #.*...#
## *.....# .\. ...##....##......*\... ...\. . \#..\.*.*..\\..... ..*.#*.. #....\..  .....  ..\*.......#.. #........*..*. ...... . .**\ ..  . #  ..* .#
#... .  ...... ..#.. . ..##. *#*.#...#*.*.. ..##.\ .. . *.... . . ......#\.....\..#..* ...  ....#.\.....\...*...*#... \... ... #....\.\*.# .\.\\  .* #
#...#..** .*..\   ......##. \..*.## *...** .\...#. .*.......\. ...\..... .\.. ... . .... ..* ..\..#.\#...# .....**...\... .**... .....**...#\.   ...##
#.#**# #.#...#.... .*....\#...* ## . . .**.. ..*...*##*\. ..#. #  * ..   \.......** .#.......*\....#.\...#. *..*#* \......#..\ . ..\\.\.... ... .....#
# ... ......... ***.  * *.#.....\. ......*... *\..  **....   ..\.. *..*...*\..*\.  .#  .\#. ...#***##\**. .## .... ... . .... * ...*...* \... . .....#
#.\ *.  ...  #...\...... ...#. * .\..*. .*.#..#... #. # *\...  .....*#*.*.. .. ...*..\#.... .......*...  .#.. #*....*. .... \..  ... ..# .. ....*.####
#. .*. #.. ..**.\.*..*#.......*# .# #... ...**. . ..   .*...# ..*.... .    .. ........*... ##.... \..  ... #. .. .*..*.\ . #..*#...\.  #. .... \.... #
#* .  *. ... *  ..... #... *..*..\*.\  .#.. *.#.....  *.....    . .\......#.#*...... ..... #..\.*..* .# ... #... . .. .. .*  \. ...*# . .. .#*..\..#.#
#..\......#....##.....# .........*.#.# .. .#.. ..# ..\. ......... ....#* . \.# ..   ....#.\*..  ..\.. ....\*..   * .   ...*.*.#. ......*..#... *...#.#
#..\*. * ..*\.. \#...\*...\ ..* #....*.. ## .. * .#. ......\.  * *...*. # #.**\# . *. *.........\ .*.. . *.. #..*# *.*  .#.#   ..  .......  ###...\#.#
#*. . .*..# *##.....#..\.\ \...\.. #. *..\. ...*. .*..\ ...#...** ..   # .\ .#... .#.* ....\*....*#*. *#.... ...... ..#.#*.**.....* *  ..#.*..*.#....#
#.*\... ... .. #..*\.##*..\... .    .#.#*..*....*....\## .# ...#. .\##*.... \*  ...\.#.*  . ...... .*. .#.* .*  ..*#......*\.*.##..*.. .. .  . .. \ .#
# . *..*.* ..\... ...**.  \.#...***#..* *\ .*#......\..\*..##... .....*#..#*. ... .....#..** **........##.. ......... ..  *.*  ...\..*. .*......*.#.##
# . .#...### .#.... .*.*...... *\*\.*. . ....# #\. .  ....  \.#....\\. **....#  .#*.......*. .*......*.* ..#.*.#.... . #\.*.# ... .#...\. #* ..#..#..#
#. *.   .... \#\ .\#*.. ..*. ###....\...# . .#....* \..#.**\ ...*\.## ......*.#.*.*.  . .... . .* . ....\.... #. ..*... ..#.* ...#\..#*..#. .  .  *..#
#......##*.* ..***....#  ......\..\.. ...\........ \.... * .. ..#.##... ..# ......**..*. \ . .# . * .... #. \ .*\#......#. ....*\. #.#.# # .\ #......#
#. ....... ** .#.**\...\## ..... ..# . .#......#. ...... *.#  #...*. ..\..#....* .* #. .\......*# .##... .\.*# *. .\.. ......   .. .....#...\..#.... #
#.....*.....#**. ..  .*\..\#\\ .. #. ..#\ . .\..#.#....\ .*.. ......\# # *.  #..*... .. ...\.\* . .......... .#..\..... #.. *..***  ..###.. ........\#
## .* ..   .  # ..#..# *......*.. .#   .#..*. ... ... . #.. \....\....\*.\...*.# ....#. #*\ .. *... .. .. .*  ..#  ..\...  . .... ..##. *   .*.......#
#...#*. .#  ..\. ....#.......*. ...#......# ..\. ..* . ...... .*..*.# ..*#.# #..... *..\*..*#**..*\. .##..\. ..#....    .#.*.......#.## ..# .**.... .#
# ...*\ ........*#  . ........  ....\ ..*..# #\. .** ..*##.*. .. * *. .*#* #.....*..#.*..... .... .\  .*.**\.. . #*.#*\#\...**.*... \*. .*.* . . .. .#
#... ... .##...*... *.#..*.#. #. . ..*##........... .*#. ........*..#...**. .*. #\. ..#..\ .#.***... ..*.#.*.\..**.***.\....\.#. . .#.#*\.*....*# . .#
# ....  ..*..*..##....* ..*... .. .\* ....*  .#...#.  \* #..\.....*....# ...  ..* #....# # * . .* .#..*#.. .....\ .#*.#. *#.....#. ... .#... .. #..#.#
## ..\* .. ...#** .#\#.  .*. ....  *...##..*. \#.#*....#.... ..*.\.... . .\.   .\...#..*#  .##.#.#... ..* ...\.\\ *...  ... ....#.#*.....\..... ..*#.#
#*. ....*.* .*..#.#*.*. ..#....#. # . .. *. #.*..#.. ..... .... ... ..  ....   *.. . ..#  .#.#.. ... .. * ... .. .. ...\#* ..#...*.#* #. ...#.#*#..\##
#.#.. .#......*. ......  .*.*. ..#... ....*....\...\#*... .. ..... ..\.\ ** .*.*.. ...*  .#*\ ...# .*#* ..... * ..#.. .....   ##.#  .....*... ...... #
#..#. *.. .... ...... ......** *. ..#*....* #    . .\.\..#.#.....#...... #.. **.* .. ....*..#... .. *#.\... ..#..... .....# * .. #... .#  . .\*.....##
#*#*........\...  ..*.*...#.. .*.  **. . *. ....... \.... ..\..  . .# \..#... .. #. ...*..#\#.. *...* .. .*#.  ... ...#... ..#\..  \....*.. *\...#...#
#.#*..*.*...*......*.\.\*\. ..  ...#. #....\. ..*. ...#...##*.. ...\\... .*.#\.. .#.\#....*\ . .. ......*...* ***\.\ ....\..*..  ..#...#........##* .#
#.*.##  *  ..*. .#*.. #..# **.   . ...\.. .**...*\..***..#. ..#.. \* .#....*...*..* * .  .  .. ... *. *.#....*...#..\#.. ... #*.#\.\. # # .#.... ...*#
# . .*.*.# . \#... .*.*.  . .\*.\.. .. \..#\#.. .. . . .*.\..\. ...#. ....*.#  ..#*..*#.#*..  *.#.#. *.#**..... .. .. ......#..**  .#...   ....*.#\*.#
#*#*.* ..  . ...*..\.##..* .*.. .  ##. .*..#..#.*. ....*. #.*.. ..*..\.#.......#\..#\. \..\  #...*....... #.....#*.* .## ...*#**..   . .. *.. * .\*. #
#  ....*#*.#  *..* #*.*. * .# #. . .*... ** \.#.#..*. . #.#.. ....... .* ....*.... # ..  .#. ..*. .#.... .# .##.. \* .*.\..*#.. \.*#..*\..*...... .*\#
## #.*..*\..#.* \\........#.\# . .* ...*..*  *.  . .*..# ..\ \ ...# ..#*.#*\##.#.#... .#  #..#.#.  #. ... *..* \ . #.......#..\....# #.* ....\.... *.#
#. .. ... .*\##. .....*##....*....... .. . .... \.. \ ##*.\...# .# .\.*..#.*.  . .#..*\.#.. .....  .*..*....# # ....*\. ** . ...**.. .\..*. ....\..#.#
# # **..*.. .*.. #* .  ...\  .##.*..*...#* ..* \*.*.**  ......*.#\.....*....#.*#..#*....\. .  .#..  ...#*.\...#.....\.####......#. .*\. .#....**.....#
#.*.*.......#\....* .......\........  .. . . *..##. .**.....\ .\ ..*  . ..\..... .# *\.\.. * #.#.\.... #\.*. .# *.\\. \...*..   .* .\#..#  . #.... . #
#.. ##.... . ..  ..... .#.*.**.##  . .#  # ..*.#.  ..*...... ....*.. \\.. .*. .*. ....* .\  ... #..  *.##.*.  \#......\.... ..*.* ..\*.#. ....\***...#
#.. ..*....**#.* . .#*.. . ........#  #.....##... ..\..  .# # \...#...*#..#......\..\#*  ##..\\...#....\ ..#. ....*.* .....#..   *  ...*#.. *.  .##\.#
#.\...\.#.....** ....#..*\ .... ..... .\#...\... ...#...*..  .  . *.....\. ......*.#\#.....*.. .##... *.*..  ..*# .......#... .*..#.. .\.  ..  .*. ..#
#*.*..*.....#.. .. \.... . .# #.  . ...\...#.  #. ... .....  ...#***..#..#. . *\\......*##. . . *\.. ... .*... ..*..##.. .\.#.. ..... .\ .\.#.... . \#
######################################################################################################################################################