######################################################################################################################################################
#*..##...\*.. ....*.*.*#...# .\*. .. *....*.#...  .. ..*. \......\. .#\.... *\.....\... ....# . .  \#.......#. .\..\\. . . . ... ..\ #* .*. ... .*  ##
#  ..  ....* ...#\* * .#..#......*# #.... . .#... *.#....\. #. ...\..*....*\*. . .#............. ..\.. .#.*. ...#\.....*....#. ..  ..*..* .#...*.\ .*#
#..#.*  ..*.*.\.* *...*.\*...*\\........... .#\..*.. .  . *.#....  .#...###... #\ \...... ..*...# #...#. ..# . .\ *..  *.. #... .    . *.#.#*  * .#.##
#*.# ....*.*.*. .#.........*...#..#..#.#....\...#   ..#. \. *.*  ... ## *.* #.* .#*...  ...*   .\ #...\. \.*. .#....\. .   .* *.#.*...#...*#. .......#
#.. .  .... *#.....   ....*.#....###  .  .# .\....** ..# .# \. #.\....  .*....\.....*... * . \.... ..#.  #*..#* ....*. .  .\.#. .. .*... .....* ..*  #
#..\. ... # . *..# .#..#*. .**# ..# #..# #.....#.*#. ...#.**. #.#   \ .# *..\.  ..#.  . \ *. ..    . .......\... .#.... ...*. .#*. .*..*# ....... * .#
#**. . ..*...\ .. ..#..*. .. .# ..... .. ..  #* .  ...# . *...*  . .\. .  *  .....#... *..* .#.#....#*# .. ...\#\........... ....#* .#....... ...#*#.#
#...#*...#..# . .....  .......*.. ......*......##. \... #...... . ...*\...\......*.*  .   *.*...##\..##.........# . ....*..  ...\.\\..# . # .*.*....\#
#.. ...#.....  #...  *#...#..**.. .# \..........*.*....##.....*...\ *. ..* .#...*..#*.*.#....# .  *.. . *.. * . .  ....**  ....#..# .. ...** .\. ...*#
#... .# #. . *....*.\. . \ #*. ....\#*.## #.... ##.......\.#...\.. .*..#\.. .***.*.#..*.. ...*.\ \.. .#.  ....#.   ## *..\##.. #*.#......... *.* .*#*#
#..\* ## .... .*. ..#*.#...\.  .... . # .. ......#. ...* .#....#.  .# .  .*... ... # .#...** *. ..#.*...#*.\...##. # ......###.#. #  .* ..... ##...\.#
#....* .. ...#*...#... ... ....*  **...*##..*.#.\..*.*.*. ..*\**..  ##\* ##*....*\.. ** . #\ \.... ..*  ..   * . . .\..*.....# .*.  *. ..*.. * ..  ..#
##...#\ ....\... \.*..#.\\. . ..\   *.. .. . . ...*....\... .*  .#........ . \.. .. .... ..#....*.\ .# #. \...\.... .*.## ..*...##* ..*....  . ..**. #
#... ...#..*...*\........   .....\.. ....#...... # .*.*...#*.. .# .* *... ... .... . ..**.... \.  ..\.**...  ..*.# . .. .***.\..... *** ....#... ..#.#
#....#..#*\.. . .# \  .........#.......*. .*\. \.  ...#.... ..  ..##..* .. .  #...  *#*... .\.* ........*#.\  \. ......#.\...... . .*.\**...  .. .\..#
##*.\...* .*  .....*  * ...\...*#*. ..*# \.....*...... . .*.. ..\##.  *.#.... *.  ...\.#...\..*\....#.#.# .... ..* #...  .\# #...* ..\#* *.*.*.  . #.#
#.#...**#.. . *..* ..*........ #...* ...* #.... .. #..\# . .#.#.. ... .#.*  ...... .\\.#*...#.*..  ...\. ..#.. ..#    *.*.\*..\..#*\..*#\\\....  ..\##
#* **\ .#.* ...#. ...# ** #..........\ ...... .#.* .\... ..#.. # ..#.#..  . *..\.#.* * ..\* ............. *  .#*..#..#.........  .. \...*  ..*.**.#*.#
#....\..\.*# ..*...*. .*.**..\..*#.*#*#\...*....* .*. .\.*..*.....*..*... #.     ..  .#. *.......*\ .\\* *.*...   .. . #*..*. #. .* ..# *.....\. #...#
#....*#.*..\....# .#.*#. #*# ...  ...# *  . ... ..  .*... \\* ....\ .*  ........*..#** .. #..  #....**\ ## *........ *#..#. ...#.#.*.....* ..*.. *.#.#
#..*.#*.. .#**  ..*\. # *. * . ...## ##.. .\.. .*.# ...*.* \.... .. .*#     .#*..... ....*  .. ..*.  ....*. . . .*    .  ..\*..\. . \ . .... .*......#
#**..*.#.  *.*  ..*....#* #..\  #...###.. .\...**# #..\ #... \.. ....*.   ....... ..* **. \....\.#.......  ..# ...  .....*...#....#.. ..*.. .\..\....#
#..\ ..  ***.\*.*..* .*.....##.*...\ #. \.#....... ....... **.*#..##.**\.*. *...*.\ #\..*.# ...#*... . ..#\. ..... ...........  *\.*.. ..#.\ .. #*.\##
##  ....*.. ... .\..  .* \...... . #.\.....##.*.\..... .. \# *...#\.*. #...... #... #.. # .* \*... .#. ....*.*..... *#.### . .*###.#....#*. .*.\ . . #
### #*.#...\ .*### ...*###.... ...*.#  \...*#.## .   .# * . *.#.  ..*..  .... ....\##.\..##.... \..* ... \........#\##. .   .  ..* ......  .#*. . .*.#
##.*.. \.. *..... .#\ . .\.. #.....# *. .. . .....#...    #..... ..\*.*..* . *........ ## .\.  .* . ..#.... ..*#. .#.. . \. .# .......*......... ..**#
#*  .. *........#..\#.*...\.  ..... .**.... ... ..#...##\.  ...*.... ....#*.#.....#. .#*.... .*\......*...* .*.. \\. ..*#.#...# ..\.*..#.. . #..* *..#
#.#*.\.. .* . #.*...#.. .* ..#.#  .. .#*\.**#..#.. ..*. *... .\. * . * #. ........#. .\\#  ..*#.*. \. *...* .\ .#\  .*...*..... *.......##*. .....#..#
#.........*. * *.. ........... .. ....#..#.#\\....#  .*.  *    *.....*#. ....\ ..* .\\..#.. .. .*. *..*  . .. .#....*..##*.. .\.# .. .* \ .. ..#* .#.#
#..*#**. #.\. .  #\.... ...*. # ..#. ..*\*......... ........ ..*...* .# .. .#.  .* ..#* ... \ ....#.*..\. *.... ..#* .#.......**.* #\.# * .... ..#.**#
#.#..... . ..* #. ..\.*.  ..*..* #.....\... .... . .....\...**.*#*......  ...# .....* \.#*. ....... .......* . .. ...*..*.* ...*.. ...#. .. .#..... *#
#.......#*. #... **.\. ... ..#. .. \*..\..* .##......*..# ...*   ..  #...#.... # #.# #*##.  .#..#..# *..  *.  \. ..\*.*.. ...  *. .*......*.. .. .*#.#
#*\ *..#\ .... . ... #...  .*. ..*#*.. ....#.. ..*\  ..## \.\#....\#..# .# ..*. . .....\.. .\ ....*..#.* ...  . . .*\*..#.#.****.....* ... #.*.\..\#.#
# .#.... ..  *...\...*.. ....#**.*#.#. ..*..# .#.. ....   ...##.# .#...#*.\........ ..#. ..#.... ..*....#......*..  .*\....\* . .*\.... .##...*...** #
#.*.....#.##..#.#.#.  ..\  ..   \.. . .... ...*....#..**..... ......*.  #  #*  ..#. . .. .**#.#.#.. #.. .\.*..*....\# ....  ...\ ... ...##......\....#
#  .. #. .. ..\.*** .#.\.#.... ....... \....#..... #\.....\.#...##......\..*..*...# . #..\... .. ......# #.#  #.*# ......... . #\.. *.  ...*..##.... #
#... ...*.*.  .# . ....  ...#..*  ...  *.... #.#  ....*#  #*\..#....    **  ...  \.  .*   . .#* ... ..#..........#\...*..#####..* . .....  . .. *.. .#
#  *. ....*..   .*#..\ ..#   ....#.  . ...... .. ..###..  . ..#. .. .. .#*.#.\  ..\ ##. ...*.*.. ....#...#...*\.  . . .  .##.#.*. .* ....... . \*.# *#
#....#    ..........#. #*. .. .. . .. \.  \.##*..  ..*\. .#.  ..*  #.#...*.#*.. *....*.#.. #. .# ##.*. ..  .....#.....#...#..*..\. .  .    .\*...... L
#. ....#....*... ..\#..*.. \\..\..#...  .. .#... .\... .*..... .....*. .#.. . . ... .#\.* \...#.....## . .... #..\##. *. *.#. . \#..* .  #.*#... #..##
#....**.# \......# ...#..#*.#.\.*. . ...  . #... **  . *.\....# . .#.*... .....##...*#*.\.... * . ...*. .*.*... *.# .. #* .\\\ .. *. .*.#. .*. ....  #
#. ..  #.....#.#.#\\ .. ..*.....##\.  * .... *... ... ........* ..... .*  . ...*....*..# ..#.# \ ..\....*.  . .....# # *#\..*..  .*\.*.. *. #.... .###
# . .* . *... .#.#. .. **#. .*..\...*.\.*# **..  ..*. #.##.. .  ...*.*.    #*.....*\.### .... .#  ..# .... *. ..# #..#..... ...* \\. . #.*#. .\ .. ..#
# *.\.**.. ...#.. **  .#..*#.. ...#.##*.\.##.*  #* ..... .#.\*......#\ ... ...*  *\# .##. #.. *.#..##.....#.......*.\...*....  . .........# . .*.## .#
#...# *.### . ..#. #..#. ..##.... ..\.*   ......**. *.*\*... ..* .......#. ...*....*... ..# .\*.. .....*..... .### ....#.. ..#.. .**..## .  ...  .##.#
#..*#. *.... *.# * ....*.#.......*.. *  *** ..\.. .*...#.\.. .. ....#\.. *.*.. \ *.##  .. \..   ... .*...  . . .*\## .... .***....#.*.. \.\..\ ..#...#
#\....*.*. .#. #*. ..*.  \ .*....*.#..   ...#...*. .... .* ..*.. ...  ..**.\.. ..... .. ... ...*.. . .#.... ... .#.........# ##. .  .#.#.#.\. .......#
#.. ..\.#*. .\.   ......#  ..... . ... *.*...  . .# .*.\#. .... \.#.......#\ .... .. *..#* .. .  .. #*.\ # ....... \.... \\.*....\*. .....* # ... *#.#
##.* .\#....*....  ... .. . .*..#*.\.... .*.\# ....#.#..  # .# ..... #...#..  ... .*... #......*.\.*. #. ....\\*.\.....*.. #**#*\. . *.....#.......#.#
# ....*#.....#...*.. \.. ..* *.....#... ...*..#  * \.  ....  .\*.............# ...*. ..*..*\  .#.*........... . .\.\ .#...#.*.........#  .... ...... #
# *. ..  .#. ...#..#...   . #.*..\ .*.*. ##....  *.\ .#. *..# .#*.\ ....#.. ***.#. .#. .\. #.*.. .#*... \ \.#.... #. #*..# # . . .. ..**..#*.. #*. ..#
#.*.\...*.\...  ....##... *.*.. . *#......#*. #..## .#  .. #....  ..\.. ..#*#.#.......#......\  .....* ..  .......\*. . ..*#* * \... ....  .  .. *   #
#..#* .* .#. . .#.#..#.. **.#..#. *#.*...*.#...##..#..  ..\ ...... .........\..#... .... .. ...*\. . .*.\.# ..  .#.... .*.*.*...\\.*.*#.......*. * ..#
###..#. ...#.#..*. #.*.*..***.. .... .*.......\##.....\*.*.***...  ... ..##**  .* ..#\ .#.  .#.*. ...\. ...# #. ##......#.. . ....* ....#*#*..   ....#
#\..... \   *.....#..  ..* \..*\ .\\*.\..* .........*   ..*# ......* .* ##  ..#. #**.... *...   ..#..*....*. ...*.  *.. .**  ....*.#*.... \.##....\*.#
#.. #.#** ....#\.  . *..*.....##. . .#*...  ...*... * .  .  .....\*\..\ **#....  *.. ....*.*.  #. *.. ... ......* *..#..\. .... ... ..*....  ...*. ..#
#*....\. .. *.. ....   .#.\... .\ ...* . ..\.....**#.....# ...*.... .# . *. \...#*......\ *.#.#*....* ..\\#. .\.*#. . ...\\.**..*.. .*.  * ...... .. #
# . .*.... . .\ ..  #*.\ . .. .#..*#.# .#\. ......... ...##.\. ...*  ...\ .**......*....#.....\.#\ #.#**.......#.. .. #\...**.#.. .... ...........  .#
#*#.*.... ..#*.. .\   ..\. ..#.. .\.#.... .*.## .... .*.#... *.\.#.*... .*.* \.. ..\...\ .....* #...  .. .. ......#....#......... .*\\...*.. . \ \...#
#... *.. .\..* * .... . #..#...##..* .\..... . ...  # .*.....#.\..* ...#...##....... .. \*. \. ........*. \....###.. **. ...\.* ...\.* .*#..#*..\ . .#
#... .*.....*... . \ \  ***...*# *...*  .**..* .#.*..#....*......*.. **..#..*..#.. ..##......\..#.#...... .# .....\... **.. .*\.. .. .*.#....    ....#
#..*.#..... ...#... ...*. ...* *.# .# \ # #. .*\..# *.....\  .*.*#\*#.* .....##..*. **....   ...# * ... ...*... \.*..\ *. #  .*. .. .*.....    ..#.#.#
#.... .*.*#*..#.. .. ... .\. .   #*..... ......*..... . *.#\  ##*. .# #  .  .# .\. *...*.  .#..........*. .\.*\ ....*.. ..** *.\.... .. ....... #. . #
#.\ ..*#......\..# #.*#..\...#... ... .#. #. .#.....\ ... *. *..\ .* *..#\ *...  .*#.......* . ..*...*...*.. . .....  .**. .. * .#.*  . ..*...# ....*#
#.\....#.. \...**. .# \#. *...    ....\ ...# .#.\.. ..*.  ...\. ...#\*. *...*.#...*.\.*.   ..##* \  ##... ...  .# * ...##\*.. . ...#... .  .#...\#.#.#
#.....\ ... .\#..*.*.*#.. .. ...**#.*.......... *.. .* . .  #.\.\.. .* . *..... .#.#.#..#\...#....#.#... .##.*... ...*..*..#...*...\\..* ... * ..#...#
#...  \  \..\#* \...* .#. *... ... . .\..*.##. ...... . .*......*.....*...# ..\..... ... .##*.*.#. #*\ . ...* *\ .* ..*.# # #* ...#..*.# .....##  \ ##
#.#..........\\#..... . ...*...*# \..*. #.#.  *....*\.. ...#\ #....**\\. .#.. . .... ..*# *.* ......* .* .  ..*#...*.. ....... .\.#.. .*  #......#.. #
# ... .. *#  ..*.  #*  #.   *.#.**. #...  .\ .......... ...   ... *   .. ... . . .. ##... #   #. ..... .* #**.*....\. ........ .# . .... *.... .. *.*#
#. ..*......  * . #........ \....* ..#*.#.*...*.* .... ..  ...#   \\#...#.#.*..... *  ..*#... .# .#... \...*  \..#.. . *.*..*..  .**.* ..#. . .*.\..##
#... ... #...##  . # *.#..   . * .......*. *.#. ..  ... #.. ... .   *.\. \. ..*......*..... ... #.. *#  .*#..*.* #. .##.##*. . # . ..# \# \#....*. # #
#..#.*..\*.#.#.\#...* ....* . .. .#.#... *\  ...*.*  *.*##.*.  .*#.\ ..  .# ..*#..*....**.....*.*\.#.  ..... .....*.*....#..... \ .# ......* ....\\.\#
#....*..*# . . ...#*   .....*..#  .#....  .# ..#....   *##.... .*#*.#**.......  # #**... ... .. # . .....\ #.*..#.*\.#...*... .\ #.. # ....##.#\.....#
##.\ **  .# .  ....#...\.#.\...#.*#.* ....*. *...\..*..#.. *.   ... .#.....#..#.*# #.. \. ...#*.#\ ....* . .\.............** #. #..*.*...... * . ....#
#*..\ #  .##.\.... .......*..\. ..* \\..#..***......# . .. .... ......**  .**..*..... .\. . #..... . #.\.  \...........* .* ....* ....# ... ...*... ##
#..#.#.#\..*... .\***..*. ...* #... ... ..   ..*.... ...*.#..... .......*##*.\.  *.* *.. ..**\*..#.  ... \.   #...*.#\ #\..#.#*# .##. .   .......*.#.#
#.....#....... .*#...#\... #...# ...# .*.** .#.#....\.#\ \\... ...##.* *.*#...*#.. .. #...  ...##*  .. ..........#.....  ...**....#*\....##  ...#....#
#.*..###..# *....*..* *...*.* ...\ ......... #\. #..\.*.. ..\.# #.*..\ .*.*...#.# ....*#...\..#  . .#*...# .. .\**...\.\#.......#. . ..#  \ #.#\.*#. #
#. ..\. . . ..\  . #....\#..... *..*...\  ....\ ..*#.#*. ..\ # . ..  .. *.*... \. .\.  \.#.#* ..* ...*#.#..# *...#. ##.. . ...\ .*....\.#....#**.... #
#.... . . # ........ ...\.* ..*..#....\#...*. ##.  . \ .... #.....#. **#  \. .\...  .*.* . . . .. .....\. .*#. .*.** *....\#*# #\..\#.  ....# .\#..*.#
#... * .  .. #..*. ..#.*.#. ...*.... .#....# .  *...  .\..... .##.... *.  \......... *  .#.. #. ..... .*...*.... ..*..**. #.#...\. . #.# . ......*. .#
##* ...* #. . .* . .  ..#..*# **.... .   * .. \..#\  .*...\ ...*\#..\#.....* ...#\...... ...#\* #.. #*... *...** ...\.\ . .....#.\\.  .\...*..#.   \##
# .*. . * ..# .*.  ... . .. * .#.. \**.. .. \.\....\#..\... *.  .#.  ..#. *. .  ## #..*....#. ....*#..*.# .\... . \.*.#* *.*. \ . .#.*......*.... . .#
# ..# * .......*..*....\..... .. .# ..... ...#  ........ . *. * .*.   . ..\. ...# ....*. . .#...... ... .  .... . . .##*.*\ . .... ........... ..#..##
# ..**..\..\ ..# .\.#*. .#. ...\* *.*.# ....*#*.*.... *....*. * .  .#. . #. ...*.....\..... .#... *. #*.. . .#*.....\  ... #..*#.# ...\.*   .... .. .#
#*. \ #. ..... . .\ ...\.\ ..............\..*..#.\...#*.....\. *\.#*.......*...\... .#.*...#.  *..#.\ . *..# ..\.....# .. .*..\...   *...\## #..# **\#
#.. .*.# ..##.#....#.# ..#*............ \.... .. *....\.....\#\ .  .\.. .....*..***#.. # ...* ....#....#*..#*#.. * *..*..... ..# *....## ...  *.# ..\#
#.*.\..*..* #..#.#.#....#....#.*...\. .......  ..\.*.  .  ... .. ....**  . #\..... \. ...#. .....\...... ....  ...*...#.........*....#*.. . . .*# ...#
#..#.*.*\ .... ##.*.. ## .*.....**#......**#..*.. ........\. . . .  *\.#.# #.  .... ..  \ .*. .\... .  .*#*..# ... *....... ..... .....#.\. ..#..**..#
#..  ..*.. .... ...*..#.  .......*.#.\.##. .*.\..\. ..* .. ...#. ..**.   *\.  .##.... .* .. #.# .. ..\...\ . #. *#.**. ....... ##. #. *..\#..##. ..#.#
# #.. . .#* .*..* ..  ...*..... ....... ...  ..** #\. . ..#. . ..\..##..... ** . .. \..*. .# **\.... ...*..*..\.#...... . *.  \* . ....... . \..\   .#
#.... \ . ..*.. ..**.* ..#.....#\#* ......*.... ..#.\. #... #  ..* ...*.* . .. .. ....*..... *#.\.# #.*  ....... .* .......#...#...# ..\.#* .... ... #
# *.... #.....* . ..*. . .\.. #..  ..* ..   # \ ....* .....\.#..**.....#   .\#.... ... .. ...*   ....\.#.*.  *.\.. .*. . . .*.#.. . ..#. ...... .# *.#
# . ....*... ..\.. . ...*. .....*.  . ....#.**. *#.*...## #........# .#  .........#.. ....*...  ...* ... . ..\*#*.........# ...   \. #*.*.*.##.....*\#
# *## ....*#.  . .. .. .#.. .. . . ....#.\#..#.*#.  \ ..\. \..\. .# .....*\ #. \# ..*.... .**\..** . *.*  ...  #   # .*.*.. *. .*#*.# ... * #.. \\#..#
#*......... . ... ... ... .*..*#..#... ..*.\..## .\# .\.\. .*.*. \.*. . #..\...  **..*. ..* ....\.* . **..\.*.*..*\ .......... ... .. ..#. .# ... .# #
#.....\... .. . . .......  ...\*.\..  .. #.  .#.*....#.* ...#\ ..  .  # ..*..*.\*... ... .... ..* . .**.# ....\ *#....* ..#.  R# #.#....  ....#.....*#
#... #.#.. .\....#.. #...# ..\. ...  ....*. #* .......\.# #*...*. .. ... ........ #\*.  ... .#.....\ #.*..# .*....*..*...\#. .. ...#.....\......\. #\#
#* *..\.*.*.*  . ......#...* ... .* \.* .. . . * #.#   \#..*.\* .  .*. \. . \\..... #.. .  . *..... ... .....#.\. #..#*.. ..   ......\...* .....\. . #
# ...#...#*..... *.... \.......... ....\*.* .*.... . *.. . #**#...#.\#............#....#.#.*...*.... ... . .*\.* .\ *#.#\.....#..   \... .**....*.. .#
#. #*.... **.. *...*\ ... ..*\.   #... #*.... .. .\.*.\....**.#..#.*.# ..*..   *...* ...*.*. ..##..\*  . *\....#... *#...  ....*.......\.## .. ** *  #
#......#..#*. ...... . .....*.  #  . ..**\....*\.... \..*..#....#.*.##.......  .. .#  ....*.*\.*......*.\.. ... #* *.. ... . \.....\ # ....  .. .#.\.#
# . .  .. ..*. ..* ... \*. .\....\. *.. .*  ##\* . . ....*.#.. ..*... \ .....  *.\.\ \#..*#...\ .\ ... .*#...#.\...*. .. ..\.#..\** \ . \...#...*....#
#..*. ...*. .# . . ..#...\...#..#\.##.*..  .....#....\... ..#..*. ...... ..* * .\\.#. \.. ...\. # ... . .....* .* .#..\#.....\#..*......  ..* *......#
#** * ... .  .\.#... .  .*\..\.#. ......* ..* . \....* *..*..  \...#...   .. #*.. . . ...# ......  ..# . ..*# *   .#  .. . .*....#......#.....*.#.. .#
#..# ... ........*.#.*..#  #.\ # #**#....#..***.. ..*. ... .*.\.  ...#.#\#..#*# ..#.. ... \ . ... ..#\.. .  .# *\.#....*.\. *#.*\. #.\. . \.....\.. .#
# .#...#* \  #..#.#. .... **. . *.#... *.#..*.*#. ....*.#....#. .#...#.*\ . .  #.*. #.#. #....\.......#....\.\.... ##.. ***. *.....*...*..  ....##...#
#.#\\   . ..\..# ** ..\..#. #..*\#. . * ....... .#. .**..... ..\.  .......#.#*..\.  #  .* #.. .\.** ..  .... #.\#.*  *.*...# .. #....##  . ... #.....#
# *# . ...*...... .*..*.*. . ....... #.. .\  .....\ * * .#. ... ...\\.*.  **\..#*#.#. ..... .##.*...  ###....*\...   .#.#\* ... .\.# \#........*.....#
#..*. .#.......  ....\ ...#..   .#..*#.... ..... .. ..  ..  ....  *...... .....*.. ... .*\\\...## ... *. #.*... *.......... * .. .........# ........ #
#.  .*#\.. .#....\..#.#.... # #.. .. .*. ..#... . #\  # *........ #.**.#................# ..##... ...*.#.......#\.. #  ..#*...*..# *# * ....# .\.. #*#
#.. . .. ..*.....* #  ... ...**...#*.*..#. .. .......# .. \* #.. * ...*..*.. .**.. .# .*## ......   \* *. ..#\*... *\...*..*.. . . ..#  #.... . .....#
#...\\. . ......  *.  #*# .#.\#....#...... . .*..  .#....#*........*..  ##....#.\#.#*..\..#  .#..... ..*##.  #. ...## .#... ..#\  #....# . ... . . ..#
#*...  #..\. . ..* .  *...*#..*. .   .. .. ..   .*..# ..* ..*..\. . *#.*.\.. . .**#*.#*    *.*#.# # .*\.\ *.#.\ ##* .. *..*......\ #*. .... ....  \*##
###..\.\ *... .#  *  . \.##.# * #....*.\. .  ..#..##\.#.#* .. .   .... ... ..* ......# .\.#*...... ..*.. . #\. .*.....#.#* # . ..... *#..*...... .. .#
#  ##\#  ..*.....\.... .\..# ......#......  .\ .* ... . .*.*....#*.#.. ..*\*.#*.. ...\\ *.#...*... \\ .. \ . . .#......... .. ....** ..#.#... ..  .. #
# ..#.# .#.*.#.# #.\.... ..   . . . ...*.*. ..*..... . ... ..   #.##...#*# ...## ....... . *.*#... . #. .... .....\#*.    .  #...#..#...  * .*..**.#.#
##*. * ... . . ..\..*. .#. ...*...#  ...... ..#.\# ...#\\ *. ..... ..... ##...# ....\. ...  .. .#.#... #.. .. *.... .... ..#.. ...*.\ .*.\\.# ... #..#
#*........#.. *..**##\.#. \.*... #. .. #.\*\.... *#.*.\* .\... ..#*...\......  \..*.*........#*#.... .##.\   *....##. . . ...........# ...  . .*#.*..#
#. . . .#*..  .*. #..\*. ..#.....  .*\.#.#..* .#..*...*.\..#*\. .. #  . **....#. *.\**...#\ ...*#*\.. .. .*.#.......#.\.*** .\...#. ..... ... *#.....#
#.....*..#.\.*.*... .*.. * ...   #. ...* ..... ..\ ...*\..#.  .*#*.  .\. ... ..\.    \ #. \ . .\..........*...\ .* . ...\  ..#\.#\ .*.\...\.. \ #*...#
#..  ..#.... ..*... ..\*#. .*. *\#..###*#   ..\.. . . .*..#......\ \. .. .*.... \#* .#..*.*.. .#*   .. .. #\... #.*.\\# ... ..\#.. . *  ###*....#  ..#
#.\.\*...###*  . . .#.## ....*.#... ...  .. #..#... * .  .*#**..*.......# # .... .\.\. . .*.#\... ..*  . *....\.\ .   ...#.*...*..#.*. ...*.......\. #
#. *..... #.#..\#.. .#.\# #* #.\.\.. \...\..\.*..# ......#.\..\*....* *. .#. .*#. .* \... ....*\. .#.##..# *.  .*.\ \.*.*.. ........#  ..*..# * ....*#
#..**#. *.   .. \##...\ .  .\.***  .... . *.. .. .........*.**.   .#.......*... .*#..*.. *.*#. # #. *. ..# ... *. .   .#* *.*..   . ..#*.#.... .  .. #
#\   *......*\ .. #*.. .#.*.  . ...*.#..*.\..#.... \ . * ......#** *.....#.# .. . ...\.\  .\.*..#.  .....*# .....\*# .....#*.#.....#**. .  ... . ... #
#..  ..*.#  .. . .......... #   .....#. *..\*##.. .. . . .. ... \..##\....  ...#.*.\... .....#...  .#* ..*....\. *. ** \    . #*...\..*\  ..  #.....*#
#.# .....##* \*. .*.#* *....\\.## .#  #.....* *\.   ...#.... #  .*\. . .. .....# .*  ..##.#  .. . # .* #. .. **...  ...... . *.. # #......*....... \.#
#.*.* * .. *#.\..*\.. #. #...*#..#.\......... .*.. ....*#.. ...#...#*..#*#\  . #.... .* #\. ..*  .\.##...*\..#\\  . ....  .\. ..\..  * #. *...*.  ** #
#.. .. ..*. ...# ...*..**\ *\#..##.*.......... ..*.... ..*.\* ...\  #...#.... .#..  ..*.. #\#...#... .*...##...\.* *..*..#  *..... #\.\#... ........##
#*......##...*.. .....#..* .. #.#. *..\\.  \ #. ... .....**..#...# ...  ....#.#.*.  \\.........*#.. .......# ..*.\*.#.\.\... .\...# .... . * *** ... #
#. . ..*..#..*#...#. #. .#*#\.*...*.. . ....*##.... .*# *#.....  .....*#. .\*.  .#...*...  .# ..**..#..*  ......\.*.. *#.**#.*....*  *\...* ..* .*.  #
## #..##..#.* ....... #   ....# *.*.*.*...* .....\..# ...\ #..*..#.*..*.....*.. ..... ##..... .\.#*#\.#*.##..#..  ....*.. #.. ...#.. ....... *.#. . .#
# .# *.....#   .* .\ ...*#...\ .**..#.... * . .\. .... ........ .....#.\\# *.*.  #*  ...   .  ...* * . ..# .... #. ..#.#.\. .......... \. .#.......###
#** *.*#..  ..... ..*. . .. #. .*..#.\#... .. ..\...\.#....   .......#.. .  # \###...* #*... ...#\* ....##  ... * *...#...  \.*. ** .#.*. #*# ....\ ##
#. .. #* .**.\  *.\#\  .*..**.....  \ ..*...   * .# *.*. . *...  *##... . #.* . .... . ..#....#.. ...\*.....##..  ..  .... ...  . #. \....*...* .....#
##** \...\. .*... ....*......*.#.... ....   *.#. . ..*\#   *... .# \.*#*..*..\* ..#....\...# ..###..*.... *.#\..#.#..\.\.. .*\.*..\..  ..**...#.....##
#.*# #.........#  \*..*..*...  .. .... #*.\..... ..#.. ...\.   .*#..  . \. ..#.*.* #.#.. .. *..*... #.... #.#.*. ..... \  .* \ #...#.###......\......#
#...... ...*... .....\\  . .*.......#  \...... ..# #. .*   *\.*......#.  .#.#\  .. \    .#.... ..   ... ...#.... ...\... . *... ... ...#.. #.... .. .#
## #...  \...#. . . \.. .* #.#. .\*. ... .. .*...*..*#. .. \... ..#..... .*.....# .# #.. ......*.......... ##\ .  .#*#  ## #...\....#.. .. #*.. *#.# #
#.  **# .. .*.*.*# ...#.. ...*#...   ....\.# #..*.#.. ........  .####... .. ..*. ...\.##..\...#.\.#. * *\. #. ....*. .\..  **#***... ... . ## ..*. * #
#.*  ....#*... ...#.*. .\...\... #.# .*.\*\* . * #. .# ##\ **#...\. ...... . .#.. # .*.  .**..*  * .... .. .. .*.....  .*## # ..#..#.....*#..   #..*.#
# *.. . \**..\....*... ##. * .....* .#..# .....#\... ...   ..  ........ \ ... .*..#.*...##*.# ...  ...*...#. .. .*.....*.#*##..  ...  ...\.#..*.*....#
#\.  *.*.\ ...  . .    . ..*....#. ..*.. .....#.#.. .* ...** *#\* \ . ..  ..#.......*  .#.\... ....#..#....... .#.. .# . .... ...#.**...\..#   .#. *.#
#.... ..... .* .*....## ##...\..\\ .\..#.... ...\.#.#.\*.. . .#.#.. .* . .##.. \.\.. #.*.#...\.*...  \.*..*.... .*.  ............*....#.... ...\..#*##
####\\*.   .#. .\#.*.. ..\ .  ..#. #  ....\ \. \.....#\.\..*.#..  ... *#.*. .*. ..* .. ..*\.#.    . . ..#.*. .#\#.. .. ..*....* #*  . \ #.* ...**.  .#
###*.......* .. . . ... .. *... *.... ... ** .. ...........*.\ \.#  ....*.#.. ..\ .**#.#..*.# . .#  .#. #..# .*# #.*\ . . *#. . *.* .. #...\.#.#. .#*#
#.....#. \ . ..*#.\#.#... .**..... #...# .*..**... ... .....  ....#\.*. .. ......\.*##.*\*##* \#....*. .... #. . .. .. . *.* ..#...\. #. ..#....#*   #
######################################################################################################################################################