######################################################################################################################################################
#..... ..# #*............#.... * ....*...\#.#\. .**.*.*..... \ .*.. #.#.. . .#.....\\... *.#** .\.*.. ..**#. .*.   .   #.. ..#..#*...#.  . .\\#..#.###
#\ \\..\\..*.*.#.. #...*.. ..##\ . ....... . .. *.\. ..*. ....#*... .#\...#. .....**.\..#... #..# ....... . ..* .*... #. ... #..\\ .\#  .*.*.*   #.* #
#.\*## ............ ...\.# \#. ##.*#.#.\... #*..#. ..*.. .** .*..#..*.... .#.*.....#*.*.. *..... .* \. .    ..\..##.#.....\... * .. ...#. . .  .# #..#
##. .#........#.\.... .#.*. .#  ... *  \....*.\.... \**#....#.... .... .# . ..*. # ..* .#.#..#**#...\ .#..# ..*. # * .   ..\\  . ##..##...  ..... #\.#
# *. ... ...#..*.# ..\... ...*...#... ....*.\.... ...#\.#. #\.\.\.*..... ...........#.. . ..##.*#..#.*. ..#..*..\ ..*.*. ...*.. ...#*... #.\...#.  ..#
# #.. .......#...... ..    ... . # ...##..\....#.* .*...#. .. ..*.\.#.#..*...   #  ... * *  . ..* . .*\. .  .*#..#.  *  ...*#\#.*.\*.\. \. *.  ...\..#
#..#...#.  ..#.*.... ...*...\#. \*..    \..*...... ..... . ..\ ...#. ... ..*.#  .  # .*.   ..  .. . #  . ...\...*#*..*....#.#.#..\....  .  .#..*..*.*#
#..#.....*...#. ... .. \. \ ..... ..\ \ ....*.. ..........#. *..#*..\..*##..#. \\........\.*. . . ...*  ..##. .  . *.. ....# .  .. *..... .. ...#..#\#
###.# #.... # ..*...\...#\ ..*.#.\. .   ...*.#... . .......#....  *.... .#\\..\..... ...\. .. .....#. ...... #... *. . .*..*....*.....\. . \..  .\  .#
#.#.  ....#\. ......\. *. *.....# *... ....*..*.... ..... .#. ..  ..  \. ... #.....#  ... .\...*..#.*....... #*.. . . *.#\  .#.#* . .......  #.#.....#
#....*... ##...* \.  . . *. *.#.*.\*#.....*#* .*.\.. \.  . . #. ... .*..#.*.# # # . .*..*... ..* *.\. # . .*.... *...\.  . .... *# .#. * \..\..*. ..\#
#...# ...#....... .#*. ....... # #.   ..* #.... .#..   \ ....* .\*..*.\ ..... ........ *.. . .\.\\.. .#.*.## .  ..*.#**. ..#\ ..#.#. .#...*.  \ \....#
#.# .#... ..\** * *.#*.\*  .. ...#\....*.*.. # .... ...\# *..#.#  .*. ..  .#.. . *   ........*...# *#.. *........*.*...\.\ .##*.....#..*.  . ........#
#\..... #*  .. . ......*\.. ... . ....\.....# .\#..#.*... .#.. ...* ...........  ....*.*........... .#..# ##..# ..*.#.. ...*.*..#.. ...#*. ##....  .*#
#. *\ .  #.....#    . ... ... .#....#... .. . #.... #.  .*..#  ..*\.*#...\. . *.. .\. .\..#* .*....... *...\#.#* .###..#.\.\.# ...#  .# . .. ...*.. ##
#........... *..*. .... ......* . #.. #. . ............ .#.....  .* ... .. . *.# .#........*#*...... ...  .. ... *.* #*... .   ..#. ..   ..  ...##.\.#
##...# .#* *. #.**.#.*#.*.### .... .*.   ... * * ..\*.##...*\.*..\*. #\.#.. ##..*.**.* . ...*. ..... ..# .\ .... ... ...  .#.\.\ ..  ....## # . ...#.#
##...\. ....\ .  . .\\ ...**. ...  .#....\.  ...**... * #  ........*.......## .*..\.#..#.....   .* * ..\.*. .....#\.*.#. . ..#.. ....#.. ..#........*#
## .*..#* ..*\... *..*.. #  .  #*.# #.. .*.... . *  ... \#...#..##..*..\ *..* ..#.   ....#  #.......#*......* # ... \. . . .\ .* .*...##.  .\...*..\.#
#.....  * . . *  ..#.. #........#. .# .*... .*..#....#.. .*.\..*.. ...#. ..# \.##.#..  ...* . .\# *.\\...\... .*..*.. . *###... *..* ..#..  .. .\.. .#
#....*... .\  \. .## ..#..#. #*....*. .*#... #....# ........*.. .. **.*.#.*.#. #...#  .. . # ##.#.*..#.. #..* ...*.#.... .....*#..# .. ......*.... ..#
#.. * *.\. #.\...#..* .*.. ..* .........#.   ...#...... ....  .#*.  . . ...  . . #.....#\...... ......#\.....\*#.. #.*.**.   . .. . . # ....##\....\.#
#*..\..*### . \..*.\.   *\..\.#.... .##...*..\   . . . ..\*# ##. ....#..... #......#*..#..  ......   .*..#* ...... ..*.... *. # \**  ..    ##. ......#
#.   ..##.*. .#........# ..*\# ..*....... *..*# ... \.#.  #.#.#.... . ..*. ...#\. .#. ..*#..  #**.. ... ...# .. # .* .... ..   *....\....#... . *# .*#
# ....#....  .*.. \....*..*..#..#. .\ .#.......\. .#...#*.......... #  *..#*..\*..  ** .#..#..........*.    \ . .#.#.......*....*\...##.#*...*#  \. ##
#..... .. .\ #. #*#..\...... .. .#.. ..\*#.#*# ....**.  \*.....# ......\#*........\\ ....*. *. ....*.\  .  #*. .. . .. \  ... ...*\**..   #..*. . .  #
#..*.. . .*... ....\*... *........ .. .* ..  ..   . .#..*.\.... .. .. ... ..*#...#... ...... ...#*\................# *#...#..*\......**\...#  ..  . .#
#*..*.\# ..*#..\    * ...* .*. #..*...#. ...*...**.* ...*.\. . .. *...  .\\ .* #\##..#..*...#..#. ...*#. . ....#....... ... .*..*. ..#*#.. ...# .\...#
#..** *.  \ .. **  ..#. ...#\. . ..\\.. .#*. ...#.. \.  *\.# #......#**..#.... .#. *.. #   .  * .. .\.*.* . #..... *.##. . R#.#.. *.......  .....#...#
#..# .... . ..#.#.. #.... ...\#. . \*. ..... *##.*  ..\#.  #.# ........*....#.. \.#..#.#* .#\ ..#.#.....*\. ...\ \ ** . *# #. \......  ... ...   ..  #
#\...#* .\.. . . .#... #....\. ..... ..*..#. #..#.. ... .. .. .. **. .... .#.*.  ...#*.....* .* \ .....\......\.#... ..##.*.# .. *#. *.\..\ .*..**.#.#
##...#*..*...  #*. ......  * *# . *.##...#* ....\. ...\*...* ..#*.. ...#..# \\.. .\#......\.......#  #*  . .\. .  ..*.....#..... ..  .# .. . *.\.*..\#
#*#..\\..*.#\..#*.*\...#. **....\..*....\*.**.. .*.... ......#...... .#. .\...\. ... #.. . # ** .... #... . *...#.. .....*# ..#..*. .## .... \* *. ..#
#..  *. ....... ..*#*. ....***.... .  *...*. #. ..*.. #......#... .. ..#... .#.. . **.\*#.#.#..#.#... # .#..... *  #..* *#. .......*.. ..*.*. .. *.. #
# .  ......  #...#...  .*.  # .*. ... #  ..... .. .#.  *. .*..#** . .....#.#* # ....##..#...... .\.. . .*.\........ .\.. *...  #.*\. ....  \..\*\..#.#
## #  .. .. .##.#. ..#...#.#**# ...\*#.*......*\.*\* .#.....*...#..*..#  #..**..* ..#*.*.#.... ..#*. #.# ....*.... . .. .*.*.... .*.*#.#\ #..*.. \...#
# . ..# . **. ......... ...  . ...#*   ..*....\.....    *\.. .\. *...#.. ....* . * ..   . ......  \ \  ...  ...#....#.#.. ....*# ##..... ..  **.*... #
#\ . . .\*.\...*.#  *   ..   #*.. .*# ....*...... ... ...#...... .. ...# \  ..#..##.. *.\........ .....#.. ......\ **.. ..#... . .. . .. .*... ..\...#
#  . .#*#...... .#.# ..\.# .#.. **....  .###..# ..... .. ... .* **\\. ...# ... .*\. . \.#.. #.##..   .. .....#... .    . ...*..  ....#.* ..*. \\  **.#
#.*.... . . ....*..# . ... ..*...\ \#.. . ...  *\..  *....*\.#\\#. . ...#..#..\\#..*.\# #.  *..... ....\.*#\ .#. .. . .\.. \*. .. .\\...\. .##...... #
##...\. ....#...#... #.* * ... .#. ..#.\\* .\... #. . . . .. #... .. #.......* # . .. *...#.....** *..#..# ..\.. . ..#. \..*..... ..  *  .  ....... ##
##. #. ..... .*.* ......*....#.#.#.......  \...**#*... ....\#..... ...\...  .. #.#.. ... .... ... . ..  ..#  .   ..   ...*. . .*.  .......#.. .. *#..#
#.. . ..#. .. ... .\.#*.*# *.. *#..#... .. ......#...\. *.##..*\**.... . .# ..*\.. ..*... #*  * ...#. *  .. . ..   ..#.... *..*.\ **...#...# ..*...  #
#.#..   .. .. ... .... .....*  .... .\.    # *...#\.... #.....\.#.#.**..*.#..* . . ..........#....##\. # .......##.. . ....... ## #*.  .....#*.#*...*#
##.*  . \..*.\.#. .. ....* .*.. . ...\*...  **....\*.. .#*.\. .\ * .*.  .. ...# *.........*.#... .... ..... *. \.# .**.\* ..# ....#.#... .*   ..*. ###
##...\....* \.  # ... .# .. ..#.#*#....#.#* \* .. ..**.\..\#.* .. \.*..#..# #.*..#.\..#.. #... .....* .. .*  ..... *.*.*........*....#. ... . #....  #
##..... *# *.**.. . . . .\ ..* ....*.........#.*..#* . #.#..*..#*.\* .... . #.. ....*.\. \..  #... *. ...\ ...\*.. .*. ...#   ...* .\*...\.......*.#\#
#\....*. .\. .\ .. ..... .... ...... .  ..... . .#*#..# \#  *.. .. .*.*. .# #.# ..*..# .  .#...*.....#*.... .  ...\.... *\ ...*... ...... . \.. .... #
###....*. . ..*. ....*.#.**.. .*...*. .. \ ..*....\.....*..*..\. . ...*##..*#*\*.....\. .## *.......#. #......#*\.**.*.  ......  \ ........ . . .*.  #
#..#. . ...  .#.#  **.. .#.\.##*. ... ...*..  . ........#*... . ...#.# ...*.. .. ... .\... ....#... *.. .\# .. .. ...# .*.......... ..* .. .#.  *...*#
# .. ......#..#.\ . ..# .....\. ....  *..# . .. ..   *.. #.*\..#* ..\#. *#....... . .. *.. .##. .  \ .....*.. .  *..#...*#*\..#.. # .* ...#..*#..  ..#
#..*.*...*.. .. .. .......** ..\ *.# .....#.## .# . \ #. ##.. ..*.. **  .... .# .* .#..## ......# ...#...  .*\......#... ..#...    ..**#....  # .. .##
#. .... ....#....*.#*#*...*..*.#..#......### \# .. \\..#.#*.* .... . .  .. * .#  .*..#.. ...#......  .* .\...#.  #* .  ..\* ....#**  ..  * . .. ....*#
##.#.#..... *# . .*#..*..* ... . ..*. #..*. \. . ...# ..*.#*\#.**...# .*\\.# .#\*#...#....*#... .  ...* .#*#...\# .**. *....  ..#\.. ..#... .#..*.\*##
# . ..#\ . # .........**. . #  .... \. *. ...#* ...\..#.. .#...  .... *..\ ..* .#.. .*#..#*..  #.#   . #.. *#..... ...*...... .#..#.. .. ....*.*... \L
# ..*. *#...  .\.*..* .... ..   #*  .. *...#\#..  ..*..#.. #*\# \.*\##.##... .*#.... \ ...#.#*\#\ . .. ....  .. .* **.. \.....#.\...... .#.* .#\**.\ #
#......... #  *.....  #.. ## .#..#  .... . ...#.  *. #.##....#..  *#..*.*..#  ...... ...#...*#.....* *.... .  ..*.....##.#\...#*# ..#  ##...... ..##.#
#.............\ *.\ \\...... ... ##....*...........*. *...#*..*\*#.  .*........* .*#   ..# ...*..... ....*. .*.\ ..#.. .* ..... **..#\ .#..*. .*...*##
#..\. .#.*#. . ....\....*.*..#.. #  \#....#*#.* .. . .* .\. .#\\..... ..**  \**\.....* .#  ... ....\...  .....#.. .*#.\..\#**. #*.*..*.  #.  #......\#
#* *\.. ..... .#  *..........# \.. ...#.  .... ....\. .#..#.......*. *# .. ..###......... *.. .. . #.#.* ... ...#. . *.*..#... .. . .  \**..* #*##. .#
# .. .#   ..#****... .*....#..\..    \. ...**. ...\..*#. ..## ...*...  ..#.#. *.# ... \#.. ... .* *# .   *  #.# \.... ..* ..... . .   .#...* .. ..\.##
#  .  *.. .. #\.\*.# ...... \.. *...\. . .. *..#.  .* .*.\..... . ........ .. .*..   .... #....\.... * #.#.* . .. .#* ..*. .. ..........*\.# ..#*...##
#.  \.*.# **.. ... ..* #.  .##..#.# ..#. ..# *........\. .....*# . ..  ..*........#. #. .#..... *#. ..#*... ...#.....#*... #..  .#.## ..\ ..*..*#*.# #
#\... . *.*\ #.*### .# ....**.*.........*. * *.* . ...*.*.......*... \\#......\.  \ * .*.\#. . ....## .. ...**..........*. **  .. .#..\. ...   .\#...#
#\..*. #.\#.#. .* . .  . \##. .#.*....  .  *# .#     ## . #.*.#..... *\* \.  *.*.......    .#\*. #.. . ##..*\.....#.\#.... * .*\...\.*.#.#.#...*.*.. #
#..*. *#..*....### *## #......\   .* . ..#.  #....  ....... *.#*..**.**...#.  ##.. \*#...#... .. .#***.......*. .#. . .*#*## .*.. ..*.. ........*#.#.#
#.*... .... .....\ .\. ..* ..*...\ #..... ..  *#  *...* *...#. . \ .*.......\  .......* ##.#.. ##. .... . \* .\.. . .. ...*.#*#....*..#.#\... \#.. ..#
#.\ #......*. .* \....## \.  .#.....#.* .## #\#.*.*#.# .\*  .....#. ...*.. .#. ** \....*#... *.#. ..*\..**..\*...... . ..#.#... ... ...* \.#.. ....#*#
#..#*.*. *#\..#\.**..* #........#..... . .#.\......... ...*...#.# . # . \...*#.*...#.  .*.\ ..  ......  #.*\.*..\ . \...**....*##.. .#..  ...... ....#
#. ..# .#.\. ...\ ** \.#..  .*.# .... .\...#.  \. \......\ #..#\\#. *.  ..\.\   ...... .... ... ...*.... ##.*.\\. ...\...\..*...#. ..*. .. ..#.....# #
#   # . *#*...\.#  *. .  \ . ..  ..*.. .  .*.*...\. . .\...#*....*...#\ .# .  .... ..*##**###*...... . ..*... .....*. #...#...*.. ... ..* ...... *...#
#.*# ...... #\..  * * ..#\. .. .#.......*#..#\#...## .*.... ...***..*\*.  #......  ....\. ....\..#  #.. ..\. \#...#*.. #. * . *..  ......*. * ....*.##
#.. .....#  ....*........ ........#. .#.......#. **.* * ....* .....   *.... .....\##. .....# .*.*#  *..#.  . .# .##....\.* ..*.*\.. ..... . ..* *\. .#
#\.\.\\\# *.#....*  \..* ..*.. #.. ...#. . #.*.....\ ....\....#  .... ..  ##. .#.* .*..\ . ...*..#. . \..  .# . ..## .*. ........#* . .  .*##...#\ ..#
#.#*.. *...\#. .......*.*.\  #.#.#**##... *   .*.*....  \*....*. #.  ..#.  ...  .\.. .#. *... ..  .. . ..#........ .... #.*##... .....#.#.. ....*#. *#
##.\..  ......... *....... .  .  ##   .*..*\.. * *  ... ..* .* #  . .. .....#  . # *... .. . ..*....\#.#....  ...\#*..\**. .. *.#*... \ ..\ .### \..##
#.#. ...#. \...# . ..*...\\.. *. #...*..#..*..#. #..\. *. . *  . *.#.*...\..*. .......... .*. ...#*.#. #...#*. #.. . . \\ .. . .....# .....*#..... *.#
#. .... #.\#. \ #.. .#\.#...* . ..\ .*  . *.\...#. \#....# * ..## ..#\ . .\ ...*#... **#.... .......\.*\...#. .#*..... ..  ##.#.#..#..  ...*. ...*. .#
#..  .....#*\.. .. ..*.......\\.# ....*** *..* ..#.....*#*..#...... ..  #... *....*..* .. . *... .*....\.... \... .......  . ...* ..#**.  .... .* *. #
#.*..**..*#.. .#*...\#  ...*.  ......#.. *.. *# . ........#.\ \#...  *.... *.. ....##*...#..*.. #*.\ *. ..##.. .\... ... .* ....... #. ..*...* *..   #
#....#. #....*#  ..*... ... ..    # ..... ....\.. ..*.#.... #.* ..#...   ....*. \#..#* ...#..    . \*#* . #.#....*..  .* .   .....#. \\ ..\*.#......##
#.\\   ........ .# .. .*\..#. ...\.  .. ....#.. ..*...*..*....*\\........ .. #...*  .....  *.. ..#....#  ...#.*...*.... .#...*.....*.*.*...# ..\ ... #
#.*# . .... #**\. *. ..*....#.#.*.... .*. ....*...... .*.  ...\\#.#*. #...##..**.##.#  ..#.*#**.*#\ .......**..#* . .#....#\ #.#..**. #.. . ...*.... #
#....* ...\# *... .. .# .....\\.... .#...#** ....... . .#........#.  .#*#\*..\ .\#.... ..#. ... .#  *.#. # . \#.\#.....\\  ....* ....***... \....* ..#
#. ....*.. . ....* ....* .  *... .  #. . ..*. ..*......#..#.....#*.. ...... .. . .... * . . ..\ ..*.. ##  .....#...  .... . ..#..... .. ......... ..##
# ....#.....* ..#  ...*.#....#   ....* .**#.\..**#\*. ....*.......\.. \ ....... ..#*....  *...#*.* ..#   ...## .#...#....*#.** .\.. ..... . .. #. # .#
##.#......   ##*  *...##..* ..  \ .\ .* #  .... .. .##..\.. ..\.\*###.#*. .*.*#.... #. .  .\ ..#..#..*.# . #**.. *....#...\\......*.  ..  .\ ....  \.#
#.....\ ..* .  ..*..  . \....\..\#.#.# .*.\..... \.* ......# *#  #*.....*# . ... .* ...*. ..*. .##.*.......... .#..*. #**\..\\. #   * .#.**#. #  .# .#
#.#. .  ...#..  *.#*#. *##......#....* ........*.. .**.*. ... #.#..#.. ...  .....#.*.# . . . .\. ... ..... .# ....  ......\...*. #....\..\*....#. *.*#
# . ...\.\...*..#..*  . .# .*# .* ..*..\*. * .*\* .. #..#...#..*. #...*\.*#....#.... . .. ... *. .\..#..  .. .......* ...#*. .* #. .\.# *    ..  ....#
#**#.  #. ..* . #. .*   ...#...#.  ..** .* .#*..#.  #.##..#. ...** ....... ... ...\.* . #..**.. . .  . . . ** *..* . ..*...... ....#.#.*#..... . ..  #
#. .... ... ......\. . .... .*#\..*. ......# *. .. *.*..*..#.#....\..*.* .. .\.....** ....\ ...#. .* . . *.. ..... ##.# ......\ ..*. #\...  *.....**.#
#\.....#\*.. .. .  .. ..##.#.#.*. .. .\...... .*\.\. #  .*. #.. ..... ..*  * #.  ....#. ##..#\ .#..*..*....... \.........\ ......#....*..#**...#*\...#
#...*  ..#* . .**.. .*#...*.**#*...#.# .#.  **#.........*##......##\\. .*.# ......  ..\.#.#*.#*.# \.. ..\.. .  #..#.#.##\..#...* .\#   ...##.  . *   #
#..#.  .# * #\ . .*.  # .....    .*#*.*.  *** .  \**\#**..#. ##  ...*.....\....#....*\..# #.#.. #*.. ...*..#.#.\\.... .. *# *.. ......# ..\#...** ...#
#*   #....**.*...##.. ...*.#. ... .....#. *. . . #..#. # .\..*  *.# . ..#...*  . .... #... ..  *.**.. ..... .\.... #...  #.\. \. *. *.# .*........*..#
#. .# .. #.\.#\ *.. ..#.*..*..  .......*.  *.... .. ....\.* .*...  .#..## ..#  . ........*.#*... * .#.#.. \*.....#...*#.\ .*..#.. # **. ...*. ...\. \#
#...#. ... \.... ..\.## .#....#.. \. .. .#*## .. .. ..#  . ....#.*.# .*.....*.* ..#..#.*.....# .... ..*.*.\#.##. *..#......#.. *......\ . #*   ##.. .#
#.* .#..*. ##.\.. ....# . ..#    ....\.......*..# . . . .*... ..*.\.... #.........* .*... .# .# ..#.. .....\#...\...  # .*** \.... \....  ....###\.  #
#\..##. * . .**# ... ... .* *.\ ..#...*.*. *..# . .....*.  . *\ .  * . ....*.*.. *...... .*  .#.. .. ... *\*  ..*.# .#.*.## .. .  \..  *..#*.. ..... #
#...   .\.**.*. ..#\.....#  ..#....#.#. *\. \....#..#.#...**...#. . ..*  .*.... .* .........\.. ......\... . .#*......# .*.* ..... ....#\.#.  . ..\* #
#.*...*#.#.\. ..*.   ........* \.#.\#*#.\...*. ... .#*. *  .*..  ..*.#.. \\. ** ... .   ...\.#.  .... ....\. * ... ... ##...  .  .*..* #*.## . . #. .#
# ..\.\..#. .. . . ..#.#.##..# ..##... **......**. .#. #..*. .\.#..#.  . ...*. #\....     #..... # ..*.#..*. *.. ... #.# ... ...* \...#\... #  ....*.#
#..*.* ## .*..#* ....*#.... .#. ..* .. ..#\##......\.. . *..*. .... * .  .......# ....#*.  ....\.*. ..* ... #  ##...# \...*#.... ....*.. .*#.   ..##.#
#..**..## #...*.*.# * # # .... . ...*#.....*.* ..**#.. \..\.... #  .. *.. ..* ..**#...\#...  .#. ...* \....* ...#...\..* . .#.... #. *. ..* ..#...#* #
# ... ..*...# . ..... ..#.. ..\*.  .#.* . ..\..... ... .... . \#. ...#......  .....#.**. . . # .. .* ..   .*..*....#  *.*  ...  ..#.*#...... * ...#.##
#.#..   .. ........ ......\#.#.....*..#. *..#..#..\ \ * .*# .**..*..*.\.....*...\** .. * *...\\.#   ...# ..##. . #\.*.....  .*..  #\*.##..##.   ..#..#
#.#.. . ....*.*.*..#..... *  .. ....  ....... .*.#* ...\... * .*.*. . .\...#  .. .\.#..###  ..* #. .\* \. ... . ............*.#......*#..  *  .*. .  #
##  .###....#. ....# *  #......\..... #.*#. ....* .......*.  . .. .* .. \.. *\.\ .***.\* ....*.\ .. ..#..#..... .. .. ....\.....\**..\ ..\ # ....  . #
#\ .*. .... *.*.\ ..*. *.#..#.##.\#. .*.##.......   .#... .......... . .\#.**.#... . ...## .. ....... ..... \ *.* \#*. ..\\  .#..  ...#.... ..*..#..*#
#. .  #....# .*.  *..##..... . .... *....#\ * # .\.#.#...*.\* . ... . ... *. ..* ...#.* \*... .. ......  .#.  #.*..... \. #\ . *.....*... #.. \## *..#
#**...\#.. ......\#*.#. .....   .#*  *....  .#...#...# \.. ..# ....#.#\ ...*....\...#.*.*..... *...  ..**..*  #.\#.\*...... ..\\..*#.. .... ...*..*..#
#... ........ #* . ....\  .. . .#.##.. ..#. ...*.*.. .. *.*...... ....*.. ..# #. .. .#\ .#\...  .#.*.  *..#.. .*.....\.# .#*.*... .. . #....... .\ #*#
# .#...*...#......\ . #.#..  \** ..\..  ...*..#.*....*..#. .#.\.. ...* . . # #.. .#..  .*.* . \.*.  # * ........  . .\....*......## . . .*..#*... #. #
#*.... #..\. *.....* . .........#.*..*\##.. ... ........ .\...\.*. \. ...*.. .* .#. \ .*.. \. .#..#...*. . *###...... #  . ..#.\\ . \ .. **.  . *. ..#
##... #*. ...*..*.*# .*...#...   .*.....   *..*.. . ......*..*..*.# ..*.. .\ *#. ...*..... \ ....  ..  #\.**.* ..... ..# ..... .. ..\... .*. .  . .#.#
#*#..#   ..##   .....\\..*.\#*.....*  .#.#\ .# .. **#.*#..#*\.  .*. . * ** ......   ..# * .#..# #.* . ......*. ...\..## ..*.....*.. ..* ... .**..*  *#
##.. * ##. .....\ .. .*.# . .. .\....*.#..\\.# .##..#.\..  ......#.. ...#..\.....*  . . ###.*.... ......   . ..#. *.  #...... \......#..\#.*.##.....\#
# #. .\  ... ..  \*. .#  .*....# **. #*.... \.**..# \... . .  ..*. \.......##... #*#......*... * *.#..* # *.  ......... ... .\ .#...#.\.   .*.*..*.  #
# . *. . .... .#*......... * * . ...*. .\.  . ...*\\..#.*.**.\**..*# \.. #...# #.... #*.#*  .#.*\##... .#...... ..# ...#\.\ * .*#\ #.##..#*.. #*##.. #
##*.\...\*... .\..#* \ .\ ....*.#...#.   ..*..*..\ .\.#...*#... ..*.. #  .#.. . . . ..#.#..\# # . * #..*# .......*#\##....*...*# . ..*.*.#.#. # .#.#.#
#.....**. *..# ...*.*.*.. .#......\..*....*..#..... .*.. ...##*..*.#..*#...#..#.. #....*. .... . ##*.. #... \ .... #*....#  #...... #.*.. .\*#...  #.#
#..*.#*   .. . .*...* #  #...* # . *..\ .#. # *. *... #. .... ...*\..... ... #*.#... .#..#... #. \ .#*  .* * \*..*#.#...*.. #. .**.*.#... ....... # ##
#... .. .. . .  **.\ #.... .. ##........\ .*  . ..\#.\#....###... #....\.. ... ....\#.*. . . .\. .  #..* .*#. #..\#  . .#...  ..*\....*.... .   *...##
#* * .\... #.*.. . *...*.. ...\#.# # ...**. . * .  . .#.#*.. .. #..# .....  .. .. .. .\ #....#.***.. ...# . #.. ..* *.*#.#.\.\.#.*#..* ...# ## .\* ..#
# .\ ##...## .* .. .  ..*..#*  ..\ .#.....\..# \*.  ...... ..# .*..... *...##..#*.... .#...........\\\..  .#.....   \ ...#..  ..   \#..*. .... ...  .#
#*...*.\ ..#*..*..* ..  .*.......#..* #*.# \..#......**** ......\.\* . * .# ...*...... ....... *. ... * \ .*.... \......# .##. .. .*#.. *#... *\.*#..#
#..\.. #.*# .* . ..\.# ..##*\... #..** .  . .\.. * # * # ...... . #*... . ..  #.....#.... .##...## .#.#.*  . .\..## # \.#.#*#*. ..*..#.... *.... ..*.#
#... # ... *.*.\*..*\.#.. ...........\.\*   ..\.*.  ...  *.# ##.....*.#... .....\..#*. .......#.. ... .\..  \.#* . ..  . ... # .. . . .##.\... .#.#..#
#. .  . ....##.#...... ...*  ....  . ..\..*  .....\..#. . #.. #.. .....*.\ .. .#....*..*#..*...**#... ...\..\....* ## * . *...*......*.*. ......\.*.\#
#*....  #.*.....#.#..#....\.....* *..\.....#......... .*.. ...... .#.. .* . .#.**#  ..*.    .  .##..\..# *#\...... .......  *.  ... ...*##  ..#. . ..#
#.*#.. ....*... \ .*..\.\....\.... ... \ ...**. .....\ ..#.*..*#  ..#. ..... # \\...*.*.  .*. **. .*#. ...\.   .\.. . ..# ...\.\.. *#.#..#... *... #.#
#. .#*##..# .**\ ..#.#..* ..**........ .#..***. . #*..#.*.* .. \.#...\#* . #.\ *# .*..........#.. # . *....#..  .\ .. *.\ .. ...\. ... *. ..#... \#..#
#. . .#.*#.. .  .*..# *.#.. ##... ##.*.\. ..*. .....#.#.* .* ..*. .*  ***.*#. .\#\..#.... *.*. #....#..........#.*.*##\*......   . .  \*. . .. ...\  #
#....#\*. *\.....#.  . ..#**. \. ... .. ....*..*...\..*  .* ... ...*.. ... .**...... \.#.\#*.\*.*.\...  .....  .. .* #..\.*...#   ....#.....#.... *..#
#*# #.. .#...... .****# #....#  ..*.. #. #\ . ..\*... *.....*..* ...*...#. .* .* ..... #\  ...*\...*.*....#. * .*# ..... ..## .. ......\*...#. ..  **#
#. # #..#.#\.#...**#..#\*..\###*..\.#..  # **.*\.# .\  .*. ..##.. . *.*.. ......\ ...# \ .\....\...*#*. ...#.#. .# \ ... .....#..*.....#  # *.......##
#*..... . .. #.* ..#. .\. .... . #.  ... ... ...*...*.*.....#.*#..###. .. ...#.... ..*..**#.*..\..... ... . .# .\#... ... ....#.... ..\ # #. .\#..* *#
#..... ..... \. . ..*. #... .. . ..*..*.....*..#..#......#. ..*..* **...\...  .  #.*#....  ..*.. . .\.#....  * * .  *.#..........\..#**.* ..#..\..#  #
#....*.. \  *.#..#....#.# ... .*...#.  .. .  #.*#. .*..#*#.....**... ..... ...## . .. .#.\. ... \  .  . # .#.. *\. ..\.\*\.. ..#.\*# .. ...#...   ...#
#\.. . ...............\.#.\ #..#*... .. .\*.#.\    .*  #....  .. *. \...* . #..  ...*.... ... .#.# .**.\ .#* . .* #. #.#\. ... .. .. . #.* ...... .. #
#. .. ..  # ....#...\ .. # .#.\#..*.. # *.. # .  *###.##. .*#.. .\### ..  .\..# ..  ..... \###..* #.. ....*#..**....* .\.. **\ .\..... ...##*   .\ ..#
#\.*# .*#.\ .#..# ..\... .# ..\*.#.. . .#*  ..#*##.  ..#.#**.\#......#..\... ..\ .... \*# ..**\*.#*.  ...... # ...*. .* *....#...    * ..\..#\ ... #.#
#.#.*#..*...* **...#.#.\..... *#.. **. **##.. \*.\# ... \ ..\ ....**#. ..\\..\  .#. ..  .   ...#\  \...* .\# ..#\. ##.*. ..*. **. ..\....\ .. ..#.#\*#
#.......  #...\ *.. ##.#.#...#..    ..\.* . .. .. . . .#  #...***. .......\..#.. *. ...\#.... .....*. \   .**.#...**.   .#  ..#   .. ... . .  .. .. .#
# . #\#.*.  ....*. #..*#.####.  ..*.. *..#.#*.*.....*...\#.##.  ........... \.... .\  ... #\*\..... . #.   #.#...  * .\#....# ..\* ..  * ........*.*.#
#...* . ... .# .#*..\*....\##.......**   #*.#*...#. . ...\.. .. *.*...#  .........  ..... .#... *\#....\  .*.....*#..\.#.*.\.  ...#.##*  .\.  . ..#*.#
##* ###...*#. .#.....\....   ... \...*..\  \* .\.\.. \ *........*.#\.*...* .. ..#....#. \........... ...... ... ...*. ...\.*\*..\ ...#..\# .. .*...  #
######################################################################################################################################################