######################################################################################################################################################
#.\*.*.. *.\*.#..**.\ ...**\\...*. .*#..#.*.*\#.   *...#. ..* \. ....##*.\..*.\\ ...#   . #.. .***.*. ..\*.. .....*  . . .  *....... *.. .. #.*\. ..##
#.. .\.#..#...# . .  .. ..\ *. .#...... ...#...... . \..\.......... \ **.# * #.. #\..*. .\#...#\*..*...\ ...*..\\   *\. . \....  #  ***.\*  . \.. ..##
#.#.. ...... .. *......#..... ..\   .\* ..#.. ....... .......*.*.. \.. * * ..\... .*...... . .. .*..\* . . *..#....#.#..#. . .... #.  \..... .#.*#. \#
#.*. ..... .\..##. ..\*.#.#...*.. \ .*. ... .. .*.  .\. ..*.*  .#.. *#*....# .#.#. .**....* ......#.*.\. .#.**..*......# ... .#.. .. ...\ ...*... .\.#
#.. ##\\...*..*..#.. . .* .. \  ... *.\...#.# ..* .#.*..*...# \.. ..   # .#*..*.....\\#*..**... #. ... ....#. ... *.........*##.  ......## ###..#. ..#
#. ..*.*.. *..#........ .*#.*....* .............. ... * \. .##..#.*..#...*.........*.*..*.\...  ... .. .. \.  . # #..\\....#.*...#. .# ..# .*..# . . #
# ##... . *\*... . . ..# .   . #.  ..# .\... .*..#.......##.... .#..\.. . ..#\  ..#*\ ..*.....##...*......*#  ## \* *  \. . #. \ ....#..  #*..*#*\..*#
#  .....*#. . ...#*..#.\.#..\. .#.\.. ...\...*..#....# ..*. .  \.......**..... #.. *..#..* #*  .# . \# *.\*.## .  *.. #...*. .#.*\*. .. .. .*.**...#.#
#..##. .   .# ....#. ..#..  .#..*. . .. ...... .. *##.* .*..#.. . #\..* *#....#..# * .#* ... ..#**.......#* #*.*....#.*....#*..#\\.\ \ .. ...\#. ..\ #
#.  ...   **#.. ..*. \. .*.*.. .#.\.#\   ....*# .. .\..*..** ... *. *.. ...... ...\. ....... .  #. ...*.*....... ##*. ....  ......*.\.... .. ... ....#
# .**.  ....\.*# ...*  ..    .\.. . #...*.*.#.... ##\# .*  .#.....  \.. #. . .... #..*.#*...*\*. # ........ ..**#. .*# #. .#..*.......* ..# #*.\.....#
#..... *.. .....*.*. *#...*..# ...\.....  . ..... . ........#...#.*....# #..#  .# . . .#..   .*. \....*.. .......\........ *# ..  #..#....#.....#..#.#
#. \... ...#... .. . .  ..# #... .*.#\ ...... . *.. . \.....#. **..*. . ...#.. ##  ** #..#*.........   #.....*... .....*...*...*... #*\.*. ....#. ..##
# #...  . .....## .*..# \...##. . .* .#.. .......#..#. #...#*.  \... * \.....*.... **.#...#...#.. ..*.#....*..*....... .*..#....... * ..\.#\**.*.##*.#
#. . #.. .  ..#.... .*.# .   ..#.\ . .. .....  #..  \* ...\ ..#.. #...*. ..#\. .#.* *... ...... ..*...#\#. #...#.** *  ..    . #....# ..... #  \# .. #
#.  *.\... ..\.  #* #.# .. .  \.. .#  .*#..*\........*  . ..**....\.. ..*. ..###.#.... ..*. . #....*  ......\ *#.. ... ..* ##*   *.....##\ ..........#
# ...* ..#  ..* ..#.*.......\..#...\.\  ... ...*. ..# *...#.. .. #........#...** #....*... ..#.\*..  **..#.*.#... ......  .# .* .. .. #* ..#*..*.## *#
#  ##.. .\. ...... *.. .*...\. ...*.\...\.... ..\.......*.\*.# .\...# . #.##. .. \ \ .\#..#\....# .. *.....*..#..\. .# .#..#............\...... .....#
#*#.* ....  *#..*.. *.  ..# ..*. . . *##*.  ..* .  ...* **\.\....\  ...# #...####.#... ...*...#..  .. ..*. ...#...\.. # . .  .*...# ..\. . .. . . * .#
#.. .#..\#.....**. .*#..\\..#*..* #....*.. .*.  #.# ... . #..\\...*.*..#..#  ...  .\.....  .*..#*.\. .*..  .*. # ... .. .# #..\ # .. * . #.#  .......#
#..#...# .. ....\.. ..\* \.. .. #* *..... .# ...*..  #..*..\..*.. .........**... .*#*... ... ...*. *....#.## ...*. .. .**... ..... *#.# ...#  *# ..\.#
##.......*  ..  .*\.....* # . . . # # . . #*.. *.#.  .....\* . .. ..#...  .... \#.... ...\... #..   .  *.# .#.   ...*. ..*... .. .*.. \.. #..  .\ ...#
#..*. ... ... .. .\ . ...... ..*.#. * .* ....*  #. .... .\...\.....#\*..... . ...  *.... \. \*.* \. . .\ ...* ..*..... #....... ...... * . ... . .. .#
##  # ..# .##..*.*  . ..  #.* . ..*... . #...\.*. ....#*.*.....* .* ..#.....*.  ........# .......\ *\* \...\. # ..*. ......#\\*.. ...** ....  . .. . #
#*#.* ...\\#  *.....*.. \* . .   *  .. ..#  ....* ..*......#.... .* .\..*.**\....... *..##*.\..... #.*. #. **..#.. ..*....*..*....*..#..#.*.. .#*.  ##
#. ....*.. .... \..   \. . . ..**#*\.*..\  #.#.....*. ..*#...\... ......... .\.*.#..*.# . . ...#*..#.#.#.\*.**.  *...  ..*..*# ##... **##* ......\ ..#
#..\#   .#* . ..*.#..#**.. *\..  \  ##..#. .... ..\.#  \.. ... .\*..\....#\*.#.   . \...  \..*....\ ..  #.**.. .*###. .... *.#.. ... ...#... .#..* #.#
#...#.... .#*........ . .#...#    . .... .#......  # *#.*  ..## #\..... .\*...... .. * .....   ...  .# ....# #. *. .\......... .#...*#.....*.#..#. **#
#...#....*.......*.# .# . .#....*#.*...   .*## .#. .#..#.*\.#* .*#..  ..**.*\#\*...# ....... . # .......# *.. # .\....##\.# * .. ...**......*..*...* #
# .  #\ ...... \ ... ... * #...#..  ..* # . ...*....*.#  *  .#..* .#.\\.##.. .. ###.. .\#*. ....*......*#.\.#. .*#..\. *...\    .... .#...##...* #*\ #
# . .\... .##.#.* ##...#.*#... ##..*.\.*  .... ..#*\*#..*........#  ......#. ..#. ##. * ..#*. .......#. ...*.. .\.# #   \. *..*....#..#.   #..*. ....#
###. .. *..# #*..#*  \ ....#. ..... ..\ .... .........\ *.. ...\.#...#\ .. * ..\..*.#* .... ...###..#.. ........*.. \.# *.*  . ****..*.\. ..\....... #
#..\.. .*.....  .. .*..*.....\ . ....##.....#.. .. .*.  \...*#.  #  ..*..#.*... ## ......* ....#** . ..#...\. *#..*..#.*. . ......#*.* ....\  ..\...##
# .....*.#....\...#.\# .... .....#*.\... * ..#..... ... ***.\..##.....#.. .......#.. ..#..*.*..  .... ###... .. ..## .. ...  .*.. .....#.. ..*\*...*.#
#... \.\.*  ..##..\#. #...... ...... . *##.#.* .#..*.*\.\\  . # . .#..... .. . .. ..#**.. ..#.# *#....*.*\   . ..* ..\ .... .\.....  *.*..*..\ * ..#.#
#* \. .\\#*. . #. ....##. *..#..#.* .*.. ... ..... .#\ .. #.#. # . #.*#.*..* .*...\ .# ....  .....*#....\.#  *..... *. #..#.* .. .\...#*.#....#... *.#
#. ...#..  ...#.....\....... *    #..#.  *.##... *.... ..\ ..*#. .#... ...\   * .. ...... . . . . .. . *\#.*.*.. ....\#*\#.. . \#* .. ..#.**..\#.... #
# #...... .....*......*..  ..*#..#..... *#.. .\. ...   \ #. #...... ......*#. .* .  ..##.\.  \. . ....  .. .#. .  ....\*##....#\  #... ..#...**  ..#.#
##. ......#. #. ..\.#  ...## #  #  ......\.##.\  ...*.# #. \#. #..\.*......#. .. .*   \\..*. ##. ... .....    #...**..*.#*.\ ...  . .. . \... .#.\#.*#
#\#..*## \ ...* *..... ...*.. .. .  *..# \  #...*.*#..* ....  .**.*\.#.. ...##.*.*#...#......# .\.. ..#*. . .#... ..# .....*.#*. ..* .* .... \ ...*. #
#... #. .. ... ....* .........*#.. *.# ..#... .... ... . ** ...**.....*#... .\#. # .*....* .. ..#*...\ . * ............. .*.* \ * ......*......... ..#
#.# .. \\.#\..* ...*. .. #..#\\ *#.* .\ . .... .....\\ .*...*.#... ..# * ...**.. .. ..........# .**#.. ...#..* ....#.... .#.*.  . .*. #. .#. .*  .# ##
#... # .. .**...#.* . . *.........#...#. # .. ..*\.*.. .. .# . ..# *.#\\.#...\ ..# ... . **#.\\...*.   ....*.*..*.*..\...# ..\.*.*#.  ...#. * . ..#..#
##...#....#.. ... ...#.**#* #\...# .  .\ .. ##  .... #..**  # .....#.  #.## .  *..*.  ...\. ##..***.*.... .... .#. ....  # .. #*#.\....#.#.....###...#
#. .. ..*..#.*.... *.#*........ #...* .#....*..#*. . . \....\. *.. ..\. \.. **....... ....*. .#**    .. ....#...#.*#.. .... ..* *.. ... .#.#.#\..  *.#
#  ..... . .... .  .#...* # .\... ...\...\.# .\.#....*...\......*#.....# *#..\.*...*..*  *.##...... #  ..# ..*..\ .....  *..  .#*..*.# .*   .. .. . .#
#.# ....#.#* #\ \ *.......*......*.* ..\. ....\.# ..  .\..#...   . .*... * .#.#....*##.# .....\....*. .*#..*....*. .#....#\. ...\#.\....*. . . *.   .#
#..... ... ...*. ...* ....#... *.... ..*  \....... ....* * .#. .\ ..*.*. ....*...#...#.......#...*.*  ...# ... . *...#. ... * ..##.*.# .  #..*... *.\#
#\...*# ...#.##*#.. #.#*.*... .... #...*....#. .*....\.##     *........* **... .# #...\ .\ ....*...... \#. *  .#......**.. .\.#...\.*......# .  #...*#
#.#.. \#... \..# ....... ..* .*  ..   ....  \.....#  ##..  . #..\. #.. .... \#.... .. * *.\  ...\....## ... . *#.  . . ..*... #\*  .\..*... ..# #. #.#
#...* * ...#. ..*\. .. ... .\...# ....*.***..\.##* ..... .. .  ......  #. . #*.... ... *....\*. ..#....#... #\ .#. .*\.......#. ..*#.*......*.\......#
#....\. .*... ..#. . .  .\. . .. .\..#.*.. \* .#.#  ..#\...   .*. .*..*..\  ... ..#..  **...... ... ....  ..#......\\   #..\*....#... #*... .  *. .*.#
# .**. .#\.#* ..# . .  ..#.. \.. .  ..#\...* .*.  ...#.# #.\..#\...#..*..*.\  .. .....#..\*. # .... ..*... .*.......#\\ .\. \. .. .  *...**.# ...*. .#
#... . \........*.....*. .**. *#.......... ...  .*.  \.. . #*... .* ....   . .. *\..  * . \....##.....\ .. . ..\..#\#.. *.* ....*.... .*#...*.#....* #
#......\.  *....* ....... ..#...*.#..*.*... \ .\...##... ... # .....\...  .... #.*#...**.#.\.##.*... ..  ..# ...#.  ...#.##. .*.....#   . .#.. ..#* ##
#...#. ..  . .. .*..\.#..*...\#.. #... * #.# \ .. . .#\ ...  *. ..#........*.....*.\. .....  .\ ..\ .#. *. #* ........\.# \..    ...\#.#\*  .# . .  .#
#*.# .*... .*.. . ....#. . .. .* . . \.. #.*\.. .  * ....*..  .#.#.. . .**....*.#*\.*#..... . *.*#..*... .#...... .\...# ..##.*\. *.   ..*.. ..\*....#
#.............*..*.*.# ...\..*. .#   *.. .# .. ....#. ...\\.. #.# .....#.. .# ..* .  \.\*  .\*.*. .......#  ... *...#  .#.. \..# ... ....  #.*.# . *.#
#.  * ...*  . .... ... *...*..#..#*. .* ... ... * ...**#.#.# *..\.*.###* ...#*.*.... #........#... . # #.... ..... ..*#.#.#. .* . ..*#.*... *...... .#
#...* .*.. #*.. ..#*#** ##*.. ... \...*#.... #... *#.#...#.  . \.  ... .. .*.. .##. *.. .. ..#. *.. \\#*#\ ..*.. .*.   . \*.. ... .. .... ... #.* . .#
#...#*....#**..\*\.....   .#......  . \..#.\ \  *.....# ..##.#.*#*.#\ .*..  ...#.*..*...**  * ..##*# . *. ..   * . .  ....* **. ..#...#...#.....#. \.#
#**.. .\.  \**. . \# *.##..*...\. ..  *..\.\.\* .........*\ ..#*..**.. *  .\.. . .... ...\...#.   ..... .. ..   .*...\........* ...\..#.*......\.#...#
# # .*..# ...* ..#*#.  ..**..*...#..#..  .. #..... .\. .#.*.*.*##  #. .. . . ..  \.\.* .# .\*\# ..*.. .*.* #.\........ .*. # ..* .* . . *... * ....*.#
#... ..\....\ ....* ...*. ...#. \**...* #...#..... . \ ......*..##\#.\..\#.* #.... ..# #*.....*....* . .**# ...*#.#*##  .... .# .**.*...\..*\ ..\.*#.#
#.#.*#........*.. .   .*...    ..#. ...#..*\**..#..#.......* .. ....  #.... .. . ... .... \\... ... ...*#.*.. .  ##.. . .. #. .* #... .. ....\ .#.#..#
##.*... *. ....\.. .\....   .  . ..#..*. ... ...#.*#.  .\ . ........ .#....*.....*...#... .# ...  ...**. *#.\.\# \... *.*..\.#. . .#... * .\.......\.#
#\#   ..#......... .#.#..### \.# . \.*. \..  *...# ..#*  .*.\..\.. .#*#* ......*.......#\....**.\.####.. ..  # .* *.. .#. . .... * #. ..*..........# #
##*\....*  ... ..  .#. ..*..**..*.. \ ..* * \. *.... .  ..# ..*....   .#*. ..........  .\..... ..**. *  .    *..\....*... ... .*##..... ..*. \*.. .  #
# .*.... \...#..*...**\.....#.\ ...*#*##*. #.*. . ......*.....\****.. #.#.#  .. *. . . ..*#*\ ... . . .. * \...#.*....*#..\*.....#..#### ....  .* .#.#
#....\. . ..  .* ...... ......#.#..   ..... #....*..*. \..*. .* #.. .#*\ .\* ... .\...**.  #.#...*.\. #.\..#.. .....*...... ....\..\.\.*   ..\.. ...##
#*..*. .#\\....\.........#.* ... ..*#.... ...# \..*..\#..*.. ....**..  .. ..\#.# .......  ..# .......*   ...... ......  .. ....* .*...   ... . # .. .#
#..... .  ..#.. .#.  . .#... *.\... . ..  ..... ...#.#....#.* ..  #.*...# \*..#.. *#..\....*.......... ..* #.## .*  .....**... . ...#...#*.  .#.. . .#
# #\#..  .*....**..#.##....#. .. .....  #..*...#... \... ..*...   *\\..*...*. .# ....#.... # .. ..* *.##* ..#.. ......\.\........ ......#... ..#.\.  #
#.# .##.*.*# **.##. ..\... .# . ...  .**. .. ..* # ...##.... ..  ..#..#*... #*  ..*#*#*.#**....*... .\*.#.***..# .....*.*...\.. ..\.. ........*..##..#
###*  ...#*#.\.  ##..***. # *.\.........#..*......#. #*..###.    ..#.*  ... #\\*....*...\  .\........  \#.* \\. .*.*.# .*.   ... . #.##.\\   ...  ...#
#..##\.\**....*. ..\.. ... .  ....* ...#..#.. . #.\.  . *. ..\.#.*# #. ... .\...\. ....#\.# *.#**..#.....* ..\.*. #... .... ..*.*..\.. .*.*#  \.#..*.#
# *\*. *  .\** #......*..\.. .# .....\.\..#\... . ..##..  . # #..\.. .. * .  ..**.# .#.*\. . *\.*.. .....\..\..*..........#*.... *.. .. ..* #... ... #
#... .\.. #..*.*...... . ...*.# #...*..... .. .*.#..... #.##  .*......... .#... . * *..*...*..*\.... .* \..... ....**.*.\..\ #..\#..... . ..*..  \. .#
#*.#**\....#*...**.....\..\ ....##.  ....... .... . .... .*#......... #.....*\...*....\*..... .\* .... .*.#.. .*..\. .......**\ ....*.*.. **# . *....#
#*.. ..#..#. ... * .. .  \. ... ...\#*...   ...# ..\ . .* . #...# * ...*...#* .   *....\... .*.... .....*. .##*#.. .  * #...........*....#. .......  #
#\.....\#.. . ...#.. .. .\ .. #....... . # ##.... *. .. *....##..*  \..# . ..*..*....\ ...\. .#.\..*...*. ...\.\*... *....*#  .#.*#** .........#.#*..#
#......#.*....* #.*.#..*. ...  .#...\.*.*...*.. \. .*..... ..  *.....#.#\.....*  . . .* *   . . . ... ... .*. .#*..*..## ..#..#. #..... ...##. \.  ###
#\  *.* ..  ..# .*\.# ..\..## .*#......\..\ .*#\ ..  .....*. #..*.#.\#..  .....#  *...\.. .*. ... .  #. ...*.*.*....**.*\. ..\. ... ... *.  #*.\..#.*#
#**..*. .\. ...#......#.*...... .#..# ..* .. ........  .\* #.#.\\. . *..##*...... *  .#**.**.\.*.*#..  * #.   .#....#..#\.. #*. *.\. ......  .. \##. #
#*. ... . .#.*#.#.   . .. .\....#. ...\..   \#. .. ..\..#.*..*.#.  ...*....  #.*....# ..\# #. # . \\ #*....**.. #.\**##\..#\  #. #....##...# . *..**.#
# \**... . .# .    .#.   .\.##.\\\..#...  .  *#... .# ##...*# # . . .#..*.\  . ..#. ..  *...##\ ......... ..*. #.... ..# ...#..\..........  ...  .#..#
#*... *..\ .\# *.. ##..... . * ...  .  ... .#*\.\*#.*...# ... .\. .*  #*..#**\.. *.#...*#.. .#.. .#..\*....#.  . . ....\. .*# . #.  .... ..   ... . \#
#.* .#......  ........#*..#   ..#.... \.. .* ...#  .\.*.# ..#.*..* .#..*.. ..**..\...\.#...#. . #*. .#..*......... ....*...#... .. .*# .    ... .... #
#......#.. *   . .# # \. ..*..\**#\.#...\ ..... . .. ..#.*  ... **... . .\...... *\..  \ ........  .   ..... # .. ..\#. ..  ...... ..... . # #.\.*.\*#
#*... .  .. *.. ..#........#*.*.  .. #  # * ..#.\. \*  . . ...*..#.. .. .... ..#* . .. .. .*\  .. .. #.. ....#\. ..\......\... .... .\..***.*. * .*.*#
# ..#. #.#.  .... #..... .... .#..# ..\* ....#*\ #.\ #. ... ... ...\. .\. .. ...  ...**..\.*. *.\*... \.#.. ...*##.    ..\...*.# ......\.#*#.. *....##
#.*.*. ..## ...  *    ...#.   . ..\.**.. .....#...  ........ .. .. .. #.*\. .  .... . #.....*....*. #..\. . ..##..#.##....#..... ...  ...\. ... ..#..#
#  . .... .####..* * .#*. .*.#.#...   ... *\..# ... .#...**... .. ...* *. ..#... .......*.*....*.... ..... ..  .....\....  \*...\....  ... #.. #..\..#
#..... #..#*\......#**  .*##\..*.... .\ \#... #**.. . ##.**. .....\#.**.* .#..  ..*.#.#* *..#.#*.#\. .......... *.. .##.*\ ...... .*..* *\\..*.*.....#
#..... ..# *.... #...#\ .\.....##\#.*.*\#\# ...#  *.# . *#*.....#.. ..#.# ...*.\#\.* .\.... .....# *. ....\*..... ..#\ ..   ... * ..#.#... . ...*    #
# .*. \. . *.\..  ..#..*..  .*###.. . ....##.... .#....*#..*. .. ....* .. ..*.*......# \...* ..#.#.# .#.. ..  # .   .*.. *.. #.....  ... . ....*...\ #
#  # .*...\. ... \ .#. ....*.   *...... .*#. .*  . .\.#.# ..#\. #.\** #.....\..#\.# * .#.... *..**. #   *\.*   \.....#......*.. .. ...\.*\.\.# \....\#
# . *.#... #..**..  ...* *... .  ..**... .   ...\.. ..... ..  .*.#....*..\..*.\...*.. .*\#...* ...* ..#... .......# .\#..#..  . .*  . .#*..# *....   #
#.#\\  ..*.....#*.\#.\...# \......... .#..  \..\.. .*..\...*#.\..* . * . .*.. .....\...*.....*.#.... *. ...   ...#\ ..* \ **.*  .. .\..**..*. *....#.#
#. ...... . .#.*....\  .. .**.#.#*#....\ .*...*.   .#... ...#.... *. #  ..#..#.....# .*..\.  .... #.. .. ..*.......#. .. .#   ... # .*.... ..  ....* #
#*.  *# .\###... .#..*..**.*. \.#  \..#..#. . ....#\*.*..#. .#....\..*.*. *... *.... .\\  .... .. ..#..##.. \** ..   .  ...... .\.........#..# ......#
#..   ... ..*.. . #.#. .... *....# *..*. ...... .*..#..#  .. . #... #....\. ..#.  #. .\.\.#... ..... .... *... * ... *....#..\  .#* ... \#  #..\... .#
#.\*#.#.  * ...#.*. ........*#.\# * ..# #* . ..#\*#..##*.#\###  .. ..\\*..**\.....#...\.#..#...    ..*..##\....**...... ..#.\.  .#  . *. ...  .#*.*\*#
#...#.....*..* .** *#.#. .......... . .....#. .. .. . .  ..### ...#.\*.. #\ *. .... .....#* ..... *.\.. # \ *..*. . .\.* .##... .... ... # .\ . .#. .#
#.....*  ..##. #.. .###...... #.*... ### ....# .. . ...* #. .*#..#.#*.#..... .. ...#.. .\... #**. .#. .. .  ..# .\\.\ .\ .#**..\...*.#*\ .. ....#.. .#
# ..*. . .. \\ \..........* ..# .... \....*. #**. .#..... . ..#..* ... *.. #..\..* #.......\.. .. ... ..#*.\. ..#..**.\..###... *. *\#\....... .  .  #
#. .... ... ..#. #.....#*....*.  ..\ .*#.* ..*.# ..  .. .*.. *...\. .#..*# .\.. #..* .   ..#\.....  \#.\ ..... *.# * ..\.... \\  ....... ...  .. .\ .#
#...  .\..#*.*. **.#.*.*. *. #. .. ... . *.. .\#*....*#.#.  *. # *... #.# ..##..##..*......#..\  . \*.\.*#   ..#.#....\*. .#.. ...... ...... ..#. . *#
#.*.   #. #*#. ..*\** #..*.\.\* .  #**. ...\#. ..#*#.* .# *..*..\.\ .. .\...# . .  #.  ....# *. **.#.. .*#..\.*.# *.#.#.*. . *#...... .**.... \..*. *#
#*#.*... \.#.*.*.. *........ ..  .* ...*.. .. ....  .......* # ... ...*.*. ...# .#    #* \....* ..#.\*#...\..* . .#.##\\....  ...*... ..\..... ..... #
#.........#* . ##. \ ..* .#.. *##.#...\\..# ..  .#... \*  ***....*# ......... .\.*###.*..**# ..... . #.*#...# . ...*... #.....*#...\. ..#*... .* \.* #
#.#*#....# # .. **...*##...* ..   ..............   .... . .....*...... ....#*.*\.** ...... ## . .\*\. *#.\. # *#. #.. . .. \\.*... ..*\####* ...... .#
#.\..\.. ..\.. .\ .\ .\...#... . .#.*.* *.....#.#*.  #....... #\...\.#. .# .. #  ... . .* ... .*. .\. .#*\..\....**   \.#.....*.. ..#..*.*.*. .... #*#
##.  .... ..\.. ... .*.\ . \   .##. # ..  ##.....*. .. ..## *... .. . .#\.*#*...#\..... #... .. .. ...*.  \.#  .   *.*#......#..\..\. .. ...*\.#    ##
#...........*...  .. ##.#. .. .*. ..\* *.....#..#.#.. \.. .\ ..#...#...##.  *.\..*.* ##..... *.#.*.*. ..* ...*# #...*..#.........**..  ...#*...... . #
#.*... . ..# *  ......***.. ** .*.   ...\\ . . ...*.#.*....\..* .*...#.*...## .....*...\..#.\  .## .\.##  #*.. .#*..  *..#.. \...\ ..#*#..#*.. ..* ..#
# ..* .*. ... **.. .. ..*.#.##...*..# .*....***.. \....*. ..... .*#. .. #... .* #.#\.  .* .*  ...*.. *#.*#. .\..#*#..#.... # ....... \ . .**. ...*.\.#
#.*. ...#..  ..#.#...#. *  *. ***...** ..... .#...... *...\.. #\. ..  # ..\\ .. ....\..... #..#. #. #..#. ..#.\*.*...*... .........  ..*.. *    ..#..#
##*  ..**. ...#.*.#..... .....*# .*.. .##..*#*.. *.....\##. .\. . . .......***. #.*#..  ..*#\.\#....\.. .  .. ... \ ....**..# ..\... *...*.. .* \..*.#
#.. ....*. #..#. ..# # .  .......\* #.... ..*.*..\........* \...*... . #*.*. ..*.*...**.. ..* ##..# .. .... .. \ ...**. *.* *. \ .*....# #.\.##.* .*.#
#.... #....*.#... .**...\*.\. ...* *..*. ..  .  .\\. #.#*##..* ..* *.. .. ..\. . . ....**.\.##...# ... .   ......\......#. .# .\ #... #.#\  ...# *\..#
# .....*. \.#..* ..#*.. *.*# ...*#.. .# .\... .# *.....*#...*..#... #\ .\ ..**\. ... \..  .. .*.  \....* *. .\*#. ..# ##......#*.\.\*### ..*. . .. . #
#.. *. .. #..* . # ##. *..\..#.#....# *.   . ..*....#..*. ..... . ..#.#*.*##.. *.#.*.#*.##... ...*#........#...#. \.*...#*.... ... *#...\*....#.... .#
##. *.. ..*  ..* \..*.....#..#.# #.. .... ..#*\.#*.** .. **..*.......#\** # #*. \.......... .*  .....\**  *... . ##....  . * \  *##.....*.** . *.....#
#.. .....*# .#*.*.... *.**.  ..*..#..... .    .*# *.. .*.. *#.... . .\.....* *# .##\.##..##......  . #..#... ... #..#*.  .... ...#*.. **...   . ..\ .#
#...# . ....* ..*..\*\.#.*.....  *..#.... .\. . . . . . ..*   .*.... . .. ....*....###\... .#\.... ..**#. ..*.***.*. ....\.*  . .....*.*.#. ..  ..#. #
# #*... . #.. . *.#..# ...\.#. ...*#*.#..  .....*... # .. #..*..\. #.....# ..\*.....*.##.........* . .*..\# #...*# .\.*.# ...\ ...*.*## ..\..\ #...\.#
#....*  ..  *..#.....*\..  ... .  .* ...#. *..# ...#.*** # #*.. .\.\#.#..#. *..#.. ... \.. #R..... ......* .. .  .#.\..... #...#.. .  ...*##......*#.#
#.. ....*.  . .# ... ....\ ....*..#  \..*\..#..  ##..*  .\...#\ \.. #. ...#.  ...  \.\.*\... *.. ..#*.......\ . *..\. .....\....\ ...##. ...\#..... \#
#.. . .  ...#...# *.  ... .#.....# \. .#.*#....  ##..#.#..# #..##....... ... ...*..#..  ....*\ ...*. .. . *........**#.. .#.. #*... .* .##*..*..# #..#
#..*.*......#.. .*.  .\..*. *.\.... # \. ..#.#..#.*.\.*\#....# .#* .. \ .*.\...  ...\*. ...... .# .. .......*..#  ..#...\....... #.\\..\ #..*..#. .#.#
#.....*.\\*  *. ..* ...# #..#....##..#*.\#..* .. ..#. *......... \. .#.* . .. #.#.\ ...#..#.##.#.# .*...\..* *.. # ... .....# .....*....#.....*#....*#
#*... ..#. . \.*...##.**. ...# ..*.#. ..#.\..#\.  ..\.#.#  \....\#........ ..##. .. . .#.\.. ....\.*#...*#... ..*.  .\..* .. \.*.  .* ..#... #\.. ..##
#.. .# . .*\##  .. *.#. . .#...\*.*. \..\*  .. . #*.*.#*..\ ... ... #.....# ...#. * .. .\*.*..# .\.# ..*..#.. .\.*#.. .....*...\. ..\  .. .  ..  ....#
#. ...   .. .\.*.#..*.  ..#* ..  .. ..#\.*. ....\* *..*.....#.#*. . ...#*.... *......... .. *.\#.**.\**#.*.. ... \*..*....#...*\...*... ..*.. . ....##
#. ...#.. . ..\. .. ........#.*....##.#.  #\. ..\ .. .##....... .. .\. ..  . ..*  .. ...\ ....#..*. #...# .#. .... #. .... ..#.#.\#..*. .......*....##
#.**... \.. ..#*#*...*. * .# .# #*.\......\. . .*.* \..#....... . *#. #...\.*....#. . .\. ##... . *.. #.... \...*\ #....# ...#..*. .... #  *..*... #*#
#..*## \  ....\\......#*\ *.....*.*... ..  *...*.... ..*..... . .  ........\.#..# .....#.  .* ..\ ..\...\* * ... *#*.. *. ......   .*..............\\#
#\*....\.# ##.  ....\.. .#.\ .*..\.*\..*.. . ...*..#.\.\..*  . ....\.... *..#\..#.......*.* . .*\#.  ... #..#\#...#. #..  .*....#* \  . ...#.... ...*#
#.  .#.*.#....*........ ..#. ..#......#.#..  ..*.....#...*... .... . .#\..#. ...... *.  ...#. ... \.#....  . . ...... * *.. # .\#\*. .*... .. # ...\\#
#...#.\....*.#.#.*.* ** .\. ....  .  * \ \...   *  # # .\.#*.......*  #...    .##.*.\ *.........  .\#..# .*.. .. \*. .....*  \ .....#\..#. *.....# ..#
#... * ......*..#.......\#....\ .*.#.#.#  \..\... .\ .#..# .#*.**\..  ..#..  ...#. . *.\ \.#.. ...#  *. . \ . ... # .... .  .. .... \.. .\..\.#. .. .#
#...*\*# #.\. .. *..* .#.#.*.   . ........*  \ \..#*#........\.* .#....* #........#\..*  *.... \.. ...... #  .#.*..\\... . ....#*.... ..\ . .# \.\# .#
#...*.\...... ... ..*.  **...#..*  ..# ... .*.. . ..# ..##*..  .  .#.#  ..*.... #..#*.\..  .#.#*  *. #*..  .. . ..   *. \. *.. . ...# ...\*......  \*#
#. .... .#.*\ ..#... ..... ....#..\#..... ...........#.** . . \  ....#.. ...... * .*... ..#*....#.  .* ..**. # #.  ... *.**..#.*.# . *... #..\\... ..#
#. *  .# .. ....**.. #*.* ... #..**. . ..\\. . ...**\..#..\ ....##....## .*.. #.#.#\.* ...\#  . . ....*    \# ..... *..**.....#......\ ...#.. . .....#
#.... . . .#*.. ..#.*  ..... *.**..*. .. .\*.  #......*#.\..*..\..*... . .. #. .# # ... ##.. \... ...\ .. ...\.#.#. .  * ##..#. \  . .. \. .. .#  .*.#
#..# .... .#*..... ..##...  ..#... . \ . ...  ..\.# ...#...* ..#*\ #.*.\#*#  #.*.   .#.... *.*.#.# .. .. . *. ...*.  ..# ...#.#\  ...#.....* *.\..#.*#
####################################################################################################L#################################################