######################################################################################################################################################
## \  #. . ..*\..*. #...\*.*. *. ..... #...\ #.. .#.. # .. .. . ..  .......... .. ###... ....*. *.....* .##.......\..#*..#...  #. . ......* \*..... *#
# ..#.... .**\. ..\ *.. ..#*.*....# ... .*.. . . .*.#...*. . #.# .*  .....*#. .#.#....* .... * ...##.... .... ..*....#...#.#  * .. ##  ..*. .# ....*.#
#\. . .\. ....*...*.*. .\...\...**..#..*#..#..* #. .... ..\   . .#   .. .\  .#.\.. ...*.#.*.  *. *.*.# .... ....... .... ... #.  \ .. #...*...*... . #
#.. .**.. . \#..#.\.. . ....\. .... . .  .*.#*..* ..*.\\#*.. .. ... ..* #.*..*. . #...  .*..*. .\...#.#\ .*.#*..* .*.. ..** .*...\*. .\.  ..#  ... ..#
#.\. ..  ..#.*....*#.*#..*  #..\.*#..*..##. . ......\ ***.*..#...... \* . ...* . ..  .*.  ...* *.*.. # ...*. *. ... ....*. . #.*#...\... # *. *..... #
#.....*..\.\.  .#.. . #..* .#. *..#   * ..\ *. .\. .  ...*..#....*. ....\#  *.\...#..\.  # .* . .... ..##....*...#  .*... ..#..\#...... #.........*..#
# ..... *..    . .... #.#\*...#..* ..  ..##.. . ..  .#*  .. ..# #*..  .# .#......*\.... \ . .. ...\ # .*.  \..... .\..#\  ..* #... *... ......##..#..#
##....... .#..*.\*.*..# ..*.   \ .* * #... .#.#..*..#.  .......# #. ... . ..#.\... ..  *.   \...*. ..\. #.. ... * #* *....... .\.....#.... . ... ..*.#
#  .*.#.  .*.... ... ..\*.#.#.#.**\.# .**#.. ###.  #.....\. .*\ ...*.#*.# \.#... .  .\. #....*....*...*.\.\  .#   ..  ..... #.. ..**. *.. *....\*....#
##. .. . \...\. .......#...*#..  *.* ..*..#.. ..#.\. . ..#..*....*\... .   \ ..     **.\.. .. ..\\.#.*.**# .. ..##...#.... .\\ . ..#...#... ... ..#..#
L ..#..*. \.* ..   .  #.....*... .***.#.*#.*.. .. .....##**\*#...\.**.***\.*\.# *. ....#..*..*. *.   . *\ ...#... ..*...\\. ...#.. . * ...\.##..\.##.#
#. ..  ...  ...#... ..  .. ## ...\.#* ..# *#\#........*...#...**..*.# .. \... .....*.#....* .**.**\ \ .. ..* .*.#..*....**..\.. ..#*.\.  . ..\.*... ##
#.....#.*. . .... ..#. .# .  . .  .... ..*.***....#....... .#...*\*  .# *#.... . \...... .*.\ #...## ..#...*..#..*\.#. .*..#.**\.. *..... . \*. *\\*.#
#..* #. .# *  #*. .*... *. *  .. ....*.   ..... ... ..#  ..... ..\# ..#. .## .#. #\....*#.# *....  #* .....*#..  .#.##. . ..\* ..... . ..*\ **.*.....#
#.#...\...#*. #..## *... #.  .*..\\..*.*.\.. .**....\*\ *.. .* .. ... #...\....#. #. ....## ...  ......*....    #....*...*.. . ...*...#.# .*.#\*. .* #
#.. ##*. . **.. #.   #.##* .#.#.*#.#....  .\ * .  *.... ...... ..*... ..... *\*\.* *.*.*.* ...#...#...*... #.*# ...  ...*  . ..... ....#.......\#... #
#.*.#.. .#\* ....   ..#*...*.....*  .*... ....#.*.....\# .#.....*#*.  . .*......#..*.....\.#.. \... ...*..#  ..* .#. *..  ...* . ...... .......\# *..#
#..*.* ..* ..* .\ *....*..  .. ..#...*#..\. .\.*..#...# .   # . #. . .\...... \..\.. .*\ ... .* .*.  *...\...## .*. ..*\.... . .#..*........*#.\*..\##
# \...\ ..\...  .*### ..  .... .#....#.#....\ .\.. .# . .. ...#  #..#\.*.... ..\...#*# #.. ...**..*#  .*..  .*.\. .\#......*.. \.. .....*.#.*.. .....#
#*... ...##\............ .*.. ..  ....*  * \ . ..... .*# ..## .. ..*.. .*......*. .\.#*.*#*..  ..*.. ..# * #.#\#\.#\. .*.\....\.\..\...#.. \.\\*.*  .#
#.\....  . #.. \ .*#.*.  #.# .*...* .\......\\\.#*.*..\*.*... *  .  .   *\# .*. .\#.  #.#...# .. **\#\.*.\# .\....# ..\\...#.#\. ...... .# #.*....\..#
#.... ...#.*.. .*..*# .. . #.... .\ . *  #.\ ...#\ # .. .. .\..\* .#*.. ...#.  #*..\. .**.*.*...*.....*.*#.... ..#.......* ..\#..\..#.*## ..*.*.*\\..#
#*..  .#* ...* ..*...*#.#\.\* ..#. \.... .\.... #*#.\ ..#....#* .*#  ....*#.##... .. .\*..\ ..* .......###.#.. .# .. .#...#......#..... .# .. ...#...#
#.  .. \.**. . .*... #.   ... ..*. . \.#.  .. ....*  *.*.. ...#..*.#* .\..*..*. ..\.....\.... ..  .. . . *..  *# *#.*.. . .\.#..# ......... ..#..\.*.#
#.#..\.# ..   .. ..*  . .\...*.\# #.# .*. .\....* ......*.#.\#..# *. * ..* .*.#...*.#. *. .....\##.#. ... ......  #.# ....... *... .*... .... *....*.#
#.**.     .. *... #* #..##*.#\ .#*\*.#....#.. *# #...#*...    * .....  ........... . .....\. .#  ...... .....\ .......\ ..\. #.*#..... ...*\*.*.# *..#
#.... ##.# ...##.. ....... . ..** #.#... ........ . .*..... . *.. # .*....*..\ ...*.....# * . *. .*.# ..... .   *..\....   ..\. ...\*... \...\.#\.\..#
## ....*... ..... .#*  #  . ..\. # ...*.... ..... . #. .*.  *#. #.*#...** ..  .*#.. .## #..  . #.. \.  # ..# ..*.#.#.*\. ##. \.# #...#....##.  .. .* #
#* .. . .. ....... ..#..* #.....**...#. ..# . *# #.\ ..*.#.*.\#...... ....#.*..#*...*.. ..  *... ... #.* \*.  *. .... ..* .. .#.#...\....#.\ . #.*.. #
#..  *#....#.*..\. \ ..#. *# * #. .. .\..**\\.....*.  .# \ #\.. .  . #.....# . \#. ..#...  ...#* . .....#.# . \... . #*.... ...... #.....** . ..  . .#
#..\.*.. *\.* #. ..*.*. . ...* ....* ..# .... ..  \  *.#*\.*#.. ... . #...*..*.#\. ...\#..\#...#   ..* ..*#... .. # ...\* #.#.... .# .*....#. ...##..#
#*.** .* .  # *..*##..*..##.#*.\.. \... ...#...*.. #..  . * ..* .....*.. .#*. *\ *.#..# *\..  .#####..*#..#..... . .. # .. \...#..  ... ...  .## * .\#
#.#.* #* ...# ..*.\.. .. #.....\ . .\\.... .... * ......*# .* . ..........\.# .#.... .......#. .. #.... *#   . .#\*...#.# .. ......* ... ..#...... .*#
#\.*..#.. ....*.#.#..* #........ *.\ # ...*.*.**... ...... ##.... * ..*.* # *#.  .\..*. ..#. .* . .. ..*. # .. *.......  *##. .   .*.. R. .. *. . ...#
#.#. .\ #*.   ... .#*#....**.. ..  *.\... ..   *#.*.. * .\#..... . .. .#..## * ..\ #.\...##...#..#... ...\ #... ..\\ .. *......... . .... .. #...*...#
#.......\. ....\...*.. ..#*. ....** .** *#...*.. ..* ....  #.....\. ...#* #.#.....**. .. **\..... ..........##.\#..*..... ###...........*. .#... ... #
#. ...##.  #..*.#.  \.*...... *..#.*\..#.*.... ... #*.. *.#..... ....##. *..#*.. \. \#..  *..#... \......**.  .# ..\ .#*. .   .** *............ **...#
#......#.*.. ...# .... ##.... # . .\\\..\   *..  ....*... . . *## ..# .#........ .*\ .........#*. .. \....#..##. .  .\ .  ....# *....* #...*.....#...#
#  .#.#\*. .* ... . ...#.#... ...... *  ....*.....**...*#. .  ....\*..\...**#.##.*...  .................## \. ..#...# .# \ . . . .# .\..#..#.#.... .*#
#*...*#.. *  . *#.\.#.\. \.*. .*. . . .*. . . .... ..\...# .. .......# ........ .. . . ...#.*. .\**#..... .*..#.*.. \.. #\.\.#...*. #.#.\..#.  *\**#*#
#... ..# ..**......* ...*\.# .##.. ..\ #*. #......... *..#...## .* .#.... ..  *.... \ .#**.** ..\.*.    . .*#..\ .... . ..#. ..**...* .*...\.*.*..*..#
#... . \.#. .#.#.. .... .    \ ...*..\ . .\#.... ...* ............ .. ..  .*.... . #..  *....#...\* *....*.. .....**. ..*.. .. ...* . \  .... .\....*#
#..* .\\..*............. ...... .#..  * ...  # .*.* ...  .\ .... ..*.#  * . \...\. *  *.*..*. # *.. ..#  .*#* #..  .* #....  ..**.... .#.*......#.. .#
#..#*. . .. .. ..\. #*. \... #....#. .. *..#.  ..*..\.##... ..*  *.. . .   ...  * ...  * ...... ......\.. ..##..#.. ## .*#. .  .##*#..*.*.....#\#\..*#
#.#. ..#   \ ... .....#.. ....*..#\# ... .# \...... # ...#\#. .\..  .# ...*#..##... .  *  ## **.  ..\. *..  **.....#.#  . *.*.. .\.#. ..#. ....*.. ..#
#\*..# .. .*  . .. *#.. .#..*..   *.....#. .*... ...  .. #.......#.\#  .\#\...... .* ..*.  *  ... .. .......\.#  .... .#....#.. .  .......\#\.... .\ #
#.. ....*....# #*. .#.* .. ..# #.* \.   \..#. ...***....#..  ...######\..#.#*#.  *.*..#\..*..## \*..  \..*  ..*  \.#. .\..#. . .#*# *. . ...*#. . ..##
#. ..... ..*.. *#.#... #... .* . .  .....# .... #... .#... ...# *.#. #.*  \ . ...#.  \...#. .. . *#..#. .#\. ..* ....  ..*.* ..\*........ .*.#... ..##
#.*...*. *... ... .. .   #.#...###.\.. . ..#..# ...\\*.....#  .#*. ...*.     . ..\.**..  *......* #.\#.*.*..#..*..**... ...*.. .*..   .  #*.#.\...#..#
#..\.\#....##  *.. ..  .# ...... #*\*.   .* ....*.*#.. .\.. ..  ...*.*...* . .\.# *...##. .  ........**# . ....# .. ... \ .. *#..*.\\.*. \..\..*....\#
#...  #.#.*.#..*.. .# *.\.#*...* # .#....\\ \ ..\. .\.#... .#**.#.#..... ....... ***...*..... . .. ........*.# *. . *.   ..... ..\..#.......*.. .\ # #
# .\\...*..* #*  ...\ ...*...\.#..*.    .*..... \.#....... ..*........ *......... .*..#.\*.  .. \ .....  *. ....# ..#..#.* . # .*........*.....\.*.. #
#.. ....... .# .. ..... .*###\\ .....*.... .\....\# ..  .....#. #.... # .*.... *\... ...#\...  .#..**#.*.. .. . \ . ...*...  . ..#.........**.....  .#
##*..##..\*..  #..*##. . *..\.   ...# .  *# #. *..#..... #. *..#.. . .... #  \  #.* .... .# ..#....*.#........  ....#*.... .*.## ....\.. *\.# \.  #*.#
#..  ..*#. . ...\#..#.#**# .. ..... ... ..#..**.#.\.   ..## .#.##..... .#......\ ..#.. ..*.\#.\\  .... # . ....*..*...  .......#..... *..* ....#. .#\#
#. ..\....*.. .... . *#.#.   . \....  .*.. ..... ..*..*.#  .*.  . \ . *\\...\... ........# #.#*.. ...* \...*..*\.......*.\. .. ..*.* ..\. .\#\*....**#
#..#.. .#... .. #. .. .\... . #... .. ..*...*... #.# . # ...#**#. ......*\*.** .*..*.#*.*#.#.. ..##*\.. .# #.\\.*...*#. ...   ...#.\\ \.#. . ..  . ..#
##.....\ *#.. ......*.. . . #.**..#..*. *.*..#.....*#.**..* ..*. .....*...  .....* .....  ..... ......  ##....## ... *.*#..*\.. #. ..#.*.***.. .#...*#
#.  ...*.\.*..\. . ......  ... ..\#..... .  ...#.*..\ .*...*##... ... . .  .. ..***...... #*.#... .. .*. *.  ... #  ***..**...\ ... ....#..  .... .###
#.. .#.... ....*......\.#.*.#.. ..## *.*.. .  # *.#..... . ..*#. ...*....   .....#... ......#..# #.*.......*   .*\*..*.#.*\.*.**.* .* ..... ......#.\#
#. .#. *...   .... .# \... ... . ..#..#. ..#.\ .\.. . #.*#. . ..\. . ...#*..*. . .. ....*.#...# . .* .* #*......#.......\... ..  .#.*#*...*.\.   ..#.#
#*..\..\..##..* ..  .*..*. .   ... #........*##... #.#..... \ ..*..\.. # ..*... *#.* ......#. *##.##\ #  *.. ..\ *. ..# .. .#. .*.#..#..*. \# .. *..*#
#. **.  *#\.*.. .. *....*.*...*...  *...\. ..#*.*##\ ..#*.. #.*\\. ... . .#...  ...*#..# .....#.... ...........*..  ..#.... .... ...  \....... ..   .#
#** .......*..* .. .  *..#.......... .##.. *..*... . .#....*. .*\\..\..  . ...\... .. .*#..\*.#...* #...##.*#......*...*.*. .....# *.*  ..  .....\...#
#....*...*   . #*#..# . ..#. .*...\. .....#....#.. ...  . . .....*.\*. #.........#.#..\  .. *.#*. #\* .*..* #**.. . #  #\...#...........#*...\.*.*.# #
# .#  .  *..**...#.*.. .*.*. .#.# ##..\#........**. .#.  * . . \......\#. # . *#...#. .. .* \*. ..*.\. ... . **. .. \..**.. \* .. .. ....*  #... ....#
##..*. .*  #**.  ##....#\. .**.  ..#..... ..#..#. . ...#.......#...##*....*... ...  .\*.. .#.#.*\.. .\ .\..* .. #....#.*.* ..*... \..*.  #.*.#.#*...##
#.\ *. .#.#.#....... ...#.... #.*#.  *.# .\.....# ...#... .. .. . ...**............\.*.. #.. .#....# ..\. ..*......##............ \\*.. **.  ... #**.#
##..\...#.\#.**.#\*..#.*.  .\ ... .*.#..#...\..#..#..... .. ... ..*.#   ... .. .*.. .* #..  \*.#..*.   ...#\..# .  ... .*#. .*.  **.# .#.*.*...*.#* *#
#. .. ..#.#..\ \. .\  .\ .\*  \.. #....  .. .....\. .#. .*..*. .#..*#..  * *.*.* .. \..*. ....*#.##..* ..  .#.....#.#.. .. ...\ ...#..#..**.\ .......#
#. #\* .**. ...#.......  ...\*...#.#...\...*#*.\#\..... #..... *... .. . .......\. ..... *.. .... ........#.#.*.. ....  ....# #. ..... #. .. ... .  .#
#.. ..#.*#.*..  .   . \.. **........#. ... .##. .. . ...*.*..* *\..# .... .  #.  #  .. ...*  #  *\#.  .##* .#.**.  .*.*..# ...  ...* *.#...#..  .  ..#
#.. ....*.# #.#.#.#.. .. . #.* ... ...#....*#.. ..**#..  .....*.#..\#\ .....# .#*..## #* \*.. #.#.#*... #*\..*\ .. ...*.*..*  #*\.\* .**. #*\#.*...  #
##..#. . ....#.....#. ##. ...*.*. #*.#....... . *\......  ..  ..... .\. #* .. .#*#......#  .  *#..  .. ..\... \.\ ## \....*##.*.\*...#... . .\.#.. #.#
##...*#.*........\... *.   .\**.......#*\..\.....#... .. \#....  .*  \.. ...... ...  . . \* ..  .#... \*  ...\ ... #..*..\.\* * #...* *....*\.....#.*#
#..\*..*.\ ... . #.   .. . #*...#...\.... ..\#. .#. .. #*. .. ...*\#..  ....*.\ # ..*...... ....\#\#.. ..#\.#. ..*.... \*...* . . .** . \..\#  .#.. ##
#.*....#.* ..\#*......##..*#.\. ...#. #.....\...  .....#. . #. #..* ..*......#.#..... ..... .#. \.\...**..... ...*\...*#.#.# ..*\ .. ..  ...\  .. .\ #
#.  \*.. .*. .. .#.\.#........\.* *...*.#....#*...**..#.\ *  .*...  \....* .  .... *...# ...\\...#....  .. .. ##*#.\.#.. .\..*# ..#*.*. . .#....#\*  #
# ...*\*...  .  * .... ..*.... ..#. ...*. \  .. ..*..  ##\....    *.#.*.**.# . .  .......\.*.*  .*..*. .*...  .  . ...........*..\...\ ...# .*#.*...*#
#.*.. ..#.#..... ......#*.*. ...* .*  .#..**.   ...#........ . .. ....*\.  ..*...  .... *. .\ .*. .... ....* ...#.*   .\ ..    *  . # . ....*.. ....##
# *...#.. # *....**  ..*\. .#  **.#.  #........# .....#.........# \.\ ......*......#..#  ..*...... ....*. . ... .  .......*... *   .*..*#. *..# #.*#.#
#.. ....... ..*.\..*.. ..     #\... *.*.....* #.  .*.* .. ....*..\ **....\.....\..\#..   . *#..  #.\..*#.. *. . . .*...#... . ..... .#. .*. ....##...#
#. ........ #. \  #.. ......\.. ....#..  ...  .#.. *. . .. .. ...... .\ *#.......* # ..#.\.*#*.\....#..  . .*.\. .. #..#......... .#...   . *. ... .\#
#  ..... . ..  \ *.. .. .#**  #*.\...   #*.#*.. . #\......*..\ ####..#*   ##.*#... . ..# \....#.....\*.*.\.** *# ...*. *.........#...# ... .#.*..\#..#
#...  ..*#.. . * *. *.. ....#.* \.#...#.... ..#.....   ...#...  ....#... * \  .\** ..   .* ....  ..*....*... #...... ..##.*.......\..  ##..#... \. ..#
#.\.\.........#..#. .....  .......*# ...* \##... ##.\.. .\#*#....*.\. ...\.  . .. .#..  ... #.. . ..... .#...\..\..\  .. ..###*.*\...*..*\.......\.*.#
#.  #.* .* .##.*.*..... .. ..* #. \ . .  ..*.\ ..#.. ...*  . ....*.* ..*..  .  ..*.#. ......*..... .. ..*\..  .. #* #.*   #.*....... # ..* ..\  .  *.#
# ...# \ .....***..... .. .*.....#.*#.....# ..*\.\.##\.  \.*#.  . *.... ...\. ....*....  *#  * *\.. .#*. .**\ #  . .. #\.#.. ..*..  ...* #.. ##.#..*.#
#.... .# . # .*#.. ... .. ...... *.... ..\  . . ..... *#.... .#\\ \...\....**.. ..\\..*... .##. ... *........* ...* #..#. *.#.*#.*.*#.... \#.... ... #
# . *.  . \..*# .\..\#.. ...\........ #. .. * .##.. ...\... .#.*\#.\ # ..  #.. .....##..  .. *.*... ....*....* .  *.#.......#*\.. ##\..# ....# .*.#.*#
#.#.. ....\.#..... .... #..#... #.... ......#..*.*.. \ .... *.\ ..*.\...*.......*#.... .... ...*... . ....\.# ..#* . .. #...#...## .... . ..* *.*.*..#
#..  .... * . #\.\#....\ ... ..* .\*.. .....#....\. .\..... **.....** ... ###...*.#.  .#.  .#\..*.  #... .# ..... ....\   *#....*..  .  ....****.. *.#
#...\#...\.*...*.#. \#  ..*....*** ...#. *.....\ .#.. #*.*. ..\.*...#\.*.. ...# ..\...... *.*#.###. .....\\\\#... . ... #..  . * ..*..\... ...\.\.#..#
#.*.*.*.#. ##..#....**#*.. .*  # .....\#...#..#. ....\.\\........**.*...*...... ... *..  ..#.*.....*.. **.... .. ..**.... **. . .. .. *......*....*..#
#   . .  *.*#..*....# ...#..#*. . * **#.....#.\#... \   * #..#.......  . \* * .... .. .*.. *.**.#*.\ \...*...\.** .*. ..*....* .   ............ ..  .#
#*\. . ##..  *...*..#*\\.*.. ... .\..\.  ..#.. .* ...*.....  \...*... ... .....#. *.#.... . .##... ....\. .*.*... #....... * .#.# . .#.#.   ....\.*..#
#*.... . . ..*.*# ....*\..#.#... . ..#.....#....  .*...\...\*........# #..\ * #..#*\..*\.*\ . #...*. .##*.... ....\..#. ... .......*....  .** ##.#.. #
#....*.\#*.*. .#.\..**#...# .# .. ...* . . .. ..* \..##*#.. ..#\ . .... . ..*# ..........\. .\....... \.*.\.#. \..   #.*.#. ....\.#. . \**.  .. . .  #
#......#.*#*\...#...\ \**.*. #..#..\* .#* ......##.* * ..**.* ..*\# *. #\..#. ....* *.#. . .#....#.. \  ..#................ . ..*..\*# ..#.\ ..... *.#
#*..*. ...#...*. ...#. #.. ..\. .#...# **  .\.#...\.\*...\ *.**. #\#..# # ...#*..... \...*......* ...*.\#... . ....\. .#. .. \ .#*   **#. #....# \...#
# # #. ..*.*.  ..... *....* ..... .  # ..#....\...  ... . .#... # \........  .  ..... .*#.. ..*#. .*....*##\  ....#....... ..\*#.. .. . .#.   .....*.#
# *... . *.*.*\*...... *. ....  .  *.\. #...* *. .*....\.* .... . .......\#.. . * *.. ..   * ..\.. .......  .* *.##......  .  .. ##..*  .#... .. .. .#
#.. *#\*.... .#..#.*.#*...#\*\. .. ..   . \**..... .* . ..\.....*... ........ .. ..  *...   ###.*. .* ....#. ...**.*\ ..... # *. *. *    * .#.*. ..**#
#.  .*..* .#.....   ...* *.*.* . .#. ..\*.. ..... #... * .# . . . *  #*. .*..***. .  *......*. #.# .\.. *....*. *. *.*#  ..##\.# ..... .* .. #.   ...#
# .*.....#    ..\..#... . # \. .#.\..#. *.. ... . . .. .. ..* ...\ .. *..\..\\\* \...\.. *\.* #*..#.. #.* ... .. *#...* #.. ...* #*... ..... ... .. \#
#...... ..#\*#.   .* *...#... #.#.#....*...*\ *  *......*.. . ..\ ........\..*. . .\.. . ..*.....  .#. .# ###..#...\#. ..*.. .....# ** \..*. . . . ..#
#.\..# #   *.#...* .#.......  .\* \#..*..#\.#.. #. \..* * .. \ * .  ...#.\ ....* . ..\...# .....\*#\. * ...##*#.. #* .  ......  ....*.#.. #. ... . ..#
#..\#.\...  ..  .  ... .# *  . ... #* *#. ....# .\*......  .   ..*.\.*..# .*.#.#..\#...*. .. ..  ...*##.. ..... ..*  .#. ....\#.  ..... .*. . ... . .#
#.  .........\.#.... .#. #\.....#. *.*.#...\....... .. ....#.. . #.*.**..\...  ...* .*..#..  *.* #..*. . . ...... *.#..*..*\#....#.\.. .. . ..\ . *#.#
# .*..#.#.\ .. ....*.#*#...# .. *.*.............\....#...  ....   .....#..\...* *. .. . .##*#. ..#.  .......#. ..*.\..#.. .#*.#\##.\ .#  **.#*....#..#
#  #..* ....\*. ......  . .#...*.*.#.#... #. ...#. * . ###.....\.#..... \... . . . ....* *.\.* *.   ... **.. .#* #.#.#.... .*.*.*#..\.... . #.*..*...#
#..  ..*... \.*..*#. . ##.....#\. ...... .... \.  ....#... . .  .. #. #......#.\. * .**.\  ..*..#..........#.......#.... *..#..## *.#..  ......\. ..##
#. *\..*#.*.*.*.# .*.#... .....#. * . ...#.. ....#. *\....... .*. .\. .#\.#.# ..\#*..#.....**. *.. \ .*... . ..*.... .  ..*.............. .  ...# *#.#
#.*... .. ..\...*#.* \...... *... \*.\..#\..*#\...##. .... * .\.....\*.*.  . .##....*..#   ...  # .*...\.*.* ..*.*.#.# .......*... . .....\..\*.#....#
#.*#.... . *... . .. .#\...* #.#.#. ..#. #..*. ..  .. .#....* \#....#  . .* #. .#. .#.#.  ..  ..\ *....#...*##...*.*\ ...... . . ...\#.....   .  .\..#
#. . \... .....  .#.\..*.. .. .. . \.. .*  . . ..\*............#........ .*.. #.*.##*\...#*.* .*# ..  .... *.. \..#..... . #....*#\.\...# ...\.* ..# #
#.....#** \.......... . ...#......*...*... \*\.. #...  ..... *.*  .. #... ...\# . . ...#.. ..\\#.*#.... .**..... . *. .........*....#   *.........#. #
#.\...*.*\*.... ...\ *.*  .\........\ ...#....\#.  .*.. . .*. .\.....* *.#  ....  .......**..\. .*..*.# #.. .#* ...#..#..  ........ .....\. .*..*. ..#
# #.**.* ..\........ ..* #.#.##..#..\#.. .....\\ *.. .#.. ..*.#.\.. .# . .* *... .. .*#..... ..... #*. ...* ..\..  \... #. .... ........ .. . .. .#.##
#..*\...#.# ....... . \....#..#........# * *....# ..#...* ...#..... #.. *.*..  #. #\....*.*.  .....\.. .  .#. .*.#..\##...#\...*. *\.* *..... ...* #.#
#..... *##.. .... ... ..*. . .*\... ..#\.#  .. .......\* ..#\.  ..\*...#...#..\.#*....*...#. .. ..... .\.#.\..  ..  .... . .\. ..\.\ .....*. .....*..#
#\*.#... ...#.... .#.....* *. \\.#...*  .*..*.#...#..#.* \...  ..   .. #*.# *... . ...* ...  ..#.. ..*#...#..  \.#. \ ..*.....**......*.**  .\  ... .#
#...... *.##.. . ***#.. ...# . .#** *... #...#\.#*#   \ #.#..*.## ....*.... ..*#...#*. ....* .  . \* ..... ....*# . .\.... ..* ...*.. ..#*.*..* ....\#
#*\ ..\.*.#.... .\ .*.*\ #..... #... *. ...#.   .. .\#.*  ..*#* ...##  # ....#... .*#..*.  ....*  #*  .. ..##..........\*.. .\..*.  .#.\#\  ... .#. .#
#\..*.. .*.  ...* ....#..####... ......#....\.**...*.\.*...... .. . ....   *# ... . .*. #. ....\.  ...#..  \.*. ...*.# .... . #. .......*. # ....#.  #
#.#..#......#...... ... * ....#... .*#...... .**..#*\ . .. .. \.  #.*.\..*   *.\ . .#.*.# ...\.\  . # #..  .. ..... .#. *#... .. *..    . * ..*. .*.##
#.#.... .... .... .* .. .\#. \. \ \# ..\.*..*.\......#. . *.. #.#..** ....*.*... .......#..  ..# \*..\*.\..\. \....*... .   ..*.#*.. ...\..#..#....  #
#.*.*...*....#..\.......*. #** \* \ ..#  *  .*.#\. .. ..*. .*..*.#*\......... ....\. * * # ..#*.. .\... *\.....*..... .* ..#... ...## .# *...*. .....#
#...... ......* ##..*. .#...*....*. ........ .\..#... .#.. ..\.#.. . .#* #..\ .*. .. .* #.....*.\ .  .#  .. ....#.#.....  \  .  * . . .. .#\.\..*. *.#
## ..... .\\. ..#  ..##.. #* *# .. \#..  .#.... #.**.. .#...\...##..*.**...\..#..  ... *.....# *  ..\..*.. .** ...*. .. ..*.... .....\.   .... . ....#
##.. ..* .\....*..  ..**..#. ..##*.**.#*. ...\\#.. .....\#. ......** ......*. #*.# .*#  .....#*.#..*. ... ..##.... \# .*.....\ # . \...\ *. \#... . .#
#. .*.*...#\#.**. .\....#...... ..* .#.....##..* #...\. .#..... #.\***#....#..*.. .##...## .#** . ........#*\*#....*#.*.**. #. # ..*\.*\.. \\..#.*. .#
#*.# #\.* \ #.*.\#. ... .#*......*...#* ...*\..* \ .  *..*..*. .... ..*.*.. ... .**...# #.. . ...* .#.. ##.. ......* .\..**\ .. .  \.. ...\*  ... ...#
##.##..  ##* \.. ...#   ..#.#.*\.*...*..***..#. *. . # *.** . .....#. #.......*..*#*.. *....... \...**.....#. .** \......... \#. . *.....#.*#. ...   #
#..#...\......# *\ ...  #. .* #..\... #.\.# .#..*..## .#... ...  . #...\ . *##..... ...* ... ... .*.\  ... .. .#..#*.*.\....**\ *\.#..#.##*..... ....#
#....*..##..*..#.. \.  .\ . ..#\.  ..#*#* .***\..#\ . .* . .\*.*..... .*\..  \.*##.#**.* . *...... ......#.. *..#..... .**...*\.# * ...#. ..#.#\#*..*#
# \ ..\.\.*#. ##.**#......*.\..\......## ... .\ \...#... .#..*.. #. ....**.*..* .#*.....\..\.#.. .. .*.. . .... ... .. .  ... ... .. .....# *........#
#.*. #. ..#.#...... * .*... .**\ .....*.. ...\.   . ....#...*  . ..#...##. ....*.*\...# ** ..*.*\  \..#.* . ....# ..  ..  ..#.*.. .#*...#*.\.. .#..  #
#*.. . .\. ...*..#.#...## .. .. .\. ... ....#*.. #*...#. . ....#..#\..*#. *. ........ ##*..\ . . ** *#.. ..##. .*.... .....#   . .....*  ...# *\..#..#
#.*  . .*....  * .. ...#.  ...#.# . **. #..... .. # .  .\   ...**..*  ##.*#* .*. ... .\.. #.#.... .. \.  .......*.\.. . ##.#**..... \\.*.. ..... # . #
#   ....   .#....*..#\.. *..\ .. .. .. .....  ....  .*. #.*..... *.#.. #....\ ..#.#*.*.\.. .\ . .*........... \..*#..\...*.*  ... #*#.  .##....... . #
#..**....#*.  \....\. . .... ..... #..\...\. .....\\.*. .. \..##.#.  ..\ ..*##..*.*. .......\ *.#. .. \*....*.*#. .....# .  ... ..#..\*..###...  . ..#
#. *## ..*.. ....\ #... .#.# ......#*. ** .# #..*\\ ..#.\.\ ...# . .##....... ...\. . . * *.*\.  # ....  \ \*..*.  #. #\#...* .. .. ....#.  . #..#.*.#
#. .. #  .. ..  ... ..\..*. *..#   ...... ............... .*..... *#.\   ..* ...*...*# ...\.....*..*#..# .  ..\## . ......# .......  # .  *.#*.......#
#.  #..... # ....\ ...\..\ ...\.\ .*. #.  .# . ..... \.\.... *..... .. ....\#*#.# #. .  . ..*.#. *...*.#.. **...*.  ... ......#...*... *. ...#*.. ...#
#.*.#...#.  .*. # .  .. . . *#* ... ..*\*.#..  ..*....... ..#*. ....*.*....\ .\. #. . ..\...   .  *..*.#\. *. .... *  #.\ . .. #.   .....*#\  .#  ...#
#...* .. .*#.#.....**# ..#.* \.  . #.\.\ .. #\.*.**..........*...  *. ...*..*... . *..  ...**..*.....\.. \#....\   ......* .....*\..\ ....* . *#.\  .#
#.  # ... .... ..##.......#.  ..... ... ..  *\\.. . .... . ....#.. . . .*.\*.  #....*...#.*........#\*..\.**...* #..\. ...\..\.** ... ..  . *.*.... *#
######################################################################################################################################################