######################################################################################################################################################
#...#...#.*..*...**\\ .#..*.\ #.  R*\..\.. .. ...**  ..**.#.#.#\.# .. .*... **\.*...#. .....*...... .. ... . #..#....*..**.# .#*......\#...\..#. .#..#
#..*. \   .*. *.  * ..*\.**#*. ............. .*#*..* . .......##*\. ..#.....* . . ***#....\.\...  .#\...*...#. #.. . #.. .##. .*#.... #.. ..\ \. .\*##
#.. .##....\ \.\.* ...  *.  *..*.  .\*...\......**..\.\.#.....*.*....\ *\. ......#. .*.  .\* . ...*.**.#* ....#.... #*#.#....\.  .\. ......  \.. .\.*#
#..*# ..* ..  ..* *.*.. #..\....\*...#.# ..#.......... . ..#.*#...*. #\*. ..*..\.....#....  *...... # .\   . .. .**.  #... .#..*\....  ..*  .*.  ..  #
## ...*.#.. *.* ..# \.#\. # ..*.......  .*.... ...\ ..# \  .*.#...* .... .. ......\#....\.#.. *\  .#..   ... *.....#....#.......... ....#\.\.\.* *.. #
#. ......\..* .  .. .. .\...  .....*. .  ..#*.*. .#.* #....  #*...#. ... .* .. .#.#..\.........*. # . *......*.. . ..... ..#..#.... . .. .#.#* ...#..#
# #  *...#......\ ......*.#\.*.....*.*..*# . #..  ..##....\. #.. *.. ...\ .*.* .*.*  \..*.. *.#.. #...\.... \. . .... \\ .* #...\   ....#.*.... *. \ #
#.#.  .\... . .#\. #.*\....#..*. .#.\ ..*. .\*.#**..*..**...# ...**..\*....  .....*\..*.*#. . .. .*.. ..#.* ...... *...\#....#\*.*.. ......#. ..... .#
#... **\.... .... ...#......###  ..#*.. ...#...*  * ......\.......... ..##  ..#...*.. *.*..\...... ..*..#.. . .... . #*\........ ....#... .*#..* # .*#
#..#.#.... .\ ..#.... . ** ...\...\..*..... ..#.....\#*#*#.... . .#..* #\..*....#.#*#\. ..#.# . . ..#. . ...*......*..   #.*.*.*..\.. #.*#. \* . . .##
#..# #..#*..*.*#.*.\ .. ..*.# . . \#.*. .**\..#... .#  ..... .#...*\..... .....* .*...........#. #*.... ....##*.   .*.*.* . .#...#..* .*. ... \...#.*#
#  . . ... ..*. \*. . *... *..\.*.#. .. .. .*...\. ..*.\. .. #*..  . .. *.#\ .... #...\.** .. ....... .....##..*.#.#.... *...*##. . .\ .....#..#...  #
#. .. ..\#... .. ..\ ..**.. ##.....*..#.#.\. .. *... .. ...... ..*. ..*.. .#... .*  . .\. ..... . .# #.#...  ..#* ...#. . .... * ............. . *## #
##.*. .#. * . \.  . . .....\.* *.\..*\#  . #...#....\#.#..... #*..*.# **.* . \ *.    *\. ..# . \.  ..  ..\#...*..#.....*.. \.*.. . . #.*# ....*. ..# #
#.. ..* ..#. .. ...#* \. #..  .. #... *...\..*.... . \#..#.#.. .#.... * \... ..  .....*. . ..#  .*..  * *.*#*.....*#....# ...\#.   ..*.*..*.... . ...#
#\* ... .*.*\.# . ...#*#.. ...\ \. ..#.#..  ...*...#*.. ... .*#.*....*.\  * \.##.\*..#.....\ *. .* * .**....# *.#. #......\..*\  ..*  #.... *.. .... #
#*\#. .. *.   #......#\#*  .\*.\.*. .......  .. \**#.\.....#.\..#.*.#.. .....*. .*.....  ....*.... #.# .. .*.#....... # . * .... ... ..  ..*..#..*   #
#.* . ... ....* #.. #....*  .*. #.* ***.. #.#* ....*#. .  ....*.......  .\\.**..# # ....  . ..*.....#..* ....#.  #.\#\... ..*.  ....*. .....* . *.. .#
#..#*. .#  ... # ...#.  ..# .....  *...#### *.....*  **#.. .*.  ..\.. ..##.#.*  #.**... #*.#.\..  \#.#. ........*#\\.......\.... . *\ ..#.....##\.####
#.....*. ....  .\ ..#.. ....  ..#. .....   .##** .#. ... *...*..... ..# \.*... ...#. * \. #.*..#**\.    ..##. ...#......*  ...*#*....\.#....\..*#*.*.#
#.#.#......*......##.. .# .\. . #  . *. .. *#..*#**#..\ .\..\  #.. **\. ..## .###. . .*..  .. \. .. .. ...*..#... .**\.........*.*.. \..#.*....*. *.##
#....**..... .*\ ....*....#*#.#....... ......*..#\ .*  *#..#. .*.. ..#\...#.*. ...## .*.*. #. *.. #. .... ##.  .....\... *.** .. .#.. *. .   ..#* ...#
###.\#*.. *..#.*. .\ ..#.\#.......* # ...* *  .. ..#. *. *.*..#\.**.. ...... #.  *.\ .#. * *.....\....  .* . .#.#. .. . ....*.*.\*....#..\.. ....* #.#
#.#**... . .#.#...**# . *...  .  ... .#..*. . *. ... ..*.. . #...# .#*. . *. ....   .....#.....#**.# .*..# #. #* .. ....\.. *...# . *..  \**..# ...\ #
#. .\ . *..#  \ .*. *##.....* \.\. *. .\*#\.\#.  ..*.. *..*    . ..  ..# * .. ..*\ .##. ..* . #* \..\.  #....  .. . *. .\. **.... ..*.*#.**.....#.**.#
#**.*. .*  ..### .##.#  ...#.. . .\. . .\.#..* ..**.**  ** .#.  ... .#..*.. ...#.*.. *.. .* #... ..#.. . . .....\..... ...*... ....#.....*.* *.\. . \#
#. ...##. .#..*.... .*...# \ .. .  .* *.* #\....*..... .\.... ... .. *#\*..#\ .....*.. \.. *#... ........  . ...#.......*... ...\***..... .....*.*.. #
#. #*#.. . .... ...**.*#..... .... #  . \...  .*....\\ .##*.**#.*.. ..... \. .\.... ..*..#\...*. .\#.  . #..... \  .*..#\*..* ... ..\\ ...#\\... ... #
#  \.....*..  .... *.\. . ....*...*\..\ *.\  .. ... ##\ .   ***   .. . .# .**. .. ...... . #\* #. . .*..#*.\ ...  ..... .\ .. .##.  #\ ..*..\..\.#.#.#
## ..    ...**.\*.....  * ## .##. #... \\ ... ... * .. #*.\. .. ...   ****.......#*.. *. ........ ..... .... #..#. ..... \. .  . .#... .*...#\#*#\.# #
##......##.#  .. \\ #  .*....* .. #..#.#. *...*.*.*.*.\.##..#..#...... ...**#.. ... .* * . . ....*  .*...#* . .#. .  ...*..*. ... \...\.##.**..... \ #
#..   .*........ ....*.. * . .*.#\..  .. ..\....   *# ...#*.. # .#.... *..#... \........*.......#.*...... *..... .*...# ..#... .*......#  .  ..# ....#
# .....*...#.* ........*.....   .*.*.. .# .\. .\....\ ..#.. .* * .#.# .#..*.*..**.......*## .* **..#  .#.\..*...#. \.....  .......###.....\.... .# *.#
#  *\.. ...#...*...........#.  ..*....*..\\.*#...\ ....\..#. #\.. .* *..*..* #. .*  ...**  .. \\.\\.*....*# ... .... ..* \..*...    .#.. ....**... ..#
#...\......#.......#.  .*......*..##*.#  . .  * .......*.... #*.# .. ....  . . ...... ... \#.... ...\*.......... ..#. ...#.#*...# .**.#. #.. # ...*..#
#. ... .\. .. . # ....#* **.*..\ .... .*.... .   .#. .. .#.#.*...... ..#.....#... \ ...*... #..\..*#.  .#*.. ...\......* .... ..\.   . .   .. #.. .. #
#.# *.  .\..... *...* . ......#.*\  .\*.##..    ..**.. #...**#*#. . *.  .\# ..##. . .  ...*......  #....\\. ....*# .... .........**...... . ...\...  #
#\....#..#..**#.... *. .....*.\# ....  #  \* .#..   #....*... \\ .. ...* ... ..#**.**  .. .. ...#..... . . ..\...... ...*..#.\*.. ..#.*.#.*..  .*. . #
#.  ... . ..... .\* .. .# ..# .. ....*..\\.... #.*  .\.. ...  \..\#.*#\#* *.# . .# ....\*\.#...*....*#.*.... ..\ ##...\....  *... .  . #. .*.*. *  .*#
#..   . \.... . *..# .*#*.*.* #.. . . .\.#\.*.#.*#.*.*....\**.#...*.. .# ... * #   .* . .  ..*# . ..*  .*  .*.. \. .. \ #..*..\ . .#.... .* .*.. . . #
#... .\*. ....\\....**.  .......... . \.*\\..##....... .#..*#.. .#  ......#.#...#. * .. #.. .*.....* #\.... ......# ..*... ...*.#..*... . .*#  #. ...#
#....... . .  .** . .*..**..#**# .. .. .... #  ......\  .#... \.#...*...... *# * * ..*  ..## .......#..#.\. .#..*. . #... .##............ #\ .*... #\#
#.*#.  .\ #* .\..*.#*.  ........ .. *....* ..*... ... ..*.*.......#*.... .... .\...*.  *#..##..\.##.\. . .\....**\##*.#..*.\ ..#. ...### .. ..* #.* \#
#..#. .....  .#..**  .*#... . . ...# \.. ...# # \... *.  .#.... ...... #... . .......#*. .. #** .#. .#. \*.....*...  ...\.. ..#*.....#..#....\...#. .#
#...#.#.  ..*...#\.. \#...# # *..#**.......\...#..\.. .... ..\..#*.  .. .   . .*..*#. *.#..*.#*.\* ..#.**..#  *.. ..*.....#.  .* **..#.#.#\...***...*#
#\.\  .\...#.#*  \*  ....*  .*.. .***.#.......  .....*. ...# ..#*...#..\*...\........ *.. .....#  . \.#.\ .#.\   .........*. ....*..#**.\.....#.***..#
#. \. ...#.#.*..#...\.*.# *.*#.*.  .*. #.........*.\*. .. \*.*...*# .*  *  .. ....*.# .. #.\.#\.*.#.    ..*...**#* . #. .. .*..*.#.* *...*....# .. #.#
#. #. .*\#..\#.\..##.#\...   ....  # ..\*.*.\....*..  .#.# .. \ # #...#\ *#  ..*. . .**......*.\.   # ......#.##. \.. .# \...#  .*..#.*...  . .. ..* #
#*....\.\#  ...#.**.#..\ .\#..\ \...*#\#.. .. #... #.... . ...#..#..*..* ....#. ...*\.....*..\...   .#....  \..*. #... .. ..  .  # ***#...  ..... ..*#
#.. \*. .......... ..#.. .  ***....#*.. ......*\....#**..\ ....#.*  #.*.##..    ........*..**.   .*... *.... .... * . #.# ..# ..*##.#....*.  .....  .#
#...  # .\.#. .#. .#.#. ..\\.#.*..  .#.. ......... .\...*.\. ... .. .#.. ..* \..........##.... *#. . .. **  ....*# ...#*.#.#.. ...... .#. ....#*.  ..#
#..* \#. . . ...* . *\.*.#.  \#.*..** *...*#*\.....*\# . * ..*..*\... .\.  \ . ... .* ...# # #.\# .. .... \.*# ....#..# *.   #* ...#\.... # #.\.\*..*#
#..#..# ..*...  .*..*..* .. * ...\....    **.\. ...........#. . .  *   .....*. .#.###.. #.. . .. ..  . ..\...\.**. *..**\*.. ..  *#\....#.  .. ..*.. #
#.\....*.#  *. . \. ...#*.*. .. ... .. \# . .  .. . .#\...*..*..... .*.*. .#.\. .. ..* ..... ....... ...... #.\ ..#. ...... ..\. .*#..#...#.\........#
#.. ...#... . .**... .... #.   .. ...... *.*. .#... . ..... .##... ..\\. ....# .   ......#  # .  \.*#...# #  . ..#... #*...#..\.#. . .. #..... .**. *#
#*#... .*.. *.....#. .. ..*..    ..* .*.*.#*\***.*.. .. .. . ..# .# .. .... .\.\..  .... . .. .*.. .\*.#....*. .##. #..* ..#.. .\\.. ..\ ##*\..###.. #
#.... *..\.. . .. #* * \ .. ..#.* .\*.\ .#.....*. **#. .*. \\.. ..#.\...#..*.###.. . *  \  ...*.. #*..    ...*.. ...\ ....*.... .... .....* \. *.....#
#.\*..*#. # . *# .. ...... .... .#  .*.*.#.....*\* ... . .#.   .....*.**.  .#...*\ ....#  .#. *.. . .\ ....\ . *..#. \..\#....*.. .#*.#*.#.... ....\.#
#..##.. .#.....#. . ...\.. ...*.. #... * .*.....*..*... #. ...#....... .*.... .\.  ...*\.\* ..# .*#. ..\ * ..*#. . ..* ... .*# ..*..## . .\.#..#...*.#
#.*.....\....#..##\.......\..\...*.#...... . ..\.. .. .*.. #...*#   #*##.\....*#.#..*... ...\*..#...*....#..*..#*\ *..\\ .*##*#\*....  .  \.. #......#
##.**#. ...#..# ..* #....*  *.# #. .\. .#.. .. ....*\. *..*.  ..\.**..*..*.. ..   .*..#..**...... ....... .. .*...\...*...* * .*.\. \#... #..#  #*.  #
# ...*.  .\..... ..#. ...\..  #. . ... .... ... .*.*.#  ..*   ....  ***.*..*..#.. ...#..*....**....#..*....#.. ** ..\.. ... . . .. . .. ... .    .  \#
#....*..*  . .  * *. ..\  .***#.\*#....\..# .. .* ##... \..# . *# .*#.....#\........... . ....\. .**.*.......*.*##.#.. .\#.... **...... .....#..... .#
#*..\* ... ....# **.. .#.....\.*......\. #...... ..*....#...#* .* ..  .. .#..#. **.#.#\\.# . .#**.* .... * .*.\\ .... .##... . . \#. ........ \.#..# #
##....#  \*\..#\...  #*... ..  ........\.........*. #.\**.. ...* *.#  *.*#.*.... ...# ..... ....*#.#...\. ***.  *#........ # \.. .. .. .. ..*.. .***.#
# *...*.*... ..\ .#.#. ... .#.#* #.  *.*. # .#.....* * ...* .*..*#..\.*#. ........... ....#..* .. ..#. *# .*...**.** ...\..\*  ..\#. ..*  * #*\..\*  #
#.... ....*.#.*... ... ..#*..... ...** ..* *  ..*..*.##.\.\# .. .........**.#.\ ** ...* *.#...........\*.......#.#..*  ..* .* . .* .....*...... .\. \#
#.....\\.. ....**. ...   #.*..#.*  #.*....   #*# \..\* . .. *. #.# *.. #.#.#..\.... .....*..\.* .#.#. . .#..##. \.. .*#   .\ *....#.#\.#.\*.... #.. .#
#    #  #  .*\....*.....*\..#\\.* ..*#.* .# . *.. #. \**.#. #.#...##.  \.....#.. . .#*.. ........#........ ........\...##\......\.#.*... . ..#. .....#
# ......#  .#. ...#*..#*\.\ .##...*...... # .\*. ..* ... \.#..##......#. ... .\.... ##..*. # . #...#* \.    *#\**\#  # *.#*.. ..#..\.. .... . *... **#
#.. .*.#.\ *... . .#.......#..##  #..\....# #.. .*.. ..#* ......# *..*#.*#..  .*.* .. \.. . **.\.* ..*...#.\...  . ..\.\.#.....*.\.*.....*......\.. .#
#....*. . .**.#. .... .\*..\..*. * ...... #......*..#.... .#..# ......  #.\\# . ..  .... * .*\.#.#.... *.## . .#..# *.#*.\. . \..\#.#... .. *......*##
#...... *.... *.. #.... #.# #\.**. . .*.** .  \....  . * .. .*. . .....#***....\.*\  .#. #.*.  .  .. .\.  .# ..... . .#.#..\.......##\ .....\. . . . #
#*.  *. .. .#.#..  .. #...... . .... .....#  .....#\ .# .....*\ ... # *...#. . . *. ..*..\* ... ..#. .... . #.## ..... ... ..   # *.. .#.*\\ * #***  #
#.. ....* . ..#.... #..*......\# ...   ..\#.#*#..  \.\ \#....   #*.. . .........  #.*.  *..#.#...  ..... *....#.*...*.  ..  .* .\.  ...##.#   ..\.. .#
#.#..*  ..  ... ... \*. ... .#..#  ...# ...* #.. #  .#.#..* .\  .... **...\.#.#.##*..  .  ...*  *## *  .#.   .*.* ......\.....   ... ..*   ..#..\...*#
#.#\.# .#...*..... .. *##*\\...  ..\## #* #..\... ..* *.* *#..\#\#....  .*... \ . ....... \..#...... ..#...* .... ...*..* .....*    .# . *...# ...\..#
#*#* *.. ..... *.\ ..#\. .#..*....#.......#.....*.. #.#..... .\....\.\..*.# .*#*.. ... ..\ .#\. #  .*#. \.#.  ......**\..\.#\*.. ...  ......*....#\.*#
#.   . .\*...  ..\.\....*\... ..*.** .....* .  . ..\ \....\.#..\ #\. ..*.\..##*.*  ..# *.... ..... #..*#*..\   *.... #  . . ....#*..... . \. *.    *##
#* .... *  #.*.....\ .*..#...*. ..\#... .. .... \.... .... .\   .#.#.#.##... ...#..#... .... ...   # . . ...\.... #.  ..#.... .\\#..*. . ..# .*\  ...#
#.**. ......# . .\ .. .*..# ....#..*##. ..**#\...##..#..#.##*#.*..\#... ...#. .*#*.*.##. .. *..**#.     .# #..*.*.\.....#.# ... ..*...#  .*\ \  #.#\.#
#*..** ......\  . #\..*  ......*....\. . *.\...#.#. *.\. ..#.. .*#. . .\ .*.\.. ..*.# .*...... . *.#..*.. ..*.....*#... ...\ ..  .###.. . ..  ... *#.#
#...#..... *. \ . ... .   .  ..*.#*......#..** .... . ...*##.......  .... .#  ** ... *..#.\..#.*.. ...*..#.....* .# ..... ...#... . . . #\.... ..* ..#
#..\**#....\ #. .. ..#.  . .. *.\ #\\..**\   *.*.**..  .###.*.*\ ##...##..\#.# #*...... ....*.. . .#.\... \#..#*.. .\..*\ ... * #..#. . ..*..... #..*#
#..  *#.\#. .... . ....... .#..\.... ..#\*\..#.......  .. ...#* .. .. #.*.. ..#   .....\..*..*  ......#..##....*... .*#.#*#   .. \.*... ..#. . #.  . #
#.... #.#.*   .**  ...#*.. .*#. #*.*#.*.. . ##.# #.*.#..*# .###\ . ... . .*.... #..  *.. .# .  .. .  .*.\ ..*...* ..... ... \ .. .....*\\....*.*.....#
#....*. .  .. .  # .*..*\#. ...#*. . .....#  #....#.....#.. ..  #.....  .\*.. #.#*.#..\.#.# .. ##.. #  .*....*..*\## .   ##..  ... ..\ ....**..\# ...#
#. ....# #*\ .\..*..#.... * # #..**...**#  . .#.##   ..    ...#........*..  #....##.*  .... #.#..... ##. .. *..#.... \. ...#........ \.  *\. .\**..*.#
#. ...#  ...#    *\.*.. #*.  \.  ....#*..*...*\.#..#..# .. \ ..*... .  ..*\ #** .. . *.#.**   #*.. .* .... .. # #......  .\.  ..*... . *..#. #.\....*#
#*. .# #*. ..   .......\.*........ #.*. . *... . .. #..... .  .  \....#* \..#.  *.....#\. ..\*.*##*\..* ..#...  ##..... *..... ..  .\.\##  ##.*\.. ..#
#.  . . . *\. .#  .*..*. .\.#... *  .#\. #....#..# # ......*\.**.*.*.#..    .  # ###...  ..\.*\... . .\. .. . **. ..* ...  .\..... **. ...#  *#......#
##*. ....*#*... .*.. *. ..*.#...* .. #\...##..#..* ..\...\. # ...   ....\#..#...\ # . #. .. *..##.*.  . *.*.# . **.. ..*. .. ..*... \.....#. *.. ..\*#
#  .*  .#.. .. .  .. .. \*\...\* .* .. .. . . \ ..\..\. .*.#. .*.*. .. ..\*..\ ... ... . .  *.... . \.. ##.......**.#...... .. #.. #.....\*.##...\. .#
#** .* .... ...#*... *..* \  .. ......#. #.... *  #  ...#.##.....\ . ##*..  .. . ...#.#.... #*. . .#..... .#......... \..#.\\**  ..#.  .\..##  *.....#
# * #\. . ....  \..... .*.* . .... .. ..*....\*\..#....\.*..* **. .**  .......**..#.\.. .. * *..\. *##. ..#..#*#...  ...\.  ....#...#... ..\ .\..\ .\#
#.*.#*.  .......*..  ...#  .......#. .. .#.##..*.\..   ...  #\   **..#.*. .#  \..*.*#.....  *.*.#*...#..##.* . ...\... ..*.*.*.......\#.\.......#*.\.#
#\. .. ...#\..#.. .. #......\ \.#*...## .....*# #.....* .*\.... .  \#..... ..#* #.. # ..*.#*.. *\*...*......#   ...  *.*...*.*..#* .. *...... .  ....#
#...* *... \.. .. . *# #.\...#.... \.*.\.*. ...  #  .\..* *# #.*# **  #.## #.. *\.\.*. .. .#**..#.***. *.  .# .\  \. .*.. ....#. ...... ..  #.  #....#
#..#..#..#.....*. \ ..## .....*..  *.\**.*..*.....#*....*....*..*....#...\.\* ...  ... \... .... ... .. .#....#..*.  #*. . . .    ....\....\.# .\ *\.#
#.#....  . ...... ..# .#........*#  \.*.  ..#. .\* **#......  .#....\#.##.. #   .. .   .*\.. .*#.......#..# . ..*....  #.. *.#*. ..*.... *\ *.. ....##
#...*.  ..#.#..#....*  \.**....\.  ..\. ..# . .*# *.**.\ .\....#.. #..... #...  . #... .  .\\ *...*...  *\.# .#..\ \.*.. .. ..**.* .# \\. .# .##..*. #
#.... ...#. #..*.\**..... \*. *# *.**.. \*.\.......*\.*..  * *.  ..  #. \. .##.. #   *...... .. .#.. ....#. .......#..#... .......... .  . . ....*.#.#
#. ..  . .....*... ..#....#  .\.. . .. \. .. .\ ........ *#.. ...# **..#*..# \...# #.. #......# . ...... . ...# .\.*##......#  \.#..*...#.  .##.#. *.#
#. *. . # .. .\\.##.. .  .. #*. .\#.# # \.. *.#.....\....  *...\...... \. #\.  * ....*. * #  #.  . \*... *##....# .\.# ## .#.#*..   .*....... ...#...#
###.#.*  \.#.##......*..#  * .#* .\ . \.#...# ......#\ \..*....# .. .. ......*#. .* ...    .. .#.. .\*.*..*........ ...  ..* .*.  . *.#...\ .*..... .#
#\.#*.........#\\.*.*.  .#.... ....#**....... ..*.**#..\....  ..* .*.*...#.*.....## .*...  # .#.\\..*.....  \.#..#.. .#*..*.......**.##....  ..* #.  #
#..#*\. .. ...#  ..*.#.. .#. ....#.# .. *#.\.* ...*..#. .*.......*.## # ..*. * .*..**.. .#....*.....#*.#. ...\.###  ..\# ...*  .... ...*...  ...#.. *#
#... ...  .#  .#*....#* #.  * ...#....... ...*.*.... *... ... .  .\.. \ . ...*...#.*.. \ * . ... . .\. .. .... .\...\##..#*...... ... .. ..*  ..#*...#
#.     *...# . .*.\..# . .  #. . \.... ... * . ...\.. .... ...*.. .**..# . ..  . \ .* .. .. . ... .**...   ...... ..*#...#...\*....*. .. . #..... ...#
##*...*.*\  ...  .... * *\.....*..\ #*... .. .*.*.#... * #*.... **#*.. .# .\. . ..\. ....\#.   ....* #..*.. .#.\#..* ....#..# .  . .\...#..####. .. .#
#.#\ . *##*..\...#..#. .... ##... .#.. .. . .. #..  ... *.#*..\\*.##. .....*.....*..\.. .###.\.... ....#.#.##.## ...*......  . ... . ## ##.*.**.#....#
##. \. .  #  ..  ............ ......##..#. .... ... * ......#..  . . **. . * . .#....  ... \..\. ...*.\. ..#.. #.. .#.  ..\ .......*...#.  \ ..*# *\ #
## .. ...* . ##.*... . .. .. ..\.. .....#.....#......#.#\..*# *.*.. .* .#... *.. \.........# .#..*. ......\#.*. *..  ........... ......\#..  ..\..\. #
#.. * \ #.    #.....#*.......*  . .\#\  .... *.* \.# .  .  .....#. ....#..\........#....\...#\*  . .  ..  ....... ...*.#..#...  \...... . .\.. #..\ .#
#.. \..*\...... ## . .. . ..* ... # ##*.*..... .\.. * .....#. *. .*. ....#.# *..  ..#.. \..#.. ..  *#.#  \.#. .. .. #....  ...*# ... *..*..##.*.. ##*#
#  ....* . .....**# .\\.... #. ... \#*.#..  #... \. .* \...#\. *...   ...... *  .. ....* ...........  \....#....\......\. ...#*..#. . ..#.  ........##
#*...... #. .* \ ..# . .* ..#.. ..  ..  .. ..... #.........*.*\. . .........  .*.\. . **..#\.*##.\*....\..\..#\.. #*..#*...*#. ..\.*   ...  ..*... .*#
# ..#..*.  \#  ...#..**...*.....\. ....#.**...*#.#...#.*\..  ...\.#..#.... #..... #*\ ... *\\...#.... .* \... .... ...\ ...# . .\   #  \ ..*.....*..*#
#. .....*..#.#.#.\.#*........ . .\........ . *. ...##  * *.. ..... .. ...... . ..*. ..#... .\.#. # ..#.... #...  * . ...*.#.. ... \ ...\... #.. .....#
#...  .. ..*.*  # *..*. .#.. .\........* ... *.. \.#..... * *... . .*#*..##. .\..#...*.. ..# ##. .\.# .  ..... ... .. ....#.\...\ ...... . #..\#.*#.##
#\\#* ... .# .\..\.\#.# .. ....*.\# \\\.#  \.. \.*.* #* .... #*\...#.#...* .. .*...#...  ....\. .. *. ...#.... ..#. ....*#. .*.**..#.#.# *. ..#*.*#. #
#.. .***...  *\....   \  *.##.##..*.\\...  # ..*........ ..*..... .#. ..  . ..\... ..#.....#..  ...  \ .#\... ..# .*.*#...#.  \*\. ...#.....*... ....#
##\....# #..*......  ......  *#.\### .* ##..#..** ...*\ #\ #..\## .*..*#.. ..#**#* .....*#...*..#.*.*.#..#.*. \\ ... ..*...\.*\ ..#   ....... ...... #
#*\ *.... .* ... #.#  . ....*..  ..... ...#....*..\.#. ......#.*...* .   **.*.# .... *.#. .# *. ** ...# .. ....**..# .     ..*.*.*\.  .. .#..*#... ..#
#\*..##..##...###*....* . ..............*... . *.\..#.#...# .. #...\#*.*\......#* *...... \...*.#.....   .#..#* #.#.\ .. #..#. ...#...\*..*.*.......##
#.. . #.##*. *\ *.# .#...#.. .....  ..   ..# ...\#.... . .. ........  . .......#..#.\ . ..   \*#\#...... #\#.......#.. ..*.. ..#..#... . .*  .. . #..#
##..* ....#. ... \.. ...\ #.. . ... # .# **... .#*..#.#..*...... ..# #.*.. .. #*#\*. .. #................  ...# ...#\ ...........\ *..... \..*  .\. .#
#.......#... ..# .. ..    ##\ *.\.*. .  .** \.**..*.....#....##...#.. ..* . *  .**....  *.**#. #.#. .#..##  ... .# .# .....\...* ... ....*....\# ... #
# ..**..  . #.. ... *.#....*..# ..\ *\.  #  ..*..\**..*.* .  ..... #.*.......\ .#  .#. . ..\ . ..#.. *.. # \.. #...  ... \*..***.# ..   .\##.. *#*.. #
##.*.#...... ... *  #..  .  .  *. .#.#*.#...  #.#*   .##.. # ...  # ..#* .*. ...\..*#...\.. *#.\. .\...#.#\...*...  ....#*. .. .. . \ ....** ##.. ..*#
#\.....\. .*.*#... .. .#\.......*... ......  ..*......... *.# # # ##.........\.....  \*#** ..  ......*...  ... ...\. .  ..*#*. ....*.. .  . *...## \.#
##. .... .#***. *#.    .. *...##.......  ... * ....   .  \. \*\## ...*.... .... .. \...*... ...#..# #*.\#*#*....#.. .... .\..#.##.* .*....#.\..*..\..#
#.... # ...# .. ..*.\...  ..*.* .\#  .. *. #..*..\.## . ##*.*.*... . .# .#... .. # \..*. *. \. ..*#... . #.\ ...#  ......#* .* ... ..#*\\.\#*. *. *.*#
#..*.* \..  ###  .*.. .. .. #. ..#. *..  # *.*. . ..* .. ....  . ..*. ....... .  \ .\##\.##... .. * \ ... #.\ ...#\. . .. .\..## . ......#*   .  ##.##
## *.  . ...#.  #  #* ..*...# ... . .... .*...# .*.* ...#.....    #..... *#.#... ......*#. \...\. .. ..\*.  ... ..\. .#... *\.* *.*.## \.. .  ...#...#
#..#*\* #.\ . .\..\ .... .#... .#\*\.*... #.*  *..*. .  . \..... ..**.*  . # .....* .  ..\.*#.# *.. #\..... #.... ##..* .. \...#.\.. .. # ...#..*.. \#
#\#\.* *....*.. .......#.# *..#...*. ....#..  ..\# .\.. ..\.. .*. .#....\.. *.. .#.. .# ..#...  .#.. ...#..**   ....**..... * .. ..##**##..*\\  *  *##
##. # .... .\* #..  # * *\#....* *....\. .#..#... *..\...#.#........ .*\ *....\..*#..  .# \.. ..#\... .  ...#..*#... ..  .*..*. .. *..#...*....*\ *  #
#  ...*. ..*.  . \\..... ...\   ..... ..*..## . . .  ## ..  . ...*...#..\ .  #. .#**\* .... ..\...... .*\.*\ . ..... .## .*... ..\#..*#...#...\.*#...#
#.. ...  *.....*  ..  \#.#\ #.  \.#..  #..\*.  .#*..... *....#* ....#..*  ..#. .\  ..  .. .. .#  ....  ..## ..# .  \\.....#.........\..... ..\...##*.#
#. * * ...# .*...  ..*#. ..\.....  ... ...*\\\*.#..*#. ...... .#....#...\..\#  *. ..#*.......#....  ..  ....#..*.......\\..#.  *.....#..\. .. . .#..##
# .#* *.* .. \.  ... *.... #... .*#...... .\*..*.* ...\....##.. *.......##...*.....\.. ...... . \..#.\......#... #*... .* ..\  ....#....\..\*.... .*.#
#.*#. ..#.\*.\.##..##..  ...\.**# ... \.   ......** . .#.. ##* ..* *\.* .##*  .*.#.#.. *. .* ..  .#..\#\........*...*. .  ...#.*.\*. ....*....*.*..#.#
#.\..*..#.... .\##..#......... ..\.***..  #. #.....**... ..#.# ... #.#..*. .*.   .*.. #.#.*#.#.*..* *\*.. #....* ....#...*.. ..*#.* ..........\. .* .#
#..*.#..  *.... ... *. ..  ..............#\.. .  .#\  ... ..#.. #. ..\..#*..# .*..  .** .* ...*.#....   #... .*.\.#..*. .*#\* \.   .\.#...... ..  .*.#
#. ...####.......... .. ...#.   * .. . .\ ... .    ...**#. .. \#.   ....  .# ....\... *..#.. .. .......  .#*...#*.....\.#* .#..#*..\. #.#  ..# .## *\#
#..  .#....*\* . .\. ..*...#.. ... .. *.*...#.....  ... **.... *.. # *..*.....* . .....\ ... ....# #*## .*....#  .#.# .*#.#.. *.......*  .* #\.#.... #
#.\... .  ..\.*.#.  .\*.*.... *\##..\. .\  \ ..* .. . ....# . .... .\# ...*.#..*.#...... . ... . *.. . .....#. .*.. ..... #.*..#.#.\ ... .*#..#.... .#
##########################################################################################################L###########################################