###################################################################################L##################################################################
# ...#. *...  . ..\ #... **.**  .....*.## ....\#.* #  .  ##. . ..#*.\..##.  #.....*.##..*#. .. .... \. .*.   ...*   #. . ..\..\. .\...\ . . ..**#\. ##
#.. . ...\.*. .. .*  ...#..\.. . .  ..#....*.#.**......*#. ...  ..\*. ..#... ....* .\*.## .\.*#..###.*. ......#*...\ ... ...#.  ...\.. #.*...* ......#
#.....\...*.#...\....*.# ##.....#. . ... . *\.....*.# . # ....* *.. .\###.. ........ \....\.#   #..#*\.... *  *....##. . . . .\...\.#\..\\ *. ...*...#
#  .#.#. ...## # . .. . \...\... .#*..#. .* \....#. #\..#.*..*...#..#### #.# ...*#. *..*........**..#. . .. .*. ...*............ .*...*.  *#.*  .#.. #
#.\.....*.....* .  ..  .**#... ..*.... ..... *..\ ....\..  ... ..\ \* *.#.*..##.# \...  .# .. . .. *.\.*.*..* ..* .#. .. .*#..#.*...\.. * *.. ...  . #
#..\   #.... .#..*...\.....#. .... ..#...\...\#.####*.#...... . ..*.*. .### \.\.. .**...*.........#. .... # .\.  *.#*.  .#.**.#*#...#..*.. ...... . .#
#.#  ..*\.#  .. * . .......\ .*\..*...........###*#. #.*.#.. .\..#*.#.* ........#**.. .. . ...\..*.. \.  ...\....#..\.......#\ . #...#. .......*...  #
#..# *......\*  .....* ..#*.#.#..* \. .. .#.*. ....*.#*..#.\... ..\.  . ..*..   .*\......*....\\. .......## .  .. # . \.#. *.## ....#. . ....  \\ ...#
#.. #. ..*#  .#.*.. . .........  .#\*...... .*.\##.....*. . ***.. ..  .#.# #.#\ . . ..\..* .#......\ ..   ..\#\... ... . ..  .... *. **....#. .....* #
# .* .   *.........\\.# .... *..*.* \#.#.... ##...  . .#*..\....  .\ .*.... ...#......**...#.. .. # .\*. . # #.\.*\.. .... .#...#.. \.....*....*  .. #
#.. .*. .... . .....*...  ...*  ..#..*.. ...  .. ..#.#. ....\ .. ..... ..#.\.#....#... ...... .. . . ...*. .*. ** *.....* # #..#  .. #...\.  ....**\.#
# ...*.\. * ...*#.*....#.*..*##. .... #.*.  #* . . #.. ....#...#\*.*...*##...*\##*\#...#. .*\ .*#..*..* . #.*.  .......*.... * #.*. **..**....\. .*..#
#...*....**.#.#.....# * . .#...#. ... *\\*.*#   ... .*.\.. ..\.. .... .\ .\  .#.## \..*...\   #  *......* .#*# *\. .*......  .*#.#.* .\..  ... ...*.##
#.......*  .*.#*. \..  .  \ ....#... ... \  \.\  .  #*. *..*..#. * \*.... ........\  . ..*.*.. .#.#.. *. # #...... ....*.. \.   ....  ..\....... \.*.#
#.*. ... #*.*.*\ ..#....   .#*. .......*.* . ....*.#\. .. . .. #.. ..*   #. #.........## ....#.\. . .#. *.*#..  ........ ..#  .   ..#.* . #.#. .*. *.#
#.#.....  #.... #\..... *...**..   . ......* .***.....#. . ....*  .....*.* *.#\.. . ....  . .#\ \ .. ..#*\ #  .  ... ...#.... *. ..  .*  .*...\.. .# #
#.#.#.*...*. .#.....  .*..#..#..*..#.\.. . ...  .##...#...#.  .  ..*...##*. ...**.......\ #.#.....\....*\* ....*. ..*.  *\*.*#  . ...\.   *\ #..*\#. #
#.  .... . \#\*..*..# .......**. #*#*.\..#......# .. . .... ##.#.#.....*... ... .#..*...##.. . ..... .**##.#..\ . .*..   .\\.\... ..#..* * .# ... ...#
#\... .#...  .\  .  .......*. . .*. .... . . ...  ***#. ...... ... ...## \. ... ... . ... .. *. .. *#. ..#*....\..*... *.##...  .. .... .. ..*.*. ...#
#.*....*.\. \..#*.. ..  .*###.. ... .. .. .......\*... *... ..* \ ..# *.\\#*...*#.... .*#\. .#...* ........**.*.##. .  #. ........*. .#..#..*# ..#. *#
#..#...#.#  ..*\.## *.# . *.*. ##*.    ..... . .\...* ..\. ....#\.#... ...#.. ... .. \ ......   .*.\. ##  #...#.  \..\#..#\#**\*...  ....*... . * ...#
#  .. ..#.***.*.**........*#... *.#.\. . ..#.  .*.. *#.#\*.\.   ........ ...#......  ....**. .*.*..#. #**.*.. *... ..* ....... ... .#*.   *..*\..\...#
#.  .....*.. * #\## ..\\.  .. . . *.\.*#\.. . . #......#*...*. .  .. \...............  \...*.#... .#.# *... .. ..#.\.. .#  . . .. .....*#...#... .*. #
#....###.#.*.*#. \..... ..#....#.........#. .. . .. . *  \... \#... #.#  *.  ... .#*....#.. ..*\  ..#...\.. .# #..#*...#.#... .. \.#. .. .*.   . .#.*#
#.# \...   #.  .. . . *....\. *. . *..#.# ..\..... ##... ..#. . #. ......... ...... .. #.\. #**   .   #.....\.\.\..\#..\...*...#* * ..... . .#..... .#
# #.#  .**#*.*.\.  . .*.*.\. ..#.*.....##.#.*\.* . ....\........\..*...#.... .\ #  #....#... .##..\.# . ....  . #\ ......\..... .. ......#.  \\ #..*.#
#.. .*  *..#.*...##. . .... .#.#...*..*.* #.. .*. #... *.#.... . # .*.#. #....*. .#.  .* #.#...#\#.. . .  ....*..*..... *.#....  .*...*.. .... .. .. #
#\  ..* .*... **.#. .. . .\. #.##.#. ... ..#.   ..#.  .. .* .*.*.**..#.# .#. *.. \. . #......#   * . #.*#... ......  * ##.#* \. #..#\.*## . .. ... #.#
##\........# ..#.#...*... ... ..   *#.# . #  .*.#  ........#.....#..\#\..\....** .*....*.*#*.#..\.#....  ....*.*..\... ..*\*\ #.... .\... .  *.#... .#
#* ......   .. .#......*\....# ... \...#  ....#.. *.\.  .. .\#. .. ........ #*#. .# ..#..  .  .\. ... \# .*#.  . .#... .. #**...... \#...#.##..#.. . #
#...# *.\..#...# \.  \.*.  .##   . ##..*....*.*#.....#.. ... . .. #...#\ # . .#.## .. \...  ........# ..  *  #..  .#..# ..#* ... ...... ....##.  .. .#
#\ ..... ...\.*.....\ ..##  .. ... \..#. .   .    ..\.\..\.  .#..\ ..# ..... ##.. ###\..\##\  ..  *#...#.  .*....... ... #*  #...*..  .*..*\. *.*..**#
#..#.    .... \....# .. ..*#.*\...*.....*. . ..*\.. . .. ... .  ......#.\*.#.#*.  #..\#. . *..#.. ...#...... .......*\.....*. .. ....#..\... ..  *.  #
#.*\..   #** \.# *..#\.*...*. ... #.\..  ........#... ... . ..#...*...*.#..#.*..#.# .*\...........  .  .##    *.#... ...... . ....*. .#*  .. .\ .*\. #
#\...# ...#*\  .. #\...... .**\ .. # ..# ##...#. ... . .*.....  ..\..*.     .* .. .#*\....  \.....#\.*   .......#*...##.*# .. #....#..\.#..#*... .. .#
#.\.....   ...# .\...*..\...\\.# . ..  .#.  .. . ..*.#.\.... .* *. .# ...#* .*...*.#.. ...  #. ......#.. \... .  .. . .#. .... #...   *..*....... .  #
##..* ... *#  .. #...*.   . ###.#\......#.*.# .. ..#*. # .....\. ..  #.  .. .......  .  .. .* ...\# ..* . #. ....#   *..*.... .*.\.\.*.*.. ...#*** ###
#....# . .#*.\.\. . . ...... .## *.\ .#.#** ##\*##....#.#*......#.##. #. .\...#.\# ....#. * ..  * ..... .\..*. #... ......#  .\.... .. ...# #. ...#..#
#.* #* ..#..*# .. .. .#. \...## .  . *.. .  ..*. . . .. ...* \.#.\*#*....... . ##.* . .*.#.*#*  .... .\.  ... .# .#..... .*.#..\...#. .#.... .#....*.#
#.#..\.. *...\*.. ..**\... \..##\..  .*#**..\.*.. ...*.. # ..*......... ..*#.#.#.......#..#. \..\.  .#\..*  **. . .. .\.... *.#. .##.#......*...#.*..#
#. .* .....*  .   # .# \ .*# .*..  .   .  .  *...*..... .# . #. . .#..\*....*  ..........***...## *#.* \...\*.#...#. *#   \.*\...* \. .......#..# ..*#
#...   .... .*#....*... .\#\*. ##. *.. .. . ........ ...##...*.*.. ..# .. .*\ #.  #  .. ..# \...*...\# # ..#...  #......#  \.##...... .*. # . #  ..\ #
#. .\ ..   \. .  .....*..*  *. . #.... .*.... \ *...#. ..*#...*.*  ........#.#... ..##..\.\ * ..** ..* . ..\ . .#.#.. ..*..*.  ... . .  . . *..*..#..#
#\..# #*...#*.#.#.*#*....* . .... ..*  #. .##  .\#.. \ . . ..... *..#  * ... . *. #... *....** *......\..\#.#... .. \.#. #..* . ..#..# *.# .... ....*#
#.  ..*..#..    #. ... .......#.*.## .\\...\. . *..\***.  .# #.\.*....  ...#.#.#.. .. .\ .# .*. ....#.*\.#* #..# ..*.*####.. ....#\.#. .#...* #......#
#..   \.*.. ..... .*.\#..  ... *\#* #..*..\#.#.....# .... #.#...   .#* ..* . .  ....\....... * #...\.  #.. .*. . *... .# *#..***......   .#  .  * ...#
#... ...* .. ...  ...#.. .** #.*... .... ...#...* ...\.. .*#.... *. ....\##  #. ..*# ...*..*.. \   .*.\.....\..\.\*.\.....\.#.*#. .. #..* ..***  .##*#
#....... .*.#..  ..... .. ... .*.. #. .. .#..#* .. ...*.. ......  .....  .  . *#.\..  .... .  .#. . ... ..... ....**. *\ ..\..... *.#...**.  #...#..##
#. .#. **...#. *...*#......*.*..*......#... ..#...#   #.\# ...... .#  #*.....\*  ...... \**.. .......\.\.  ...*....*..#  *# * #.##... ...* ** ......##
#.. . ....#...##..**.#.*..  . .. . #.  *..#.*#  #.. #.**........  ..*...*\.\.#. **. .\...#..#... . .. .#     * . ....... .*..*   .* . .*.#...\.#... .#
#..\... .*.*#....\.. ..**#*..#......\ .*.. * ##.\ .  ....\#**#.#. ..* ##...*.* .* ..\...#.# .... .... . .#. *. ... . #..#**....*.....#.\.   ..\ *.. \#
# ##..#.. ..\... #.## ..## #..#.\...... .. .*....#*. .\.#..*.**..  # .*.##...** ...\*.  #  . *....*..... .. .. .\  *## .. ... \  .#* ..#\\.\*.#..#*..#
#..\   #.   .. .*.. *.#....*........*. *..*...**. ..  . #..#\.  ... *# *. .   *..#*.*.....# #.. *.....*\**\.. .....*.......*#.#.# \.\. ..\ *.#. ..#. #
# . ... # .*...\  .*..*......  *.\*.#....*. ..* *.  .* ...#. ......# . ....*. .*. ...*..#..# ##.*.. \.\..\..# ..\......#. *#...*.  \..##*.* .#\..# * #
#..\*..*#...\.\ #..#......\... \.# ..#...##...\ . #.*..*..\* . *........#.*  ##... ........... . .......... .\.*...* ..*.. \  . *.. ...#..\* * ... \##
# **........ .# \ **.. #........ ..*#  .  .... \ ...*. ...... ..  .  #... #.\*.......#. .* \.*....#*..  . #.* *....*.... #..\. ...#*.. # ** .. *.. ..#
#* \.#..#.*.. .*.#..*.\#.* . . #*#. .\.*.##.*....#...  . *..*..  ....  ***....*.  \... ..* \ .....*..*.. *# .# .*#. ...#   . .. .*#*.*. ..\ .##. .***#
# ...   ##.##.#*.#... . .*#.#*#\..\#.. . .*..#.. \....\... . *....\.. ..#...    ..*. ..# ..*..\ .  # #.#. #.* ..##*. \#. *..*\*#* .*... ....... .*..##
#. ...\........*.#......**.....\..*.. ...  # .   ...#..#\..\ # . .......#.##*#..\.... ..#.#.* ##.*#   . .. ...\...#.*  . ........ .*...\*.. #.##..*..#
#* \\..*#. ...   .*.... ......... ....* . ..  ....#   .\........#..\. ....* . .*......*. *   #* .#\  ... ##* #.  #....... . *.*#... ...#\*.......**..#
#..  # .. ..#..**.*. \..  \.* \.\*....*...# ....*. \*.\.. *.##......*#...##... #\*..  .....#.. ..\  .**...*.  ...  ..*#*.\..# .....*..*.. *......\ ..#
# #... # # .# # ..*.#...\\ # \. .   ... .*.  . *.\.. .#.# .*.... .. ..*... *..* # .# *\*.*# *  ...#..*...... .#.#...# .... ...#.#.*.... * . .** .....#
#. ... .# ..  ...#..##.... ..*.. ... . \*..#. **..\* *..#.*.*#\  .....\. . #.** ....  ....#. . ...\....... . ....#.#.*..*.*.#....#.... *....***#. . *#
#*  \  *#.. \## ....*.  *. ..  .  ... .\...#.*. .#...#..#.  .#.#**.# ..*... *...##..\....  .*. .*.......#. *#*** ... .... .*.# . ......#  *#......  .#
#.  . *\.. \.#... ....**......##. *...*. ...#.\. .. .#*#.#*.  ....* . #. #.....#.* .#\ . #....   *.*  ... #.#..#... . #... . #\..\..*.... .. ##.* .# #
#. .*.. ..  .....*..#*..*... *.#.... . .#*....*#.... #.. ##..R.\....# *....   ..#.#.\. ..\#   #... ..*. .... ............ . *..... #..\*..#..*..#.**.#
#... * ...\ . .# \ . ...... *.. .#. #...\  ... .*.. *. .\... #  .*..\.#.**.*#...............*....###.... ..##.\.# **. . ....#..\.#...\ *\......#....\#
#. .\\..#.\.. .. ..#\#..#.*.# .##..#* * . ...\..#\...  #\ .  .....*#****... .#.  . .*.#.#. * *.*. ... ..... . ##.\.. . * .. ..*.....*.. ...#.  .*.  *#
#..#*....   ...##  ...#.  . .#..#\.#.... *.*. ##. .#......#.\#.*...\..*....#*#  ... ..........  \..#..\.\.\ .      .#* *# #  ...#... #. # .#.....* * #
# . . \...\.*..#. .* .#* #........#...**....\ .. * . . .\. ... . .  ...# .**..*#*.#..*.\*..#.....*. .##.#.....**.. **.##...#.. ....*... ... ..  .....#
#  ## ....#...*\..#*. *......#  ...#..\ .. . ...\ \.. ... ...#.. \*#.#*#.#.... . . #...  #**..* . ..*.#.* .*. ...* .#.* .....\.#  ....*..........  ..#
#...* ...* \..... .#**# ...*.#.#...#.. ..*\...* *#. .. .\*#.*.# ##..#..... *. .\ . .\...* ..\.....* \..*#*#....#*....*    .##*.#  # ..#.. . . .*.##*.#
# \.* .**. \.#.  # .#...... .. ..**.*.* ... #*...#.#..\#*  ...*..#..#...  .. ......#..*   ...#.  # ..* ...  ... . ..  . *#.\\..   .#.. *..#..# .....##
#\. *  ...*....*...#..*. .\.\*.##.....**. .*..#\#\\. # .##**#.#.# #  .#..... ..#*.....##...  #.  ..*# ... *... ..   .....\.#.* ...* *.\...**...##... #
# * .....##.#*  .#   # \*#.# #. .\.*#*..\.  ...\*.. *.......  .. #..... ..#... *.#**..  ..\...#. ...# ..... *.. ...##.\.\.#\#...#.##. * #. ....*.  ..#
# .*...#.#..  #  ..#....#. * ...*#.*#...###.# * #...#. .#\... #   #\.. .. #\..#*.. ...#... # .......\.  \ \...#....*..** ..*#.... ........#*.. . \. .#
#. . .#* *.*..* ..*....#\.  ..  .*..*......  .....#..* ...##* #..... . ...#.. .. \\.*...*.##.\.. ... #..##.. ..*.. .* . ..#. . ..*.## . #... . .#...*#
#.. . ..\. * ..#\.\** .*\..     ........*.... \#. # ..\.#. .# . .  *...# \*.......**... ... .... .\ ..# ..\ \.. . . .*........#.#...#.#.. .\.\. .*  .#
#*.*.*.*.. .. .\#\\.....#*.........*....*.. *\  ..... #..........\. \.\\..\* .*... . ..*......#.. #.#.....*#  .# *.. .\\\..## \..\ ...\.*\  .#...... #
#. ...*.\.......  * *. #...#.*..  ..\....#.....**.... . #...*..##*.#\. ... #..  . .   ...##.. .#.*#.*. # . . \..\ #\.* #\..*... **.....#.*......# \..#
##... .......  ..... ... ......*.... . .# ### *...*  *..  #. .# .  *\  *..*#.* .......*... . .. ...#.... .... ....  ........  ...*. #...# ...#.. ....#
#..* ..#*....##.**..##*..*.. .#  . \*.......**..#..*..*\#   ..   .\......*\.*.. .# .. .. *.#\. .  . . .#.....*.... .....*#.\#\\ .\.   ..*.  \\.... ..#
#.. . .\#\. .**\#\...# *......*...#.  \#* ....#.*.\..... \.....*. ....*...*.#*..... ..***. #..#.....# ..*.\#......... #..#  .\ .. \...## .#.. *.\ . .#
##.\..#\ .#.*. .. \.... ..# *#...*. *#... .# #..**\ *#* .#. **.... . .\.\*  #...  ........ .\..  # #.*... **... .... ..* .. .# .* ..***\*..\....\.#  #
#.  ....*..\ ..\. #. .\* .*.#.....#.... *.# .... **  ....#*...#*.### #\...*#*....#...\..*...# .*.#..# .*# ... #   .. .* ..  ..... .**...*. ..........#
#\  #.  ..*#.*#........*...... .* ... .. .\#...........\.. . .. \.......#.   ..* #.\#.#. .*.. . #. .* ..##  *..#..#......#..\..#......*........  .   #
# .....##.#*..   #.#\##.... .*..........  ... ..\ \..*#..    #... ...*...\*#.... .....*..#\ ... .* \..\..# . .....#..*.#\.. .... .#.. *....# ......*.#
#... .#\. .#.. ..*. . #*..*..**. . ... ... #* . ..... .#* \  ..# *.# #*.......\*.. ... ...\  ... .*. . . *#... ............ ..*#..... .#.*  *.\#... .#
#.#...#. .  . *. . .*.#..*..*... ...*# ... ...# .. .*... ##..##.** .\.#..... *\# \*.*.##*.\. . .. . .\ #.  ..#... ... ........ \ .*. .\....*#..\#.*.*#
##. .#... ....  ..# \ .. #..  .\# ...  ..*. . ......#\* .*.. .......#... ..... #..*.*.....#*...  ...#.. ..*.  .. #..##* . ##..*. ...*.\#....***..**..#
#...#*  .. . ..\#.* \.  .. .*...** .#... ....##...* ..#\... ...*...*. .....  # ... \*  \.\.\. .#.  .... #. #.  ..*...#..  ..* .  . #.#. *.#..#....* .#
#.... #.. ..*.  .*.. #.  .. * ... .*#.... . *. * .*.*  \**..\.#...*..... ...*..... .\*... .##. ##*.... .. #...  .. .*...#.   # .** \. .**... .   .**.#
#\#...\.. . ..* .#* ##... ...*....... ..##..\.\.  .  #.*.\ ..\. \.. . \.*  *... .  .*\\... . . ..... ..* . .  ..\*.# #.*.. * * .. .#. ..#*....... *..#
#. *. *#*...# .*......* #..#*..#..  #..*..... .#\.  ...  *\.\.## ... *.## ..\  \..#.....# \ #**#*#.   .#.\ ...#....\.#. #..* .*.\*.\... .*.#.# .#....#
# .......*# . \.  *# *..*. .#\#....  .# ..... . #\..   .*.. ..* .#\. ..#.\.#..* .. #*..... *..   #. .... ...*\ ..*.... .. . ***..*.... . ...# .. *.\\#
#** ..* .#.  .....*#.....#.. *.. # ##*.\#...\.. ..........#.# ....  \#.... .... ... . .*#. ...# \...# #... ...*...#*.....# *. *.*#\*...##.  ..  .. ..#
#*....#  .  ...#  .....#..   ....\\ ...*.......**.. .#*\.. ..\..\..*.# .#. . ..#..   . .. .. .#. \#. .. ...\.. ....\.*......#........  **..#.*.* ...\#
#.. ........\* .. *#. .  ....... #. .... .* . ...*..*...*.*... ..\.*. ..\#*..*. ..*.#..**  ......#....\.*.... ... \ . ...*.#.\# *..*....  *# . ..  ..#
# .#. ..\....*. #   .#....... ..  ....*#** .# .* ..*.. ..*..*....* #*...*.#* . .*. . .. .#.. ...  ... ....... . ...... ###..#.. . . .*\ .#\*..#.* ..*#
#.\... . . .\...  # ...  ........#\...* . \*...\ #.. ... ......**  \#. ..#...#..... .. .#.  . .  \. \#. *.. #. . .#*#..\.\*..#. ......  .\. ...#..#..#
#*\\ ..# #*... ..#.  *... ... # .. .. #....... ... ... #. . .#....# .......  *..\#......   ....... .#.. ..   \  ...*. .. #.. *..# # ..\......* ......#
##.\. . .......#.....*.#.....*...\.... .*#.. ..* #\.. .*...* * .....*   .\...##. . . ...*.#*.. * .. #.# * .\. ...##.. #\ .  ..... #..##...*..#.\  \.##
#\. .... \ #*#..#. .*\. . ...\*.\ ......# . *. \...#.*.... .#.# * ...#....*.  .\..  \.#  #**   ......\....\*.#... . #...#* .\. .*..#...*##\*#..\ .  .#
##..  .*. ...\...#\ *...#**#. \.. ..#.#\..*   ...**.#*.......##*\.**#........*....*. ..#*\ *.........*\*......*...#*.*. # .# *.# ..*.....#..#*#.. #..#
#..#**.\\.....# *..#.**#  .. .\...#..# .. \..  ....*.... ..*......  .. *#.#\ ....*.\\*..  ...  . #..\.#.#..*#....#..##*.#..\*. \.#.#.\ .*  .#.#.##*..#
#.  *..#..*. .**.  .#.#*.\.*... #* ...\..##. .... ..*... . .*...... ..#.  *.. *.... ...# ..*#.... ## #*.* .#.   ..*...   ...* ....*.. .*.....\.  *.* #
#..... .....*. .#..........#* *.*. ...... ...#....#..#..#..*... \.#*.. . ..*...* ...\*..*  ... .#....\ .... \ * ...\ .**.*..#* .* ....*.*  *. ..... .#
#.. ....#.  ** .#\....***. .\*.. \..*.*.... ...  \**. ....*#\..##..\ **....  .# \* ..  #*..#. ...#* .   .#.** ..#.... *..#.. . . ....*...\* ...# . ..#
#..\.#...#.... * . ##..... .# .... **..... ....\\..\. *. ..\#..\.  #.. ... ..*.....#.. ... .# ..\.. . ..*.. \ *.*.#..#..# .. .*.... .. ....*..\ ..#..#
#**.#. .......\\ .#. ..# .#. .*. ..\*...  . . \.*..... ....\ . . ... ..\ .....#..*.**....#.. .... .*..... . ..........# ...\ # \..#.. \. *.......... #
## ...#*..\ . .\  .......  #..... .. ........*\....\*...*.. #.. . .##...... *.#* .#. #.**....#.. #.......**# #....*.  * \. *#. .. ...#  #*. .\...#.*\#
#....# . # #.. \...**..*# . \. ....*.. #.. ..#.* .*.*. . .*.  .#...# . ...  .\ .\ . ... \ .\.. .. ..... ...*......#.#* . \..#...\.......#..   # * #. #
##   ..*....*#..... ......\ \..  ...\.#.#.#.*. .   #...  .*. ...#.....#...  #\#.. #*...*# .. ... #...* .  ##\.. .#. . . ##. *. .#.. .\.*\... ...   ..#
##.#.*... .*.***.....##  *.#. .#.. #..*. ..*..*#  ..#.. \*. *....**.. ...\... ..#.. .. *\.*.#  .#....*...... ..*....*# * #.**.  \#*.#...  . ..#..#...#
#...#....\*. ....#   .....#. .. .*..#.#.. ..*...  .#....  # .##.*...*...  .# .. . .**.\  . *.*.  ..  ..* \..#.\ ..* ...\ . .. ......###...* ...# \*.\#
#... ...* .... . .# *...*. .#..*...** ..... #.#.\\...   \..#  ...# . . ...##.*.   . ..*  # .*.#..*......*. #.. .*....*..  .......*.\**.\............ #
# .# ....#..*.\.* .\ .#  \.*.*.**#\.*...#. #. . #... .. .*..\.# .... .#.. ..*.**.......\# **..*.*#...  . .....  .....\..\**#.. *..... . .. **.##.*. \#
#.\.............#  ##. ..*\#**..*#. ..*.* .*.. .#.*....#.*.*......#\ .....* .\# . ..........##.*..\\. ..# #...*...... . . .\#... .#\ ..  ....#..#..#.#
#.#.... .# ...#\.....#. #..*..#.... ..##* ..... .#\.#*\...*...\* .\#............**. *.*#\.*.. *..\ .*...#*. ...* #.\#....\..\     *.*...#\#  .. \.   #
# *. ....... .....**.. ....  ..#. ... .\.#*\...*## .#\.. .*.##. #*..#.... .#... *\.#.#*.....  *.\..*#.#.  ...#*    .... . ..\  #. .* *....\...**..\  #
# .....* .... ....*.#.  *..\..#*.#. **..\.... *** ..# .\. .\ ....... #...** . ... ...*..  #*#. .#\#.*..## ..\\  . ... .. #. **\   .*..*. ...\#...# ###
#.#.....  . ..#.**.*. ....*. ..\..#....  *.#*. * \.. .\  ..*. #..*. ...**...#.....    ..#*..#.. . ..*. *..*..*..\  ....* .. . ....\ ... .. *.... ....#
#*.#...#.......##. ......* .*... .#*\ *........ ...* .. #.. \ . *... ...  .... ...  .# * *#...........* ..  .*. *.. . ..\.#....  ... .*........ ....*#
#   ..*..#.....#..*........###...... . . .\.. .....  ....\. . *. .*..*. .#. ...\*. *... .\. ...\.*..## .. # .*...\..*  .*.... ... ....*.. *....*  #.*#
# .....  .#. .. \....*.. ........# .   . ...#. #.\ ... .......*#..\.  **..*. .. ..# #......... \..##.. ....* ...\ *\.#.# . #.....*.##...... .    ....#
##.... ......  .......#... .\..\...*....... ... ..  ...... ...#..#.  .\...  . ..... *.. ..  *. .*...#..*...* # .. ** ... ... .....\..... . * .\*.. ..#
#.### *. .#.\.#####*\. ..#.##*.. ...#   *..... #.\...   . ..* .\. ..* ...*. .#.**.*........## *.#.  . ... ...\.### ..# *# .*..... ...*... .*..*...*. #
#...*\\... *#..* ... #..... .. ...  ..\. ...#.\\ # ..#. *. \.. . . .... .. .... ..* ...... \ *.#. #..*.  # ...#..#......  .\\.. ....**. *. .###. #.#.#
#.\  \.#  \..*..*  #*#\ ..#*  ...* ....*..#  #..\..*.#.*#  .# .\ ....\#**##.. ...##. **  .*...* .*.#* .#..*. ....*.. #**...*..##. ....#\...*#*.   *.\#
#...#*..# .\..#. .  .*...\\#...# ....*#... .*\\# #.....*.*..    .....#.. . .. .*.....\...... ..**..#.#.*.. ..*........\...*. ..#..*.*...... ...... ..#
#..* # .   ... *..  # #... \ \ .\ ...## *.  *. ...\... .. ....* *... .#..#.. .#..# .  \..  #. ..\\. ..\ #.*. \*.*. ..*.. ..... .\#.. . .#..#....  ##.#
#\**..*.* \...  * .\...... \.*# .#\#*...*#* . .....  #.. # ..#*..... . .. .***..*.*# *..#*....*.....*..# *...##.**\......... .  .. . #... .\ *.. ..*.#
# ....*. .*..  #.*#...  .#    *.....#.......... ...**#.*.  . \.   . ..*... .# ##..\# \... . .#...*.#*.. ...*... .\.....\#.*\#*. .#..* .*...*##*. ....#
# ..#.*.. .....*  .   # \..*..\......... ..#... #.#......*.. ..*..*..\.*** ...*# ..*.. .** *...*  ......... *   *\.... \* ..\..  .... ..#.\*.**#.\...#
#.#....* ##.... . .#.# ...##....#\.. \..\ .... #..*. #..*....# .#...# ...... .*\.. ...........#.. .*........# ..\..**\.. ##.#.#\.... .# ..##..#.... .#
#.*..\##. .......*..  .......\....*.* .... .  . . .....#**. .*..#   #.\...*  .\.* * .. *..# ....\.. *\..*  ..##  ...#*..# .. . .. \ \*\ *. ......## .#
#.#.*#.... .. *..*.\**. .#. . ..#*#..*......  #.\..........#...# ...  \... ......*\.....# .\**  .. .. .# .* ..# .. ....#\..#...\.......*.#. # .......#
# ...* ..\........##. ..*##. ..... .*. .\ #.*\.*.\  .........* ** #. * .\.\. \...##*.....* ....  .#...... . . *.......#.*. .... ..\...\ .  \....  .\*#
#.......# \.........#... .*   .#  .# .\*   #..\...\.\#. . \. #*\....* .. .   #........ . ..#.. * .  ..# *.\......  ... ## .*..*..\ ..\  .*......\..*.#
#...*.\ .#*..  *.. \*..  ..#.  .*....##..\...***.*. . ..... #.. .... .  .# . .. .\..#..........# # .  . .*... .... .. ...#\... .. .**#  .. ..  ...# .#
# .  * ... .. * ...\...**... \... ...*. .*..*#*..*#*.. # ....**# ... .  .. #. ...# ....*. ..* ..#..* . ...#.\..## . ..#..#..\.* ..#..  #\.....*\ ...*#
#..## ..... *# #..* .* . .  *...# ...... .* #.\ .   ...## #. # . .. *..... .*..*... ..*.. ...*. ...#**...*  .#* *..*.....*.*.....*.*. # . .*. .......#
#*..#..... .  .#  **\ **.**.. .#  *. \ #.\. *..#. * .  #* *.. .*. # . .  ..#*. ..\#..*.##. . .* .. .. ..#.... .......# .# ... ...... ..*  #. .. .##..#
#.\# .. \...*..#.... .#.*... .*..*.#.  . .*..  .. . .#..# .#*# ....*\... ..#. ....\... \ *.*....... .... .#..  . .. .#..\ .##  . * .# .. .. \ ... ...#
#..... ... .. ..#..*.... .. .\*.. #.......*......#*.  \#.#....*. .#..*#. .#.. . #..... ..#.**.*.\#*.  ...*.. *.. .. . ...........#... *. .......* *.\#
#....\..  .. .# .#..... *     .  . *.#.....#  * *\.   ....** * #...*.\.\.. .#. .......#*#*...#\ * . *..#  ..*.  .. .#.\ ..  .#....*\. .*. *.#.. *...##
#.. .#*..\ ....**.#.. # *..#* * # .. ..\.*.*..*\**#.#...#...*..#...*. .....  .. ...\ ..*...*..\ ..*... #\ \ .#..\*...#.....#.. ..\... #... ..* ......#
#.. **... .*... #...#..* \ ... .. .... ..**..*.* .\#*#... . .. .#\*#......# #.#\......#.*.\. ... ...*\ * ......#.  .*...*.*.. .... ....##\ .*.#. #..*#
######################################################################################################################################################