#######################L##############################################################################################################################
#..\#.* ..  .* \#..#*#....*. .......*.... ##\#\. ....\#.*...#...# ... ..#. ...*#.\.  . .. ..#. #..... . .. ............ .* .##.*\*# \..#... ..*# *#..#
#..#*#.**..#....*.#.# . ... ......\*.....#.#. ........#  .. .\\....... ...#* .....#..*\#\.. .....\... .\***.*. ..##.* .#  . ..   *......\.\... *  * .#
#.*. .. .\.......*.#*. .\* *.*#. #.... .  *.... ...\*#  *.*.. ..# . . .  \... .  .#* .#..# .#...  #. . \... . ....*...*  ..#\ ....  # ...#*.##.  .#. #
#. \ \..........#..*.. \.....#.#*.* ..* .. .#.#.. ...*.     ..  #*.*.#. ... .# * *#* . . *\...#.... .\... .. #.##  ..#. ... #..#.  . #.#....***...\. #
#.....\    *#.. ..\ ........* . ...#.\.*..... . *....#. .*.#....*# \#..**#.*#  ...#.*.* ....... .**.* .##.....*.#*...\*...#.*..*.... .#....... . ....#
#... ..# \.*.*... ... ... . .   #.. .. .. . .*.... ... .#. ..\.*..* **. #* .# ....*.... ..* ..... *..\...*....*.. .#*.\....#.*#.* *..... .  ....#.#. #
#..* ..#.... ...**....\... ...#.**......\.. ...##........  ##*....*.#...#.  #... . *.....*.**\* .*.#.. .#. . * .. .#* #  ............**. *.. *.#..*.\#
#..#. ..* ......# .###...#......#  ....### .#....#...*.#. *...\...*..\... . . #*..\.. ...... ...*  ... ..  ...*.*..# .... # . . .#.. ...##\.*..**. ..#
##\.#... .*. .#...#\#\.  \......  ... . .. *.. .. .. . ..#.... .....*##.\ .*.  . ..#..*........ #..* ##..... #.. *#. .....#*.#. .\ .... * ......\\...#
# ...##.   .#....#*#\..*  *..#. .\ .#*...\....*..*..... .\.......\.##\..*.......*. .#..\..**..*.\ .. # . *.\. \.\.....#* .*.#\\.*. ..... \.....#. ...#
#....#.  .*...........* ....#\ .. \* .#... ..# \. . . ..#. .# .*.. .... ...#.# # #.\*.#*...*..... .. .......  #..\.. .* ..#*.#..*#\.. .# .##.\*.#*...#
#....## ... .... # \..*#...*..  #\..*..  .*........ ..\#..#. ....*.. ..#.. *...*...* #... .#.. . \#. \.#*. ..#..#. .* #.* .. .....  #...*.. #* * ..  #
#.. ... .....*..#......#*. ..#.. . ..*......#.....#..  .###\. * *..   . ...* ......*\ ..#..... ...# ..*  .*.....\.***... .....*. . .. ..... #. ......#
#.#. ... .....* \..... # ..#.. ... .##...#... .... .. .* ..\.#**#..... .*..  ...#*.\ .*... .*#. . . ........*.*  .. #**##....... # .*..*.  .  #.*....#
#. . ..*.\. .. \.*.* ..  . ..#.  ......... ...\#.\\# ...... *. *#..\.  .. . **...* . #.###.....**.*. .#......*#..# .*... *......#... *. .## .*.. *. .#
#*.**... #*\* .*. ..#.#*.. . . .##....* *.......* *.*.##*.*..\ #.\ #.*#*\. . ##.. .... . ... .**..  ..*....#\*..   ..#..#. \..# ...\.....****...*. .##
#..* .##.#..#.. .. *  * .... #.............#.... ..*. ..*...#...#.  # ... ##..# .*.... .#... ...#..#  . .. . .. *.#*...\*. ...  #....*...  .*.*.#.. .#
#.   .*........*..#.. #*..*. ...\.* *...# . #. . .#*.\.. .. .. \ #.#....**..*. . ...  ..* .# .......  .. .*.#. .. . ..... *#\.....  *......**. #.. .##
#***..* ..* ...\.*.##.\..*.... ## .##.*.. .....#.*..\ .*\.. ..... .....*#.... .#...........#.*.... ...*\.* .*.* #.#.#..#.... .*.\..\. . ..#*....*..*##
# *. *...\..#..... ..... .  **..#..*#..* ..  ..#.#...... .#\  .....# ... . .*** .  .  ..*....*.*#*. .\. #.... #..\ ** .#..*..*.... .. ..#...#.#...* .#
# .# *.*  ..... \.\...*#.# .#.....** # . . *.\. ..#..*..*.*.....  #... ..  .#.\..* *.....\.....#....#. ....##...#.*.....# * ... .. . .\.# .. ........#
#. . .. .#*.*  \#....\*. #... #...  .\. .\ ...# ...\. #\. *...  ..  *#. # ..  .  .*..*.#.. ...\.*..* #...   ...\. ...*.... ...*#.. \*\ ..\.... ..... #
# .* ..\ .#...#\.. \.#. .... .\...... \..* *#.. .**. ....#...\.\#***  # .\ \....*\#... .*.\. #..   .... ..\ *..#  \.. .   * .#   . ... #..#  ........#
#....   #..*....*....  ..... .#. ..  .. *...#**.. *#.*.  ...#.  ...\....# .*.*..#\.##.\.... .. #.*.... ...#...#.*   #* ...\\ ..\#...\... .#.... \. ..#
#.  * . ..... .#.#.\*.# .\\.. ..  ...\\.........#..*... ... . .. ...*.....*** .. #  .*. \.*... ..#...  ...*# ...  .# ... . *..*.* .*#.\#........   *.#
#.**#* . .....#..*.. .#..*\......#..*\.\.#.#....*...#\**.. *   . #... ...###.#..*...# #  ...##... \.#*\ ..#. ...\...##. \  #..*. .. ..*\*... ..*.*#..#
#  ... ##. .\....\.... .*  .... \ \. . ..    .#..\.\. .# . . .*   *. .#. #....... \...#. #. *.  . .*#.*...*... ..#..#. ..**. *\*.... #...#. . .# #.*\#
#... .. .#... ..... .*\... . *.*. *#.#. .##... .\.... ..*.*.  .. .#. .*..\....#\*##*.###  ....# . #..\...  .  .. .#... ..*...*..  .. \.*..\..#...# ..#
# .. ..*.........#....* .#.*\*#**.. .. . *.#..#..... . #*. .....#.#.  .*. #* #.. ... ..#*....\....##. *. . .......#*.*.*#..\*.*.\ .#...*.* .   #\# . #
###.\. #...#..*\ . . . .*. #..... ..#.....#...* *#..*.\...........\.... ..   .. ..*....# *.... ..*\..##..\ \# .. ...#.. ... * .\ ..... ..  . *. # ...#
#.* . .\.... ..# ..*.. .. *\* ..**.*\..# #*..... ........*  ...#**.... # .*#..#*......\. ..  .. .#  ...# ..*... .......  #.. . #. * ... .*. # .\.. * #
#.#.* #...*.. \.*#.##.# . . ..\..\....... ..   .#..*#. ...*.... ..* ... ...*..*.#....##   *#\.\#...\. .... . .  .# .*.. .  ...\......\. #*.#.... .  ##
#.. ...#.*  . . ....### \. #... .** ....# #..... ..  . #...#... ....... \.  ..\#..... .\ ...*...\\###.*... . .. .... #...# #..*  .. ..\ \.   #* . ..##
#...*...#.  ... .#**.*.. #.....**..#. .. .. ..#*.*..#  ..   . . #...  .. *. ...\..* ...#...*......\. .....  * ...*  .\*. . ...#.  .*.*.#.#.*.........#
#. *...#\. *.. ... *.. ..# #..   .....#...... ..\..* .\.. .*..*..\ ... ....#.*.\#*..   ....\.. .. *... . .*.\##....#.....#. ...*.. .. ..*. ..*. *. \.#
#*.... .#*... .#.*....#...#..\\ ... ....#.#..#.. . # ....#. .  #..  #.*.. . . .. ..#*..\.*......*. . .... #...*. *.*.........\.#.\ * ......#.......#.#
#... *. .....  ...  ..*.# .#..*.##..... # ....*.\.. ...# ..  ...##.. #.....##. . .\...# .# . ...#.*#..  .\...#*#. .*.. . ......* *.  * #....* .**. ..#
#  #.. #...*.....*... .*..# . \*\. ..**..#.*...*.\.#.. ....# .... .*... ..*   ..##*.\*#..... .... #..#...\.. *...*..... .*.##. ..  .*.*#* . ...\ # # #
#. .. . *#.......*.. . .\. ..# * . .*....... ..#*......  . *...*..* .#.... ... *....*#\.#.... *.. ..\ #.# ...\.. ##.#.*.#.. \ .*..\#. .*#........... #
#. \ .#. ..... .#.. *..*. #* ..## .#...#..R....*... ..  #. .\...# ..  .. .#*#.....\......*# ... ....# *..*\. #.#...# ....#. .* .. ..# .*.. *..*...  .#
#...\  #. # .*... ... ...#.#.....##.. ..\..*.*...*.*.*  ....**.  .  ..*. \..# *..#\. .\.  ... * .\#. . \..........*. .#\... .*.......#. ......\. .. *#
# ... .*..... *.....  # ..*.  # \..\. *.###.**..# .#.\.# .. ... *.*...\ . . * .. .. \..*.#......\....... ..\...\ #.#    .#\* ....*..  ... .. ..\..\..#
#..#.*##.. ... ..#\*........ ..  . .....\....\.#...\.#......#\##**..**..... ....#*..*.. *.... ##  .  .#. .*. **\...\ .....# *.. #..#... .\.# . .. #..#
# .... .*# ..  ..\  *#.*#\.. .  .#.. .  \# ...... \*. #...    ...#.\. .##\#.#*#.  ......*  .. *\.*#  ... *.....#*  ... .... ... .#\.\.#.\.*......*#..#
# . ..  #. .# # ##* ...... *..\..*..#.*.......\ .......**..*.#*.. .. ...... ....*##*..#*......*. . ##...\.  *...#  *. *##.* *.**#.#. .#\..**. .....*.#
##..#*#..  . ... #.  ..\#...#.#.## #* ..\#*... .\. .* *..  *.\..**..*....# *.. \ . .#..*#.*...... ..# ..\. *..***   *...*  .\.#.#... .. # \.#.......\#
#.*  #.*... .#*...  .*.*..*. .......... #....** ..  *  .. *.. .. ..... ..#.#..* . . ..* .*...\.#.  . ...*  ..#\. ...# #......#.#.. ....## .*.#. ...# #
# ..*.#  .\*.  .. .*.#...#. .# #\.... .   ...\...  .\..#..*\#*....\..\...* ..*. *. \.  ..\*...*.# ....*..#. .#. #. ..* **..*.# #.*..*... *#.*  ......#
#...\ ...\.... .  . ... ..*#*.**.#  * ..#.#. .. .\\..*## ....*..* \....... \*...  \ ..\ #..*...  .... . .. \.  # ...*#...... .. ..\.\*.# .....\..*.. #
##...... *...*........\.. .....\ . .*. ......   ....#.*...*#..*#.. .#    .#..* .\.....#....##\..  ............ ... ..#..#*. .... .*. .*...# ...*\* ..#
#*... #.. # .# ..# ..#.. **.\ #.   ....... . .*.* . ...#*.\. ...\  *.*. *. ..#.  ... .....*... .**#.#. ..*..*...#...* \..\.... #. ..#.. .* .#..*.##. #
#\ .   #....\* #..\.... \....* ... ...... ...*.*\##.\.. ..# ##*.....# *  *.*#..... *..#.....#*.\.... * \ .  ..#*#*... *....#.\.#..  ....* .... #.\ . #
#*# #*...** ##.*  #. ... .  ... \...*.  #..#.#\... .#.. # ...\....\*#  ..# .\\..#.. ... ..*...# ..  .#.....#. ......\... . .\..*.\\..* ... ....  ..  #
##.*.### *....#. . ##.. ...  . *.*... ..\#.....#.#\.   . ..*# .*....\\...........#.#\.*..*.... .  #.*\.. *.#.......*..*.. \... ... .....  . **.. ....#
#....\. .....  ...*.... #.*...* . ..\# .....*.... .  ..#... .... ....# #............ .  #. .#.. .*.*.#.....*..* . . .*\.*.\..... .**#...#*# ..\ .....#
# .*. \   . ...*#....#..*. ..##### .## .. .... . ..* #*.  .#. ... . #*. #...#.\#...   .... **..#....\.. ... . .\ .\\...#*. *..* *. ..#...\ .#   .... #
#*...##.\*...\*#. .*. * #.*.*.....#..#..\.. *. *.*......\... .  \..*#*.\ \.*.#...\.#...  *.......#*.\..*...#*...\.. #..# ..**.#.....*\.....\#.*.....##
#.\... #*.  *...... ..#...#*.. ..#. .............. ..  .# .# .*#....#.....* *#.*. #\.. * .  *.\##..... ..   .. .#.. . ..\..\#... ..\# ..*   * **.... #
#...#... .*   ...\*.  .....#.. **. ..*.. . ..\*..\....... ... ...*..... * .*.# ...*..#**\.# #*.......# .....\#\..#....*.\.**.*.*#.*..#...#\ ... .....#
#...... .... . .#..#.* .. ......#. #.*...#. \ .  .......#...\ \....**  *....#*#....#\.. \*.\*.#... .\* . *.   . .#.\#.*. *.#... ...*.. #...*.. ...#..#
#.... **. .*.*# ....\##..*..*#. . .#.* . ........\#....#.# .......# ..... . ...*#.*  ..*.# .# ... ...*..*. .#.**...##.#. .*.. \.*....\. .   #..*.#.#.#
#...  . \#...\ .  ......*....   **....#... .\**  .....#* *.\.. ...\...#..*  .  *.. ...*. .# . *. . ...#..* .. .\*.\ . ... *.#. ..* \\ *... * ....*# .#
#.* * *....#...  .\...**#.. #...##   ..#\.. .. #..#..# .#.... # #..# .# .... ...\..*..........##*##.*\.*. *..#.\.. . \* ...\ .  #..\*. ....\. \#.#  .#
#.\*.. .. .....*## *...#. ...*...# . #. .  ..   . # *. . \ .  *.***.. *** *.......* ..*\.... ..*.... * .*..  #* .... .#.. . .##... ..*.# ... ..\ ...##
# ..........\.. ..#......*. . ...* * ...... *#....# .....\. *.#  .# .#..##......#.. .*......*.... ... ..   # .*......\ .#  ....*. . *........#**... .#
##.*.\..  # ... *.#. .#. .. ..## .. # #.*#...... #\...\..  .. ...\....*. \..#.*...   ... .. .*. #. ...#... #.. .. #.# ... .#.* #.\. \.. #.#.# ....#..#
# .. *..  . ..  .. ......*.... ....##. .*.\ #...*. \....#\... .  .# .\\ .*.. ....\ .*..*.# ...# ...   ... .......... .  ..#**#...\ .\ ..\\.* .\ .....#
# . .. #. \..\.*\ # #*\*#**   ..#*...*..  .#*.. ...  ........*..**#*... *.*.. ...*.\\....*...  ..*.**.\ .#.. #*\.# *\..  #.. *.. ... #......# ...... #
# \\  ..\........  .\......#... *. . \....\. ...*.......... ....*.#....#..# *.*....#..#. ...#... *#*...#...  ...\ ...#.\#.#.#*.. ..\..#.# .   . . .#.#
#.** ..#* .*.....*..  .  .....\.* .. .............  ......... .#.. .... ..#.* . *#..*..##*.#.#.#.  ..*# \.\#..*..*\..# # .. .#.*...#......#.*......\.#
#. \.......*.###\.*  ..#..#..  ......\* .. * *.# *  .* *\...*. ..#. *..*. \\  ..... .#. .... ..*#. \. #. . .#.. *#.#   .... #.*\ .* ....  ....... .*.#
##.* .... .\.. . . .*..\.# #.#.*....**#.  .\.*  *... \..... .# . ...  .....#.*.....# ..*#..#  . ..\ \... .*. .. *....* \.#........\.  #.#.*# . ......#
# ... \*.#..  #.....#*.......#..#..#... *.....##*. ... ...*.\. .#.  .. ## . .#..*...\...#. .#*. \*\    . .... .*...*#......\.. . . ..#  * #.... ...\.#
#*\..# ..*...#. ... ...... ......\*. ..**#...\..\. .#*. .* .*.*..*. .*.\.. ..#..#. ....# ....*   .. \ .. . ..\...*..#* *.*......**.  ....#.*....#....#
## **  ... . #  .**.\.\....* *...*........*...*#.##. .... .# .##.*.*..#..\..*.... ...##.   . .#..  ...* .....  ....\*..*.... .. .*....# *#...\ #*\\#.#
#...#..\*\.#..*...\..#.#.#* . .# ...#.* ...........*. .. *......  ..  ..... .# ..****.. * \. .*.*...... .... #....  .....\... *  .* ... ..\ .*\*.....#
#..#.#. #... .. .......*.*.... .. *......**. ... .....\.*#....\ \..#*.\...*.. ..#.... . . *....  .*  ..#.*\..* #... ....  . ..* ....#.#.. *.. ... #. #
#   \  . ...... #.*.#.. .. . . ..* . *# ... .\... .*\ ... .*..#* .....*.....*.** ..#.#. ..#.## .#.\* #. * .#*\#* #  \..#*....# .*.\   ..*.##\. . .. .#
#...*.*..... . .. .... ... .... ... ...*.*... ...... ..#...*.... ... * ..* ... .......  ...*. ...*..... . . #.*.#.\....\...*..## ..*#..\.*..... .... #
#...*..#*. #.. ..... .... .#*.#*.\..\#.. ....* ...* # .. . *... # ...**.*....   .......... .. .\\.\.....#... ..  ..*.#..#. ..  ...*.#.. *.  .. *... \#
#.... ..#.*. *. #.#. ..*...# ##. ###. ....#.  . *#..\\...#.#..... .  ...#\*.#*.#. ..**..\. .#...*.*...\  ..#.*.  . ... * . #....... .   ...  .# # .\.#
#..*.....\*. #.. .#. . ..\...\.\....  .. *....\.*....*\... *..\ * .# . *....*#*\#\.... \#......*##.*......##.. .* . ..   **#\#...*...*.. ....#.*....##
#. *.  .*.. ...*#*\.\#. #\..#.. #. .#.#*  # .\#  ...  ....#. ..\#. .\ *.......#\\#.....\..* *# . ##\..*..#*# ... . ......*..*... . .* ...  .. ....   #
# ......#.**.\... # .*....... . . #.. #... ... .#...\.. *..#* ...  . . .....*..*#**. #... . .  . .  .#.#....**... .*. ... .\..#...... .. .. .#.\#.#..#
#.\*.. . ...## #\\. .. .  .# . *..**.*.... * .  ....\ **. \#.. ..... *\..*. . ....... . *... .. * ...*....*. ..#\ ...... #\.* .*...#.... \..\.#\.  . #
#*##\\ .*.#.......#.#..##*...  ...#.. .. #. .* *.... .#.. . .......\   .#...\..*..*.#*......\#.**\*...*....# #... \.. . #..#.# .#\...... . * \*....*.#
#*#.\ ... ..*... .*..\........#*.. .*..#..**..... \** ...## *.....#..\*..\...##..*.#... ...*.\#\ . .. .#..\.\..... . *... . **.. ... #. . .*......#..#
#.. ...#.... *.\* .# \\*\. .*\........ .*.*...... .*....\...*..#.#.*#  #.#. .....*..** ..... ..* ......\... ** ....... ...##. .  ...\ #..*# .... ....#
#.*... #. ..  ... * ..*  *....*#.# .\.. . *.#.\... ..#\#*.*  . #. .\\*  .#.  \..#.*....... .*#.\ .#.#\ #.....#...# . ...\  *....**# .  #...\..\*#....#
#.  .....\#*........ ..\*..* ...*........\. #. . **  \. ...*...  .\#.# .. .* .. ..**...##..\#.*.#\*..\..# *...    *.....#..**........  .*..*#..*#..* #
#.. *.*#.  ....*..#.\#.#...*..... ..# #..... . *. . .. . ..#... * **  #.\ . #....   #.. .....  ..\.. . .*. ....#.*#\ ...... *....*...#* ....#*..**.* #
## .....  #\..  ....#...\ ...#..  .*..#*...##\*#*..\#.. .........  .. \#  \*..... ##\*..\..*.*.\\.. *.*. **...##...*....*  .  *...# *#.*.. *....*.## #
#*....... .  #.... ......*.. . *.*.\ .*#.#. .......\# ..#..*.  .## ...*..# . . .. \.\ .#*.....#....\. .........** ....... ..*.  . # \.#  *.*.*....#..#
#...... . .  ..#.  \\...# .....#*.  *..   .\.#..##..  ..*.#. ..#... ......  #...\ *..# . .....*.# .#\ ....\.. #....# #...*#*..#.* .##..#.. ..\ ..#**.#
# ..... *.\.....#...\ .*.... ..*..\...\.. .. ..  .*. ... *.*.##. . ..\ .#.. #.   . #..#. .##.... ..#..*....\*.  \. . .*.##..* ..*.#\.... .... #.\ #..#
#.......... **.*#. ..#   ...# .#.... . .   ......#.**..\##.#......#..  . ........#  ..#. .\.*...... .#...# ... ...* ..#. . . .\#.\*\ .\.. ......*##..#
#\....* *.#..*.  .#..... .*.  .* .#..   . .. .\  . . \ .#. .*...#...\ ....#.*.. ...##*.#.. \ ..#\. ..*. ...  **..*. ....\*#  ......#.*.#*...*..*.... #
#.#.. . ......\ **\.... .# #*....#... .*#. ..  .  . ...  .......*..\.\ .\ ..  .*..  ...\..#...\\.#. ..#*.* \. #. .... .*..#*........*...*.\.  ... *  #
#..#..\. *...*.. .#\#...... #.... ... *#..#*...... *\....... #. #.\.# *  .##*...#..* *..*... ..##..\#...  .. #. ...... .*.#\.....#* .# .#....#.*..\* #
#...*.... .*.  *.*...\.*.#..\*\..  ..*..* \. \ *..#*...*.*#.  *#..#... ..... ....#.  ... ... .. #*##...... .   *..........#.  .. . ....* ...\. ...  *#
#.*. .. .... ...#....  .\..  .... *\...... #..\\\. *.*# ..\ .#..#... .. .# ...# .#\* ....#\ .....*  .. .#......  ...#... # .. .# .*..**..*. *.. ..#..#
#.. *.. ......#.#....#... ... .** #.#.\* * .##... .\ ..... .* #.. .. . .. .. #.. #..  .#**.\**.... .*..#.\... . *\.*. .. .#..*.# .... ...... ..*  ..\#
##.*.*#...*** .\.*.\*. ....#.....*.....  #. #\. .. .. ..*..#..*#\. .#** ....#.... ... .....#.*..\.. \ #. ..#. *#.#\.#* .. ..... #....**.#*..\...#. . #
#.**\*.*.#*..# . #.\  #.*...\# ..#*.## # .  .. ..#.**.*. ... .\* ....#.... # ..\..   ...*   #...#.... .  .#*...  ..#...#..*..... .#  . ...#* . #.....#
###.*\*.##...\  #... * .* * .#\.* \  ..... ..\ . . .* ....\..*.. *# . #.\.#.*  ..*....*..#.# \..    .#...#   . .#.   ...  *..  .#.*... .*  .\\*.  ...#
# . .\.# ....  ..... ..# #..**.. ##.  ..##. ...... . #. ###...# ..*.* ... .. . .......* .#.. .#. ...# . .* ..... ..... ..**#*...* ..... * ....\.. ...#
#..*\#  ..* ........ .*... . ...*..  .#* ..  .##...*\.... #.. ..#* * #...  . .*..*. #.. .........#. .... # ..*#.... ... \. . .. ##.... ** ... ... .  #
#.*#.*.... .*#..  ...\*.. . .#.*# . ....#  # \#..#.*#.\#... ..... ........*.#\.\#..#..##.. . # .\...    .##.. * .... .. .#..#.. ....*.... .........**#
# ..#.....#  .#. *\.* ...\ .*....  *.......#*.. .  ..**.  ..*... ..#* *.. \.#....*.#.*..#.*... .*..... #\*.. . *... .*#....# ...\# #.\.  . .# *...  *#
#.*..##\. .*\..* ...#*.   *. .... . ..*\.#......*.. . \.*... \**   .. #.\.\.\#.\ .# ...*  . ..#... .\* . *.* *..*. ... .. \ ... \.#. ...  . #.. .\.\.#
#.##...\...* ..#.  *\# * .*.. .\... *.... ............ ..#.#*..#.#   . ..  \....\#.#  . *#.*.....* * . .*  .#..... ..\...*\.. # .#\\..#.....##.\.\ ..#
# ** .. ..  *\ ... ... . # ..#   ..* ...  .*.* #.*...  .... ..**... .. #. . *.... .. #.*... ...*#.* .*\.\ **   ...... #....*  .#.#\ \ ..*...\*....#..#
#***.......\. ... #.*   ..........#*...*. #.#.....# *  .#.. *.*..#.  .....#*.. # \.  *.......#**.# ....\.. ..**    \.##.  ....*. .\.#*... .. .. .* ..#
# .\...#...#..*  \. *.#.\*.*... ... .#..........*\ . . #. ...#\#....#..\...#. .. *. .  \.# . . *.   ....\#.....#.\ *\ .. ...#...#  .. .. .  .....#*. #
#. ...#.. \#....... #.*.* #...#.##  . .  *...\.#   \... ....\..  \..*....... ..#*. . ..*.... #....#*.....#.*. ... .. #  ....*.* #....*. ....**\# ....#
#.. *....*...##....* . * ...*.*.  #* ..\**.. .*.* . \...... ..\ ..*.. # \. ...  .. .. .#\..... ..*....***# **. .  #.*.. *.....\  .#.. *.. * . .....* #
# ....* .....*#.*\...#....**.# ..\ .. **. ....#.*.   ....*# ...#\ . ....#*.#...*\ . .\..# .* *.......\.\.. .** .*#... .#*...\ .. .*#.#.. . .. ..  ..*#
#....* #.#...........# \.# . ...  . . #.......#.* . *  .\...#*.##.....**.....#..\......      #.*..  #..... #..\...\.. ...*#* .#  ...# .#..*.  \  ....#
#....## .*....   ..#....# ...**..*... ..\ ...#\.##*#. #.  .....*.\..\*.\.#\. \..** # .\..#..... . . .. .. \ *. .*.. ..  ........##. ...*.  ..#.*.  . #
#.\...*#.  .##. ...*. ....* . \.. ..*  ..\ *.. ....#\*. ....*\ . ..*...*# .*\.........*.*  #.*. *....#.#... *. .*....*#....*.** .. ....\..* ... . .\.#
#.#*...\.#.  **..\.**....#.. .#....\**...\.. . .\*\# #.....*..* .##....\....#. .\..\ .... .*.\.... ...\*.#*..*..# #.*.# *........\..**\. ..\ .\..#..*#
# ...#   .#.*#... **\# . ##..  *.*.  #....**.. .\* \#.#\..#... ...#...#....   ..#. #*\#.#* ...#.   . . ..* .#. .*.# .#..*.... .# .\   .. ...#\. *. ..#
#* .. #..\\*#..... .*.#....*\.# ... *.##..*\. ..... #.........\. . ...#  *...*..#........#..  ...## #  .... ..#\. .# .\.* * ..... * ....*....    *.*.#
##.  \#. ..... ...# .#... \.\....##*. .\*...* .* ...* ..\.  #.. ......  ###....\ \*#..#.....* . ........*.*..\.....*... ##.*....\. #...\.....*  \ .*.#
#..#\ ..##.*...#*..\..........#***..# .. ...#*..*..# \.\#.... ... .  .\#.....*#.... #. #... #*   . . .*.*.*#. ..#....... . .  ... .. *.. .... .......#
#  .. .#*.*. #.. .... .* .... ....\\#  \*. ##....#..\....*#\.*..\......  ....#.   ..***#.#.......\.**..# ..*#..*. ..*. .    #. ...** ..#.. # ....#..##
# #.... *.\. #*.  *. . ** #..... ........ *... * .\.. .. #.#.*\ .** # .....\*.. .#\#*.#.*.. #.*  .... .#.... ......* ..#.#..#..#*..\..#.* #\...  .#..#
#...*  ....#\ ... ...**....#. *.*.... *.  .\. .## .*......#\... # .... .......#...# *   ....#....#..* . ..*. \   . .\. ... ......# .#.. .# \.. .#.   #
# .*.# . . #.....#  .\.*\ . ..*........  . ....#. .*..#. .. \ ..... #....#..\...... ...... ..# ....*\...#....*.....**.#   #.. .#*\ .*\....\ .#.....###
#... .* ..#  .\.*.#.#*\*   .. .. .....#..**\.. ..  .... ..*. .*.  **    *..*..*.....*.* ....*... * ..... #..#.*# ..#\*#......# ....\..... .#.*.#. ...#
#.. *#..#.#*.* .#.#\. ..*.....*#\#...\ #..*...\..#... ..** #..   *.. .... ## . ...\.....*   ......*.*# . #..   .....#...\. *# *.......\\. #.....   ..#
#.*\#.  .# .#.. .#.   .#.... *...#.#**#.. .... .# #...#.  ..*# ... .#* .....#.. .\ #\#.   . #...  #.**.\....#.#. . ......... \ ...#*.**. .#..#\ .   ##
#..........# *..\*.#...#  *...#..#.. .*.* ....\* .#.#  ..* .* #... .\\....#\....# #\.*....#\. ...\\.. . . #.. .#.*.#.  .....  * .........#...* .*....#
#....# .##.  .....*.. *  *  ....## .   \  *.#..# .. ......\...#.\.. ..#....*. .#..#*......#....* #*.*   .. ....   .....#*...... .... ... .... *..#**.#
#....# * \#  ..#.. .#....*#...  *.   *...#.... ..\ .....*.. \... ....  *#.. .*. ..*.#..  ##..##* *... .*# *..#.......*...*.# . .\....\. .. .. # \.#..#
##  .#.....#.. ....*.* ##.#. .....#....\..\. ... .#*..... #...\.##... . * ..*......*#.#*.. . ..\..*.\.*.\.... ..  ...\# .... .\ ..#. **.*.#\*........#
#. ..* . ..  #.**\*#.* .. .#* #.. ... . .........#.. * *.....**.**#. \...   . .  ...*... .. ..#..... #.. ** ....  .#..#.#.  ..... *\....** .\. ..  ..#
#..**#.... .#  #\. ... ## ..*. .\.. .#...*#*. . . .....*.\ ..**...   .*#.**.*.#...  ..*.. .** .....*...#*..*#  #.\* **..  #.#\\*\.#...  . *.. *....\.#
#. .....#..#..#.#.  ...........#. .*\. .. . #.... ..\... .... #.....*.\ #.* #...... *..#\.\..#...  ... ..*.. ... .. ... .\  ..#* \\. .*... ......... #
#  .*...* ..  .. . ...** .* *.\#.#... \.. ......*\ .##.......#..**. . .*..####. ..#.#.#*#. ..*.#.#*. .#. ....  .*#... \..*.. .  .........*. . \. .*..#
#.\...##.  .. #..**. .   . ...** ....*.**.\......*. .*..... *.\\......#..*#....... . . \. . .\..#....\ .**# ...\..# ... . .. #. ..**.. #  \..*.*..\. #
# .* * .....  #.**.*.. ..*....# .....  .#.   *..\. ....#  .*...  #........*...\.*#.\*..* \ #...**#*. ... ......\ .   *...##.#.  ...... ..... ...#.##.#
###**...# **. . .  *  # ...#   ...#\. .....*. \...#.*#..*..*...*....*.... .#.*.... . \.#.......#.\. ....\\..*. .*..#...  .* \.......*# ...#. \ ..#...#
#\*.  .. \......*...*.. .# . ..#\.....#\. #.#. . .   ......\#.. .  ....#.#\.. .. ......... * .. # . #........ .*..*........*............ ....\.. # #.#
#*.# ..... ... .*.##. \\. ...** .#.*..#.*..* *.\*#  ......  * ....*. ..\ *.**.  #..#..#*#\\. .\.......\#..........#\*.\.. .\..#  \#.... .\ .* .*# ##.#
#...*###* #...#**## .*..*...*.. .  .. .\.# .*....... \.. ..\....\##*.**#**#  ..*. ...  *.*.*.#..  .\#*.\*.*#. \.#. # # \#.*  ......#*.....*\.#** .\..#
#..   \*...*..#...... .. .  .#..\. * .* . \...*....*\ .#.  .\.*# .\*. . .\.......#..  .*... .*   .....\.. .\* #. ...  .#*...... #*\#. \. .#... ..... #
#.\.*#.  .  .*....#...###.....\ . ** .#*. .......\..\#\#...#.#.*...#\...#..*.. #.. ..*#*.. .....*\ #. \   .. ......#*....*..  . .... .. ..*...\..*...#
######################################################################################################################################################