######################################################################################################################################################
#.*.. # *.. # . \\. \....  ##.*...\. \.. #.. #.**..## . ##*#..*.  *.* .#..#..\ . ..#.#. .  . . .. ** .*.#...*. # . ....* * #....\.. .*....#.*.... * *#
#.\.\.. .** *  .#*.*#*.*#\*.*.. # .  *  . .#  . ..... ..#.*.. . ..\.# ..\ .*.  .*.  **....# .*.\...   ....* ##* .....\. ..# ..\ ..#..# . *.. #... . .#
#*  .. .\.\.   . .* #  ..* .\..#....\\* ... ..### .#..* . ..##.*.... **.#\...  .... *.....#.. *#.#..**. ..\. ..#\.*....#..#*.#\#....#\\#..   ..   \..#
#.##... #*..... .. .*.#..... .*.. #. .... .* .*..#..*. ##\..#.....# *..  ....*.. * . ....*.\##....*#.#..*...*... ..*... * ....... ...**#......#. . ..#
#. *.  \...... #.....##.*...\..###\.\#.*#*  ....\. .....#.  .*\.#. .  \.#..#...*...*  ..#.......# #..  ...#. *..#......\#..... ..*..\..... *..* ..#. #
#. \..# ...#. *.....#.**... .......*. ...... .**..** ....\.*. ...*.* \...\.......**.#......#.....#. .##... . ..*.  \#... ....  ...*#.* .# ..* ..* ..*#
#\ ... \..  .* # .##..... .*..# .*. \ ##... .##.  ..*..# ...\ *..* ....  *.. \. ...\.**.\   ..*.#....*.\.\ .. ... ..... \\   ..#.....  .#.#\... \..# #
#.....#* **# *..   .#..\ . ..*. *.. \*  ...\ .. .\#*.\..* ..... .. ....\.*.  ..\.*\ . .  ....*.... .   ..  \...* .*.. * ....*#.*...#* .....\......#\.#
# .\.........#..*... \...\.. # ......... .*.\\ ...#.*. *#*#.... ...## ... . . .*.....# ..*.\.*.\.*.\.. ...\..#..\.\. .. .... #. \*.. ..#..#. *#.# .. #
#.# \.\ ....*\*.*#.##.. .*......#... *.*.* .....\ .. *......*.. . .##.. ..#.*......* **.. *......# ... \. \ .*...*.* .... ...**. .... . \  #.#.*. ...#
# ... .\...#*. * ... ##.# .. \.#..* ..*...#. #...*. .. #*##....*..*.... #..#... *... ...**.. *.. ..#.\*. .... * .*.*.*.# # ...*  .   ...... . .#.. * #
#...*.    \.. . ..*... ..... ..#.. * #.  #....#..##........*  ...\#..\ .. .* ....*..\ ...#..\.#*.. .* \.##..*. .  ... *.\... #. .. .\*.\..\  . **....#
#.....#..*.*.......#...  *....*. .*. *... #...#. .#..*..*. .  ....#.*#* ...#.. ..*... .**. .\*.  . ..#.... ...\. ...*\ ... # .  ..... .#. *.# .\.... #
#.# ..  *... . \...... .. . ##.* .*.* . . *. ... **# \. .. . . # ...#\...#........  ..*. .\..*##.....##.* # ...  *... \.#**#  ...\ \ *...*. #.#.. .. #
#.*\.*     . . ..#. .  .. #.... .# .....#...# #..... . #...  . ..*..#    .#*#... ...... ...... # \.. #. .##  .**\\...\#.*...*...*. .\.....*\...*.... #
#. .* .*. . ..\....\....#.. ..*..*....##...*. #..   * . ..\.  .....#.  ... .. # .  ..**...\.... ....*.  .*  ...\ ..*#.* ##. .. .. .##.#..#. .........#
#*.\.* \.\.#. . . ..#*.. .  .. .. ..#....*. ..#.##.. \ ..*... \. ..*....# . #... . .#*.# \#...#. .\.. . ..*#...\.. .#........ .*.#..  ...*.###*.\....#
#*.*.\...# ..\.....  .# ..  .. .. .#\\*........#..#.. ..#..*.*... ...\. ... *.. #......#. .*.*... .* .#.. ..  \.# ....  \#. . ..  . #...##.. ......**#
#.\***  ...... *#...##.*.*...* # ...... ..**\ #\.  *  .### .*. #... ......\*..# .#\ ...#....... .#..\ ..   #  ..*#. . .... .....*.. #..... \ ...#  # #
#... ..#\ .\.#..*#. ..*. ... .\..*. ..  ..*# ...   . ..*......#*.#.*...*.. . .#.*....#*.. .. . .....#...*.* .. ....#.*.\.#..# .##..#*...#.\.#... ..*.#
#\\#*. .#.. ....... ...\..* ..#. .# . .. ..* .*.*\# .#. . ...  #  ....*    .. *....... ....*\**.# ........  .\.#.... .\* .*...*.  .. ....*.*.. #*..\.#
#*..#** ..* \.**\*#.* .....* .#.. .*.  ##  \ . .  ..........#* .\ . . .#... *. ...*# ##.. #... .   # # *.  .*...#*.. .#.. ..*.* .. ..# .. .*.. ..#.  #
# ... . *. *\\.\.....\#\  ......*...#. .# ......*.#\.#.*  *..#. ...#. ..*#. .....  .. \...*.\..#\.*...*.# .....*.. .. .\..  *..#* ....\\\*##.#.... ..#
#  .#... . ......   ..##... .#.....\..\.*... ..*. # *...**.*.... \#.. *  . . ..#. .#*. . \ ..*..... .. ..\#...*...............  \  . \. ..#..#.*. \..#
#.#.* ..*.. .*\*..# .* ..#.... .#...\.*\..#.#* * ... #.. .#.*\ ....* .   *..... ...#.\\\...  #...\   . ..*.\*  .  #... * ...*...*. ..*..#.  ..  ..* .#
# *#.\*. .\##.* *...  ..  . .. \ *. .. ..   \*.\...... ......* . \....* ...*#\. . ..\.# .*.#. .. ..*\ # \.\. *.# . .  . .#  . .*..\..##.. ...#\# ..*.#
#.*............#.... .* . ..# .#.. .. .#.#..#.\...\#.#.. *.......*..*.#... .* \# ..... *.##.\ #\ *. . .  .#\.... .*  #* \#... ...*.......#..... .... #
#. . ........ #.   #..  **.*. ...\#...*.. .....  ..# *.. . . ..\###...\ .*.#.*...#**. .... ...\.#\. .. .* \..  . \.... ..#... #.* ..    \*. ....#.. .#
#\.\ ..*..\.  ....#...#.*. \**. . .... ...\.. ..#. #.#.... ..\.. .. .*.*.... #.#..... ...## .\..#.  ...  . ......*....* .. ..*##..#..*..**\.*..#. .. #
#..... .#\. ........***. ........  .....#..#.* ...*... #.. .##*#\.* ......*\  .. ##*.#..... #.*..... .# #.* #\.......\....\ #. .#...#\.. . ... *.. *.#
#\..*\.. ......  . . ..#.\... .#....**.*.... .*\.##..# .# ..##...*. . *.# ..*.*#\*..*....*..# \  #*\... #.........\..*..\ ## .**..#. .. *...#....\ .##
##*#.. .#.\#.... ..... . ...  ..\ \..  *. .. ..... .#.*.. .. #....#   **..\** *. #.....#..  ... *.*  .\*  ## ........#.  .. .*.....*.*  . . .. *.....#
#.#.... ..*.. \ .*.. .#** ...  \ .#.\#.....*.. .. *.#\...\ .*\  .* .#.\\#..*\    ..*. *\. ..... .\\.*.... ...* .*.\. .# #.#.....#. .*..*.#...*.\.\*..#
#........ **.\... ..* ..#....*..#.. ....#*. . .##... . .#.  . .*.*.*#. #.. ..\.* . ... *.#.....\.. ..\ .#.... #**.\ . .....* *.#..\.\..*....## .\.  .#
##*.*.. ..*....\..\. ...#...#.*..... . .*... .##......  . .* *...**.*....* \.*..\... . .\..## .#..  .\* .##..*....... #... ......\...*.#.. ... . .#.##
#\.  . # .. # .. .*  .#..... #..... *#.##. . .##.  ..... #. ..... ...  #.*  .  .#. #.* \..**..*. . . ....    \. .###.. .*.. . #....# #...  .*.  ...#.#
#.... .......#*\....**# . .** \.\.. \.  ##.*.# #......  . ..# ...  .... *\ #.*\\.\ #.#..\ . # #... .. ...*.\ ..*.   # . .# .......... ...\.....\..\..#
# \...\\...***.#.....\. ...#*..#..* ...*\.* ..*. ..#. ..*.#....\..#* ... .. .#. *.*.. .#.......*. *... ... . .#*.*  \. \.# .. #.#*..* .\#...#*.#\ #..#
#.......#  .. \. .. **........ .* * ....\  .*.... .#. .\.... .....#... .\...*#...\\*.. .... .# ...... . ....#.... .. .#.# .*. ... ..........*.*\#.. *#
#..*** .# ..\#.\#.*..  . .. #.... .*.* .*....*. . ...#  . .*.\ \.... .*.#*\.#  #. . \.\.#** ..#...\.. .  . ..*.. ..#.. .#*...*.\........**. *.. . \.*#
#.  .*..  ..*...\....#...*. \  ##...##...##...#..*.#.. \.. ...\... ............. *..#.. #. .#...**.#... .#. . ...\... *...  ....#...# ..\. .. ..\...\#
###..  ... *.\...* ..#*..*..*.*...# ..# *.....#....... ..*.\*.  ..*.  . .\.. ...* .. #. .. *.#*....*........ . ..*.\.  .# #. ..#....*##...#.#.*. . *##
#.#.*#.... *... \  .\..\.#.. *. .*  *....\..# .*.\*#     .....*.*.#. .#*.\.. #.  . .... . . # .*...\...#\.* . ##  ...#.......... .... #..##...*.#.\..#
#..\#. . ....#...* ..  .**  ..*\.. .* .. .. ....... ..# ....# . .# \ . .\ ..\# .. ...\....*......... .**.  . #.#...*.\. *# \. .. *.  * \. . * *. #..##
#*......  ..*. \*. ...*.. .\.*..*#*.... #.#*#.\..\... .. ..*.\*# ....# *.  * \ .......*... .. ..#...*#.... .#**.. .#.  .* ....\ #\ .*#.  .\ . .##....#
#..*\..#...#  . #.#..\.\..... #. \....#* . \...... .*..\ .....\*. ..#*. .  .# *........##*...#*.... ...*.#.. .*. # ...\   *..... *... .**.\#.... ..# #
# ..... #...*# \........* .. .. *.  . .. #. .* .... ...* . ....*. ..#... \*.. *.#  .#..\.....#..  ..*.. #.**... .\.* ..#.... .  *........*.  #*.. . .#
#*..*.# ..#\#..***.* ..# .#...  # ........# *..*..   .  .\#. .. ..# #... #..  ..\*#... .\.. ..*.* .. . ... .#\...*#..... .....*. *\. *.#*.... ....\*.#
#*# *..* .\\*   ....*.* ..\. #.  .. #... #..\ \..*....* *.....*# ..#.\... .#...\..*.......#. .**..*..#.. #.  .. #.. ... .*..    .. . ....\..#....... #
#..\.\...*\.*.*...... ..\.#..*\ .... ..**. .. \..... ......... #.* *.. \... ...#.#....*.*... . ...# ....... . .#.. .. .. . *...\..\  . \.#....\..#.# #
#. ...\##.*.* ...... ... .*..*.\#\\  *. *  *. * .*#.# #.# ..*...#*.#.. ##.*# .   .*  *.##* .... #. .*. . . ..\*.. #....*. .#.#....#....\....* . *#** #
# ...\..\.*.*............#*....##.. .*.  ...*.#.. ....#.. .*   *..# ....*.#\.. ..#...*# # ..  *. . ..  .*#...*..*......\. .....\.#\.. ... .. *#......#
#. .*. # ....*.. #..#...  *. .# .# .#.#*#... #*... ..# ..#.   ...  ... .. .....*.. . *... *  .\ ...##. \ .*..... .  ......\\  . * .. #...# . .#. ..\.#
##. **..*.... . .*..#*  .... .....*.....#... .......  *......#\..  .**.#.. #*... ..*... #. .. . #\  ..  . .#.*.. *...*.......#.*...\#. *..#..     # .#
#.**...  #*.#........\.\.......*. . ... ..\ #**    . *.*.#*..  #.*.   ......*.......#* ...*.. ..*.  *  *.. .\..  *. ...*. ..#.* ..#*.\.#.*..... .. ..#
#*..*## ..\ .*. ##  * .# .\#.. \#..#.....#. ..*#.*.#..#.* .*.# ..   .. #..#.#. .\#.....*#.#..  #...#..#. \# ..#.... #...#  .. . .# ..#.. .#....#* .*.#
#..#.#  .**... ..*..#.#. ...*.. .* . ..\...... *#** ...#.*.. # .*.. #.** ..  .. .. \*...  .*. . .#*.....#......\ *. . **. .* *#...* .# .#... .. ...\.#
#*#... #.#\ ..  .   #*\. .#. # *. .. .........   ..***\..\ .#. \ *.**....*#.# ..*.. ..... \. ..\. .. . #* **.##....  .... ....  .. .*.*...*.# .. ....#
## *.#..  *..*# .#.... .# ....** .....#*. . .\#* #....... .*... **# .*.\.. . ..# ..*.. .    ...... . ...#*  ..   ..*..* ..*..#. \ \ .#.. .... #*\..#\#
#........ *.. .# *... . . ... . #.*......\..\\ ..#.*#.... *. #... #.\..# .#...#..#. \..# .#..#.#*   . ..    *...#   #..#.......# *\ ..  ...*##\...* .#
# #.*. . #..* ..........\ .. ..\.*#. ....#.#.\. .#. .*. ...* .....#..   .\# .#.. ... \#.#...*.###..    *#...\...#..*. ... *...#..*. * *.\..#\* .  .###
#\.. #*... .. #......\...*.#....#* .....#.# ...  ..#. \\ .*...**.....*.\.**...*.* #....*..#.... .. ..#.* *..#.#\.\........ .** .. \. *. .#    ... . *#
#....  ..#.. ** .#... ..*\  #..  ...#.#. \ .\.#*. # .*...*...\.#\.\....#..##.*#...##\** *.\.##. ..*** . ##..*.....#.*. .*.#  #..#..#.. ..\.  .*.... .#
#..\.#  .#.\.*. ..\*.. \. .......\*. . .**.*.#\..# *. ....#....  \....\\...\..#\.  .. .*...*.*....*.. .  .*.##...   *...  ...# \ \.*.* . **.# ..#...##
#. ..... #*#*..#..  *.* ....\\..#.. .... .# \ . .##.\ ..# .\.\..  .#.#..\. ....#. \.\.....\....  .   ##. ...#.......*\...#...\#. .#*  ..#\*..#....#. #
# .\.**.  *... .\... . \.#...... **....#** .*.\.  . *. * .\.....*##\. .....**.  *.. * *  ..* .#.#\*......#\#.. # .*. .#..#.#  ... ..\ .  *.\........##
#. ..  ....# \ ... .  .***....\. .#..   . . ....\*...#......#.  .  .. ........ .**.. .....*#.\* ..#**....*..\....... *.# .* .*.. .. .  ..#..#... .*..#
#. . ...  ... # .  #.  .#*.  #...... .*...\..\..#.. # ..#........*....\.. * ...*#*..# ....# \#...  ...  ..*.*.\ ## . . *#..#  ....*... ... \.#...##.\#
#.....#..##   ...**... .. .# ......*.\..**#\*...**\.\ .....*.  . *.......*. .#..... ..#*....\ \ ..#\*....###.#\.#.*..*....## .\. *.# . ** *\..#*....*#
# ....* . #..\...**\#.*.\  .* *. ..... *. . *..##. .*... ....*..## . #..\....#* ....... *.\.. ..*#.. ... ......  ...###*..**#  ....  ...*.......#\#. #
#.*.\.*..#.## . ...#.#.**...**  .#*. ....# .. .*..\..*.  .\#. *. ...#.........\. *...* . ..  \.\\*.   .  #.#.\... ..*..*...# .#. #...#....#..#.....\.#
#. * . * ##*.#.#* \#  # ... . ....# # ...*. \*. .\  . # #..\  \...#.*\..#.. ..#  ...... . \\\...#......  \..#.. ..# *.. \.*# ..##.*...   .\. ......**#
#. ..*   *. ..\.#....... .. ..  ..# *..#. # #..*.\.. *... # ....*.**# #..#......  .. *.#.  .***.# .#*. *#.. . * * ......*.\.#. # ...\... ... \##..**##
##*.  \#.\.. #.    \....*.#...#.*...#.*\## .# \....* .. *..#.  #. .*.*   #.. ..... .. ..*.. . *. ..#........*#.. ..# .....**...#..*...* .. *.#\...*.\#
##. ... .. ..#*. *\ #. . . \#\#*#\...*.\# ....  .#..#....*#...#......*#*... . \..#.... *...*..* \. ....**    .......*.*#.# ..*.. \.... ... \.#...# \ #
#. #..... *  ... .#.*\. #* .*..#. .*... .. ..\ ..*....  *#\..\ \#*.#.# \#*... ..#.. .. .# .*..*.*.***..\...*..* *.... ...\ *.........*##..... #...* .#
#. .* ... .\....#....*.  .. .#....#... *.   .\..* ..   .**. *....  \\\\*.. .*.. . . *\....*..#..## .*...* # #\\... . ...#.#.. ... ....\.#.* \  ......#
#.*\.....\ \.......\*. .\*. ..#.... # .*\*\#. .\..* # . . ..\\#........ ....*\  .. *....#*   \#..*#..... .* .*#.......*..#.#.# \.. ..........  # *.. #
#.......#*#.**.. . ..#...# ...*. ...  #...*\. \.*.#... .#  ..##.# ...#*.*#..#.\\... #.#. #. *. . .. ..#......#*..\.  ....#. ..* .*. ...*.#* #..#....\#
#.... . * ...\. ....  ..*..*....\ ##*. #*..#..  *#.#... *. .. **#.# .#. .#.. #\****....\...*. ... * *.. .....*.... . *\*  .... . .\# # #  . .....#.*.#
#.\ #.*.**\..##. ..\\. #...... .*.\ ...* .*.\  ..... .#..#.  .. ...   ..  ... . ...\... . #..... .#.  ...\..\*.\.. .  ..\ ..#.*.*#.\\ ..#...... ... .#
#*....  .  *...#. ....  .#. .... \.....#  *.\\\ #\ *.*. ......*.#.#*  .#.#....#..*.... *. .. .*  . ..   ... .# ...\   # . ..*.\ . . .*#...#.#....*#  #
#... . .#. . ..## .. ....  *#.......... #... ...##.#. ... ...#.##....*.......\ .*...\. .  .. . ..*....#. . ....  * ..#* *\.#.#....* .#* *....... *  .#
#. # . #.......\.. .*.# #.....   #...##*. *... ...*. .#*#. ..*#*.... .....#*#*..*...... . ...#.* ..*. *...  . ..## \ #.....  .*.. ..  .*.\.*....##*..#
#. ... .*....*#* ....#*. ..*...*#.#..#......\.....*#. *..**. ...#.*... ........# . .....**...#.. ........#..*.#.  ..\... \..#.....#. .#... .#..  .. .#
#.. .* . .\......#..* .*.  .*# ...*...\. .*..# ...   ...  ..  * ..\...* .*  . .#.. .....\ ..\....**\ .* ..\*#.  * ... .#.. # ..* #... \* ..*....#.  .#
# ..\ .. ..\. ... . .###.  .... #...**#. ...#... ... ..\..\. \.### .#..\   * *.#.*.. .. .*. *\.#.#*.\.. .*..*..\. ..\##... . ....  *... ..*...#..* ..#
#. .*. \*#.*.\ .\... . . \* \.*. * .#* #*..  .*..*.#..*#..#.#\...#..\*\... . *.\....\# . .**. ....... ..... **. . #.. \.##... ...*........... * ....##
#.*...*.. ... .#.. ...\  \. .....# ...# .......\........#..*.\. . . ...\.. . .. .....*\\.#...*##..#*..\.......... #.. # .# \*.  ..   #.. *.. \.\. *..#
#.#. ..... .#.... *\ . ..#*. * .#. *.#*.*...#.. ..*\.** \...#.##.. \#*  .....##    ...\*\.. ..\  . ....###...*\.* #\.\ ...*#........... #..*.. #*..#\#
#.#.***\. .#.##.. .*.\...#....*#...#...\  . \ ##..* .**... .  .*#.   *. ..*##......#...*..# #......*\.. #..... ......**.#.**..*....#...#.. **.*...#. #
#..*#.\..*. #.. ... #..#\. .....\. .... ......*..  .###... ..#.#....R #..*. .\**..  # . .\.* *.      *....##.#*   .. . .*.  .*.#.# \.## ..\#  *..# *.#
##.\.... #. .#.  .*#... #. .*..\#*.... ..#\..\..\..\. . *.\..#*\..*........#  .. ......**. #.*.*. .* ..**....#........ ............ .#.#.*\..*.*..  .#
#......#..## .....#*. ##.*.. .. ### *..... .#.*.#....*#* .\..    *.......#*#.......# ..* . ..  *##.#...........#..... .. \#*.\  ..  \......#\ ..*.*..#
## ...#*  # #..... . .. *.. .#. .#...........#..*....... \#.*.  ..#\ *..**.##* #*  ....  .\ #\....* \*...*...... \...##\...........*. ..*... .#  ..\.#
#* . ...#..# \...* .  .. ...\..  .*  \..\...*.....# .###..* .*.\.... *...#......*   ....  \ .. \..*...    #..*.....#*.... .  *..#..#*.#\# ...*..\... #
# *#...... .* ...##* .\#. \.. .. ##. * .. ....**.#..\..\*..  ###. . \. *..\. ..**... .*.*.....  ....*.. .. .#*.... .\*.........*..\.. ... .#.....  ..#
# *..*.#....* ...\...*.*. ..*.#  .#.  .....#. .... * . * *....\.... .. \.. *.... ..*\ ... .....*\#.\.*#.*.#... ...# ....* *..* *. ..*  ..\  .#..#.*..#
# .#...\. .... .\  . ....#.# .   ....* ...     **.....#. ..\ .*#...#.... *\. ##...... \.... .*..#.#...#. * .....\#.  #.........*  ..\# ## .\*#.....###
##. .*..*. #.*  .. . ... . .# ..... ..**#*  #.*..#.#...\.... ....#. .\# # . * *.  .....  #.\*...# * .#  # .....*... .*.*#. .. ..... ......#.#*#* ....#
#.. .. . #. . ........# ....\.## .. ##*...*....\ . #*.. . ....# .  .#.  . .* \\..\.\*.. .. ..*\.  *.. *. . ..#.....#.\*# .. ... .##..#.  \..#  . . ..#
#.....\.* .##.\#* .# ..* #.. .. .* ............*..  ....... ..\\*.*...*#\. . *..#. . *.#*.#\## *..# .# .  \.#... .#...*#* .\.... ..\*...*..  .....#* #
#. .*. # .....# .##\...\. \..   .#....*# ......*.. .#\... #...... ......*......#..#.....#...#.  \..#.\  ....*.#... .##..\#.\ . .\.#.... . * * . . .  #
##*.\. * ....* .....\... . .   . *  .... # ..  .*.*...#.  .. ...# .\  *....... .. ....#** .*..... .. #. .*\ ......\\#   \. . \...*. . ##.# ......  .*#
#..\.. #.*  ..#..#. .....* #. .*...*\.\# **.\. .**.*...#..*..#* #  . . #.*.\. ..  .... ...# .**##.....*#.  .#.......*\..#***.\\#\.#.... #*..**##   ..#
#.  ..# ...#. .# ...# . ... .  ##*..*....** #*.. .\..*.#.\....#.*.#  ..#........ ... . .#.*.....*..\#. ..  ..#......*....\*  ..* .. . .# ...#....*...#
#.... *.\.  ... .* *. .. . \.*. ....  ..#.\...........  . .*.#. #.......*...*#. .#*  .#.*..\*.\.... .# \. .\\.*# ..#.*.\.*....*#*. ... . .#..\  ## \.#
## ..  ....*#. ...#\##*..# .# ...* #\ ...#..#. *.....*\ .  ...#  ..# *... #.\... #  . .. ...... ...# ..#...*...*  .. .... ...*..... *.. ..... . #... #
#......# .  .. ...\## .\....... .... .. .#  ... #........\.# . .#\* .#........ ..*#.#.#..*.....#..#  .*  .\#  \*...*.*...  . #*. ##. .#*\..  # . *...#
#.....#. ..\..#* .. *..... . ..* \#.*...#...*....  .. .  ##..#.. #.....*\.. .. ....  *.# *.*.\.*.\ .# #. ...#*...#\ *..#. ##.*.*.#*.......*. *.*\.#..#
#.. \.*.*.#. ...#.. #..\#.. ........\..#  . . **...*..#....\. . . .... ... .......\... \#....   . *..*\.. ...*....# .....#....##..  . ..  ..  *#*....#
#....* #\. .\...**#.##...\.# ....*\..#*.* .*....** \ ...#. ....*..* *. .###.....#. .*.. .. .  .*# ...  *.#. * *. .\#. ....* \ *. .* *. ..*.** .**. * #
#.........# ... ....\#..*....   .. .. # .# .\##.. ..\.\#\..*.#........\..*#..\* *.. .. *. ... ....* \..\.. ..*..  ..*. ..##. #. ..#.  *..   ...\....##
# #*... #*.*. ... .*#.....#.. ...*.. .... \. .\.  # . .*#. ...*  ....\#.* .. *  *..*.#**..# ....*.# .*......# #...* ...... ...#.. . *#\....\\..#.*...#
#* . *  \#\..*.**.#.##.. ...*. \* ..  ........ . #. .*.\....\.##.\ \  .#.*.#  ..\\. . . . * .. . *..*.. .. *#.\.# . #.........#..##*.. \..# ........ #
##.# ..#. *.#* ...#.*..\#....\ . . ..##.\...*...#.....  . ...    *.... #*.*..*#  .\..#....\*..  ...* .....###.. .... ........ . \* ..#.#.#.  #*.. ..*#
# *. ... ..\.\#*....  .....*..*\\\.**.#  . .##.*.... .\*. . ......*\*.  ..#.#*.#.*....\.*..# ... \.  ..#.*##  ...##*  *.. \.*. . .... .   * .....\#.##
#\...*.. **..... #......\. ..*  . .*#..#.. .. ...# *..*# ..... ..*.*** .#..    .*# . ..## . *\*... ..  \. .....#...##. .# .**... ... ...# ..###...  .#
#......\....# .. .. .. .#..  *.**. ... #. # .\.#.\  ..*......*..   *\..\*\....#.*... . #. .... .\.*....  .# .#* .#. ....  ...* # .\*.*##.#..# .# *. ##
#.*..#.  # .# .*. #  *#.#.\  * .....  .\..... .\ \.... *... **... .   ..##.... \..\. . # ........\...#.  .   .*#....  .*  #.#*..#\..* .....##. .  # \#
#.  .  ....  .. *..* ....\..#..#*. *#.#..##* .....*.#...*\. . ..*. #..\.*# # ...#.* \\*.  .. *.. . *.*....*\... ..\  \ ..\.. ..#..*\#... ....\.. .**.#
#..#...#.# *... ....*..#. *  ...* *...*.#* .#...*. .   . ....\*\.  #..*.*.*\.......... *..   ....*. ..*..#.\*. ..*. .#.....\. .. .. ....*#.  ...   \.#
#..*....\.**..*......#......\ .. .. .# .... *..*#* ..\ \.\*.*\.**..* ..... \ *.. . . .....*........\* #. #.. .... *.. .##..*# ...**...#*# . *.#.. .. #
# ..#.. #*..... \.#* *..* *.#..\.#.**. .# .... ## ..#*..* ....... #..... .#*..\  .# \  . . .# *. *..#...##** ....***... ....* .\....... .*. * .  *.#.#
# ......##.... #*. #....#..  #. *.* ..*.#....#.\\*#*.*#....\\...*. # *..*...**.... ........\. #..*.*. .  .*#..... \.\*\. .. .\.\......# ....#. . .\#.#
#\.... .#.... *  \... *..  .*   ... ...** ...*..\.. ... . # ..# *.#. .#.. .*#*#\. ..**\ ##...#  ....* ##.#..#..  .*  ...*.  .. . . *... ..*. ... .#.*#
#.. . .* .\ ..........# # .#.. .. . .*#.\.*\.*. .....  ..#.#*.#....*\  #..#.. ..*.\*.... ...**.\ #..\.** #.  . *...* .\.#**..*..... ..*.# ..**.... #.#
#. .*.#..\ *..*... .... #\....#*...... #.*. ..#.#...# *#....#...#....\  *.#.*....\  #.#..#.. ..#.. ..#. #* #. .*...* . . *....  .\ *#*#. *.... ...*.##
#.....#..... . ... . *... *#\  #.**. .. .\*#....*\... *.#..*.\..\.*.# ..\\. .###....   *.  .. .........\.\....*.. *\.#. ..*.#..#. .. .....*.*\* .*. .#
### ..  #.\\. ..# ........*#.......*.. .*. ... *.*.. *.\** ...*. .  .... # ..  . . .#*...... *#.  .  ...  ##.*#*# .*... . #.# .... *. #..#. .... .*..#
#.# .\\ .*.** **...\..* *..... #...# ..# ..   .......  \ .*.\......*.##.\. .*.... ### . #.#...\...\.. *...#.... . *....##.## .. ..  ..  *.... ....  .#
#  # .  .*.....\..... .** .#..* *.#.  ......###.. ..*. .. ...*.* .. . .. ..# .... . .* .#. ....... *\# *\...#*#.. *.... ..... #.**..\. .*.  .*..\.#..#
#... # .. . . ......   . ..  ..*. ...*.  **.. . .*. .  #...* ... . .... ...* #\  *##  .\.# ...*. *#.  . .... ##  . \\.. ... #. *.....#.# *.... #... .#
#..*..* *..**. # ##.....*\. .. ..#............#....... ...#..* ..*..* #*.  *..### ....#. ...*.\.. ##. .\.# * ....#..#*. ..... .. \  *..#...*.........#
#. *.#..\.#....*... . . ##.  ... .#.. . .#. .*.... # . .... .   .*...... ... .. .....*.#. #. .* \..# ..#........# ..*...*## ...*.*...#*. .. *#...*. .#
#... ... . ........\..# .. . .\  #..# *. ..* \....*\  # **..... .. .*..#......*.. ..*.... ..... .\ ...# ..... ....\. . ..#.# \.#. ..##.\...\....... ##
#....\ #.#. #.*.. \.. *. .... #. .*..*...#.#.. ....#.......   .# *#.. #.......\.. . #.*.. .\*..... ...... ... ....*\\.. * \.#.*.# **..*. .#*....  . .#
#..##.* ..* . .. #..#\ .  ...*\..*.#.  ..\.*..* *..*.....  ...* .#*..  . .# ..  .#.#.. \.....  ... ....#. . ..*.#.......#... ..*##*.. .. #.  ..* \...#
#......  \ . .........\.. ....*...*.. ...\\. #. .*..#..\.. . ..*...............\ ... .. # .....  *#.##.....  *  ...*. *. ......*\ # ..... .*...  # **#
#... ....\.. *# .... *..\*.#.*\.#. \..*.# .. ...*... .... .*..#* #* . # . #. . .  .#..# *\.\.\\...# # ...\*... ...........#\... .#. ..**.......# . ..#
#....*...# ..#.. ..#...#.....*.*# .\.*.#......  ....   . ......  ..... ....  .... . .#. . # *\* ...##..*.. ...\*..*. .*.# ....  ... .*. ...\ .. *... #
#. **..#. #...\.#.# **..\ .#\ ...#*\... .. . .. . .. .  ....\.#\.#...#..*.\. .*... ..  * ....# #\ ....**. # #\#....  .*.##.\.. *......#........ .....#
L..#.*. \... #...*  .\#. #... . #**..  .#....*\ .\#\.....*..\.. *\.#. ..*.*.*...*.   ..* ....** ....*..  .. \  *#..##*.. ..  ...... *....*.#.....#...#
# . #  . #.....\*\ # *. ....**\*..\ ....*.* .. . ... ....  .*\. . ..  ...# . \..  .. ...#.#..\.*....\...#.##\...... #. .# ..# ...  #. .#.#. .*..  .* #
#..* .*.\... .#. *# .. .. \ **#.*. ...## ......*..  #*  *##* \* .....\   .# *.........\#. .. .#.....  #.\  . ...... .*.....   #.. ..   .....\#*. ...##
# .\...* .. .. **\..  ..  *.... .  #.#..... . ......#**.....\.  **. . .##*..   *..*# # .......\..#.. .....  ...#..#...*. ..#.. \ .  .#*# .#...  \... #
#*..\  #... .. . .*#.* .\. ... . ....*....#.* ..\ . .#..  #.  . .\*  #.#... . *. .*.  . \ #......*...#\...*. ....*...... .. .#.# #*. .*.  *..........#
#..#  .  ..\.*..#. .**.   ...\. .... *#*.\.... . .... .  ..# . .\\.*.......*.... *.##. \..\...  . .*. . .....  ....\.#. .*..\...* . *# ...*. .#..\...#
######################################################################################################################################################