######################################################################################################################################################
#......* ..\....\....*.* ... ..  \... . .... .*  ..... #*.... .......  ....#....#* ..#...\  #..*..* #*.. .  ..# ..*.*.*...\*... ##.. ... .*....** .#.#
#.**.* #..*...*.   .*. .*.. *.##.. ..***.\.#....*..... ..** ..... .. ...#.##... ....\##...# \.. . #\*.... ..**.\ #*.*.*#.#.\. .... * .\.....*.*... *.#
# ..\*   #.. ..... #.       **..... * \*..*...   .....*.*.# #..*.*# .\....\..* .* .*..* .. ..#.\.. . .\........#*#...#\.* .. .. . .... ....#.  #.  ..#
# .\\ **..*.. .# #.* ... .  . . ...... .*.* ... *.....*..*.# ...\......\ ...... ..\#.*#*#..#. .... #...\.# ..#...#*.. ... .. \..*..#..*... * *. .\...#
#*\ . ...*.* *.\*.#** .....#\....  ....*. ..*\   ...#\...#...*  #..  *....*#... ...*  **..*. .\.#.*.\. .*... . .***... ..*# . ..#. .\  . ## ......* .#
#..... #.* .. #. #.*. ## ..#..*. #...#.  ..*# .\.....#..*\.... ...#...#*.\...*. .  #.*..#....*.#.*\#. .   * .#.\..* #\... ......\.\ .*. ..  ........##
#\.# ... . #. .... .\  ...........\...\ ... . .\.  . *..#.*.. # ... ..\##.... . .# . ..*..  . * .* **.*.... .\.. ..*..  ....\.. #  #.....*...*..#. \ #
#.* . ... .... ......*.. .  ... .*...*.....#...*.#*..*..*#  \ .\.  # #...#......#*. .\... #...#\..... *.......... .  . ..#* # ... .. \ .#.#.#.. *....#
#. ....#..\ ... #\.*.\. .... . .. .#. .. ...#. .* ........*....  .......... .*.. .....#*##... ..#  ...#.**.    *.. *. . .......#...##... ..*.\. #. .##
#.  .   .#.\ ........*  #\.....#  ..#.....\.# ....\ .. ** . #... .\..#.  .... .. .#.....*#* .  ....\.\ .\#. . *.\.. ..*#...\.  ..  . .. .....* . ....#
#\*..#.# #*   # . *..\# *...\........#.....*. #.. . .\......  .. *.# .. \#**...*. # *.* *.*.* ...*..*..  *\.*.*........ # ...**.*..\##. ...**.....#. #
#.#....#... *.*#*\ *.*#\.  ..\ ..#...\..  *. ..    #...*#... . #....*....*# . . .......*.\.\*.....\....#...*.. .#*.*.. . *..  ..**. #**.\ ... ..#....#
#.......*\** #.\..\....#..# #  \ .*..#.#.#..* *...#.***..... . .##..# # ..#. ..*.  ....*.#.# .*. .....##...# #...\.*... \.#. ....... ...#.   .\.#.. .#
#..\* ..#.... . .#.. ..* ..#\*# ...# *.... .#.....#*#.# .  ##  ..*. . ....*  #.....*.....* \ .\..#....\....# *...\  .. .\ .......*..#.  . ..*#.##.*.*#
#.* . ...  *##.  #..... ..\.. . ...  .....\ \....#..*....  .\ ...*#..**. ....*. . . .......#... . .. * #....*..#.#..#.#.**...\ # .. **.. .*#....\..*.#
#...#.\#\. *.\#.....# ....#..*  \.....*.# . . \.*.#...\#. .......\ .* . .* ... \*......#.   #..*.. #  .* .#..\#...#.*#.\.#.*..#.... .\.....#*\ #...*.#
#*...##... #. ... ##  .. ..  .  ..*.... . .\. . ..\ #*..#. ... ..*#.. .. ........\. . *.  ...#..... *..*..**.........*.... \........ #  ##...# . ....#
#.. \..**.#... .#\\. . #\.... . .... .  ..###...#.#...#* ... . #.*.. #*...*...*.. .\...  #... . #.....# ###.#* ........* .\..##...*.*#.#.*#...\#. ...#
#  . .....#........*... . # .. .. .  . ..*# ... .# ..*.* #..*.. ... #.* *.\ #...#....#.* .. *#...\. #.#......... .. ....* . ..  .#........\.......\.*#
##.#.**.*#....**... . \  .  ..#..\. . ..\. ..*#.\.......\..*.  #  .*. ....\.\##*.. #..*... # . \.*.. ..# ..*\...\..\**. .#*..\ . *.#.#.... ....*.....#
#...  .. *....*#..... .. . ..*.. \...... #  ...#*. .** . *...*.#\......\.....#.*. .*..  .#.# *..* ...*..* ... #... .*... ...\..*. ..*..\# ..  ...#.*.#
##*  . ##... ..*.. \..  .\ ***\ ##..#*..... .*. .. ##.* .#......***.. ..*...   .. ......# .... #..\.#..**... ..#\..     .......  . .#.  .....#.**.*..#
# *\ # . .... . ..... . ...#..#**.......* #.....#.* \.**...... #.##.. . .. ...##. \...*.... #.*.#\...##...\**.  .**...# *..* ...*..*.*.*###\ * .#...*#
#*.*  .....# .\\........#.....\.#\. ..*..\ *\\ .   .*...#\#.... . .#. ...... \.. .*..* * ..*..#\... **..*.  #. .\..#\*...* ..  .# ...... ..**.#..  ..#
#.#.........#. .. ...\*.... .. ... ***.**..*.*.........\ ...#....\.  ...#...... ... * ..**..#.#.. .....#.**   .#.\.* ...\. .*  . . *... \ #. .** ....#
#**. \ ....##.. ..   .. *#.\#..... . \..*....*#..*\#*##. .  .....#.... *.. \.....\. #.. ...# ** *#... . \.#.. ..*.#.\...#.*#.*.... #.....#.* .*.. *..#
#.**..#...... ..... ..#..*.  *   .. ..***#. .#. ..#.\#..#*...*. . .#.....#.*\##.....#..*....*...   ....# .............**..# ..#.... . .....  .... ..*#
#..#. ...**.*.**.. .**# .#*.  .*...\\ .#.....\........ ....#... ...#.. .... \..#....*.*..# #.. .. .**.  .#..#*#*..*. ....*.. #......   ..#.\ .. .. . #
# #..* .#..\##..#..*#. ...  #. #  ... ..... . . .*.\*. #. .... .\.. .. . # .. ... .\.. .*.. ....#.... .# .....\ .. *.\.#*..... ... ... .#**. *# *..# #
#*.#..*...*.. \#  .. .#.  .#..# # ..*. ..\. #...*#.. ..*\...* . . .. *.. .. .. ..#*##......*  ..\#.  *.....*.*#..\.#.....*.# . .. .. . . *.#*..*.  .*#
#**   ..\*..*#... ..*. #.#.....  #... *** ....\  ...  ..*# ... .. ....#.... .*... *.. . ........ ........#* *. ....... * .*.... ###.#\..# .#.#*..#. ##
#...  ##. ..#...... .. *..\*.* ....#** ....\..*.....  .#.. ...... * # *...\.. \*...   ..  .##.*..*\  ... .. *..*. .. .*###*..\..\#.\...\ *.#.. ..#...#
##. \*....*. **#... .*    ..\#* .\# ...#*. .# .*.........  \.#.....*.#.\  ..*...#.**. ....*..*##.... #*..#.*.. .   ... \*# ..#....  ..... .... .  . .#
# .*..\.\ ......#*...\.\...... . #.*.. ..#.\#.  *.#..*.. \#. ## .**... **. .. #..#.#.*.\..*..# ..   ....#.... ..### #.#...#. ....... .......*......*.#
#.# *.*\.#....*...  \.........  \.#...** .......  ....\.#*  \.........\. ....#.##.*\#.....*..\.\ .*#.. .... *.......* . \ * **.*. \....... ..  .*..*.#
#. ..*.  ...*\.....*\#\.... .#..##   ..#.#*#..... . .*. .. .#.*#..*.## ..#.  \. ..  .*. * .  . ...*.........#. .\..\#.#.##.. .. .#.... .#.#. .    .#.#
#. .  #..*.#..*\*.  . .*.#\.   . .\# ..* .. ..........*#.....*\...\   .#..#*.\#...... ..... ...  ..# . #.\. .*** *..*. . \. .....  .. .....*..... ...#
#*.. *.* .. ...*.## .... . .#* \.....\..........#.. # ...... ##..  ..#... . .#*....# .#*... \ \ *...# \*.*.. ....\ *...  ....#....#........#...* *  .#
#.*.# . #.. . ... .....*... .##.. ....#.#.  ...*..*.##.*..   .....#..  .*.# .\....*...  #. ...#\* ..  ..... .. .. \ *.#.\#..*#..#. * ##........ #..*.#
# . . .... ...#.*.#...\...#.#.*..#.\. .##..*..   ..\..  ..\*..*.... #......#. .*..#.* .... .*.... .#.*... .\#.\.*.# . . .*.......  #..* ..  .. ...##.#
#.#.#.*   ..#\.\  #... #.#..\....*\..*.. #. ..*...# .  .**.....#*.*.....#..  .*.#*.\#. .... .... \... .. ....  *##..#....  # *.\....\ ....*..#... #**#
#...  ....  .*.* .#.. # *  ...\*... ..\#**.*... ** ..* ..#.. .#.#\ *\....\#.*  ... ..... .#.........#..* .. ...*. ..\#.*#..**......#.##..*... .\ ##..#
#..#..# ...# ..........  . \\... .*.*. .* *. ... .# #.#. ..#\*\#*  ..#..\..*#.## ... .*.#. . ...... ...........   #..#   ..*. \..#... \... .#**\.....#
#...\.#* *\... ... .\ .....#*.\.... .*.   ..*... #  . #  . ..#. ** *.\..* ...\#\ .#. .#.....# #. \.*...   . .#.#..*\ . #*\...*. . ...#..#*.. ..\*.#  #
#*#.... *.  ...*\  . . . . \...  ... .#.*#. ..#.#.. ..... ..\.# #... ...#. *  ..#...\... ...*.. #. ... ...\....#\*#..*# ... *..*. .....*.#.... .. #..#
#....... .\...##. ..*... *. ...  \#....\..# .#.# . #....\ \.# #. ...#**. ..*#.  .....*........ ...#...#.#.*... ....\\......\  .# *... ..\.#....#.\.  #
#.......#*. #.  ...# * ......*.*.. ....*.. #..... . .*. .... ....* .*# ........\#*#.  \ #. ..**. .* ..*#*.   .. . ...##\.#.....#.\*..\..#.. #.#. #\..#
#........ ....*.*.. . * .#..\.#. ... .  ..*\#.#...*.\ .... *...\#. \*...........\.#. ....*..   # #*.#...  .##.  ........\*  .\.. . * .# .  ...#  ... #
#  *.#...#.*..# . ...*...* *.......\...  ..\.* .*  .. .#. ....#......*.. *..#   \ . * ....#.# .  #...#..#*#. .. ...*...*\. . ..##\..#.. .*\* ..#. #.\#
# .#...#.*.... . .* ... \.*.. #   *# \... . *.. ..* . .. # . . ..#* ..\ ...\\  ...*.. #. ....\#..\* *.  ...#..*.*.*.... .....  \..... #.*...*...#*. .#
#... *..\...#..\# .....# ... ............#... ...*.##.#\#.*# ..## * ..\. . .*. ...*.*.. ...**#..\..# . # ...  . *.. *.....* .. #.#....# ....* .   ..##
##.. \..#.. . .. . *#.   #\ #*.#\... ......*.*.#*.. ..#.**#..*.* ....*..**.. .. .*.. .*....#.. . .... ..*. .. .#.# ... ..####..#.....*     .. . #. * #
##. .  ....## ......#....*...  . . .* *..*#......\.** #* ..\#.#.# ......*#.... .....# ....# ... *...*.  *.. .  ... ..* .. \.....#* .#   ..#..... ....#
#. ..#.\*.....*# \\ #.*.. #. .** . ...  ...*.* \ .....\... #\ .....\.\...... .. .*.... .. .\#*...#  #\.. *.\.*... ......#. .. #.. #    . *...#..*.*.*#
# ...*...*#.......#..*..\..\. ..#... .#..#**.#\.#   .#  \.\#...#\  ..### *. ... .\....#.# . ..  .... *.#...\ #**.**..\.\  .# . ... #   ..#..*.\#. *#.#
#*#.. ..*...  . * .*...*... *.#.##. #*..*.... ..\ #..\... ... ... .* .* .#.  .  *\...*....... ....  .*#*........# *\  ....  *\. ** .   ...... . .....#
#..  .  .....# .. *. ....\.*.*\.#* .\.\.\...... . #..**. . #  .   *.## #.*.... . ..*..# .. ..#...... ...... .. ..\.* ..#  .......** \.***  \* .\.. \\#
#.... .# ..#*.*..\ ..*.....* . \... .* ..... .... ....#. \*.*......#.**..  .#.. #...*......# . ..*......\....\#.*...#... * *#..\.. . #...#*..\..\..*.#
L. #*.#\ *.  .#.... . ... ... .. ...# . ..# . #. *# ...*. #. .. \.\....#.......#.  ...*.....#. .. ** . . .*...#*..R * ... .#........#.  * #...\... .\#
#*  #.\.*##.... .  . .\# ......#*.#.  ..\ ...#.. .. \..* ......   #  .#... \.. .\\..**....#..#.. .. ..  #.  . *.*.  * .  .\ .*...#.... .. .#... . #.*#
#...... .. . ...# .\....#..#*# .\.. . .. #..*...*\..*. ..**#.... ##*.#  ....... . * .#.. \ ..   ......\..#. * #.\. .#. .*\..\#  . .*. #*......\......#
##.   .....#*....#......  .  #. . . .... #.#..... ..*  .## \..  ...\. # ... .... ... *.#....# ... .....*.*\..*.\\##  *..* \... ....#..* ..##.*.*... \#
#.. ...#.  .*....   ....**.#..... ....**... .*..... .#.\ .*. .*...*. #.#....#..\. * .\#.\##*...... \*. #.*.  ..\........ ......*.. . .*.#...\. . .#.*#
#..##* # .*..#. .\  .... ... ....\... .*...* .\\..#.... ..*# ....# .....    #...* *.# #....***...  ..*.\...#...#.... #. \......*#**. \ . *# #... .*.*#
#..#..* ***#.  ..**\ ..#*..#  ..#\\.....*....*..  *...  . .##  .*.. ... #...*. ..*..\.....*. ..\.  . ...*. .... . .***\....\.*#*..  ....*#. ....*..#.#
#. ..*#. #.#*.  #\#..#.\ .....##*.# .*..... ..\.#.\.. .......\###..\.\*.. .# .#.*\*\.# . * \\..#. ..#...#... . ..*. ...# ...   .... . ..****\... ....#
#..   .\# *#.#\..* ... . * *.. ....  . ...**.#..#  **#.   ... ..#.  \... \.... . ..*...* ... ......... .  . .. .. \ . ..*...\* *.*  .*    .*.*.. .. .#
#*.#*#.  #....\.*\   *.**. *. ......# .\\ ..... \....#..#....#....#\. #\.#  ..\.... ......#.##...  .**..  . \..#......... .#...... ......#.##.*... . #
#......\ * ...*#*.. .....#..#  .   ... \# .....*#.*. . . #. . .*...... . . .##. .# .#.#...*..  . . *.  .*. #..*...\. .....\.... #...#...\*  ....*.. *#
#* .. ##.. ..*.. .#***.. ........#.# .##. .   *#*...#    .** ..*..*  .#... ....\...#..*..*  \.###\*....\#... .  *.#....*.*. ...... #..... #***# .#**.#
#.* .#.. .*  .#\ .......#\ ... .  ..... .#... ... ...*#.*..*..#*#...##..... ..*.#.  ..#  ...*..#.... ... *..* *.. .. ... .. ......#... \\#..* . #..\.#
#.* #.\**#..*. \.\  . * ..*.... #\...  ..... .*.*. . ..#..*  ....## ....**  * ... .  #*. ...#* .*  * .#. . ..... ...*.. *. ...\.....#\##.#\#..\ .#.#.#
#... ... .## * . .\.. .#.*.. .#......*##*# . \.. .#\. #..*..*...*#\..\.* .\*. .. .....\. #..**#..\...* . \ . ..***#.#.#*\.. .*  * .\.* ... .. ..*.. .#
#  #...\.\....  ..#. .#. .# .*..#*.... .... *. #. *#.##\  \*.. . ..* ....*.....\..*....\ .*#  ...#.... ....   #. .  .....#..* .......\#... .# . *.. .#
# ....*\#...\.*.   .*# .  \.. .. .#. #*..#.#.  ...*... ##.. \ **..\... *...........  .... ... #..*..## .  .  \#..*.#....... ..\...* *  .. *.. ..*.# .#
# ....* .*# .* ...*.#....\.#..#* *..*  . . .*. .  #..\.....##.\...#\\.  ***\. \\ ...\...*#\#. ** ..*.#.*  .. ..#..#... ......... .*.\\\#*...# *.*#...#
# **.....#.*...\ ... .#. ..... .....  \.*.*. * # *...#....   ..*#... \*. ....*#....... #*\ ..#. ... # . # * ..........     \... *.\.  ..\.. .*.*.. ..#
#. #.#. .*.......#... .. .. .. ..##.. .* \ ...\#. .  .#...* ...**...#.#. *..#  \.  ..\##..#   ..* .*.*#   *   \ .. .... ...*.. .. .. \ ......##. \.. #
## #.  . #..#..\.# ...#. .. *\..\.. ..#. ...\. *\..   .#*\..*.\\    *. *\..\.....  ....*..#..\.....**.#.........\\**.. .... . #*. .\. ..... . .* . . #
#.*#.  .. .....#.*.......#.*.. .# * #. *..  * ....#... *.. .\....#.  .\ *#.#.  .#.. . ....... ..\*#...\.\.\ ...#... *#..**#.#.\.. *.*.. . ...... * ..#
#  .  * .#....##..**. *\.  ....  ..#. . ..  .*. .. .* ..... ..... ..#..*...*.  #\..*...# .*..#. *...\..\. . ...... *...*.. #.\ .#. .# ..#*..    *. . #
#*.* .#  \..*.#\#.....** \... ....*.\ . .................*.#.# * . ..   .  ...  *#*#........** #...*# # #.... . ...\....*.\*..*.*....#..\ .. . ..   ##
#.\.*.... ... *\ *..... . .*... .#*. ...  ... .*.. ....   *   ###...  ..\\.*...... .\.. ..\.*..*.#..... .\... .\. .. ##..#..  ..#  .\\ .. ..... #.. .#
#.. . .. ....\. . ..* .\ ...   .. ..*# ..*##. ##.#.\.. .....*... #*.\*.** ...*.*.....#.. ...##  .. ..... ..*. **  \   #..\#\* .......  ... #\..\.. *.#
#*# *..*... .*..*.*.  .. ..*.# .  .#. .  ## ...#.# . .   ..  *.... ....... #... *#.*\.\.*.....\......* \. . .. #..*#\ *.. .. ....*.*.*.*...#.....#. .#
#.......*#.. ..\ *.#.\ .*...#...**\ ...*.*.\.#.*.... **  *#. .*\ ###....* ..#..#.#..  # .#.\# .# #.# ##.#. * #*. ..#.*.\\ *.*. ##..##..#.*...#..\..*.#
#.*#...#*. .  ... ....#\ #.##. ..*. ...*..*#*.*.  ##....#** .\ .....#.. .... . .*.#.....#. *.\*..*.  ...**#.#. #.*  .. . ..* ..* .* ..#.* ..\  .*..#.#
##. ....#***.. .. #...#  \.. .. ..# #..#..#....**. ..#.#.\ .......#  .....*.... .........#\.....  .# ........\ ...#... #. ..*# .#.... ..\. ..#.#.  * #
#.. .. . .#.... .....*...#...\.* \ #*... #.*.\..#..#*.* .\#. .*.... ..#. \.\....*. .\##.#*.... * ....#. ..*#.   . . . ......\#..#..... ** ..*  ..*  *#
#...* ..#*.. ...# . .*...*#... ...# ..#\ ..*..#**.#\*..  ..... #. ##.\  \  ..*. .. .\.\.........#\.....#\..... \ * . .#.*  .\ . ..\. .......... * .. #
#.*. \..#....\..#.\.....  # #..*.# ....  #  .  ...*  *....*. ..**......#.....*#\#.*. #..# #. .. ...... .***....   .#*.*...*#.* . ........  #\.## ... #
## ..*  ..* ..#.#**. *....#...#...  . .*..##* ...#.  ## #.# .. **. #..#. . .*  .. ..*..*.\.*.#. .#...##.\ . ......... #.*\.  #*......#.#...*. .#.... #
#.*. ..... *#.\...* \. \.#..*#*#  .\.....* . #...#\ . .\.\... ...*.... #......  ...#.#.  #.....#\*.#..*# . ... ....*.....\.. .\ #..#..*..\.#...\.... #
#  .##*..  #...  * .\*  ..* .  ...... *........  *#   #*...... ...\.. .......... #.\......*.....*..... ...*#...##.. \ . ..\ .# . ..#. . .#...... ...*#
#*. ...#.  .\* . # . *... .... \\. ...  .# .. ..*  #.......\  .*. #.. .*.... .# .. ...*\  .#.  .*.  ..##. ..... .* ........\.....*...#..#**. ......* #
#.##... ........ #. ...#....\...#\\.. \ .*.*. ..# **..#*.. #. . ..\. * .\. ..*... . ..  \..  ..## ***... #....# *......#  .\..*. ..\  ...... .  .....#
# *.....#.*.. ##.#.#*. ...\#\#....#. ... .#\.. .*\\.#. .\\#..#.# ...#*#. . #.*..*..\.....\*  ...#  \...# ..  *##..*......... ...#  ...\..#... ..#.** #
#\*..#..* .... \..#........*\.\\.#..  #.....*. \.#\ .#.... ... ...*# \ ..*.  *. .# .. .#.*..  .## \#.#. ..#... ....   ...#.* . \...*..#...*...  ... .#
## #.....\....\...#.\. ....*. *.......  .... .\.# #*\\...  . #*. * *...\...* *.#\ **..#. . ...*#.....#.....#...#  .... ......#*....##\ . *# . .* .*..#
#... ...##.. ..*..#....#.   . ....#*..# \....\....#. *. # #......... *  \.. # #..*..\ ....# ..  *.#..\...#.* * *......#.. . . ... #*\*... \## .#*... #
#... . ..**...\ #*.....# .. .# #. ..#..\.#*.. . \ .\ ....*.#.... .#.\...\ .. # ..\.#\.*... . *#... .#.*..#.\\..*.#\..  .\...###. . . .\ ** .. * ...\.#
# . ..#..#..#....  .\ #.  .*.*#... ..*...... .. *#.. .... .... *.\. \ .#\.. ... .**. ... ..*.... #. \.. ..*.\..  .. *    .*.*..*.. #..# ... .... ..*##
# .# .**#.#.....#*#.. ......*... ...... ...*.....**..  * .*..*.. .#.  ... . .. . .# ... .\. .*.  ...*.. . \. #..\\ ..#  .. .*..\. .....*... . ..  .# #
# ...   ....*.. . .#.  * .\* \ ..  \#..   .  **.. .#..* . .*.# ..# .... *..#..#\ ..  *..#.*. .... . ...*.\. #.# *.....  . . ..\.\..*\.  ..##...\. .. #
## #....# .... *.#. *.#.*\. .*# .#..* .* ... . ....*#..\........** .....  *.*. *. \#...\ *.. ...*.*.\.#*.\# .. .. .... #.# \.. .. .... .# . .##  .#. #
#.#*.*\..**..  . .\......... . \... ..**.\...*... *.#*.. .*.\..#  .  . *.\ ......##.. ....#... ....\... \   .... . #.#...... *.*.#... ##*..   *.. ...#
#...#\.. .**..* \ ..  ..\.... .* ..#  .*......*.   .\ *.*\..\. **..*\. .\.*#. ..\ *.. . # ........#...* . **. .*..\..* .... . . ......  \. .\  * \...#
#\..#... ..*.*  ... \.\....*...\*..# .*....#.*..*.. ......*.#...** . \..* #**.. \.#.....#.... ....  .....\.. ..*.  *..*\.*...........\.*.*\....*\# ..#
#. .*.**.. \*. *#.##..\#.*.  .. .## .\. #*.. .\. ..#.*... \#.*.. ..\..*#.\*....#\.....* ......*## .##  #\  ..... *.\ . ...##* . . .....\....\.\*. .. #
# . ....#  . * #  ..# # # ...##\#..#. .*.#...*.. ...# . .**. .#. ........ ....  . ....*.* \..*...*...* . .. . .\ .# #  ....* *....   ..#\\.\.*.......#
#.... ..  ...#.. .* * .\. *\ ... . *...#.*..........  ... .##.\*...*#*..  .. ... .. .\......#.. .#. .#.*. #.... . ... *..\.\. . ....\....... .# . \..#
#.#.  .#. #*#. ..  *.. .#. ..##....#.\.#.\..* # . \..*# ....  .. .... ....*.*\# .  .\**. ...*...*#...... *....*.*...#.. ... # ... . *. *#.* ... . * ##
#..*... .....   ........  .  #.*.##.*....*..#*   * .## ##  .\\.\# . . ..\.#..*. #..*.*\. . . \   * #. #* .\ .\.. #.*...#* \*...#.. ..... ....... .  .#
##..*....\..#.\\\. *...* ..#.# # .........*.*...   **. *....... ..#. .....#\..*#.\.##........#.   *.. ..*#*.  . \.....#*.#. **#.#... ... ..  . \ ....#
#*. ... .  ...##...\.* . .....*.#**....  #.\..  .. ... * ..**...\*\.. .*#...#.#\........* .*....*.# #. ..#.* *.\ . ......# .... ##. ...#...\. \ *.##.#
#\\.\..  ......  **#...#..*.....\ \##..#.\#..#.# * #....\...\*\.  .......  ..# #*.#   #....# . . ....#. ..*#.* ...*. ...#..\..#. #\.. ....  .. . ...##
#. *\ .# .#*.  .. ....   \.#...##...  ......... * .. . ....... #.....** .#\...\**. .........#\  . .... ..  ...\.*\ ....\....  #.*  .*. .\.#..  ..... #
# ..*. **..*#........ ...  . ......##..#....#.\.\.*.....  .**...  .# #*#..#.. ......# . *.# . ..* .#.*.#\###. \..\...*.#*.  ...*#.\..\*** *#*..*...#.#
#.. .... #..\.*.... .##. * .* #.  .. ...... .#. . .*.*. *.. ..   .  .. #.*......\*#*.#.  ...#...*.*........ *.#.\.# .*.\..#. *...\ .*.*. ...*   . . ##
#\. .#....#... ..........* #. *.*..... .# ... .*. * *.*.... . ..#... .# .. *...\\. .*.   . ...* ##.#.. #...# #...#..\.* ...* .\\\#...... ....# ..... #
#.*. ......*...... ...*.\#..#...  ....... .... ...##.#.*\.  ..**..  ....*.. .\.# #.. ....**. \ #.*. ..  #..*\  #   ... ** ......#..... .#.** . .. * .#
##.. *  *\. ...*\..#..  #*\ .. ....#.......\#. .**  *...* ...*..... .# .. .\........** .*. *.......  #. ... .# .#. ......  .\......... *\....\ .##*. #
#.. . ......# .. . ... . ..# .*#. ..*#..#....\ *.... .. **\   .... . . \.#.  .. * ##... \#. #*.... .......*.....# #.*#..#... \.###....#. . .....#* . #
#...# .*.\.#. .. . .#..\\. .#*#...... . .*. .... ..#.. ...\.*.  ...#...\.*...\..*...# .*. ..   .# ..\ .#.....*.# .. ........   .**..#. \*  ... .. ...#
# . ...##..*.. #.*.  #... .... ...#.##*...*#\.... #. .* ..*.. **...  .*\ .#.\.*..  * #... #.  ..* \#.#. .*.*......*##*  * .**..#* .  .\#. .  *..... .#
#*. #. . ... #.#.*..* *. ...... \.*##......#. ..**.#..*# .  . *.  ... .#.*..\. . ..  # *  ..#. ...## ......  \..........### .#*. #...*\...**... ... .#
# #.#...* ##....#. **.... . . ... .. #.\.... .. .*.*#... .  #.. . ... *\. ...##...# ..*..#.#....\. .#.. \. #\....#..**......#*##.#..\#. ... *..*. .*.#
#.\.*. \.\.\... .* ..*\ #*...  ....  .#\.........  .... .#\*  *......#.*..#**  .*... .... ......#*.*.*..#  . . .. .\**#\ *...**. #..\.*... ....\.. .##
#**.#.\.#*...**...... .. .... ......*..\*...\ #....# ..  ...#...*... # ..**.  *  #.. #...... *. \..*..#.  .* *.#.\. *..  #. *#. .#  .*** .  *. .*.. .#
#\# ..*.\..* ..*.#.... .. .#..*... #*.... #..#.# #. . \...... #....\*. .# ..  ...*. ..\... *. # * . . ...#...#\. .* .# .#  ..*#.*.........   .**...#.#
#....* *.. #..\. ......###**....#. ....  .*..... .*  ......#.*#...* .....*\##. ..# *..*\*...*..#.....#.....\..   . .. *...*##.\..* ... ..#.*#. .. ...#
# ...........\*.........#......# ..*..#  ...#. ..... *...\.#*.. # #..  *  # ..*#.....#. *#*  .# . ...*...\..*.......*.  ... #. #....#... #\ # #.# *. #
#. #. .* # ..#...\.#.  .*.\... . .#.*...*.\ *..#.\...#.. .... ..#..# .. .\.........#.. .#*... * *....... ..# #..... ..#.* .. ..*.*#.*... #**. \ ... *#
#.*..\.* .. ...*** *..... *..*........\#.#.#..#..##.# #.......* \#. ..  ..#... .. .... .* .  #...#\*    ......#...** \.# # \. .*. *...... .*.#.....#.#
#.*\\ . *\  ** ..#*..##.....  .#. #..#....   .....#*....*.#.* .  .*...* . ..#......*. .  #.. *.. .... ..  *..#... ##.\ ..* .* ..* .**  .........  .. #
##. ..* .. *  ..* ....#.*..* .. *...... \..*\..\*...*. ...... ..#* #. .###.*# ..#.*...*...*# ..  #..... * . ... .....# .. #*...#*..*. #.##\. ..*#..*.#
#.. #.* .....  .. ... .... .#*..*. \.. #.. *......*......\. ..*. ..* ....\.**..\.#...##*.. .. * . .\  ...#..  ..... * #* ......\......##.  * \..\.  .#
#.#.*.....#......#...\.......# #... ..  ....* #.*#.#.###    ...... . .... ..#....*..#.... *.#*.. ..*...## ...*. *. . *....\.#...*......    *\...  \..#
#*   ..#*.. .*... *.#.\.....#..   #\###  .*. #....*#\. ..*\*.#.\.#* .. \.#..*.....  #.. ..*..*#.. ..\\.  *..** ...\*.\   .... ...*. .....\ .  .....* #
#. ......*.\#.*.    *..#..**.#.*.. ..... . . .....#...*# * .... .*.. *. . .  ..... ..*. .#..#.**...\..#*# .## ....  .*..*\.*.. ..##..... .. *#.. .# .#
# .# .. *.   . .\#..........#...### *.#. .... *..## . ... ..*.\.*....#\*..*#\#.. ..\..\.  ..#*. .*#....**# .  *........#\.*.**...* .. ..  ...#...#. .#
#### .***.   . .#.#*..#.. ..  *...*#.*#..  \##*#... \. #* . *\....*... ...\..*.. .  ..  . *. ......   .*...*   #.... .#. *.# ...\. .... *##.# *..\...#
#\...## ...*. .... .#..*#.  .. .......*. .... .#.. ...#   *\ .  .#*. ..# *.#.. **.#....** #..... ...#.\#...\. .#..#.....# *...*. *.....#..... #...*..#
#..*.. . ..  * .. #. .#. \. *\... *...... *.#...   *...*\.#.*. ...*..\*   ..*.  .#... \..*. ...*..#\\...*#*. .#..#\.. .**.. \*.#*.\ *\ #\..*.* ......#
#.#..\. #\..#.. **. # .*.... ...... #*# ..##.\*  **..*.#.....#..* ...*.\ *.  .\....\\......... *.*.* ..  .#...\  ...#. \*....*. .....*....*.. * .  ..#
# .....#. ..*# *... *.\...\ *..  \.....*. .... ...* #..##.\*... # ....#....*....\...*.*##\\.. ... . ........# \. . ......*.*\#\.. \.*..*.... .*.... .#
# .. ..##\ ..\.\. .\.\*....  .. \  \. ....#*#... ...#..#.*..*..**.. ...# * #.#.......* .. .  . ..#  \..\ *.*  \.....*# # #*. ......*.#.#..# ..\ ##. .#
#.**. ...\. #. . .# ..*..... ..\. .#. *#. #.. .#........ .# .. .........  .*.......*.\.   . #....* ..\***#.. . \... ..*... . .#*..*..#.# .. *\* # ...#
######################################################################################################################################################