######################################################################################################################################################
## .....# .#... #*.. .. .#.*#.##   # . *.... ...... . .. . .# \... *..*..***  ... ..*...#..... ...  .. ..#\#. ..\ .  . #.\.   .....#. #...#  .... ..##
#\. #..\.. ........ .\. . ..* .#..*#.*\..*. .#*  ..* . ..... ..... ..#...\.. ##.#\ .**. ....  ..**  .*#...#..... . #.*.... .#...*.\... . . . .*..\.#*#
# . ..\    #* .. #.#..*....  . ###.*\    ..  .# #.. ...***.. *#..  .*.....** . ....# . .. .... ...\..... .. ...*.. .. ....\\.\ .  #  .\.#... .## . . #
#*.* .   .... .\.# *....# #..*. ...\.... \..* .. ...* .\*..* #* .#  *. .\..## .......*. .  . ...#...*.*#.... ....##.# ...*.**.*..* ......    .#  #.*##
#...#.\......  ..*.....*. . *. #  \... *... . # .#.*.*\...#.... *. .  ....#*. #. *.* ...  *.....#. **......  #... ...#...*........#.. ..# *#.......  #
#..\*.....\ \  .#......#  *.\. .*\. .#..* ..# .\. ... .*\.* # ...*#....#.* . \.#.#.*##...*\ . ..#. .#. \\..\ . *.#*. ...#.    #.# #. ...* .* . .... .#
#. *.* *......\ . ..  ..#..#.... *....... .#..... . .. \.... # #..... .. .#.. #...... ... #....*.### ... #...\ .... .....#... ##*.. \\....*..# ..#*..#
#.*..*  .. . .......* .#.... .# .# .. *  ...#.* \. .*... .***....**\\#.\... . ...#.#... *\. #* .\.\\....... .*.. ..*.. ..  ......*.. #...#.....#... .#
#... *. *.  ..# . .. *..... . .. ...*#...........\.\..... .... .\....\*#.   .*. .#*.....\*...#..\..*\.*......#... *#.* .. #*..*#. .* ..*..\ .# .....*#
# *\....*#.* *. ......##.*.#. ....\.*.* .... . *#\\.. . \. . .  .  ... .**.#.**.\   \. .. \...#.. # *..# ...*.*..... . \..#... . \* ... \#\.*# ... \.#
#.#..... ..*\. .*... ...*...#...# .#...  .... .## ##. .#.. *#.#.#..*..... *..# *.  ..  ..\. . ...*.. #*.*\..* .\..# ...#* . .#.*..* *..#. .* .  ##* .#
#... *.\..\*.# ..## ..#.#*.#*.##  ... .#\...\* .  .\*.\.# .... . #.#.#......#.* ...*....* **.. ....*...*..#..#. ..\..*#.*...... .... *..#*...##..*..##
#.\#\.*...#.. .* .... . * .\ *.... ...  ...#. \.**. . ..####*.*....*\....*#...#..#.. *.\..*..*.. ... .#...  #  . . .....  .# #*.. .\.**.#....#...#.# #
#..**  .. ..... ......#.  ..# .#.......*.*#.... .. ..  ##. \..*. #.\..#...*\.....##...  .*\*...#  .\#..# **#..#   *. .. #*......#.. *#.# ..  ... \...#
#..*...... . #*.\##...*.*...* .... ...*...#........#*.......*..#. .* ..\. . \....#.#.   ... ..#..#..\.#.....\. ..\..#*.  # ..\...# .*.. .* #\...###..#
#. #.. . . .   ..**.# . .#. ... **......... . ..*##.*\*...#..*#*..... ....  .#\.*...* ...*.... . \.*..*.*... ..... \.... *....# * #.. .*.#. ....\  .*#
#*.##.... .....*\...... ..\ *..... . ..#\. ..  .# ..#  .\\......*. .....*\ *.. .# .  ......*.. .\.\.\..#. *.. ..#..#... .. ..#..**##.#..... ..  \###.#
#...**  .# ..# .. .........*...#*.#... *#.. .##... .*......*..#...#\  .... . ..*. ..\ . ...  #\.. \.*\\\\ .* ...  .. .... ..  #.*..* .. .*   *#. ...##
#.\.....  .# \# #..* *.. ..#.\.* *.. .#..\..  . #. . . \... ##* *...#*.*. *.## .# #*.*.  #.*. #*.*. .... *.*#*.....\\*** ...#. .  \. *... ..... .. #.#
#* .#...  *# *.#.#.... . #.\.\.##..\ ..   * . .. . # ..*.#..#. # \  \...**..#..#*#..*. *. *.\# .....*.\ #..... .# *....... ...\..#.. #. \ .**\*  .* \#
# . ...*#......   * . ....\...#..*...#.....*.*...***\*.* .#.  ...**\ ...* .*.*. ....# ..#.* ...... *......**..\. . ..# **. ..\##*..*. ..... ..*.. ## #
##.. ... ..*.  .#\.##\.. .*.# \  .#* **.  \* \#....* ..... ..  .... . .....*. ... *....  #.. ...    ....#.*...#..  *....*... .  *  * \ #..*...... #* #
#.. ..#. *.... ...  .*\# \\.#...*. \..*. . ......#. .*\ ..*..*... .*#  *..*....\#*.  .. .  .\ ...* .....#...#.#..#.#..**.#.\... . ..  ... **# . ..##*#
#...# ......*#. #.. # . #  .. *.* #*.... ...*  ... #....** .#*...  .*..#. \ ..... .. .....\*...*..*..#...... .....   \.#.....  ..\ .   ..... #...  ..#
#.  ..*** #.#..\. *#...*# .*#..  ...*.*..\. .. ..  .\. .. *.   .#. ..\ .\* .*.. *.# #.*.*.  .#\..... .** . *. .*. ..  ... **  ....\..\*  #... ...*.\*#
#......\\.. .#....* ...... .  *.#*.  ....  #\.#*....*\....#.......#.#.. ... .*....... ..#.#\\#.  ..**. ##\# .. ..  .\   .####.\*.......#...*. #..** .#
#.. .... ....#\...#*... *. . #.  ...#..# ...#. **.* ...\.*  ..  ..#*... . ...#.#* ..\. . *.*...*.. ..#....# .. .*  .*... .*.  * .#*.  *   .....  . *.#
#.\..... ##..\...*.*\#. .. #... ..  .. .\.#*.. ........\. .\# ..* ..\.*  .*...#...\..... * . .  #. \. .\#...**... . ..* . #. # *..#..***........  #..#
#*..#...... # \ . .... ..*.#. ..\. ......#   ..**...# ..*.....* ...# .\. #**.. . .\...\#...\\.. ..\..*.* .*.*\... #*. ...#  *.**...\.#*.*\. # . .. .##
#....... *......  #.  .  ... .*#... * *..*#.....  #. .\.**#..*.. \.#*...#... .\..  .  ..*.\   *..\.\.   .#*.    ....... ....*.  \  ...  . ..  ......*#
#  . . .\#*#...*.. .....\*.....*#. .. ....* .#..\.... .....*..#.........#..# #.#.#. *. . . ..\#..... .  **# .#.*#*##..  *.. \.*\. . #. \... ..#..*.. #
##.\\ ..*\.....  .   *.. .. .#  .#...  ....# * * .. ...#.*. ..#....\..* ... .# .\*.. #...##  ...## #.. . ....**.   ..   #...\..**\\ #. #.. #....  .  #
#. ##.     .....#...#.#  .\...#....##.. ..  .#*..#   # \#.. ..#..*.#. ..... .* .*.....\.....##.... .*..... ...#.....#...#.###.... .\..#....#.* ....*.#
#. .*.*......... ..\*.\... #.*\... *.. . . **... .#\.. *...   *# .*....#.. \* #.\... .  . * #...#... ....\.............\....#..** ...... # ..    .. .#
#.*#..*.*..\ ..*..* .#.\.....#.......*#\............##*...\....#\..\#.... .#....*.......  * ##....#.*.. . ...... .#...\ ..*  ....#. .#.......# .#.*..#
###.\....*.#....#..# #....... .##..*........*.#...*...#  ...........*#***...#.*.... ** *. ....... #....\  ## .. . . .#..#\. ...#.*... ..**...*.*  *..#
#... .\.. .. .\.  ... #. ....#.**..  ..*.#  . *.**#..#  #  .....#*.\*#. ...   .\  .. *...**....... ..#.* \ ..\*#.#   .....#... #...  .....#.# . \.\.\#
# *....*..*. ...    \#. . .....*\..*.\*....#......\.#*.....  *... .* . #.#.  # .*#..\. .#.. ..... . #...... .*..* # . *.*#. .*\.##  .\..##...\\..*...#
#\\.... #\ #. ...#. *#.. .\..\  *..\   \*\*.. .* *...#..*\* #.#....*.\. .** .\#.  ... \.  * . .  ..   .. ..*#.......* .*. \*.# **..  \ .**.. ##. ...##
# . # *\  *... . \.  ***. . \.*##..# .*##.. .*\.....#\ .##.# .*. .* ...#... .\#\..... #.....\.#*...   .* . .. ## . .... .\..... ..  .#.. #.....* *# .#
#*\..#...\.. . .*..# ........... . .. . .... ....  .. ....* .#    *.\ ..  ....** .\. ..*...#. ...*. ...*#..\\.##.\ ....# .## ...... #......... .. # \#
##.*... #. .*#. .. *\** *.*. .#..... .*#...#. ...#....... *#. . ... \*..*......*. .\........\...#  ...\.... .. * . #.*.*.... .. #..*.\*..#..#\..#..*.#
#** .. *.\* ...#.. ...#\.\     .# ..#..\ . .. #. #.\.*\  * ##... .*...*..#..*. . *..   *.....#.#. #..  . ....  .  .. . ..#.*# *.... . \.. * .. ..#*. #
#*.#... ... ..... .... .. ....*..***..**#. .#   . \...\* ..#*..*...#.. ...#.**.#.\.. *..... #. ...  ##..*.* #*.#*...\.*#\.* .*\*.....\   .#.    #.\. #
#...\# #.*. \*.\...\.\.\#.*....  .. ...\..#*#... .#..* * ..#\# .#... .*.#\.# .. ..#.#*#..#..## \#.*.#  #... # \......... \  .#\.. . #.#...*........#.L
#....* .\. ... .#.* #....... *.\... .* *. ..*. *.. ..*.# .......  .. .#....  \   ..\.*. . \.#.*.*.....# .....#...#.\* .. \. .... ..#. .. .\#...#. ..*#
#  ..*..#...# *.*. . .. ...  **.*....*....\.*.*. .*...#.. .....# ... ....*.* \  ..#...#......##.*.... #..\** #....#.\...\. .\#....*.. ...\# **..*.#. #
#. *.. .. \ ..#......*# *.#. #\......**  .. ..... ......#*....  # . .#.#*.#.*.* *....  .*.......   #..... ..*#. #.  ..\  .  . #.#\*..\.  ...#... ...##
#. . * ... \*.* .\#.#.# . ......\.##...#.### ...* *  . ... ..#....  .\\.#...* .....#.*\. .... \#\ .\.........*. .#. . ......*..*\. *...*\... \. . .. #
#..*#. ...*.# . ...# #........ ..**..*#. # ..#.....# ..###..... ..#..*. . .#  .......\ .. **. .... ...#..*  .*..*.  ..... #.. ... . *#... .. . . .*. #
#.. # ...  . #..\.  *#...*..\*. .. \.#.....\.*...*.*.**#..  .#.*\ ...# *.\# #. . .. \.... .*....\.* .#\..*..#.  .  . . \...**.. *# ...*.  .*\. ***   #
#\#*# * #. *.*. .  * .* *..*.  .....\ .. .* ....  \. .*.# ...*..#...*...  ....#.#.   .\..##........#.  ..*  *. ..*.**  \. ... ..*..# .  ... **#....**#
# ..#.. # .#*#. *.. # ..*..# . \.. .#*..... . ..*# .. .#.*... ..#....#  . *..*.....*..\.\# ....#..#......*.. .\.... .. .....* .# .......\......   #..#
#...* #*..\#...# # .*.*\.... *. .#.#......#.   **  * #.#*#\ .#.***. .* # #...\...##. ..*# .... .....* ...#..*  . ...#....... #**.* .... ..... .\. .  #
#\. ..#....#. .  ...*.... .#. . ..  . #....... .. *......*..#.*#.#.. . . .....#*#  .*.... # ..*.#.\..  .... *#.#\#..*.# # ... #..*.  * *. #...*.##. .#
#...... .*..... \.#* .*..... .*...#\..... .  ..*. .# .  ....\ . \ ...... #.*.*#...* ...\.#\..#..* *.*  #.... ...\.... \. #..#. .# .......*...*.. *.  #
#....* ..#..**.. . .. *#* .*.\ #  ...*#.*.#**...#....#*..#..#\...##\...\....  #...#. ...*\ . .*....*.. ....\. # * ..# #. * .  #\.\....**.#.#.. .#.. ##
##**.*..\..*#.\ ..  \. .**.. .  .#...... #...#. .*.. #..  ..   #*..... . .#*.\.....#\... . #* \....* .... *#*##.  #. ..\.#.. .#. ..  ..  *.**\ .#... #
#....*.*\#.\ #....*\*...#.. ......   . .#*.\....#.#*#.*... ..#. .*.#.\ *.*##.. * .. #. #..    #.....*\# .. ..*...#.#.......#. ..#. ...\*... .. ...#.##
## ... #. *.. * \....# *.#.*.# ... .\ .....#... ..* . ..*#... .\..\ *.. .\.....#......*\.. .**. .. #\. ..... * #........#.. .#*.*#. ##*. ..\.#.##.. .#
##*.## # ..*.   \ . ##..#..###.**. .... ...*....*. .*#.* #....\... #. .#..#..#**....#....... .*.\#.. .*... . .#.......* ......*.#......... ..#.. ....#
#*. * . ..... ..\. ..# .\.  ..*.*. ..\. . ...#.#..\\.#..*..##* #...*.#.*  #* #.... *.#*\.. * \*  *#...*.....* *. .#  ..\.#.#.#..#. . ...*#.#.. ##..  #
#\* ##.*.#.. .. *\.* ..#*#. . *#.#... * .\....#. .  *\.#.\* #... .##...\*.\..   ...  .. . . * . . \#...... ..# .#...# *. ... #...# . .*#..#.....*....#
#....... .. \.....*..\ ... * #  *\......*....#.*#... ..*..*  . .*. ......* . .*....*\ .. *#*#* *.....*.*......\...\........  *.* .* .......*\#.  .*.##
#.\.. ..#... ..#.... ..*.*#..#. #..*.\....*. .*......*....\*..# . ... *. #* *. .......# ...*.. ..*\#..# . .\#   .  .. ..# ..##.. *...#*\*....#... #*.#
#* .#..  *.## .... ..#.  ..*... \*  .... ..........#... .  .. ##.*\.... ....*...# .. .......#.*.*#.....#*.  . .*. ...#. #\*.**....#.. ......  ... ...#
#*  . ....   .*.**....#* ..\.... ..\. . ... #. .#. #.#.#.\ .*. ..  ...\.. \  . *...  .. ..*.#\.*\. *.... # .. *...  \....**#....#. #.*.*..   #.... .##
#..*. # *....###. .#..##.#..*. .. ..*. ...*..#.#..#.........*.#\# .# .*. ..*. .#* ..*..#*... .#. #. . .##* .* \ .. \....#.    ..**  . ..#. . *#\. .#.#
# . #..*... \...\....*# ....*...... .* . .. **.. . .\ .... .\  .##...  *. #.\\.\.#..*\ ..... *.......*. . .*  . *.*#.... .#...#\ *...\..# .......... #
##.. ... #*#. \.. # . ..\\# ..##*\#*....##.. *...   ....*.# *.. *.. ... *.. * . .....#... .*...\ .*.#*.#*......\ \ \ . ..  ..#**\. ....\ . *..#......#
#. . ##.#. ...*.\*#.#... .. .#.. ....#.  . .#.. . ..*.*.##\... ..#. . ..*....#*..\#.  .... . .*\\.... *.  ..*.#. .##.. . .....# ..\..    #  *.#. .*\.#
#. ...* .\\...*.. *.. .****.*...*..\. * . .. \*...*....  . ...*... ....#*....\...*    .. *...\.....# * *..... .#..*... ...... .#.*..*. *. #  #. .....#
#.... .#*.*#... .\..**....*\ .....*#\.*.....\ .. *...  .... *  .  .. . ....\. .*.... * . .#.*\ ..   #  ..........*..*..... .\......  #.*..#..  #. . .#
# ...##...*...*  #.*  .\.. ...\.#... .. .. *. ..#\....*\ .. .\..#.*. ... .* *.#.# .\ . ..#*... .  .... . ...\. ....#. . . .#....... .*##*.......*\...#
#*. . .\ \*..#..*#*  ..... # .. #..... . ..\...\...\ .#\\\.....#*..  .. ...\#* .*.. ..\. ....  #. * # ...#**...* .  . #** . ....\ .#. *... ..*#.\....#
#* ...#*..# .*..... *... # ...#.#. .*...*#.#.. ... .#.#.. #.# \.  \ .  . *.# .##.... . .*...*. ...#.  ..\. ..  ...#.#. .. ......## . #  . .* ...  .\##
#* ..*. .#\*#.*#*.*.*......#.*.# .\#. ..# \\.*\..#*.. *....*# **.. ... .....#..... . *. ... .#*.\.##.. .*.. ... .... . # .\..***.....  .#* \.# ..* . #
#... \..# #.  *#....# ......\#\.*.. ..#*...*\.. .#.. * ... *..*.**.#**..\...#*.#*....* ....  * . ...##\... *... .##  *.  ..  ....# .. .. ...*  *.*..\#
##.\...*.. ..  ... # ...\.# .** #  ..  ... **.* ...\..#..* \...*#.*. ......\..#...\*...*\. .. .*..*. ..*.. *.**.... . ...*.. ..*..\..##.\*..... .\#* #
#.## ..#. ..* .\..  ...   ...** \  .\......#.#*. #\# .#. .. .. *.#...*....#..... .*..#.  .*\.. ..#..... . ..##.. #...#....... #........  ... ...#* .*#
##\ .....#..*. .. ..** * .\.#. \...*...**.  . ...... ...... . .... . .  .**...#....  .*#..#....  ## . .**.....* ...... \ .*. * \. . .# ..**\#...*\ ..#
#...#.\.#..#..  \...*. \. ..* .#.#.... *#.*...\. ..... #  ......#.*\. ..#....#.# \.. .\....  ..*...*.  .\*. ..*. .#. ## ..........*... ..*..* .. ... #
#\ ...  .**.. . #..... .*.....  ...... ..#..***...*#. . .\*...#.. .  . \ .... \. ..*.**..*.. ..\ .*..  .........  .. ..\ . .. *.*....#.  *..*.. ..\..#
# ##  **.* .. #   .. .*. ....*... . *.*...#..#.*......  \.. . . ...    #.\ .. .....\.. .....  . .\...#..\* #.* * . # .**.#. .*#... .*\. ##. ..... ** #
#\.#. .\.*. #\#.....\. \.  *.*...... .#*... .. ..... .. \*\.*...#.*##..\.*.\ * ..#..*. .*...#  .. #  *.. ... .......* ......    ... * .#.... ...*... #
##..*...*##.##... ..\. *#.  # ..#....#...... .\.\ .   #..#.#. *\ .. . .  **...  *...#..... .... .##..#..... ..\ \*.\\....*.\.#*.*# ...** ......*\. ..#
#*..\# .*.  ..#. .*  #.* . .*.... \.*.........*. *# . .*. .*.# .\#....#.##... .. .\* ... .*#  . *#.. .\# ...#...*.....  .#.##.*.\*... #. . ..*## .* *#
# . ...#...*#. .\ #.. *. .*   .....#. . #........# .# ... ..* .* . .#*..**. ..... ..\.*.... . .. \...\.*\.  ... *..*.. . \.....#..*.# *. #..*.... .\\#
#. .... ...*#.#*.*\#.............**#. ......\.\ . .... ....* .\  ..... . .   #..#..*..#*... *....  #..# .. .\ .. *..#..* ....*###**.. ..\#. # .**....#
#*.**\ ..#.# *..   ..\.** ...# #. ..*. # *.#*..*. ....... ..*.....*# .## \\.*. ..#\#.....   .#\ ...... ....... .#.#.*#.*.....*\ .*# ...  .# .. \ *## #
#. ##.# #... .. \....* . .....*.. ...#..... .*.****#.*.. * .**  ..\. .** .....*...## ***..*##.# .. ..#  ..* .. ..  #\.*....... ##. ....#.*.. # .. \..#
#..   .... . ... ..*... . .....\#\.... .  # \#..  ###. ..#\.. #....#*##.#..# #.. .\..#*##\ * *##.....*...*..#. .  .. ... .*. . ###*..\.....\*#*..\..\#
#*... \.#   ...\... .\# #..*  .* #.#*.#.... .* #..\\\....**...####.....####....#.\.\. ..*....\.... .#. ......* #....  \  .* ...**....... ... \ ...  .#
#*...\#.. . *.....*\.. \.#.##.*\..*.. ...#..\.#**...#.. *....# .*. #...#**....\........ . ##*.*.#...**.....\..... \...#.  ..*.\\..#.# .. \. *....\.#.#
# ..*#...*\  .... #.#.. .##*. #..#.. #...*\.  .\.\\.......**.\...**....## .#*. . .. *..\.#. ..\.. .#.#  *.. .\.....# *. ...*...#\.......#..* *. . *#.#
# \...*\.... **.#. ....*\.*.* \ *.#.. . ... ..# .**...#.......# #* .....#.. \#.....  .\.*#....# .......   ..*\ .......#.##\...* .**.... ..**  .. .. ##
#..#*. . .....  . ... .*.#.#.. * #.*  .  . #.... ##..#.# .*...# ** .* .*....  ..*.#\.\.#. \..\.#...* ...  ### # # *.#.\*..... *. ..........*.. ..\\. #
#*#...*. ... \\ .....*.*# .#  * .#...#....# .* ....#....  . ### .#*#. ..*.#...***\\\ *\.*#........#.#..*  ...  .. *...*.* ....*## ........ .*.* \.. .#
##.  ..\.... ..*. #.*...*..*\#*..#......  ..... \.#..#**. * \# .\.# \#.... ..#.#*  ....  .........#... ....... *......#\\...* .. *.#... ........ ... #
#...*  ...* \.  **#.. \ *#. ...... .. .*#.. *...... . *. .. \.*.... .#.# *....#...#. . ........*.  .*#*.....* . *.... ...*........\ ......# * . \. ..#
# ..\ . #\*.#. .#   ...\.. .#\.....#   . # .#*... ..  ....**....*. ## .#...# . \ ....*#.*... *......\.... .... .. .#... ...# ..#.  . . ..#  \..# # * #
#.. ..#.. . .. ..#..*.#... . \ . ...#.#. *.\**.  ..... ....# . \. .\\ ..#. .. ....  #..*..*#...*..   *..#\..*.. #.*......##...#.. ## #... ...#.#....##
#...  #.# \  ..\.*#*.* .##*....#..# .\  . .. ...# #... .#. #..#... \ . . .....*.\#*..*. .*....* \....\.* *....*# .. * .* ... . .#.**... .......\...#\#
# ... .#..#..#*\\* #..... *...\....#.\ ...  . .* **...# .*. ...... \ . ###.# .*.  ..\. .  ..#....\.....*.  ....*#*# .# . #* ..... .#....  . *#....#..#
#.*.#.\.*\#*.....#.#...  #...* .. # .. ..#.* ...*...*....*...\. \.## ..\.\.*.......*...***.. ..#. ......#  ... *\ ... ...\* .. ..*.#*.. .#.. ........#
#...  .# ..... ..\*.\..*\# ... ...#.#..** .**. . . .. * ....  .##...... . ....\..... .#. ##.#.......\# .....* .. **.\..\....... \.* ...*#  ..... .#..#
#...#.. .\   ........#\. . ..**....*..#. ... .#. ...#..\ .. .....##... ......*.#..#... . ..*.. ..#... *#...#. ...*#. .#..*....#. ..** *#.##. . .. .*.#
#\...*... . ....\..   \..# . ... ...* .#...#\.. ....#\ *\...*.#...#. .\.....* .# .. .\ *.....#.....*\ ..  #. \#\\.\#... .*... #.*##.*.\.*..*..#\   #\#
#..##.  .... .*.. .*..# .......*##* ..R*. ...*#.... . ##..*.. . .. .... .. ..  #....#\ ..\\.. #*..*. # .\. *..#...  ....#..*..* ...#....\ . .##  ....#
# ..... .   ..*\#.#.# ..#..#*...#. ... .\**... * *....** . #*. \. .**............  .#...\*....#.*...... *..#.\\.#....  ..\   ..*.  .. ..#   ...#... .#
#....... . .*.#.\#*.. * \...* ...#.# . ...\...  . ** ...#\*.... .....#..\* ......#*\#.\  *.  *....#.#  #..  .*.. ..........*#..*.\*  .**. .....#* #..#
#..\... *#.*... ..... **..**. .... ......*\ \. #.....  \.**.. ... . . ..*. #.  ..#.....\. ....* .\.....\.....*.. ..#.* *     #. ..\*  .. .\####\..#..#
#.. .#\.\ .. .#..*. ...#  .##..\\* .\#.. . ..#.  .. .#* ..  . \.. \.* ##...# . .. .. . ..#.#.. * ........\.. .*......*#  . .....*....... . . *#.. #..#
#. ....# .  .#.#. . ..\. #.....*...  ..*.......\... #.... .\.. \\.#..... ..#  ..*. .#*# * .....#.... . ..\.*..###*#* .  .. .* .. .#.... ..#** \.. .#.#
#.*.*  ..\.*. . .\... ... .... ...#**.  ..  ..... *. *...... ** . ..  . . ..... .\  .  #*. .\#.*.*#.* *.*.\.#. #...**.**..**...\ \....\.*..# . .#....#
# .. ... ##\ .*.. *...#.. ... ..# *.\..**.....* ..#. ...*.*...*.  ..  ... \....  *. ....#.. #. ..#*..#.  ..#.....\..\..... ....#... ## .*.*...*. .#  #
#...... *. .*.....*......\. #...#.#..#.#.\ .#\ #... ... *.* *..#.  .. ..*....#  .*.. .*..\\.\.....*..# # .....*..#..*\.*   # ....#.  *.*. .\. .......#
#. .... **...\.. ...## ###. ..*..# \.. #.#\  *. *. #. .** ....#*... *. .. .... .*.. .... #* .#..#..**.  ..##  .\. . .#.. .  . ..#.. * ... ...... . ..#
#.  \#.....\\*.... . ..... .......# ... .* . .*.\ .*.. *.\.... \ #. \.#.#.... * *..*  #\.. ..*.*.#** .. \#...*.  .........#.... .. .....*.. . ..#*.\ #
# ..........* ..*#\ *#  #.\.* *.#*.#.....*..   .*#.. ............*.#.....*.#.... .**.   *. .#.... #... ..   ...... ....... .....*#. .\..\.#*#...#\# .#
#.*..\**.. .*. ...#...#..\.  .# ...#* . ...... #*\...*.. .. *.\# # .*..  #...**.#. .*..*..*.*..*......# ...#...* . . . ..*#.    . *.#....\\ *...  ...#
#....# .. .#..\\..#.. *** ... .*.... . . .* #.*#. .#.... .  *.#...*.\. ..  . ... . ..  . .*.# *# * .. .*##..... # #.*. . ...*...*.* . .*.##.##**  *..#
##. ...  .....*.*...#*..\.*##..**. #.#.... ..\...*#*..*...#...   .* #...  ...#\#..  ......*........#...*.\* .. ...#. .#...  ..##  ..\... ....* .  . .#
# . ..# . .#......# . .  ..# ..##*##..\\.. *.\*...* ...*\ ...  *. .\....\.. . #....\. ..\#\\.. .*.#*.**..*....** #\\..*.....\..... . .  .....*.*.\.*.#
#..........\*#.\ ..   . ..  ..*.. \# .\..# *\..#.*. ##*..##. .*..# .\ .... *.. ....*..*...\ .## .#* ..*.*  .. \ .*# .#......... .   #... ...*\ ....#*#
#.. ..#.... .. ....... .. ... ........\. ..*#.\#.#.*.....  ... #*..*.**.....*.. ..... #..  * .#.....\.* . ... *.##....... #.#.\ .#\.. \. ... ...***..#
# .#...\*..\... .\ .#  .....# ...*.. *........**..... . #. . #..  .......## ..#.\. . . . *.. ...#  .* .*..\.#.#....#.*.#*#\......#\.* .....#.**#. *..#
#.  .#.#. .. .. ..*......*....# .* .#..#... .  .  .  *.........*.......#\.... ...... \.*...*....\...  #... *. #...*.# ..  .##.\ .#.. . .. ...*...*\..#
##.#...# . \.*.... *  #. \* #\. . * ........   .... ...  . .. ..#.. *# #..\ ...  .*.. ...#.**..* .\#. ..  #. ..\... *..  .#.#...#.......\.**.*.*#\* ##
#..#....* ......*##.. *.*# ...***#*..#...#...... .  .#.*  ..\\.....#.#. .#*. .  *.*.*...\. . .#... .. #* \... .*.. #... .........  \.... .#***.. ....#
#.\\. ...\#..#.#. \# .\ . *. ... ..   .\**\..*.*...\ ...#\.*\..**\.** #..* .. .# * ..*....*.*. . ..*#...* . .... ...#.*#.*....#....#... ..\.... ...\*#
#. #  *.#.*.#..*#...*.... .#... ..*. *.. ..*..... . ....*.......*.... . . ... \ ..#.#*\.#* ...  ..*...\...# .  .*.\.# .  ..**#. *  ...#..* .....\.#..#
#**. ..  *... .#.. .*....#...##  ... ....\ *#...#*.*# ##.... .*.     \#\#* *. ........ ..\  .  .... ......**.**.. #.##....  #. ...\# *#*\.#... ..# \.#
#..# ...  ..*.....***.. ..  *..... .\... ......#..#..#...\ .# .....*.....\ . ...... .... .....#...#..\\...  #.\ #. . ....... #.#...#. ....  #.#... *##
#. .**..... .*.##. . . ...\ \.....  .#.. ..#. ..\.#.\.... #. .*  ..  ...\#\** .#.#.... .###*........ . ..* ..  . . \ .........*.. ....  .##..#...#.  #
#...**. .#. .  .#.#*.#.*........ .*.*.. ..#..... #.....# . ..* ....#. * .** **....#***.....*\...* *..#*..#  . ...* # .* ....\*. .. #.*.*#... # .*... #
# # .... .# ...#. .##.....*\# ## .\#*....# . .*.#\ .\....*#. .#..#\ # # * *..#*.*#.** ...... ....#\..# *#. ...  *..\* ..*#. ..... .   ....\#. .. .. .#
# .#  ..**#.*# ............ ..*\...#..*.. . #.# ..*...\.#.#   ....... .*\ .  .#........ ..\.... .. .\.##..  ..\ ....#.  .\**. ## .\ ....*. *...#. #.##
# ..\*#*.\.#..**.#... .# . ... #.. . # ..\#* .#.   .   .. ....*.. *..#. .......#....*...*.. *....#*#..*.   .....\\\..  . .* .  .#.##*...# .... \.#...#
#*.\.. .#.\*.....*....... # #.*  \.*.\.....\.*...#.#\#\\.*.... .*. .. \*..*..#..*## #..#*..  ...*\\.#.*. .......\..#.. \*..#.....**..*##.#.....*... *#
#.    .#. . ...... .....# .. ..*...........  . ..#. ..*..*..*..... .* .. * ..\*.*\......#.* #...#... .. ..*....* ......#.\\ .. \.* #..#..**....*#\...#
##...*.  \.##..#.   .... .*. ... ..  ...* .  ..* ....\ *...#\#*.*.. .#. ..........*..*......*#..\ . . #\.*#...#\.....#.. .#...\..*\ . ..# ....* #. ..#
#.....*.*  .#  *.*#.... ..   *#. . ..*.#.#. .##. .##.... # .*. ... .. .*.. . .# ..  #...*  *..\\*..  #. ..   ... . .*\ ..\ .*. . .#.#. #*....*.  .*.##
#.. . .* ...*..*..#\.. .* . ....*.. ...*.. *.\ #. #* .. ..\*\.* .... .....##...*\ ..#....##. *.  .**..\..*.....*#. # ..   **#.#...\.... *...#... ..\.#
#..   #. ** .....# ..*###.......*#*.. .  .  . . ... .#...#....#*......... ... ...# ..... \...#.*. ..... .. *# *..\. ..*. *... .   .......* ..*#..#...#
#..#.*..... ...**#... *.#.#..\.**\*. .*. *.*...*.. . #. *##.\.. . ..... .. # . .. .....#.#.\ .*\**..##*..... * ... .# .... ..#.* ..#..  .  . ....  .##
#. . ....#....... .\.... *..#. **. .#...#. ...#........*...* ..*......... .*\.\  ... *....\.#......#.. .* .. # #..  *.....*#.....*.* . *.# . ...  .. #
#*..*. .#**#..**.#. . .*....#\* . *.# .## .#.. \#..... ...#...*###.**.# # .... #  #..#... .**. #.#*...##.... ... .*  *..... .\# ###.  .. *. .#*.. ...#
######################################################################################################################################################