######################################################################################################################################################
#.\ \.* .\ *...#...*.\ . ..#.  .#. .*..*#.\.... .. # \.....\.\ *...* . ..#.... .*...\.##. *.* . ..  ..\..... ..\..# ...\...#.   \.*.....*.#.   *.#*..#
#.#*# .....  ..   ..#......*. \.\#.#... .#..* \ .#..  .. ..#.... ..........\.#.. .\  . .# ..*.... ....\....*.\... # . ....# ...... .. ...#..#.......##
#*# ##...  .\. .*.*#\......#. ...*. #... .* ...*..*#.*.. .*.#\.#.  #..*#*.*...##.*..\#..#... \...## ..*   ......* .  ...# ...*.#   ..  . *.\.\.*.# ..#
#.*.. \.\*....# ..# * ...\ .........*.#...   . * ..#.  ... .. .## .#..  .#..... .**.......   ...  ....  .\.*.# *...#..\.   ...*..\.##* ..*.#.#.*.#.*##
# ...... * ..#*..  ...#. .#...* .*.#..#. # ..*..   ## \....  \... . ......* ...... .# *.... .* ..#...\ .......#.*.  ........ . ....#...\ . ..* . ..#.#
#..*.# #. \# .#  . .. ..\*....#.# ..  ..#..#... ..*.   ..*.......*.#... . .. .*. .... . ..... . ....*#....#... ...\. #..*..*\.*..#. .*..#. ..\.......#
#..*** .#..# ... .. ....\...**.. .. .. .*... ..... .......*..... ...* # ...#. ..\...*....*. #    .\*.* ...\.*  .#.*..\* \\\*.... *## ..*.......\* \#.#
# ..*.... *.... ..... \#...  ... ..##. ..**...  #. \ ..  .........* .\....#..... .  # \*.*\. .*...*. . ..*. *... ##   * * .*.... . . #. .#.\...**..\*#
#..... ..\. . ##*#*# #....# *.#..*  ....#* ...*..*....  \#...*\.*.. .. ....\ .. ...# . . ....*  . ..*.   \*. *.....*. \....#..\....\. *..# #   .....*#
#.#. ...#\ . .... ...*... ...\ \.*.*..#....#...*.**.. *. .. .**...#.. . *...  .*#.. . ...*.*  ..*......*...\....*..*.. .\  . *....#...# .. .*#. ... .#
#..#\.......#\.\..*.#.. * ..\.#*#....#. ...*\ . \...*........\.... ..* ..\.. ...# .#..\.\ .....*..... ..#..... *#... \.*....\...\. ....#*.. #....#...#
##\  .  *.**....#. .* ..\..*.. .\.  ...#.* .. ..*.\.*... .*.. .....R \...  # .. .\*\# .\.* . . .    .....\. .. ..\......\  . ......\. ..* ..\... .*. #
#* #....*\*# . .**....\ \.#. * *.*# #.  .  ....# .\.#.   .*.....* .... \#. #..* .. . ..# .\. ...#.  .......  #\.  .....\\..  .... *. *.... ... . \...#
# #..#..*  . .... ....\.#.*..*...\*.....* ..\ *.##.# #. ......#..  #..... .. *. *. . # \.. . ............####..*. .\\....# .. *.*.. \...... *..* ....#
#..#....    .# ...\.. .. . *....\.  .. .*....*..*.* .....\.#* ..*..#.#\#..#.. ....  .*.....* ... # #.*\...*..\.*....#.....##\.*. #.# \#.*...\##......#
#*. ...# #. *#.***.#.....#... . *.. ..\.. ...*#* ....#...*\ ..##..*  \. ...*  #...#.*.#. .... #**## #..\ .. ... ...#..#*....*..*.. .....\. ... .  .. #
# ..\.\*...*#.. *.\. .*.....#\.....#\.  .. .*..# . \#.  \#. .#....#.*. ...*.  ....  . # .. ...*  *# \**  ...*. ...#. ...#.. . .# ...#...* .....\.\.  #
#*.* * .\.\.*........#.*  ....*..#. . .....#. .#   .* #...##...#*..*... .*.  **.. * *.#.. # ...\.#.* ..#.*..##*\#\#.. ..*.\.....\...... #.#.....\. ..#
#... .   \ \.......#... .  #..*.. ... . .*. .*#.*.*.#  #.*#.  #..##*\ *.. .#*..#..#..\ ..  #. ..*#.#.#  . . ...#.*...  *.#.  ...*.\.... .  .*#..*. ..#
# *.#. #.. .#.\*\.. ......*.\. \*.. .*....#\..  .#........ * #*..*.#.#*..# .. . \*#...*.#. .\#.....*  .\ #. *  .\.*.#.\.\. ..#..... \  ...\* . .\.. *#
#.  .#.**.##. # *.......# *......\.*.. .... .# ..\....#.   *. ... ... ##.   #.. #... .  .... ... ...... ..... .. ##.. \*. ..  #...  . *.\...*\..  \. #
#.\....\  ...\#..  . .. .\ . . .... . . .#. .....*.... \*. .. ...\. .. ...... .#. #....\ *...*.#.#*. . .   ... *..#. ..#..*.  . \.........*.. ..#*\.##
##..\..  .* .#  #*  \. #. *.\.. ....\  ....*.. # ...*##*..#\.....# ...# *.##.. #.. . .*... ...#*.. ... #... ...\\.*...#. . ....*.\..*.....\  *\ .....#
##.. .\*. #. ...#...*. #..  #.#..*#.#. #. . ......... ..\. .# .. ..## *.#.......* ...... ....# ..*...\# #. * ..# #.. ....*..* *#.**\. *.... .*...\##.#
#.... #.*..\..... #..... #\.#.... ...\  .   . ... .\.#*.*. ...  .  ..*... \#..##....#.. .\. ##. ...* . *#...\.... *. . #. *.\..*.\ *..\.\\.\.*..  *..#
### #.... .   *.   *..\*#.... *#.#\...*.   ..*..*.* #.#*.  .\.*.. .....\. .. #   .... ...#*. ...*......*#.** #. #.\ .....#*.. \. ..#*  ...#.*.#. #.. #
#*.#.. . # .. ....#..  ..\....*   ... .....#.\.....#*#.#..*..  \......*. \... ..#.*.#..\.#  ..##..*.. *...*.... ..... #*.*.# .. . *....#...#.##.. .#.L
#. #*... .. .*.*...  ....** **.*. #*. *......*. . .. ..   **. \#...#.\\. ... .#\** . ..  .# * ..... . \  .. ......\#    \.\*.  ##.  #. . . \\ . ..* .#
#...  *..*    .  . .. ... #.*. ##*. ..*  .  ..** . *.........##..*.. ... . * .. ....*#. ...  #.. #.# ..*......\. .\.#\\.    .... . #..#. . .....#  *.#
# .. .* .#..# .##.#....* *... *.. ... .  #.* . ..*. *\ ..##...*..\ *..##.#...*....*..... .**. . ..#....... \.  ..  ...\..\..*\ .  ...\.. ......** ...#
##.. ..... .. .*. *\\.*.#*. .#.#\.*.\*.* ..#.......\**#* .......*.  * .. .##\#. *.\.. *.*.. ..#..... .#. ......  .. ... ..... ... *.  ...# ..* .#....#
#* *.....  . ..\# . .....# *# \.#.  ..#  . *###.##. ....    . . .. *. .*..*.\#  ..#.\. #  .**.*.. ..##.. #.#. . .*#.#**..*.*....*.. . .#*. .. .\.#..*#
#\..#.## .*\..... *..#.* # ...##*#.*\..\.....  .*.#...\.....*#*.  *  .  .#....#. .... *###...... .. .   ..#. *. * . **# ..*... .# .  .*...   ..*.....#
#.. . .\.  ... ..##.\#.....\#. ......\...\ ... .#. .* ..\ ..... ..*#......*.#..##*.... ...\ .#*##.. ...  . .#.*... ..* ..#.... #.# ..* ..#..  .. ... #
#.#.... . ....#..... #..#..#. ...#    .. *...# ... .. #*...#* #... \ *\ ..... ....*#.* ...* .  ...#\..#.#.* . #.#. . .. \. ....  *.....# . ...\ .. #*#
# ..#. . ... ..  \.. .....\... ...** .  ....## *.*.. . *##.\. ....  #..   #.#...*.\...#. .*..* ........*.**..*..* * .....**# *.. ..#......*.....  \..#
#...   . ..#\.\.\...*.. ..#... .*...... ..... ...#\#.  * ..#*...* *..#\..... #....*. * \.... #* \#.  ...... **.\  *....#....#*.... .#..*. . \..\. .. #
#...\ ... . ...\. ... .*.. \#    #*#..... *.*.... . #.. ...*..#.# ..#*......... .. ..* *...*.. . #..*......#*. . .*... .. .. .#.....**\..*. *. #.  ..#
#*# .....*.....#.** ..# #.*\#.# ###\ ........*.*. .#.... *#... .\\.* .......#..... *.. ..\\..*.\... ...#.    ... ...*.#. .\. .\ ... ...#.....#* #.. .#
#  ..# . * .... .  ...**..*\##*. .#.. . ..#. . . . . ..*....##..\.*...... ....* .\.\.\.#*.*. *. .#. .. *#*... #... # ..... . ....#\... ...**.#\...\..#
#..\#...*...  # ... # .....  #. .**.# .. ..\.. .... .*....\\*.#  ...  *#..... ..*....*...* . . . ... ..  ......# \\.#..\\#. *.*. .# .. . *.*#\.\#.#  #
#.\# ..#\....\.*..... .#.## .\.. . ...** .\..# #  ....#...*\...\ . ......#. ...*#.#.* .........#  \..... .... ...*.*  .. .. ..*. *.#...\\....#. .... #
#*. ....##  . . ..#.. .....  ....\.#. *#. .. \#...... .  \ ... *##...... . ..*#.... ..#...  ...  . ....#..... .. ##. . *..*# .## #....#..#..*..... . #
#....*...*..#..*..*...  ...#.......\#*# ..**##..# *# ....*.*.##\.  #. ..   .\.**#...\..# ..#.....# . .*##..*.*. .#.*... .....\#*##\....#. ..  * \....#
##\.\  . ....#.#.... .... . ...#.  ..... .... .. ......  .. .\* #....*......*. ...#.....  ..........  #.. ..... ..* ... .......  ...#...#*..*..\.*..##
###.. ...*. *.  .##...#.. \#*..#.\..\..\ #.....#..#\. .#*#*.**#**..#*.# . ....* ...#\## ........ ... . ..**.. ...  .*...\.\*.. **...#.. .. ..#...\. .#
#***.. ...#.#....\.... .\........ .*..... **...\..# *. . ... #..*.....#...\*..#.*#.*. ... * ..#..    *... \ \..**.\. .   .* ..**..........*. .....#*##
#. . .*.............**#...\ ..#  .. .#* . . ....\  .##. ....... . ..... .#..   ..# .##  ....# \. #. . * ...#\ #.#.. #    .. .  .. * *.. .* *\..*....*#
#*.. \...\*.\..  ......#..  .*#. .* ## ...# ..  ..*\..#... .  ##.*.#...\ . *.#..*.......*..*..#.*.***.* .#..## ..#* ....   # **#.   \#..# . ...  ...##
# ..**.  .... ........#...*..*.....#* *.##. ..\. .\. . ..#....\.\  ....  ... ..*.. ...#*. ... ...... *\. .  ... .. ..#. ..... .. #.*... .*...........#
#. . .##... .. ..#.......#.*.. .\. .*.#..** ..*\... .## *.... *..#. ...*....... .....#.\..*. ..*..*. .... .#.......*...#....  .. \. .........*... *###
#............\#*\..#..# .....*..#..  \.... \#\ #...* ##  .\#.\.*..\..... *. \.... ...  .*......#...*....*.#.. .*.  .... # ..*# *...#.  .\. .*.#..*.  #
# \.* .#  .....#.....*\#* .. *#. .  .*..#....... .*..#.*\ . ......*.   *###......#.**.. .#..# ....#.\. .*..  ..##... #.*... ##.##..#. .*... ...\ .*. #
#.#..#. .. #**..#.*.\..... .*. ...... ..*#. .* .\#.. \. .. ..\.\.** *....#* .. .....#...#...##* .*... ....#  .. #..**   #...*# #..*.... *#.\...* .*. #
#.*#.. .........  .#....*..........*#. **#. ... \\. . . . . . .  .... .*# #...#..#.#.**. . \ . ...#\.....  ..*. ....*..........*.* ...#.. \\.  . #...#
#.*..**... ###.......##..*.# .. .#.### . ..... .\*. . .....#*\.......  ......\.... # .* ..#..*.*# .#...*....*...#..*.#. *......*........*\.... ... \.#
#.# . ....\..#\. #*. ..#.*#.#\. #*.....*. .##...*......* * *#. . **...* \# ..   .. . .*  .  #. \ \ **. *.* .. .#..\#* *..... .. * **..  .....*....*..#
# . .#**.....*.. \ *..*#..... .\ *...* \..#..##*...##\..\ . ......\  ........# ...*....*\. .*...#*   ..#..  .  ....**.........\.......* . *....\ ...##
#\...*.....\# .#.*.#.#..\..  . # .. ..#.#.# ...#.....*..\#\ . .\\.....\.. .*.....*.... #*#. .....#\..*.#....#..\..##...#  ....\. #.\ **..  *..... . \#
#.#.*..##.#.. .* #  \ .. .......\ .... ......   .. ...... .\#... . ##.. ..\.*.*. #.\.. .. ..#. . .\..**.   *...*#.. ..*\\*.. .\ ...*#..... ... ....**#
#.....\.\##.*.*\#.\...#. ..#.  ..... .* .#  ...#.*#.* \.#.#  .# .\..... *#  . ...*  .. #.\ ........ .\.*.#* . .# \. .#... ..*....* \#.*....\ **.. #..#
#  . . .. #..*. .. ..#..*.... \...........#..*.**.* *.# #*.# .. . \ \...# ...#.#. .  ........ ..#. .# ..*#*. . .#.\** ..*#..#..#  .. **.. .  .#. # ..#
#.. #....*..*#.* .\\ ....\*..\.*...*# \..#*\. #..#.#\.. ...#\.....#..  .. .#*..\...*...*..#. .........#\ .# #\ ... *..#. ...\...\.*#.\...*... . ..#..#
#.#.*...#*..#*#.... ..  .\.... .*  .# *. *##\.. ...*.. ..#..\*#\ ..  ... #..*#..#...... * .. ... ..* #....##..*... *.*... #...\. .\#. .... . #.. ..#*#
#*...  .. .#..# ...##... ...#...   ....**.#.\...# .. ... .. #.. .....#\.*. ..\ ..#.. .# # ..*...* .. ......*..# .. ...\\... ......*... ..##.#..*.#..*#
#.. * ..\ .. * ..*... #     .\... #...\##.* ...  .....*. ..... # .*...*..\*\.\*..\.\.  \.#....  #\.. ..#......\\..  ..\ #.# ........*...... . .... #\#
#*. . . ...... .\** * #  . ...#..\*..#. *...\.....#.#  .....# ..  .. .##   ...# ..\..#. .*#.  ......* . **.... .# ... ..\ \.   . .... .. .  ... ..# .#
# *...  .*..*... .*#.....#..*..** #.  .#  \. \....#.#.*.#.#.. ..............*. #*.#.#...#.*... **\. #. . . ......# .. .. ...#*# .\ #. ..*\.\.. .\.. *#
#### .. . *  #.*  ... ..\ .......  ...# ....*.. .\...*.** .*.   #...*........**..***..#...   ..#.*## .\... . ..#.# ...#.\. ...*.*....#.*\.... ##.*#  #
#....... #\. ..## ... *.....#..** .# ......#..\... ..**. ** .   #.  .*.. .  .##. \ ..\.\.*. ##*. ..*.... . .. .*# ....#...#. * *# ......#......#.. ..#
#. ...\#..\.#....  . ..*.#....\ . ........*##. ....# ..#...... #..... *.. ..## .  .\# #. .... .\*..#....**. *.\ .\*\....  **..#.#..   .. .* . ... ...#
# ....#. *#\#.. * #.*#.\\ . **   *. .. #  #..\\.#. * .. .*#..... ##........ ..  .#.#.*.. #.\*#.. \.  .\....*.. .**....#......*..#*....*.. #..# . #.*.#
#...# . . #. *#.*##*. #.. *. *..\\  .*# # ...##....#.* #*.  **..*.. . ..# ..*#..#..*...  #..**.*....... ..#..*..*#\. ... ..* .*...*#.\...  . .#..  .\#
# .....#.....#* #. ...... .... #\*.*.*.*..\\  *..# ..#... .. . \* .###\.*..#... ......*  #  .... .*.#......\....#. ..##...... ...   . . ..\. .. ..*..#
#* .... .. ..**.   .   ... \*..##****...##..*..   . .*#... .  ..##.*. ....\ ....  . .* ..#....#\.....\ #.... ... **.*... .#... ....#.. ....... *#....#
#.\  .*..##*#..* #.. . **  #.\..#..###..... ..\*.#* .. ##\..... *   ... ..##.... . *.#.\#..... .*.#**.... ..*..* .\.. .. * ..\ .**.*#*.....* ..*...\.#
# *. .\.#.....\... ... . . #..#..#...\ ..# .  .....**\......  .*.. .*## .*.*..*...  .#.#.*.# ......*.\.  .....#.. .*  ..*.*.. .*. .. .....#. . .\.. .#
#.  . .....\..  \ #\ .\#.#***\.*. ....\..*.  .**.. #.#....#*# ...*.......*.*..## ......#.......\*.* ..# .  #. *#....*.# # ..  ...*. #. *#.*. # ... . #
# #* #...... ..\ ...*..#.... #  ..\...\... . *.*. . *\  . **....##\......\......  .  . #. . .......#.. .. ....#..* #.\ .*\...#.#.* *.. . .. .# * *#..#
# . \....#.... . .. ..#.* . ... *.#*. . .    . .* . #...*.\\ #..\..\.\......  ....#.#............ ....# \......* ....*.. .\...  .. *. ...\.***.*.. #.#
# .\ . ....*...#  *.#* ..##..\... .#  .......*  ... .#.#...*...\...  .\.. \.*..***....\.........*.. ....*......#..*   .* .*  .   ....*. #...####... .#
#* ....* ..*..#... *#*  .. .. ..**.. ..* .\ *. .. . . ..#.#.#.. .*.\..\\..\ #.*..\ ...\.... ..   .....\..  *. .\##.*.. #*....* .\#.\..#**#** .#*.* #.#
#.*.#... ....*. ..  .** ..#.. . . . .*.. #\ .**....\. .. .*.. \. \.... # ..# ... #\ . \. .... ...*..*.....\#. .\..  . ..... ..*#* ...  \...\..\...\. #
#...*#..#... #.#\*.#.#.#.. ...... . \...\\.#...*..*..*#  . #... .#.    . ..# .\.......\ \ #. #.....*. ...#...#*......#..**#..*..#....  .....  *..##..#
#... #.. #. .#.....\.\.....#\.......\.**.. . \. .*.... ..  #\\......#...*.....#..** . .* ..\*. # .*\...#*#* ##\.  .*\#.# ....\ . .*. .....*... . ..**#
#.*... .  # .*...\. .#..#*.\.*.*.# *#.* .\ .#..#. . . ..#........*.#.. #.. ...#. \*#.\.......#*.##\.. ....*...**..*......... #*...*. ........** ... .#
##\  .#*.*...... *#..... ..\. \*\. ....  \....*..\...  .##. ....*.. \....*.......  ##  .  ..  .....##...# \ ... . ....  *.....# ### ..#* ... .. #.*..#
#. *..\.....# . . .#......    .....  .......\...\#\#....... ....... *.**...\ ..*..   ..#.*\. \...\... \.*.# .\#\....#..*.. .  .\*#..\* ...\.. **....##
#....# .. ..#...* ..........*###*......*# ...# ...**.. ..#...\. . ...# .##..  ##.#*. .. *..#*.*\...\    .\##*.# .. *..........#*   * .. . ..#..*.\ . #
# .#....*......  ..#.#. *..#. . .*.  #..*. \..\ . *.. .# .*....  #. \.*..#  .  . .#...... ..**.*.... . **.* .* **#\. .. .#.*.\.*.*.. *.# \*. ..*..\..#
##...#\.. .\......\.\. #. *#.#.#**.*.. . .... ... ...# .# .#. ...#*\ ...*. #..##..# .. . #.\ ....   ...\\ ..\. .. ..##.#.. .. \  ...#.....\.. .#.....#
#. #\...\# ..* #. #....\.#......*.#...#...  \ .\.  .....#..   \.#*... #..#..#. ..\. ##...#..## .. ... .\.# ..#**.# #....... *.. .#....#..\.. *..# .. #
#.*.......   .*.... #..  ..\ ....* #. . . #  ...\*. # ..... .... # * .. .. ..*..#\.  ... ..  ##..# . .*..  ..# ####.......*....##....*..*\..#. ...*..#
# .*...... .. ... #.\..#...\ .#\.....*........ .#........*.#. .** .*.\.. #.*.....  .**. .*. .*...#.. ..\..*...#* ....\\...#..  ...*.......  *.*.. ...#
##...* ... . .#* ..*. ....  . ..*.# ..#... *# .# *.  .###..#*.#.#. .*...# ..#*.......*..... . #....*. ..... \\...# .  **\..*.. #...*.#\.. #. \. .\.*##
# . ..#*.  .*.#. ..*\*.. ##\.# .*#..*\.#..#. ... .. ....#.... *\..*... ..*#..#... .. ##*... *.  ... .   ..*..#.. .. #  \..#...*... #...* . ... .* ...#
#\ ........  .*.* ...* \... . .*. .... .. .# #...*.##...* .## #\. .\... #..\ .. .... .... .\... *#\#**.... ...*\**.*.*..... *.*# ... ..* \...* ......#
##. #..#.*.#.. #.\\... \ .*. *.*. ###.* ....... ....#  \*... \ ##..#.#.....#*#\  .*.#... ..  .## .... . ..#.. .\..\. .##.... . . .# ..**  \. .**. .. #
# . ..* # . \.. .# . #...\.*.  .*. .#..*.#. ...... \. *. *.....\........ ..........*.*.... .*.*.*....... ..* #\.....#.*.  ..* ##... .#..# . ..*..*.\ #
#.  \. #...##.\  .#   *.. *.. .\** ... . \.. #........##...... ...##........  . ..##...* . ..  \##\ \....#..#*..#.*..*  .   \*......  .\.. ...... \..#
#  \*.*.... #.*#..*\ . .... ....#..\ .  \##\   ... .. # *\ ...*....\ .. #.....\... ..  ..#.. ....... .#.*.. . *.    ...#.. ..#  . ..*..\ .*... ##... #
#... ..#..* . ........\\..#....##..\\.**\ \...*.#..#* ...*.*..  ...#.......\..# . .. *....#....... ... *...#...#.*..... . .*. ..  . ...\ .#** #... .##
#.*. ....#.  ##. #*.#* *\ ..#...*. .. #....*.. ....##..  . ..* .*....*.*. ...*.....#\.. ... ...* .... #* .#**..\..#...*..   #  ..\.###... ...#...   *#
##.#...... .#  #.. ... ..... .\.*... .* ...#.*...*.\#.##........ ... . ..*.\\#\*....*.\.*...#  .#... #...\.....#.* .....\#..........\ # #. ..\#.....\#
#*.. ..*#. .* . #*\\# .  .. .# #.  * ..#.* ... . ....\.... .*.... ..\**...#...*.*......*# ..\.# ..*.#..  .. . .  .#.*....*# . ..\# ...... .#.... ...*#
#.   # ..\. ...... # .# .....#*. .# *..#.   .#..*. ... ..*.\#..#*...#..*#... .. ..# ....*.  ## \...*.*........**....#..*.**#*#.#*. .*...# .#.#*.. .\ #
# ...* ..*  .... ..*.. .*.... ...#*  * .... ......\\.#..** ..  #\.#.\\  ..# . ..\ .*.##*....... ........ .#.  .#....  \##.#.  ..#### ..  * . ..... ..#
#. .### ..... .#. *..  .....*.#...#.# #...*..#..*...#..\.*  . *#...#...\* .....*...**. ....*\#..*.*...   ..........#.....  .....#\......... . ...#*..#
#.* \* ..* #.\# ..#  *#* ..#..\. ..* . .\..\\. ....*. #....*....\..*.\... ...#.. . ..*#...#....\.* ..##*.#.. . *. ..  \....*. ..#....# .#..\.*....##.#
# ..... .... ...#.. ......\#... \\*.. ..# *    .\#...\..*# .# ......*\. .. .. *..  . ..#   #. \*.*....  ....\......\* .*. ..*.  #. *.\...*#**.... .*##
# .*#.. *  .... .* . *.....   ... ........# #.....#*..\*# *.......  ..\.** .*.*.. ...*.....** .*. ..#.  * \*# ..*.*#\. ... . .... ..#....#...# . *.. #
#. .*...\..\ . ...... ..   ...#.....#*...*.#\*...*.. . ......*\.\  .*.# *....#.#.#..*.*... #*\ ...\...* .*...*#...... #...  ...  .....  #\.**    ....#
#... .#. .  .\ ...\# #*..#.. # ##...##.#. \  ... #.*# ..*..*. . .* .#......\.... *#.\*#.#...\\. *...#*.. ...# .*...* #. #.*..*.#. *..*...   ... . #.##
#\.. \.. .*.# .*  ..*#...*  .. #...##\#.\ .. ...... .#.*...* ....*..  *# *#.. * ..#........ ##\... .. *#... .*..#\.*##.. .  .. .......#..  *..#### #*#
#.*. .#  ..... ... . *.. \ ..#.#.. **. **...\  ....  . .\.....#.#.** .*..\##  .... *.*...*\ .  \.\*#. .\....\. . .. .. . #. .#. # .\*#..* ...#  ...#*#
#.*. ..**#.... ..  .... .#*## ...***.\.....  .  . #.....#.* .. .#.\...#.# ...##.  \.* . . #* .. *......*\  .  . .... ....*#.# *.. .#*.  ....#.. .. ..#
#..\... .... *. .\....#.##. . ...#...*..\ ...... #....*.........#. .*.  ....#*   ##... ...\ ..\\.... #.\.... ...*# .\#.*# .\. . #\.*.....* # ....*# *#
#*.. .\#...  .* .#.*....# #  .*....... ... ... . ..*.  . *. \#.....\ .......#.... \#........... #*  **.. #. *. \#*....#...\ ...# .\.*..##... #\#.*..*#
#\*.  ..\. . #. .\.... \*#..**.....#..****..#. .* .#.**. ... ..** #.#... .... ##. . . .....  .. *  * .....* #.#.  .#*..*....\..#.  ...*...... \......#
#*   ... *. .* #.##....... .. \. .#.  #...##......* . ..#.* \.  *.#.#.. ...\.# .# ... ...#.*#  *\..  ... .....**. ..##. #*.  .....# .*.. . ..\#*# ...#
#.###. ....#..*\#  **......  \ . .\. #..... ##*.... ... \*. .#.. . ..\....*. .#. .... .....#........\.*#*....\*#.\.*..... \.*.   .  .*.**. . ..* .\. #
#. \...\#....\ .#\. . \ #.#.\#*. .  .#. . .#...#.....*....#. ..... . .*..  ..*.....##.# #... ## # \ *\\.  . .\* *.*..#.. .#.#. .. . .###....*...*  . #
#...*.*..#.....   . .. ..\  ##\....\. .......\*....* ..#.. . . .....#.*\.*.*.#  . #\......... .* .\.\..*. ... .#* .......\..*\. # .*....##.\. ...*#..#
#....*..*. . .#.\.#*#..#..#..   ...... .  ..#..#*..\...... #.. .** . \. ..#  ...\ . \. #.... .  ..#* . .\...*. *.. ...**..#. . ..#...#.....#.  ..... #
#.*##. .......#\\ # ..*..... *..*.....\..* #.#...\.\ # .. .*.. \... . .. ..  .*.*\..*.#.*.\* .. *. *.# # . ..\.#\... ....*#..# *....**\# .#\  ** .. \#
#...#. ..  ...#. ...........#.#.# . ..*#...#.. #... * . . .. ..*...**  *..*..\ \.. # #\.* . ##.*.## # .#.. ......*....*#\* .\  .*. .#.#..#\....* *.*.#
#....\ \....* ..#*.. \. \#*... #.\.  .\* \#.\#.. .*\.# ... . . *... *.#.. *...#.. ... .. ..   .. ... *.\ ... . .... .... .... ..*..   \....# .#...*.*#
#.\ ..\.*  *.*.   . ... ...... *.* \.#...\. * .\.# .#.. \.... .. ....*.\...\# .#.. ..*....*.....##. ..*... *## #.##. \ .*...\ ..#  ... . ...#...... .#
# ....*\.*.. .*.....*....... #\..\ .**. .# . .. .....*...# .\*.  \...#.  .*.#..#.*.#..... \*.. \...***.........\ .*...\. ..#..##\....\*...\*..##. ...#
#.. ....*#\.....*# #..*..\ # ..# ...#**...# ..*... ...*.  ...*.*.*.#....# ..... \.#.*..*#.........#\ .*.. \\.\ .\.....# ...*..#....*# ..#. ... .*.  \#
#.**.\.\#. .*.... ..*.#*.... . # .. .*#.*. *. .. .\. ...## *#...... .#*..... . # #.....#.*...#.##.*....*.* *...#...*... \... .\.. ....   .  *....*\..#
#.#**...\...... #...* *#....#.  * .* .#. *..*..#**###.#. . #. ..  . .*...*#..*. .*. .  ..\...... *.... .. .. .. \ .....  ...  .*...#... #.# . **...*.#
#.... . ..  ...#*. ... .. *. ..* ..*** \. .#...#.. #.\*.*.#. # .** #\*..# . ...* ... .\...*#***. #..* . .. .# .* .....\....**#........##.#. #.*......#
#.... ..#.#.#.# ..*. # .#* *.. .* ..# . ...\.... . \. ....#......*.......*...*. . # . #..###....  *... #. ..  ....\. .  .#.. #..#.. ...*.#.*..... *\.#
# **... \*#*..*#...*.. \. .\.*.....\ #.....#....... \#  .#. . .. .#..* .. ..*.#..\ ..*  .*..*....*.\ \. *.# .#.  #.... ...*   ..# . .#.#. ..\..#\..\ #
#.\ ......# .* .**.\..*.....\.. . .. .#... .. ...# . ..... *.*.* *. ##\#.....*.......##*#\.  . #. *.....\... ..## . ..\\.* ........# ...**....  .#.  #
#..\**... . ....###..*.... *...#.. \# .....*  ........#..  .  *..  .#.#.   .*.   .. #*..*#.  ..#.* .#..# .. ......*.#..#................*... *..*.  .#
#  .. .\. . .#.***..#... ...\. \.\\...#.. * *.... ...\......*\..* #....*\**.   .#....\..*... .. .#\.#..... . .....* ..*..\.#... . ..... ...**#...*#..#
#. .#..\...#.\..... ... ...*.*...##.* .#*..... # ...*. \.. .. .... \....# \ .. .*..** .#*...*.##.#*. ......#\.  .. *. .. . ....#.. ...\..*.#...\.*#  #
# \#\. . *#\.. *.....#..... .*\  .*...  .#...\..\#.. .\#.\.\....\\.#. **#....##.#  .\.#* #.. .# # ***. *....#........#.......# .#......*.. **...#*...#
#.     ..#...  *..*...... .....  .#..... .......\ . .#.#..*.  ...#... *...* ..  .. .#.*..*#.. \ .....##...... * ..#\. .#  . ...#\*#....#..**#.*..*\ .#
##...  .\ ...\\#...# ... .*..*.#*. # ..#.#..##...*.*.\.* ...* *. . . ## *   ....#...*#. .. .*...\. *.... ..  \. .# ....... . **# .#.. ..#. ..*.**..* #
#.*....*##..*.. ...*... .....#  #.....#*. ..*...*\.. .. .\.  ...  \...\.*.. *......#.#.*.\. # \... ...#.......\....#.#. ..#.. ... # .  .#**.. .*.#   #
##..*... .*.. . ... # .#\.. . .* ......*..# ...  *. .. .....# .*.....  *.  *.......\ ##..   ..*..#.* .. \# ... .*... # \#*......#.*. #....#..*. . ...#
# .....#..*\..  .. . # #* # .#* . .##...\ ..... .. ..\...** . *.  ...........\.*# .  ....*#. .  .#.. ...\#..# * .. ........*# ...\. .. .....#.\..\..*#
#.\. ...*.\#.*......\* #.**.#.. .  .......\ ..*.. #...*.  .*.... ..\\.\.* ...\..# .\.....**.* ........*#..  #. #\.. \ .. ...... .\. ... ...  .*.** ..#
#... . . **#.....#..  #**... #... .  ... . ##....\ . .\....\.\..# *.   . . . .#...\.* *. ..*........\... ##.#*....#\.\.*\  .......\..# . .*.*.# .**.##
#.*#.\..... .. ... **.\ *.##... .# .#.. . *.*..  ...**..   ..... .*.. ...#\ .#.. *...*.. .*...#*.* ..**.. #. .....  . #\ . *. ...#..#. . ... . *...# #
######################################################################################################################################################