#############################################L########################################################################################################
##* # ...*..# ..*.#.\  *.*...#*  ....\.#.\.  .* #   *. . # #.. .#..#. ......# \ *. .  .*\. .\...# . . #\....\....... .. .....*...#.*..#  .#.*..#..# .#
#.#.*  . .\ .#...#.# #*#.\ *.... * .....  *..#..... *.    .. . ..*..#..\. ..\..*....*.. \.#.. ## . ..*.#...*#. ...#. ..\ .. *#... .\.\* . .. ...\....#
#.. ...*.. *...# #. *### .* # .....**\..##.*\..#..* .#.....#....*#. ...*..... .#  .\*. *..#\. .*.\..  ..#.#. ..###..#. .#.*...**\*..#  ...#... *.. ..#
# \.#..#...#*#\# #...  . **. ..* ... .*.* .#.. .. .*.  #*........  . .... \. **\*\.. ... .* \.\ .\...#.....  .. .  ....*\   \.* *\...#.#.. #.\...#   #
#..  ......#.. #\\ . ......  ... . # \.  .#.#..* . *. .# ##.# #* ...... ..*\ ...#* ..*\ .* ..... .\ \ .... .  .*...# . ##   ..*..# .\...* ...##  .. .#
#..# ...#.. ..... .  .. ... . .... .* ..*... .#.. .*. \.....#.#. ...\... #....* ... ..*#.*\.... .. . ##\....\ ##\.........*.*..#.*. ......#\**  .....#
#.*##.  .   #.... #.**....#....#.   ..\#. .  .....  #..*.   .. .....#.##. .#.  ........#..  * ... *........ ##..##\ *.....* . .*..... #. .. ..*..#..*#
#......#.##.##....*.\.. #  ..  ..* #* \#..\. ..*.\..*. .*.\.##..## #*...# .*.# ... ....*. .##\.* ... .#.#....#..#* .. . ..#**\.****....## .....*.*..##
#    . ...* .. \.. .*..# ....# ......#. ..#. ..*#  \*.....*.....\.   ..* ... .*. #**. ..*#. * *  .*.*\..* . ....# * ....#*#..* ...*...#. .......#.  .#
# .. #*.. .*.. #   .* .*..*.. . ##......... ..# ...* ....#* \.#.*.. ..*  ...*\...\.. ....  .\. ***..  .. ...*  .#.*#.\. * .....#.**... ..#*......... #
## . *.*.\\.... .. ...**........ . ..#.....*#*\#.......#..... .#...  .  ##. . ...*..... ..#.....*. .# .... #.. .\ #.*...#\#......*#\ # #.\ ..*...   .#
#...   .#.# *..*#.*  .. .#. .\ ...#.*.#*#.# ...\..  ... *#*...#...... .# ... *.*.***#...##.*..\......# . # #.   .....  ..\#..... ...*..#... #* ..* #*#
#. #.#*...\.## .....\.... . .*.... .*.#* ... . . \. .\.... . .*..*..##  ..*..# \ .. #.   \ ..  #........ .#.*\#.  .**..*\.. .  ..\ ..\..#.*#..#**... #
#........* #..# *. . .#.. # *. \#........... ... *.. . *.* *...#.\.*..\ **#. ... ..  #*... #.... .. ... . *#...*.. ..*....*. ...... .*. *...#..# . *.#
## \.........*........ . *.***   #..... ..*\ #.....* .. .*.\*..*.*.....  .#*  .#.  ...*#*............ .....*\..*...\ ....... .\. ...##. ....##. ..  .#
# ... .\#...**#. #.*# \  \. *#.....# .\\#.\ \.  \.#....*....#....# * \. .#* #  #.#.#\ .   ..\. .......#.... .. . ...#* .\. ...  .....* .* ..*. ..... #
#.. .. \  .* .**..   .   .. ...##.... . .#...#....*. .. .. .#.  ........* .. .......**..#.....#......  ..*.**..  ...# *..#.\ #.* .... ... .*...#...  #
##. ... .*  .\ ..#*..**......\.  \. .     * . #..* .#.. .. . ... ..# ....  #..... ... .... ........# .#*## *.#. *...   . . .. ....\#.##.#  #.# ...#*.#
#.\# ##...**... ##.\.. . \.*#. .\..... . ......** . .. .... ..  *.#  . \.... . \..*. . .**# *.#.*...\ #*..*.#. *\.#.... .**.  \\.. . \.. .\#* \#\...##
#.. *. .* \.. .# *. #.  \..#..  \  #*.#...... ..\. #..** \..#..#.*..**..*.. #.#.. ....#*.**.#...*. *.  . *..#. \...\.#..# . . ###. . .. . ..***.. .*##
#.* ..#*.. ...#.*** .**.......\.*.*...#*..#... .#\.** ..#. #*##.  .#* \....\#......*..*\.#.##*.\. # ...#..\ *....*  ..#.*.* .....#..*..... #... .  .##
#......#.#.* ... ....#  ..* ** \*.*.##.* . .*....*. .#*..\......*....\* #....*.*.\... ..## ##*\# .#..#.... .. ** ..\#.. . .#.  . ... .#. .#..\... *. #
#.. *.##.* ..*..#.# \# . .\* * *..... \ ...*\\..#.....*# ##.**.......#*#.....*..# .*# **.#\  .\.***...# . .##*........... .#..\.\..#. .*..# . \ #...##
# .\..  ...#.#.\.# ..\..  . #.........*#... *#.# . .  # . . #.##*#*. .#. ....*.. *. * #..**...... . ........ ...#. ... .. ..........#.#.*.  ..... #.\#
# #.*. ...... .... #.. .. #  **\\## .....  #...\.*.*.* .#  ....  #*. ....\....  . ... .#.... .*....*. . ...... # .*.. ... *.\.#.##..*# .\......*#....#
# .\*. ..*. .#.........\.*#.. . .#.  . *.#.*   . ..*.......# .#. ..# .....# .. ..... .\#..... .*.....#..  ...* * ..*.# .... ....#...* ... * # ..*..# #
#. \.. . ##.... . ..  ...*#*# ...#.*.#.\.#..* .  .#...... ........** # .. ...\...*. ........**..\.....#.**.... .   *   # #. ..#\.#... ....**.\# *. *.#
#\..**.#  . . *#*. ....#. #. #......\.# \..#.\\... . .. #*#...#.. \*.. ...   ..*....#.*#\..... .#. .*.#.#\.**.\. .... ...*.... # ..*.....#\..\.\ *...#
#.....#....** #  .. .**.... ...*##..#.*.. ..\  \ ......#  ..#.. .##.# . ...*.  .. . ....  ..   .#.*\...  ....#..  ...  ... ....*  .. ....*. *. .  ...#
##........\#..  . .*.*.*#. . .   .\ ...* #*.#... ..\\.. ..\.. \... ....... *.# ..\ \*.. .**.. . .*.\. .*..\. ...*  *.*.........#.  # ... . .\#.. ....#
# ......   .#......*. .*.. .*..  ..\..*.... *...\..   .#\#...*.*......   ..#  ... #.*..  ..*.\#.#\*#.... ..#.. . # *.....  #*......*....*.   .. .*...#
#.*  #...*..*..*...*.#..\  .. .. ...#.  ..*... .. .. ...  ..... . #.......  ..* #.#.. ....#.. .*.... .. # .... .**...\#......#.* ... #... . ..#\.. .*#
# ..#. ... ... #.. \....  \*.....#... .*... \.*\... *.#*.# ... #...\.. ..*..#  ...   *\..#*\  . .#.....*..\ ...... *\*... * ....#*.###   *#....* .#* #
# #.... *#. ....\#.\..*# ... *.#....   ...#...\.   .* .....#.. .... \#\#..# ..  ....#.\.*..#...#.....#.  ...# ..#.**.. .....\ .#. #....\#\..#...# .  #
#.  #.*..*.#\ *. ...*  . .  .#.# ..#. #.   ....# .  ......#...#.\ .  * #*.. #.#...#. .....# ..\..**...*.#.*#\ ....#.....  ##\#..*. .\#   ..\...  .  *#
# ..# #.. .... \.. . . #.     .* ... # ..\. ..#..#. *..#.  #.....  ...\..*....#.#.. ..*..*.  . ..  .. ..* **......*.\# ... .#*#...... ..*..\.....\...#
#\ ..... ....  ..# .# .....*...# .. ..*. .  *...#.*... \\* ... #.....*  ... .... .   .\** #. ....#..*.# #\ .\.#  .#.... . #. .#.... *.# .*.\\ . #... #
#..*..*....\ . ..........*.... *.... #..##*.#...  . ...#. ..#.... *.  \.#..*.  .. ..*. . ....#... .* . #**..\.....##..\ .* .* ...\*... ..  ..*\.*..#.#
#.....  ..*.. # .... \##..  .. .*#...*..##  .\.....  \ ..##. #* \ .*\..#.. . ..*.**. .\...    .. #  . .*. ..##\..*# .*..... *\*##... *\ . \...#..*  .#
# ...#.\*#. # ... .*..... ..*\ #*....\*. .. * ###**... #. #**. #.     .. ... ..*#...*.... ...*.\\  . .....  \.\**..... *.....  . . . *.  ........ *#.#
#...   ...**.#.\ . #...# ...** ..... ..#.\..##. *..#* ** .*.  *..#..* .*..\.....#.... .#.\..#...*#..*.*...*. .... .#.. ........#. ....#........ .#   #
##. . \. .... #...**.*...*  ... ....#. *.\ .  .*.. . .. .\#......\ ..*.....*. **.. .#. . .. ..\ .#.........#.*# ..*.#.#. #. ....*..  * . . .... .*...#
#\#.........# *..*...**.. ##.**#. ..# .. ...*..*.. . .....* . . ..   ......* .  .... ...  .*.....#......  ..# . ...\..#. ..*. .\ #..#*      .*# . ...#
##.....#...\..*..  *......\...#*..\  \.........\ .****#... ...... .#* . ...#.... .*.*.......*...   .. \*  .. ....\\....# .#\*  .. \ ...*#.. ..*.*.. .#
#.. ..\ .. *.. .*.\ #.##. #.# .* ...  .  #. *.....................* #.* .. .\*...*\.\ . \......*   ...# .#.. \*....*  .\..#..*...  *.....#.  ......*.#
#...#.\...#.*.#..#\. ....*#.\*  ... \*..**...# .........#.. ....* #.# #.*......* *.....#* . ...  .*....**..#.. #\... #  . **.. *..*......*#.. \ . ..##
# #.*. ..*.*.#.#*.\.\....* ...   .........\ . ##..#\ ..   .# **..#.....*   .. \...  ...\.#  . . ... *..... *. . .. *.  . #..***.#.#.\.\ * #**.#.\.* ##
#.*........#......\.....#..# * ......#.  .. # . ...# .   ..\....*... ** * .  .#..   #*#.\..#*.*#....#.*\..#  #. ... ##.... .*..    ...\.##.... #..#..#
#...**# .\* . #\.\*.*.... *.... .* *..#  ...##........*.*. *\ ........#. #.# .# ..... . .....#*.. #.*\ ...\.\ .#.. *..* ......\* ..#... ..\.# . ..#..#
#  ..*.#\* .*.\.*.. .* ...*.\.\.#.....    .. ...#\. #....**.#..#.#.* ...# . .#... *.. ...#.....#.*.... .....*.........**...#* ...#.*. .....#..  *..#.#
#  \.  #\.#......\\..   *..  \..  .## .... # *.. . *.#.\*... .#\.\. ..*.. .*##.*.#.*.##.. . . ....## . ......*.#...#**.*#. .#*. .\ .*.#.*\ *\...*...*#
#.*....#.. *.. #\. *.. *......\.#... . ..*  ....  ...... ....#* .*#.#....   ....##..\ ##\ ..... .... ...\ .#....\..*#..# .*..#. ........ #.#\. .. *.##
#.*.###.\\...  . \.... ... .#...#.#.... ..#..#** \.\...#*....\ ...*\ . \.. ..\ .. . ...* .....#........\......*.. ....#... .*..#\ . ....*...*#\* .*..#
#......*......#....*....*. *  ......... *..#.\...#...#...... .  *..*..\\...#...*. *\ .  ..  #... #..*.* .#...*.. *#*...*.*#.. ...*.. ..... ....\ *\.##
# . .... .#. ..#  \# ....\.. .*#........#...  *#.\.... *.*\#.**.  *.#..*.    * . .... ....\##.*\#......*... .##.* .. .....*. ##...#   #........\..*. #
#. ... .*#. .*....# #.. .##... \.#.#... . .#.#.#.  .....#.  *.\ *..\.*..\\. .#* ....  .  .#.*\...\...*......# .*...#..#*.. ..#....... ........#.*#...#
#. . ...#......... .\. \..\. \ . ###....\.\.###.......... * *  *#.##  . .*..*. ...   #. .*.# .*...... ..# #.... ...\#\..#*#...  .* *....\ .* #*. . #*#
#..... . .. *.* .* *. ..* \*.\ . .  ..  .#.. .....**... ..# ..* **....*......  .\. ....#   #*.# ......#....*... .#.. . .....\ *.**... .**..   .*..\.*#
#... *\#..\.**\.....**. \ #. .\ #.**.*.*......\...*.# .#\    . .#..*... .#*.... *#.... *.. * .#..\....*...#..\..... .\*  ***\\ ... *  .#..\..*. #..\.#
#..   * \* \ .*.*..# .# ...**...#.   *. .....# ...  ##  #\..... *..... .*.#........*...... .\. ## #....* *#..\** # ..\#.....#. *.#..*\.#....... #\#. #
##... ..*\..*...... .# ..*#  .* ... ..# ........* ...\#..* ..... ...*...  . *..\ ....*. ....#*..*.* .*.. *  ..\ ..**#. .*. .\.. ..\.#. #...**#.*. ...#
#. . ... ....\  ..  *.  .....#.... .*....*.*.. .......*.\..#\.\ . . #........ .* #.......*.*#. \.#. ..* .*..*.. \. #...\ *......*......... .#.....#..#
#.. ......  ..  .... ....*. .\. .\ . . \#.. .#.# \ .\\..... *.*..#... ...  \ . ..*\*  ..*#.**...\.\. #.. .#   .\. # .*.# . ..*# ....\ . .............#
#.*.*.# ... .*.  . *. .... ... .#...**.  .. ***. *\...........#. ....\#  *...**.#..*.......*# ...\*..*.*....\\....* ...  . . . .\ .**...* ....*....*##
#** . #...\.. ..* \.*#.  #.\.. * . .* \.. .  #.....\ . *. \#.#. \.  **.    .  ...  ..*# \.. ...* . . .#.\. ..###. #.. . .*.....  .*.#...**.*#..##.. .#
#..#.**.#. .*..#. .*... . ..... .... .....\...\..#.  *.. .# ..* *.. .... .\ ...*. .*\..*.*##.\.  \\... ..*.. ..\...  . **.. \*........ .**.. .. .....#
#. ......*  ..#....#..*..#..\\ ..........\...#.#.... .# *#.... ........# .... .\*......\..\#\....#\ #. *...#.. *..  ....*   ... .** #...#...#.* . ..##
# \..*#.##  .###.   #. * .. .. #*.... # .. *\.........# .......... . #.\*. .......\..#.. .#..\....\ ...# ..... ## .\**.............*...#.#..#\.. # . #
#.#.. ....\.....*#.#*..#.*.*. ..\*\*. * . . .. .*.. #..#... ......#.*.....#*..*. .  ..* .#.. .. .***. .\ ... .....*. .** # ....\. * .....*..**..\..  #
#.....#.. .* .....*.# .\. .#...#.....\..\**.#    ......*...*#*. ...*#\ ..*..#.#...#... ......#....*#.\.....###.....   . ...#.. ..  # ..#...#... *.. ##
#.# .#.#..* *#..\ . ........# \.  #.*. ##*. ..  *.. #..###. .*. * . ...*..# #..#.#.\.  ... *..\ ..*.# .**.\.. ..  ...  *.*.\# .#.. .\....*#..*.#.. \ #
# #.  \  **#....#..#.* ...*#...##* .. #\\...*.\\.  ..*\.* \..## .... \ #\ .*..*...#  *. .#..#...# .#.. ....*  .. . ..#. .*.# ... ..   . *#..#\... ...#
#   #. .....#..\.. ##....*....  ..*.#  ....**   ** #..... .... . ** .\*...*# ##...... ... *. ..*\ ... .. ...*....  ....... ...*... ... **. .... .. \.#
#*.*#*..  #...\  *...**. . ..*.#  \#.    ....# *..# ....*.*#..*.. . *. ..\ \#..\.....\..  ..#..# ....#..#*......###.....#... *. . ...*.* . .....#.#*.#
#*.*.# #. .*.#*.   *...*\ ..**.... ....*....#...#..#.*....##.##\ *.\.#....*.....#*.. .*.. \..#....# .. ...... .  ...\..... .. .#.\* .  \**..* . #. ..#
#*\...*.. * .*. .\. * .. *. .#..... ..#*. .#.\.*.. \  #.#..*\. .*#. . ......*....*..\**#*.\..#* ....*...#\ ....*...  . .*#  ...#..#* *\#*  ..*... .  #
#...\.. ..*......*..**...\..  ##....*.... *..#..*#.. .   . ... *. .. .***. . .\...# .. #*   ##*##.*. .# #......\*. ..*.#. . \...\....#.\.*\.. ......##
#.....#.\#.....\...*...*#.   ... .#.* # #.......#. *. #..\.* #*\.. ..* .#.. ..... .\#\ ...#*.###.*..##..#\ .. ...#. ..... ......## . \..  * *. *.. . #
#*.. ....* ...#........ . ..*\..*...*. ....* *#..\. .   ..  .....*.\* ... ..  ... .  ..#. #*#..........  .. \....#.... #.. ...*.. .#.#..*#..\.......##
#.#.. . #\..#... . *..  .\....... ..##.\. *.....#\*#.#*....\. #.. ... . .... .*.*. . . .*...#....  ##  ........#  .   ....... *..##  \..   #  # .....#
#..** ..\....\. .. #\ .#*.#.\ *....#** ..\\..   ....*.. ....*....... ....   ..* . .  #..#.  *....*.\.#\   .. .*..*.  .*\.*\#.\...*.*. . .#...*.. ...*#
#*.. ...\..*#*\*..\. \ *...*.##.\#.\.\** . .#...  .... ..\.# #*#....#.  ...  .#...\  # ...#.#.#...#  #\\\#....*. .....  #.. \.*.. #*. * # .... .....*#
#     #.*. ...... #. *..  ##......*.....**.*..... #......#..\ .# .\ .... .*.\ .*. *..*.. .*\.. *  *#. .  #.## ...\#.. ... **. ....... ...\.*  . .....#
#.. #.*.*. .#.# ....\*.  ... .\..*...* .. .... . .. ..*# #.*..... *  #.#. .. .*.#.. ...#.....#.***#... ....#.. .  .   .#*#.. #. ...\. ...#. ...... .##
#....*...\.# . ..*.* ....#..*. ... \.#..  . .#  #..\##*.\.*.... *...##*.. #* .*#..#..# \  ...#*.#*.\.*...\#.......\. .. . . ..* .#.** . ....*.*.....##
#...  .#.. ....#*.. #...... . ....##.....  .*..# . *..*# .# \.#.. #.\. ....#.*.**... .\.* . .#..   ...\.. #.. \ ..\ .#*\.#. *.#.*..*... ........ * *##
#\.#*.. .  # **.#.#* . .. . .*.###*....#* ... .. ......*.. ..\ . ## # . * ..\**. ..#..* .\. ## .### *. #....#. ..\ **.# .\#  * ......*.* #.* .* *#..*#
# .*#. #........*..#.  ** .. .*... ...*..# ..#...#.#* #. \ # .*... .. ... \.  ... .. . # ..* .#\..##.....\ .. ..  .*........ ..#. \... .*. ...#......#
##   .# *. #.*.*...## ..# ..#..... ... # ..#*\.........#\# ...## ..**\*..*..##.......*..* **......#\\. ... .*.*.... .*...**.. . ..\\. # .  ..*\*\.\ .#
#...*. .*..*.#\...* ....... \..*   ...  # ####..... .. .......#  *.... ..  ..**\  .. .#*.*.....*..   *## .. ..#.. \.. ...  ........*...... ...#.*..*.#
# ...#*.*.  .# .#....# * *# ..#....\. .*.** ..... . ..\.... ...**\  . #\ ...#.  ...*.\..... \*.*.*.*.*. .....* ** ..**.... #.#  . .... # ##.... \.#.##
#..*..... .. #...\..#...* .* .*.*.... .\#. *... *.#. *#*.# .##.\.. \...#...\ ..*.. \.*#  . *#*....  ....**.....\*. ... \.... # ... \..\ .*. **.#.##..#
# .**.\. .\.###..\... ..*....**..#.. #.*#..    .#.#.#.*... .* *.......*# . \.... . .\\..... ..*..  . ..#... \. #....***..  .\..#.  #*... .#.... ..*..#
#..*\.*\.. #..#....\**. ...\\...#\*.  ..... **#...##.##. ....*.#*. #.... .\\......#   .*...... ..#.*.... . \*#*.\ ... **....*.. . *..#..#...\.*. . *.#
#. ..\. ....\. .* . ...\. ....\..  *# .. ..\\ .#. .**... *.*...........*. *##* ##. . .#.. .. ...#..**.  #.*. #*. *..... ...*.*.......#....\ \* ..... #
# .. * ...  .  .\ ...*.*..\.. . .#.#.#*#\ .*.**....*. #..##. ##\.*.#. ... ... *.... ..   ..*.....#.#  .... .\ .. #.*.. ..*...#. *.#.. #.... #.\..##..#
#. .*...*...*..**#*  \ ..\*..# .. .#..#.#........  . . . . #.*.* ....\.*... #. .  ...  .#...#\#...... ...*.##.. ..#  ... ....#.. .. .#.\.\. \... . ..#
# * .*. .\.#\ .#....#** #.. ....  \........\..... #*..*.#..* .\ ..##.. ....\...\#..#..  ...##\....#. ........ .*.  .. #*..#*  *.   \ *......# .#* ...#
#....... .\#.. .#.   *..  .*..#.. #.*#\.. ..\# *.*..\  *...#* \ ... #  .*... *..\..*...# ..*#\.\*#.#...#*. ....*...*#. ....#*..... ...##. * ...##. ..#
#....#  .\\  *..# ...*.#. .... ..#...*.*. ## ...  .* #   .*...........  .*\..##.#..... *#  * ..\*#... . *.....* ... ... #\ *.*#. ... *..#\. ##.. ....#
#. # ...\.## *..*#.# ......*.* \ . ..*. ... . . .*.. **..#.#.*. #..#. ... #..... . ...\ ...* .*.. .\.. # *  .. .. ....*\**...... . ..#.\ #. ..  ....##
#.  . \. .*#.. .... ......**.*..*......*.... .*.......*.*. . .#.*...#.. ...\..  ....*.... **.#*\ .. .. .*... .* # \. # ..##..##*...*..#... ...*.# *.\#
#.*#.#..*. . \... #...#.  #  ... *..#*..\..# . *......  .......#.*. ....*... \.**.\*. \*.\... #.#. ....... #.#   ...* .*  *.*.\*  .......*##. .# ..# #
#.#.   .... * ..  #  *\. ......#*#... . *.   .....#*.  ...#...#.#...#**.\  ..*..# .*#......*#*. ..*..**. ....*...#...\*. ..\\...  .*... ....*..#\ ...#
# . *.#.#. .\...... .. .*.\#. .. .*.*.... ..##**. .... . *....... .#.* # \....\*...*.. ..\*.\.\ ....*#* . * \...\....#   .#..\#.. ...#... # .  ......#
#.  . .#.....#.. . . **.. #.* . # *.. #. .#..*.. #.\  .. *.\#*..... . ....*\#\**# ... ....#   .. # . .\. **.#... .. .. ... .***. ...**.#.. *\   * *.##
#.............##. ..*.\ .. .# #*.  .. .*...  #.\.# .*.#..#.......*..*.. .. ..\. . *.#.......#..\. #.. .. .....*\\ . . \ ..*   .....\. ..# .#....  . .#
#.*.\.  ......*....\ . ..\ ..#*......#.\...... ..##..... .#*.. \......#. ...# .....#......*. .#*... .#* .# .. *.*....\#**....#....#*.\...# \.. #..*. #
#..  .*. .. \....\#. .   .. \..... ....*#.. #... . . ....* #....*. .. # ... *#...*#.....#. . .... . #  ...* ..\.. ..*..... ... ....* .  ......*..  ###
#*. .*.. .  # *..#*. ......#..... .\.*.\# #\*\*. #...........   ... ...  . ...*..**..*.. .#.....  ..*.. ..*.#*....* *## . ..\...#..\.... ......#* ..##
# \ . ..*.*.. .*.. #..**.*.. .*. . #..* *.*.*. .*.#....#.#. ...*....  ..**. ..# ..  *#.... . #....... #   .#.R  ... .. ... .\\\...........* ......*..#
#.* ..#. #.. ........#*.......   ..*..\ . ....***.*# *. .*.. .\ .\. .*.# .... . ......#.  .#.. #  #.  .\\... ....#...#... .#...*..# *..#...#\..*. .. #
# .\.....**...... .  . ..* #..*..#... .  . #........\#..... \.......*....\ .*...\...* .*..*..*. . ... #...#.*.. .\ *\....* .. . #..   \.**. .. ... ###
###*\. ....#........\.*\*. . . ..#*.* *\#...*  ..#.\..# \.. .....* \. *.\#...# ..*.. ...##...#...*...#. # .*. .#.. *..\ ##.###... . ... .##.*. . ....#
# *..\.. .\.. . . #...# #...  . .. ...... ..*....#* . . #..    ... ...#..*.. \.  ......\.*....*.#... ..#.##..* .  .#*# #... #\.. **.*.  *\. ... .** *#
# .#. \*#..  ...*..*.*.. .*.....#.......... *.....*...#.. #....#\.*. .\........  .#. .. .*  \#.#.###..... ...#.#.*.. .#.*...* .** #.........\....#\. #
# .#. * . .# ...*.* #. ** # .\.#....#*\*# .#. .*.\....... ...**.*#\ ..* *.### *#\.....#.....# ..* .... ..... ##..\..##..#..*#.....* . ..  .. .  ****.#
#### #.. ...#.#. .#*#. .. .  .#* ...#** #.... \.... .\  .# ..*.#   ...#.... .#.  \# ......#.\*\. * ....#.....*...\*...... **#...  *.  ...#\# *....** #
##. .  .#...#........#\.*.*...*. #\.... *.# *..*\. .  ..*  . .** ... .#...\.#.\** . ...... *..*#\ **.. .\  *....... ..*.*#...*..#.*..#...#* *..#... *#
#. .*....  ..*  ...\\. . . #. ..#.*# #.\... ..**#..* .* .\..##. ##.....#.....*#**. .** . .#.. .  . #.\\..*.*...  ... ... . ...  .\...#... .....*..\.\#
##* .*\. ..#* #*.*....##.#  .. .........\.  ..   ..\.  . . ..#.. ...**..* . ..\..#*...#* .... #.*. \.# ..... .**.#...#..* .# ..#.#. ..*\.#..#   ...###
#*. . .#. #.#\..  *#\....*..##.. .#..... .. ... ....*#.#.*. *#  *.*\..  .\.#.#. .....* . ....*#*.##* .........#.*#...  .. .## ... ..#.  .\ . ..  ....#
#...#.*..........\...\*\ .   ....\ ....\..* .*..#............. . #....#.**   ..#.\...   *......#*....  **.   ...*...... \..*. ...* *.. \.*. #.* ..#..#
## .   ...*.*  .#...#..\  ...*.*...... . ..\ .... .*... . *.#..#.*..#.\.*...#... . .. .... . .##.# .#..# ##.#.... #  \#..\ ... .*\#  #......  .. ..*.#
#...#. #...*#* *...  .  ##.*.. \  ... . ..*..#..*...**...**#.#\*..  ..\ *... ..\  .* .#  .* .#..\.#**..#. \ ..#\.  ...#.#.*\ .... *........ .# .*## .#
#  ..*#.#.#.. ..  .....# *.  . .. .\.. .*. \.\.   .. .\..#..*..#.* *# ..*.\..... *\..\**..*.  \ ***. \... *.. . *#....#. .*.  ..... .. .*..#... .#..*#
#..*......#.#.#*.... ..\..... ...#\..#..*.*# ...##..*.*.** . . . ..###...........   *  .*.. .# .....\.# ...\\#.**.\.#. . #*...  .#*\... ........ #*..#
#.\....  *... .. ..*. \* ...#. .*..## ##*.*..\..*.##. ... ..###.\.#..* . * ... ..*.....# .\*.\... *. ..*...# .   .. ..#.#. *  . .  .....#.. .....* . #
# ..... * . ....#.. ..#.#...\. . #*. .\*  \...# .# * #** .\*.#. . .....#.*  **# .**. \\ .......#...*..*...\. .#.......# *..#. .#. . *** .#...........#
#. #*....... ......*. #  # **... .\ #.   #*..\ ...# * ..*. \. .*....#. ...*  ..# ...... .#..* \...... .*##.. *...  ..... ...  ...*.#..*.*#.... .\..\ #
#... .......#..#*....*. .**#..#  ..*.. ...  ..* .#.  . .#  *.. .*. ...##*..*.*.  ......*#\ ...*# ..## .# .*...#*....**. \##.#.. * #\. * #....  ## ...#
#*.##*. . ..#..#*. .# \.. ..*  ......  #\... ....\.. .#...... .\...* . * \##..... .. . . * .... . . * #**#\.. .#.* \ ...#......\..# ..... .#*. *.## ##
##. ..#....*. .\.\.#. #.#..... . # .#  . *....#*...\.*  \ ..\\\*...*.\.\.. *.*....\# .. \. \ ...#...*#..\...\.#\...... .*..*. ....*.#..##.........*..#
# ..\.. .  ..* ..*. # .. \... .* ..*...... #.\...  .  #  . .  . .#..#....  ..##.\.   ....*. .\...  * ..\\.....\. .# ......\..\.  ..#*#.#.#.*..#**.*.*#
#....  \.#.  ..* . #..  ...\.\.......\..  .... *#*........\.* .....*#.\**.*..** .  .##.# #......* \.   .*. ..**#.#..*.... \*.. ......... . *... ....*#
#..    ...*.# .# .#\*. .#.##\ ......... ..#..*. .. #*#. .*.#   ... .#. ....#*.   ..  \#...*.....*.\.....#.........# ..\* ....#...*.#. .* .#.... .....#
#..*..\. . \...  ..  ...*#...#..... .  .. *..\.#.*# .*...*# ... \ # .\.......# .**...##.##   .*  .  \#. ... . .*. .. *.\**...*.. ...#.*...*...##*....#
##.#.. .. ***......##.*... .. .#...\#..#...   .. \..*###..*\.*.. .# . #..#.. *....#.. . **#..   .... .  .*.  . .*. *\..\..#.#\ \.\.....   .#* #..  .##
#.  ..\.  ..\#.  . .*....#..#..*. ....* *. *.. .\ *  .\.....*...... ..* \***#\# ...* .# ....  .\....**.\##. ..  .. .# ... ....... .#*....##.\.. .*..*#
# . ......#... .. #  ..*. ..#.*#\ ..* .\ \.\.*.. .. . ..*#.# ..#..*...#.\..\.# . #.***#...#..  *.....\  .\.\ . .# .\#.*... . ... . \.* .#.*\. \ .*.#*#
##.  ....** .... ..  #  .*\  . \* .*...# .#...\#....##....\\. .. # .*. #.*. ..#...#...**...#.#...  ..#.#.* .... *\ . **.... ...*. *.#  .. *.#. *  ..##
#.\  ..*  ..\..... ..*...*\...... ....* \. * #......  *. ..*## *.. . *.. #.\* .*#.. *\..# . ....\..\. ..#.# .  . .#..  ..*.  ..\##... .. ..*.# .*....#
#..\ \.  ....* . . ....#.*..... . **.\..*.. .  .   .*.##. ..  ......#..#*.#.#.....\ *.. .. #.\#.* *. .##.\... ...\. .....* .#.#.....*......# ..*.#.. #
#......***..*. ...*..... ....... ....... #...#**.*.  . ..***.# #. .  ..#. # .*\.....  .#..\.  \#....  .  . .*....#. ...#.\#.....#..  ..**. *. *.  *..#
#.#. #*.. .. \*..#*.#. .#....#. \#*.\ ..#....\... ####*......#*#..#..#  ...... . .#. .*\..*# ..*.*. *\. .# #.#.....* ..\............   **. \. ... . *#
#.  *.\*..\..#**##... . . . ....\#.#.... .* #...*.* *.. ..*...  ... * ..... ...\# ..##.. .*# ....#. .. ......#..\ ..... ...  . # ##\#.#.. #.\ ..  #..#
# ..... *.*#.\.. ..\ .... ..\.. .  *#.*\.\.*...   ..#.....*. *.*.\  ...  ...  ..#\. #.... . ....\.#......*........ *..  .*...... ..\ *. .#... ..... .#
##\ *..... ......*..* #......*. #...#. \ *#**.. ....\ .\..#.##*\..**. #... ***.#.#.\ \#* .*..**  .*#. .. ...\. ..... ... ..# .. .#...*...   *.#.....*#
######################################################################################################################################################