######################################################################################################################################################
#...*\ ....#...#*......  . .......\...* ..*.. \#..*....\... #.. ..* .*.  .*...#...*.........\\...##  #...#..*.. .. ...**##*..\.#.. ..\.**......*..#.##
#.. ##.. *......#\.#...   .#...... *#.#  .*..*.*.* .... ... ...*. \.. ... * ...#.#..##**\\..*....*.....\..*.... ..*. #.*.. . .. ..  ...#.. ... .*#...#
# ..... .*#... ......*. ...#*..*...*\**....*...\.* ....#.. .#..#......... *#.*..*..... \.....\...  .* \\.... ...* .#* \. . ...*.....#.\.*\.....*\.  \#
#... .. .*# ... *.#...*.\.\*..\ ...#..... ...*  .#.. \***# .  .*#.. #. ..\*....... ...... .* ..# #. ...*.*.#....*... ## ... .*.*......... . *#.*.#.. #
#\#.\ #.. ..*... \  #....#..#...*.. .\#.\\ . #...#\. ...*....... . *## .. ...  .. #.#  .. . # ....#*.... .* *# #*... * *.*. .  *.....*...    ... . .##
#..#.\\.\. .# ..*. ...##..\.*.#.#.   \#..* . .  .......*... ... \  ........*.... ...* .... ...*.. .   . .* . .*.  .. *.. ..*\ ...# *#..#. ..   .*\...#
# .\....#.* .*#*.........#. .*#. #.*#.#.....#.\  ..* .#*...    .. ..#\#  *.......* ...# *.  ...  \ *....**.. ..\#...  * #*...\#.#...*#**... ...... # #
# #. .. ... #...*#*.... ..  ####  * .**..... #* . #*.#... #.... *#. \   .. ....*....** ... . #.... ...\*............* ...** ...* ...#..\.  . ........#
# ..**....#*  .  ..\##.....##.   * ..# #.*#. .\ ...#... ..*.*  .*.*... * ..##.#..#..#\*...*..*.*...#.. *\.\ \ ...*#..*..#*... .#.\ #..... .*.... ....#
#**   #.*..\........ #***##.#*. ..  *.#...  *.## *.#...# .. . *.   \.#. .....\. ......*  . .  ##... *....  ...    #.... .....#..**#...#......# \\....#
#......\*.* #..\.# ..*...* ..#.*...*..# ....... . ...* #.......\. ..#..#...\. .    .... \ ..   .\......##**......  #* .\ #\*. .**  .......*.#. ...#..#
#...\ *.**# .. ..... ##\.......    .*.. ...*. ..#.*...** **\..##...*\*......*.#....\. #.*...#. .*\\*\ . .#..#* ..#.....*...*#. .\.. *..  .. .\##.#.  #
#. #**..#*## * ..**..*... ...# ....\*\ ....*... #. **. ..\. #.. *... ..*#....#. .#  .** .  .. .\....#....*..*...**.##.#..#* # ......*..#*.#..*. #. ..#
##..#..  .#*  ........ ... ..#...... ##... .  *.....* * *.#....# #.*.*.#.. #.\.\..*..  ....*.*. ... .#. ..#.. . . ....   ...... ...#*....*#.. ...  ..#
#..\ \....*. \  *# *...* .....\...#.*   .......\..... .... *. ... #..*..  .#......* .. #..   #. .*  . .. **\.*.. .*.#.....* . .  * .#.#... ...  #... #
#... *.. . ...#*...#.***. . * .. . .. .  .\ .........*.# .\  *.. ...## . .#. #.. .#..# ...#.. .#* ...... .. .# *....*.*.  .... # #..#. #.   #  \..\..#
#... ...#. ..#.......*....\.\. #*.#**#... ......... ...* *...*...# #..*.. *\\.......... ....... .#.....#..\... . ..  . . ... #.. #. .*#. ..#\..... # #
#.#.*\.**.#.... #.. \. \... *.....*   . .  . ..*.. . ... . ..##*.. .#\....*.*.... .*..# .....  .. *..**.*#...*.....*#\.....*....** .\\..  ..#*...*...#
#. ....##...... .\..#....# ......   ..#..... *. .  .. . .\\. *....#.  ..#.\.*. ...*. *#. \....   ......*.*..  . . ...*.#.*..... .\# ....\.. .\*  \\*.#
#.#.***.\....... ..\ ... .*\.  ....\ \....#...  *...\.. ..#*.\... ...#    ...\.#  .   \\*.# ...*##.. .#....*.........#..............   . ..... \  ..*#
# .. \. *....#.....\*. ...... ....#.#..*...\ *#.. .. #...... .#.*..... *.. \... ..*....**. ...... ..#.\.  .*. .*#.#. .*.*... .#... ..  *.#  .#..\..\.#
#... .*.\.. .#*........*...#............. .*.   .*... .#.. . ....*.. .#\ #. *. . .. . *..##*. .. *....*#.. . ..*  . .#.... #*  . * ... . . #.# \* #\\#
#  .#*  .. .\# #... .*.*. .... \\  .... .... ..#.*...*.... ...#..  .*#.#  . .....\. .... #....  .#.*\..*.#...*........ .. ... ..  . #.*..#. ....*...##
# .#.#  ..#......## ..**.. ....*.*.. ..#.* \. #. ** .\........*.... ...*. ....*..... *.#... #.#.....\....*#  .. ....* ..#.. *  #.\..#*.\.\..\.*.*...##
#.#* . # .* ....***\....\...*. *  *#.. . #.... ...**\.* .. ...\#.#.*\...\ . ...  ..... .\...#.#.*...#*. #*# ....*** .*...\ ..  .  #..  ..*.........*.#
# \ #.....*.#...#..# ..\...###.\....#.#*....*....#*#..  . ....... . ##.  .#... ...\ .\.#..*#* .# # #*   . #..... . . .#.#  \.*.* .#..* # ..  ..\.   .#
#..#.*..# *.**.\..........*. . ...* .......#.....*... .*. ... .   #.. ... . ...... .. . ....... #....*.#. ..\..*. . .. ....#. ...... .#.*.  \*.#. .*\#
# **.. . # ... .\*......\... * \.* .....  .#...#.*....*...#.#..*\...*.. .....\. .*..*.... .###... \#. .. *....#.#....* .....*. .. .. .*. #.. * .... .#
#\.....*\..*  .#.   . ... ....#*  .. ..*...#  .   .\ . ........ ...  *.#.........#   \ .\#..#.......*.##.. #.....#. .\.* ...\ . \\..\. ...*....**....#
# ....#..**. ....... . .  # ..#...#... .. ... .\.  ..  #...**.*   *...*..*........ ..  ... . # *\.\ #... *.....*..*\..  \ .*.**..#. . ... *......*. .#
#....\  .. .....*  .. \.#*..... ....*.  .. .\...... #* #..  .#..... * .   .#. ...##  ##...  *#....#.\*......#\...# ...#.*..#. .  \.. .*..*.*.  ..*  \#
#..#.* ... \. #.#*.#*.....  .##\. ..  .#...#...  .*#. ..*.#.. .. #..  * ..*... ... . .#. . ...  ......  *.*  ....# *#...\.*.*# .\.#........ \..* ..\.#
#.* .. ..#..  ..#.\....*#...... ..\ ..*. ..#....... .#\.  .*.*.**.*....#\*..  ..#*#. ...#....  ..# .....*###  .\   #... *....*\... \....* **.  * .***#
#... .... .# ...\  . #\*.  #.*..*\.. ..#. .. .\.  .. * #.\.*.*... . ...#...#........... \   ...* \...\. *......... .. ** # \*...#.. . . .##. *\.. #* #
#*.#.#*. \.. \.. *....\..#. . .#..#..*..  ##..#.. ##..*..**# #. ..* *. .. ...#..*#. \...#.\ *. .* * .. . *\..\.... *...#  .\.#\##.*....#* .. ..\ ....#
#........ ....\.*.....#.#*.*.....  *. .......##.#* . *#... . . \.. #* ....\* ...\. . .\#.   .  ..  ..*.*\ ...\. ... ..\* ..#.#..#....#..#....  .#*#..#
#. .... .... .. #..  .\....*\.*....*.  ...... .*..*...... *.\...#..* ... .. #. .. . ....*\..  . *.  .. * .*. .\. ....*..\\.\#  . ...#..#\. .  .. .  ##
#.\.. .*#* ....... ...*#* **. *..#..*.. ..#....*....#...*#** ..  .. *#. . .*   \ *   .#.. #... ..*... .\**.. .*..   ...........#.....#.*#.   .... ...#
# . #\ \.. ... ..\. .*.#*..# * * #.. #.\*#\..# .. ....#...\..*. ..  .\.#...\* *.  *..\** .#... .#...  .....#...*.  ## .** .....# .# ...* ..# ## ... *#
##...\  .*..*#.#..*#..*  .\...*... .............. *.#*..*... ...*  ..*.* #. .. . . #  *........# . .. .......*...  .#*....\*#....# .\...\*..# # *. * #
#*. #..   ..*.#*  ...**......*.. *.. . #.. .... ..*.. .. .### .#...  \.# . **. \. \.#.  .*..  * ##.  ...##*.. .\...#.   .*.\.  *. #. # *.... ##. .**##
#*....#.... ..*#....  ..#.\.* .#...*\..   \ \....... .. ..  ..   ..#..... \.#.....*#.*#*. . ... *.....\  . \.. \. #. . .#..**.... *......#. .#..*.#*##
#...###........#..*.....  #..##   ... *.#... .#....##*........ .**....*## .. .*. .. # .*..*. **... .\..\ .... ....*. .#.. . .\#.. #.*.### .....*.. ..#
#..#*.... ..*\.... \ .. .....\.  #*.* .*\.*. ### .... *#.* .... ...... . .\. .. .*\.*...  .... ...#.  . #. .*#... #.*.#..# . . .#..*#....  #..# . .. #
#.*.* ......\...*.\... .#..\#.....*.* .*#.  .  .\.\........ . \###..#..\\....... *\...\..#...*.## ..* ....#....*. **.. ..\. .. . ...  * *   .#....# .#
# .\. ......#..*#*  . \*. .. .... ...##*.... ...*.#.......\....* * ....  ..#.... .... ....*.. .*..\#.#....## ..#.....*#..#...\.*.\. .\.. #\.* ...... #
#\...\.  . . ..*\. #..# .#... ..\.*#.\#....#...\.# .... .......*. ..#  \.. . \\* ... * . ....*#*... ..  .\. ... #..\*.. *..... \.\  #....\#.*\.*.. ..#
# .*..* ## . \#...*....#..#....##....*..  ... *. .*. .#. ..\# # #\.*#*.\. *.# .# .. ... *.. . *.. **#.*.**\ .*...*.\....#.#. .......# ..* .  ...**...#
#..*..*. # *  . . ...... .  ..#..* .. .#...  .  #..* #   . .....\..** \\*..   *.  *....*.#.#*....#. *... ..*.  ....... #..\.\...... . ..... ..\... *.#
##\#.#*. .... *  #*... . \\.. #*# ... #.*... .\\...... ....*#...#. ..#  ........# ..........#*... ..... .\  ..\..\..... ..\#.. .  # .\.. .#.  . ..#  #
#.#... .#... #   # ..  .*. *..*. . *.* .... ...#...... .#..*....... .. ##. ...#..\ .......*..*..#* ... .\# .*. ..#  #..#..  ..\*.. .  ...#......  ...#
# .\.*.. *#.*.. ..  .......*....*..# .#*. . \ #* \.*.#.* **  ..#..*. \.**... . .....#.#..#.. .\. ** ..   ..*....#*** ....#*. .##* \  .\ ..*#.. ...*.##
##. . . # .. .#. . *#..#.*. .#..#.... # .#....#.*.*..# .\.* * .   .. #..#...*\ ...\*.#.**..........** *#  ....  ....#. .#.. ..  #  #.#. ..## ......###
### .*\*.. ..*#.#....**. ....*#.##.\.. ..... .\ ..##**.\ ..**.*\ ..*.... . .#.\....* ... .*.\ . ..##. .\..\.**   . #... # . .. *# ## .. #.\.   . #...#
##. \.. .#.. #\.*. .   . #.... #. \#... ..#.#..#.. #.. . *#* #*.... ..*. .*.  .#.....\ .. ..... .*. ......\*\* ....\... .#..*\ . . . ....  *...*. ..*#
#.#**...\.  \..#\......#.. ...#.*.#...\\....* . ....\........*... .\# .# *.#.*..*.#\#..#.#...*#*.#.  . #.\.*...\\..... .....* ..#...\#..#...*.* ..\*.#
#....\..\. ..#..#\.. .......  ... #.. ..#*.**.  ..#..*#....    \#....*..**..#*.  ....*... .. .#**...*.#\...##........#.....#......\ ....#.. *..*#...\#
##**...\#.*.*#.....#. ..#  ..   ... . ..*..#..*.#.....##  .. *...# .... .*# .....  **..... #\..*.. .#   ..... \..... #....#...\....\*..... \. #..*.. #
#.....   ##\*..\ \.\ \.... ..\.##..... \. .. *. \..\.. ..*... .*.....  . #.....#.*\ .... .. .\.#* . .#....#... .  .# #.\. * *.*.*....*...  \ . . ... #
#.. *.... .  .\.#*.#.*.##..#\... \.*... .*.*. ... #..\...... ..........#. *.. ....#. #.#  .\ \*\\ ..* ..  ## ......*.*. *   . *..*.*....* ..##.. *. .#
#.. .*.# *.#.#.. # ... .##......\.. #. ..#*...  ..*. .** *  . .\.......  . #.# #. .  #.*.#*.*. .\*. ......* .  .......#.. . .#.\.\.  .#.. \. ..*#.*. #
#.#.. . . . .#\.*.*#*..*\..........#\ .\\\*. .*  .....#..  . . #.. ....... .. ..#..#*. .  ....*...#\. . . .....#.**. . *#. *. *. ..*...#..* *  . .#.##
#...#..\.. #.#. ....#.*..*   .*.....* . ##  ...#... \*..*#.\.\* * ..*#...\.  .... ..  ....#. ..* .\* *..**.\\. . ...... ...* *\... ....\ ..*# .. .#.##
#..*.\ .#. .....*.#*  .#....*\#.....###**. .# . .....#\*  #. ... ..... ...#..*..##.#....## ..  . ...# *.... #.\.#.*##...*#..#. *. #. .... ... . ...#.#
#.. ..#** .. **.*.*.# #..\ .. ...#.*.  ..... ...\...#....#.*..#...... .*.*.* .* . ..# . * *.#. . .....*....* ..*...  .* . .  .....#... # .. .  ..*. *#
#.....\  #\.....  *..  \......*#.....#*.. ..\.. ....... ..\*... ..\.#.###\\*..*... .*.. \ **.....*.................#\# .# .. ...*..  . ..#...**#.* .##
#.* .*.......#.#..*...*..\##. .#..... .....*.. .**..*..**# ... \*... ..#. *.#....**#*..##... .\ #... ..*... ..* *. .. ..**. \.#.##....#...\..**.**..*#
# .. . . ....\.#... ..*#.....**##.#*..... ..##. #.* \. .... ** .....#......# .  # ...*.*... ##. ..#.* .\. ......* ....* ......##.. ........* #..*. . #
#.#... .  # #.\. . .#. ...\..#...#.*##.*\. . .......*. ... ...  . .*#......*\.  ..#.*..\  .**\#..*. .  .\*.*..... .*. #.\ . #**.*#..  ..*........*.*.#
##..*.\...#  *..\*.\.. #. ..#.#...  ....# *.   . . *...  .... .. .  *  .....#\..#... *#.. .... ..#*..  .# .*\#.#\..  .. ..#. .....#  .#. ..\... ...#.#
#.#*# . ....#.. .*  # .....###\.**...#.## ..\......*.. ....*  *... ..\.. ....# #* .*...#*.# ..*..\. .#.. . *. . #*\#........*.  #.*...   ..*\*\. \# .#
#. * ..... *. #\ *... .#....... . \...***.. #.*. ..#.*##.. *#\ **. ..\ .#\. *.*... .#... ..#......* . ......#\#..  . ..**..\\ ..\  ....\.. *.#...  .*#
##. # .......*....* #...*.#......*.* . .*.***#. *\  ....\. .#. \.*.. ...* .... ....... ..\\  .#.. .   ..*\.. .*  #.* .....**...\.....#\.#. #..* * ...#
#.* ....**..*#........*........... ..#....   .*...*\..*..\.... *    .*. ..##..... .#\. #.*  *. *.*. .\... . ..\....... .*..* .*.   #* \. .... .**...*#
#. .....# *\\ .. ...*.**..\. \...\.\#. ...*.\#......  .*....* .. ..*#... .* .\ ..#** ......*#*\* #.\.*  .. .*. * . ...   ....\#\... ..\\.  . *...#   #
#....*.#.\ ..  *..#... \.............#..# #   .#.#. . .#...*....\.. . \#. .#..**.. ...# . ..........*...\## #....*..# . .# *..*.\. \...* ### *.  .. *#
#. #.  ...... *#*\#..  .#    ..\ ..#. ...... .# .#........*....*.* . # ##*.* ..\....**. .......\ ...#..#*.*# ..    *..* . ..#.. . .*......*#.*.#.... #
#*.*\...# * #. ...#..* *# .*...#*#.#...#...... ... .. ...* ......     . #.... ..  ..... *..#**... *\ ...\.*.*..**. .*. .#*  ..*.....  . ... \# ..  ..#
#..*....#..... *.###.#. . . *.#\ .... . . # ....  .*#..\..*..  ..*#..* **.  ..#...........*   .*.*.\.. * .  .#...#..*.... * . .*.\. ..... .#.........#
#.**.#. .* .* #.. .....#.#  .  .....  *.*..#\#*.*..*.\  .   ..# #..# .....\#\.* . *#.*.* .. #..**#  .....* ...#.\.*..#...#.*.*.*.**..... . ..#. .##..#
#  .. ..\.*#*. ..... # .*...*.. ..... .........*.....##..* . .\..*...\#*#.**...*.. ..\#*.#..*....*.*.* *.*..#.. ...# ..\. .  \.  #.. *.  . .     . .*#
##\ \. . #.#..\ . *##........**  .  *... .*\ #.. *....... ....  ...... .  ....**.#.  . **......*. .. ........ .....##.. ... ..#.*...... .*.#..*.# ...#
# .#.*..........\.*. .* .**. .  . ...*.. ...\* .#........** .. ...... *... #... . .... .\*.. . .....*.\*..\.#. *..*..#.\.##\.#.##....#...##... .. \*.#
#.   ....\.....\ .\.#  *#... .* . * #  . #..*... ..*.\ .. .*...** *.*\..\. .. .#*..#.#.\....* . .*. **. ...# .. .* .\# *.. ...... . . *   ... .....\.#
#..  \.....# ...\  #..#*......#.......\## \ ....##*.  ......#. ...#...* ..... .. #.# \... . .  .. ..\. ..\ .  . .\# .*##. .  *\...*#.. *. # ....# #.*#
#... \. .. . ......#**#*. ...  . ...*   #... *...*.*.*... .*#.#\#.#\...##..#. ...*.\.. ....*. .  . ..\.......* ....*...# .#.\... ..\# . * ...#... ## #
#.*.....#....*\* . . . \.......... .* ..*  ...* ...**. ..# ..#  ..**.. *..  #.#.. *..\..\*...\#.*#........ ....*#. \...#.......* ...\...*\\......*.* #
#. . ...\*.# \ * .... .....  .. *  ..  .  ##  *\......  .  ....*.*....  . #. . .... \..*..* .*. *#..  ..* . .#..#*.\... #.#..#..  \#..  #. # .#....#.#
#.#........ . *.... ..\..#.# *. .#... .#.*#. ... .\ *...#.*.. ..#  .. .*.\..#..#. .. ..#.#..\#..... #..*  .... .. ... **# #...*. .*##... . ..*. .# ..#
#.\...#*....*...* .#.**..*.   . #\ .* ....*.#......#...#.# # ** #. .... .#..*..\.#.  ..* ...* *  .. . \.*..* *....*...#.#*#..  #..##.#. ....... ...*.#
#.....  ..\.\....#.# .# .#.#.#.. *... . . .*..*...  .  .  .  * .*#. .. *..#.#. .#..... ##..# #..*.**...*....\.....*.#.. *#  ..# ..\ ........ ..\.....#
#..... \.#.*#.## ..#.... ..... *...#..# .....*\.... ...\.....  .  ..#. .* ##.....*... .#\. ..#...*.#.*. .  .*  .....*...... .....##.  *..*  ...#.*# .#
#.* ....\..........* *.. ..\#..\ *...*....*.#\.. .*.#*...  # .*..#..#.\ ...#.  ..#..*...... .*...*...**....#..  .#.##*....#  ... .. . .. ...##..#.#.##
#.** . .. ......**.**...#.... *.... .*.  ..*..*  .  ##.#..\.. ..*#. ....*\\#.... ....*# ..*.. #.......\ * . ......... *.#... \#.. .. . *... . .#..#*.#
#. \\..*.*#\.. ..*. ##. . *..# *. *#.##.....  .. ....# \..#.# ..*.  .  ..... ... .  . . ..# .. #. .\. .* ... .*##....*    .. #    . . .*.* ....*.....#
##.\ .. ..*...... .# .\... ....# \ ...* ..\. .*  ..*....#.\. ....  ...*..#..\#..... ......*. .  . *.\#\.. *... . .*...... .\#.##.\. . *.#\ . .. ##.*.#
#...*.#.\#*... ...#...... ... ..#..#\..*. # .  . *...   #.#.* #.#  ..#*.\..  . ........ ..*. ..# .. ***.###.* \#.  #.# * ...\. .# .... \  ..    ...*.#
#. ..  # .. .*# ..##.*##  \....**...\..\*. # .*.......\ .*.#.. .. ...*. .#....#.\...#..#. .*....#  ....* .....##. ...#**. #.#..... . *  . . .#...\*###
#... ....#.## #.. .#..\...# ... \ ... .##* .#..*. ....  #*.. .........## . ....#...#..*.*...*..#\. .*.#....\. .  #  #.#..   ...*.** \ .. #..\* .....##
#*.. . .**##\. #.......*.. .\..*. .\\... #... \..... \..* ..##..  *  ....*..*...  # .#.#.#. .. .... #.. . .............  ....#*....*#...**...*.\ #. \#
#...*.\*.*. #.. . # ..\# * . . ...  \. \.  ... ... .#*. .\.......*.#.\.*. . *..\.#. ......#.\.#*.#.# ** ... \.#.  ..#.. .# ... ..##..  #.*\**..#.*  *#
#. ...  .\.....\.\...#*.....  ..*..*.# \..  .. .. ..\...# # ..  \.. ..  ..*..#. . .#*. . # ...#.*.... . ... . #....#..*  \*.* ....##**. ..*.#*...  ..#
#..#...#...... ...* . # . #*.. .. *...#.\ .*.  ..#.#  .......\.\ ...  .#.... #..\ *.#. *...* .. \*#..... * . #..*..*#....* #...\.#* ... .#........\ \#
# .  ... ...\ \* ...#.#*.. #....   #....#* *... ..#*. ..#...\.. ..... **...* ....**...\ ..*..  ...*... .\. .. .. *.....\...#\ *..  .**  #... .*..#.  #
#.\..#.#.#.. .#\\ ....#. .  \... ..# . ..*.\. .*\.. ...  ..#.. ...\##..#* ..#.# \# .  ..... \....#..**.  ..* * .... ..\ #   .... \.. ....#.\....#....#
#..\ #*. .#  *...#.. ..#. . ......*. ...*. .. \.***.... ..\...*   ..\*. ... .. .*.    .## *...\...# . .....  ... .... #...#...\\.*#..#*.# ....##.\ ..#
#. .#\.*\.... .... #.\\ \ .   .*\ .. ........# . * *\ ..\#\#*... .*#..#*. **.#. ***#..#..  * .\.# .#.....#*... ......*   ..#....#.*..... *.... *## \ #
#*. .*#..*. ..#     ..... #* ....* . .* .  .* .# \..#.. .* ........##.....#.#...*. ....\\.#.  \ # *.#...#. #*...##... . #...**.... ..\. .... .##  .. #
# .*. #   .... *....*\..#.... ##...# *..  \ ........ ... \\..... *..  \..\ #.  ##..#..  ..*#. . .   ...#.**.#... .#. .  \ .\ .. *..#. ....\..   .. ..#
#.. ..* * . ......  ...*# ... *... ..*\* *##.  ...*. ... .\.. . .* .*\*.*..\...*...\*##\..  .*.\.\##*..*... .\ .*. .... .#\*...*.........\#.. .*#...##
#..\.....#.#.  .*#  ##*..# .. ...#.\\.##.\.*.\*.# .. . ....#.  . \. .#..\.*.\....... ..#....\.   .\........\..  ***. ... *.#.\..*... * #. . *... .# \#
#. #.#.  .\\. . #.*.... . ....  ..*..\*#*#.\ * #... *## ..... .*#*....\..... * ....#*\ #.*.. .... .#..#*..... .*# ..* ..#*..#.#.# .... ..\ .  *. .\..#
###.*.. ..\#**\...*\..... #.\. ...#.\.. #.........\# ...  *# ..  ..#......#.. ...##...#*..... .#.. ...  .... *.# # .\..... . ..*..* ...#.*.  #..... .#
#... ........ #........#*..#..* ##..\. ......... \..*...\.... .*.. .\ *. .. ..* . #..   ... .*.\ * .. ..#*...... ....#  . * ..#...\..**.# ..#....... #
#. ... .*#.. ... #.#.....#.*. .... #....* .#.. #. . .#..# \.\*#*...#.*..#.*.#...\. .* . .\..#..\* .*.##.\ . #. ......\... .. .  #.## .. \........... #
#....#.. ... *  ..##\\.*.##.*#.# ... . . .\..#....  .......** \ * .#   #  .  .#. \...... #*.*...  . .  . \#.#*.....    ..\#.  .  ..*.....*  *..# *.. #
#\ .......\. ... . *.....  .. ............  .*    .. .  .### ..*#.#....  *# ...   **\\#..... #... . ..#...... .  .  \ *#  .\. .*.. . #.....* .**..#.##
#*........*......... ........... ...\. .. #.* #  \* . *...#   ##.*.......*....* \..*\.. .... .**#....# ....#.. \..#*.... ...#. .. ##\.. .#*... .. ...#
#... .#  .#.*#... * ..*#..# .... .. ..#. *. *  . . ... *.. #... .. . ..#..\. .# .. ....#  . \.  *.. *...\#.**..*.. .#.\...#.. ... \. ...#.....\#. .. #
# *.* ..\*..#.*\.\  .  .*.  .#.. ...   ......#.......\.#\. #...... .\ #*....*.\... ....##**. *  **#..*.* ... *...*\*#.# ..*....  ....*.. ..# .. *.. .#
#....  . .. ....*.. . .*.. ..... .#* #... .. *.. ... .....\.... ..  ...... ..* *#..   .......  .\ ..    \\\...#*..###\.**.#  . .  # . *...*.\... ... #
# .*.  # . # ...... .. .\*.*  #.*..\. . *  .*. .... #..*.... .. .\**.#.*.\#\. .. ..\ .#  ...... .  *.* .. .. .*.#.... ##...*....\. ....#.. . .*  #. *#
###.#..*.. ..* \ .  ...\. .  ....*.*.    ..... . ##..\.......... ..*..# *##*.#  *  *.....  .  .* \#.. #....\##\.*...#**. ..# .. ..*.\.    ...  .***..#
#... # .*.. .  #.. ....\#.\..... .. .#...  \...\.....*.*##*##.*.#.  .\ . ...\..*.  ..#..*#..#.. ** #* ...*. . .  \. #*..*.\. .\..#\.  .. ##...#.*.#.\#
##..\# ..*........... . . .*..*#. . .\ * ......  .... ..#*\.* .. *.#.*..\.*.# #*##..#.*......***.. ..  ..... ..#...#....*.  .... . **..*. ..   .\. .##
L.*.\... .......    *. . .** #*..#*.#...#\  ..*.. \#.**.#. ...*.#. * ....#\ . . ...#.##. #..#..#.*... \...#...* ...#*... .#.*..... * ..  . .  \*..  .#
#. ..*.*\.\... * . ...... . ....#... .. ..*  #   *. ......#..#....... *....\ . . ....*. . *. *.. ..\. .# *.  .\...  ... #.. .#. ...\# . .##.... \\.*##
# .\#.*... #...*\ ..#*.** .#. ...\...\ *\\... ..#.#.#*#.. .#.... ... ***. .......*...*#.... . .** ...* .... . ** .\.. #*..#.. ....\*..*...... *#.....#
#. ....#..*.. .\....**##* #.#.. . ... ..*..*\...#..\.#*.*.....  .. ..\ ...#.....#....  ..... .#..#*. .... .\**.  . .*.. .\.. ..*  **#.. .* #....\#...#
#...  .....* . ...\\......*.. ..#. .... *#   ......\ .*..**.... ..#* .*.... .\*.\#  . ....#*....# #.#*.  .\*#.. *... #....# . . .....#\ .  ...#.#..\*#
#....*...#...\\*.. .....* **#.* *#...  .#.#. .\  . . \  .. .  .#* ..\#...\...  .... ..*......... ..... .#. . ... .*.   .......\#.* .*#. #*..\..  *#..#
#.##\*#.....*\...  #.. *....*.. .*. ..\. .**  .. ..  ...\.. . .. . ....## ....\\\.* .... \ \*..#*. . . . .. ..\*\.#..#*...# .*. ...#.*. .* *.*.\.. .##
#.. ..........*..* .. . .\. .. ..\.# ..*......# *.*.. #**. ..\.\\  . ... .*\*... ........#.**.\.\...... ...* .#.........#...... .##.*.*. * ## . .\..##
#... .  ........#.\#.. .....#... #*.*... .#... \ .....  # .*..#.*... #.#.# .\  .. ... . .. .\......#..## # .....#..*. ..*... #..... \ .....*.*#.  #. #
#.*.**.#.  ......... ...# ..* . .*..#..... .... ...  ........\.#. ... .#..# \. .\#..*#.\.... .*....\.#.##.*#*.....  *** ..#..   . ...#.......#.... . #
#\#*...  #*. .###........#*   . ....*.....# #.. \.\\* *.. ....... #...**. .......#......# * .\## # ..... .*\. . ....* .. \* ...  .. **.. .\ . #..*.**#
#.*... #..* *.  .#.  ..*.*\ ..#.....*.*. .. . \##\#*.#. \ #.  . ... .\.. ..##.\* *. ##.*. .  *##  .#.\.... .  ..**..#..##... .... \. .*..*#...*\##. .#
#   \....\..   *.. . .... #.....\..#   #.*.\..###.. * .#.*..........#.... *..*.\..*\.. *\.. . .............#. . . .. * *# .\.\...*  . ...#\. \. *....#
#.#. ...*...... .. * ......\... . ....\ .##.  \*#   ** .. ... .. .*#. .. ...*\.....# #.  ......#... \  ... . #..*.*.##* #   . .\##..*.. *   ...#. * ##
#..# ... . \ *..* \..*. *#*.........##.#.*. *#*.....*.*..#.*...*.. ...*. .. .#\..*... \. .#.*\.*. .... ..  #.... \ #.*...*** .. .##*.#.#.* \..* *....#
### .* #.....*.*....*.*...# .....*...R....\.* #.. ..  ... .. \  ... #*...**. ......#...   ....#...#...*.... ... ..**#.**...\* .......    ..#*....*. *#
##. ..*.. .. ..  ...#. *. .\..\#...**..  \......\#..##\.#... . .\#..#.# ...##***# .# **.*. ..... .*..*.#.. ...##* #.. # . .#*#...... .* ..##..... .\ #
#\\.**. ...#..*.  \#......**.. . .......  .#\ ..... .\*.   .\... . #. ... .......... .. .** . .## ..  *..#. ..*... \....#..\.## ......  .\... ... . *#
#\....#\*.\  *.#.*  # ..\ \ *..........#\.*...*... #*.... *.*. .\*.....   .  ....#.###..* #  .. . \*.. .#.*..... .. #.* *.#.  ..**..**.  .... *..##..#
#... #.*. . .....#.#. *..\\**....#......#.#.. ....\.\\...  . .#.*#.\..... .... *.* # #*.\ *.#. .# .\....*..... . *#*. ..... *.. * \.\#\. . .#..#... *#
#..#.**. .\..*.. .**#\..#.#**.#. \\.. ....#.# ..#..**.. **..#*  .. ..##**. ...#..\#...\.....#...... .#.#. #.... \..  . .\..#.#\.*\... . . .. ..*##\. #
#.* . ...#..#..# *\.....  .\.** ... ... ...# .....\........#*. .. #.  #. ..\##*.#..... ....* ... ..  #...*\........ . ... #. \......*#.. ........#. .#
#. .* ..  ..   .... #.\.....** ....  .#*...  ..* #.. ....... \ ..*. .\... .\. .*..\#.....  .. .#*...#*..#.. #.#.*##.#*#*.*# ##\.. .. .*#.......*\.   #
######################################################################################################################################################