######################################################################################################################################################
#.**.##... # *.*. . *......\  .#.  .....#...# ..*.. ..\..\ .\# .#........\... .. #.*.# ...#...*.##.. ...##....\ . . #......#..* .*..#*#  ....\. .* *##
#..\... #...  ..#.\. . \.  .... \* .# . ... ... #*#....*...*.........*. . ..*. ..* \.\.\..* .\.... *.\...\..*#....   .. #......*.... ....*#  ..\...* #
#..R. #......... #\. ##.  ...*.. .....\.*.\ . .# # ..*.\.. *\....#..\.  #* *. *.....\. *. ###.*...*..\....* .\....\...\.....**..* * . \ #. ..#...  ..#
#*..#.. \......* ..*.**..\#. .* .....* \..*\.\...** .*...\  ...\.... #.  ..# ..#*.#.. ...\... .. . .  ..  ...\.  .  ......*..***.\.. \... ..#. . .* .#
#.. ..*..\. . .##...\..* \.. ... ...*.. ....  .  *..*. . *..#...* ...   *.**..#*..\. * .#.. .  .. .#.#...\....\...#..... .* .#\#......#.. *..*. ....\#
#......... ..*. #..#*##..#....\... .. .\..\*. **.   \.*.\#...#..#.... *.\ *. . . ....* .... .*.  ....#. .....*... *.\ #  ........ *# \.*. *\#.. *.#\.#
#.*#\ *.  *  ...  *#  # ..... #.*.. #*..*. .#. \ . ..*..*..... ...**#.\ ..\*** ....... ..#.. .....\.#....* * ..##.*# ..* ...... . #...*.**..  . # *..#
#....*. .......* #.. .*.. \..#.#...  #.#*#.#. *. ..#.... #.. #...... *...\ #*. \.....# ...*....#.. ...  #..  * ... .. ... #... \*...##.....\.  .  * .#
#.*....  .*..#...#......\... .*..##... *.\\#..  ...*  .*...... #  *.\... .... . #...... #. \ *. . .#. .. ##.....*. #*.. #\.....##  #...## . .#.....#.#
#... #. *.##. \.*  \  .... *.. ..# \**.. . . ...\.... .. \ ... *. . .*\...#**..#. . #..*.. ...  .. . .*.. *.\.\* #... .. .  #..   # # .** .... # *.*.#
# .*.....\* ....#. \.....#.. \.#...  # .#... .*.**.*.#. ... ...**. #. ..............* * ....# ..  ...  .....  . .* ....... ....*....#... . ....*.*#.##
# *#\..  .#. \   *.\..*...*......  ..#\ . ...\ .... ...*# .*...# *...** .... #*  . .. *.#....#.... .... *.... \. ...  *. *.#\. ..... * .. .# .. .\...#
#.*............. ....*. ... ..* ...... .#.\*..#.\*... .. ...  ..*.. ..*.... .*.... ...#.  ....*. .*#...*.... ... ... .*...  .*..#.. \.#.  ..  ..  . .#
#...**... * ...# ..#*  ..*.....* *...# . ..... .  #. .*. . .....*  .#.. .*#*.# ..# ....#.#.#..#. ... . ..# ..*  .\* .... #..#  ..\..\**\....#...\* ..#
#\..... . ..*... ..# ... .# .#..*. . ** ........*.. .*..  *....  .*.*\ .. .. .\..* \.\  * # *... *# *# .... ..  ..* .* ..*.###.*.\. ...*.. \...  ....#
#.....\. ..*..*..  ..#.#...... ....\......\..*. .* .*.\..... *.*.  . ..  ..  .....#*..  \. ..*..#*..#\..\.*..#...# #.........# \# #\  # .. #..\.. ...#
#..*.. .. ..\....... * ..*. #. ........\ . ....*.. *. ..# ..#.....  .\. .....  *..*.#...*  .* .*.# .....#.. ..*#....* . .\.\#.......*....  .... .....#
#... .*.... .##.  .....*.*... .*.#.. . .....  ..... .   .#....*##.. ...*# #.#.. ***.. .....\.# #.*. .\.\  ..* ....*.....  ..\ \ . .. ..*.*#..\\ .....#
#.. ... .*.   .*.. ** ..**...  *..*.#....... ...... ...  .\*...#..  . ....### .  \\ *.** ....#  #..  \.. .. ... ..#\...#.*.... . **.*..#  .....**....#
#...\.*.  \........ #*#......*...  \#\.... ..\...*** ..**. ...#....##  ..\.....**.\#.*## .**.....\   ..*..*.   ..#.....##..#..**...\..*#\ #..* *.....#
##.. ..*#. ...*.. .... ... *#*#...#*. #. .*..*..*.... \#. ..#\*..  ... \*. \ \..#.  \.#.....*..# ..  ......#.... ... .#.  .##... .*\. ......**.. #. .#
#\#.*. .. ...*\\ .......#. #. .*\.# . .# * .....\.. . *.# .. *. *.*\##...  *....\..\ ....*  *... *..... #....  . .#. #.*  # ## .** .... .........#.#.#
##* #*.. ......*..#\#. *..*.* .* ....\..   #...#.* ..*.#.#.#\.\. ..........#*  \ .\.. .\. **.. ..#. # ...#. #....***. . . ..#..\.\ .#. ....# . .#\.\*#
#........*....  \...... ..*....#.# . ...  #.. *#...*. .\.**..# ..#.*...\...   * ....\\#...\.*..#..**... ....*...#....\. \..#*....#**...... *#...\. .*#
# .*..\*.#\.* .. ..#. \.\.. ... \*..*.. \. .#\...*. .. ..**.* *.#.*.**.#..#... ..*..\  .......#*#... *.\... ....#.#. . .*# ..#\\  *.*#.*..*. #..*. .##
###*... *... .......#\...#* #*.*.*.. .... .. ..**...#\# *.......*\..#\.*...\..# . ....*  #**  *.. ..#*\..*..*  *. .....*. ...  . .* ..*.#.*..... ..  #
#*#...... .**.   #.... .\.\.*#.**.  .. *. . \.***.**...*  ...#....*... ..* ##*#..* .*\..*\.###..*..*.#...##\.... ..# .# . .. .##. ... . # \\*#. .....#
#.......\  *.. .  ....*.#... .*#  #. * . #... .*..# ..*. #\.* . .#.#..*... ...\...#...#*..#* \\...   .. ...*.#......#...... ..#. .....*.. #\**\  .\ .#
##... .#*\#.# \...#...#.... # ..  **. .\ ...*. .....*..*...#.#.. #*.. .#.. **.......*. .\. ...# ..#**.... ..... .. ......#*.\ ...\ .#*\ ##.\ .* ...  #
#..\  .. .#..*\*.....#*.......#.. \ \..\#.....#  .*.... ..*.\ #.*..*...  #\#.. \.. .. .#*.# ....\.#  ..   ..\ *.##\.  ...#. .*...... . .*#.# \..\. \*#
# *.....**.\\* ..\... *...*... ..*... ....  . #**...#* ..#\.  . \. # *..  ..#\...#  . .#.*##....\.. ..  ..*.#. . .....*#.#...\\#.** .......#*.. .*...#
##.    ...#.#....#.. .*  \#.#  \  #. \*...\ \.... ** .##. .... ... .. .... ..#..#....\*\....#*.*\. .#**. . .\  . ...*.*.. # ## **... .*.\*#.*. #....##
#\. ..*  ..#... *. ....\*. ....#..*...* . ...#.. ..#..\.\.\*\...#...\.#  ..\... ##* .  #. ..# . ..*. . .. .. .......*.... ......#..*...*...* ...*#.. #
#.**.. ... ... \##*.** .#.*. ..\#. ...#*....*.##...  .  ......#*  ....*.*..  .*\...\...*....#. .   . ..# . ..* \*  .# .. #**..#*\ ...#...... ..... *.#
##*....\*#*.\ *..*.. **.. *. \.... \... ...  .  . ..\ ......  \.###  .\#.\ \#. .  ..*** ..#..#.# #...\..  #.**\ .... .*.\###.#.. ...*.*. #  ...*.\.. #
# ........ * ...\\  .....#\ *.#..* . #.#..\.\..* .. ..\. . ....\*..*.#....#* ...\... .#**....... *##*  .*...   #. .#...**..#.\*#.. .. \...#........  #
#.. .\. . * .\.... #* .....*.#.....\\.......*..... ...# #.*..#.**\ #\*#...... .\..#....#.* ..  ..* . . ..#. . .**. . .......* ##. ..* ... . ...##*.# #
#...........# .. .\##* . . . .... * *#*. *.**..*.....#.*....\..\. . \\.##..*#.*..#.......  *# \. .. **.#** ....    ..#.#.... . * *... ..*..  ..\.#\..#
#. #.... ...* \.. \#....  \..#.  . .... . . ... .... .#.. .  \*.#\.*#.. \#..\.. ....*\.. #\....#..###* ...*.. * *..#. .\.. ...#  ..** .*... ..   .   #
# ***#.  .....*\. *.*#. .. . ..*.. . .. .#..# .  . #*## . ...*.*.#.*  .#..#.... . .......  #..*......\.  \....  *.# #.* . ..\  ....##..*. ..#.* ..#..#
#\....#....*.* *\ ..#*.\**# .. #....* #.  ..  ..#....  ....  ...#.  .#.* . *.....#.#..*.........\....*. #...*.  ....*\..*. *..#...*...*#...*..  ...*.#
#..\.*#....#...* ...\*\. #. .... . ...*.*....  *#.. .. ..  . .. #..#  .. ... * . ...*...#*. ..#....#.. . . #\   .... .\.  #.## ..*.#.#  # ... ..## . #
##... .# # .#..#....  .# .\*...... # .*.##..*#*.*.. .... #*....\**  .*#.#.*#. #*#..# ... **..#* \##. #*..#.\##.##*...#.. *. . ..#.*. *...#* . \..#  .#
##.   ..*.* #...#*....\...\.*#... ..#. .\...\\. ..# \.    ... #*#... .#.#. ...#....# #...**.. #. .....  ...... ..#..#.  .*.... *..# .*.. .. .........#
# . ..\.. .. \*.... \#   .#. ..\.\.\...#*. .* . ... .* ... ..#..... ... .*..*.. \*\*\ ....# \ .. ..... *...# .#... .. ..... ... .*......*..#.... .. .#
#.... *. ........ .\. . ..* ....... ##.  # ..*.#* \......## #.*\**. .\ ...* ...##.......\........*.... .. .. ..*#.#\..\#\*  #.\\..  . #. *..... \.\. #
###. ..  ..... .....*. .... *.. **....##..\.*  .. *.\.....\...  * .#.....  ...... ...# .. # .\ .#.#\..*\. .....\*.##.. *#\.\ .  .*#**... ........... #
#.\... .#..#*.  *......**. .**#......*.....\.......*...## . .#.#  ...   *.*...... *... # .#.. #.  . #*.. ..... .. .*#* ... ...#*#*   .#.# *.... # .*.#
#. ......#.   #...# #.. ......#\. ..#\.*#*  \..#..\... #... \**.# ..... ..#.*..\  ..#*. .# . .*#...# ..* *  .*....  ..\.\.....*. .... ### .#......#..#
#.*....\.. *..*#  .* *. .*  .  .....   ... .\\\.*..# .. ...# \*..##.. #  .    *.. #.#... \.  ..#...# ......#.# *...#..*..*.. *#  ..#....... *....... #
#...# .... ..#... ....* .#  ..#.#..... .*#. #....*.\. ......** #...\.*.........#.....*#..  . .. .\.... .#.\\.. . ...... *.....*..#.#.. .\...... .#...#
# ..#...#.# \ . ........# ..#  .\..... ..\.#..* ...*.*# *........... #.# #..\ . *..........\\ .##....#..*. . ##.... ...\ ... ........ ..#.\.  \.*.#. #
#...#. * .**# \......##...##...*.... \. .*.. . .#* #....#. . #  . .*.. ....*..** ...*..#   ..# #..\*..*  .  #. .. ........ ##*....  .#..#   ....\....#
#.. . .*...  ..... .......\.......*. ..##. ...   .#. ...#... *. #..#.. *.\ ..* *. ..... **..#* ...#\. ... .. ..\#. *..#.. .. .#...#. .  ..**..  ..# .#
#.#*. *\. .* .   ... ...##. *......   .#. #\..\...#.  #.... *  .... ....\......*...*\.  . .#..#..   .. **. .. ..*.#.\ \#.*\.\#.# ..........#..* .  .*#
#........# ......#..*.       #\... . ..\..... #.*.#** ..... #.  . . *... ....#.*....\ \*. .**..**.. # .  ..## ....\ . ..\#....#*..... .. ... ... *#..#
#*\.* .....#*.. #   *..  . * **.......#..... .\ ..*..#...#*.\.  #.....*....*.*. . . . \\   *#*. . \ ... .\. #. .. .\*.. .  ...\.* .\## ..\. .....#*..#
#. * #.#. #* ..* ... .. ##. .#.# ......*.....  .#\ \.\. .... #..\...*#...\.. ....#.  *. *. .. ...*.#...#\..#.*. .. .\.. # ..... . ....*....#  * ..* .#
# .##. * ... .... .. .\.#... ...# .* . . .# ...*.#*#..*..#*... . .#... ......   \.. .... ..#...*\. .*....##\.\.\#..... \*......*...*.*...*. .#  *.#*.#
#. . .*.# .\ ...*...#.\*..#....  . .  ..#.....#..\ .# .  . ... ...**#.. .. .. *. # \..  ....#..  ...#*...  #*.#.   .  *... ..\ .. ..  ... ...*.#* . *#
#...#...*.  .. ...*..\* .#. ..*............*.#*...  ..#. #.*...#.#..*....*# *\.#....# # ..##.. ...*. . *  ....#.*.  ... \.....\ ..... ..... .#..\.. *#
#.........*.....*... .#.. . ..#.. ... ..  .\ **.# . ...    *...\. ...\*#.\. .#.* **\ .#..\ .*.#\....#..... ..\... . . .  .. *.  *.... .*#\.*...\\.***#
#.\..... .#...#\..\ *#. . .#...#*.#.... .\ .*.#..#.. ......#..  *.. * ..# *...... ....#. .\. ..#... .\*. ...\.*#..  * ..... ....... ..\.\........... #
#...... . .##...*##* ..*.**.##. ... . . . ...# *\ ..... # .#\  .*. . **. ...#.. *. .. ..#\.....# .. *   ... ....# .. ... #  .\  ...*. ...#.. .**.. .*#
#*. *... .# ##* ....#  .*   .. . ....\.\.......\..#*#..* ##..*.\** *.\.*\.. .#.#  \.........#....... \... . .*. ......#*.. #*.#*.# #.*. .*....... .#.#
#*.... .\.*....# . ..... . . .\ #.**  .....#..#* ..#..  ...#.#. .* *.\  ......#..#  ..\.*..* ###  **#..**\..  .. .... .#...#.*.*. *.....#.... ...... #
#.... .. . ...*..... ..*.....# . ** ..... ..\\# ....#. .... ...#. . .# .*  .\... \ ......#.....  .. #.. .#..... .\.....  .\ ...*\ ..* .....  .. . ...#
###.. \.#...#.. .#.# ......  ....#.#. #.... .... . *..#...   ..   *.....   ......# ...#..*.*..#...*  *.**#.*# .#.#.\......... ....#....# ..**  ... ..#
# ...... .*..*..... \ . .\* ...*#*... .#.* \  .... ..# ......#.\#.\ . .... .\ \.. ..\........  ... ... .....*. ..*.. ... \.*.* ..*.. *.#... ...#.*..*#
#..**.*.*...*.* #... ..*.*  * *#.*.\....*. #...*..\. ..*.*........# *.#....* . .........*#. \...  #.... .. ...#..## .... . .....\..\.....  ..... #.#\#
#.*.. * .**.. .\ .*. ..... *...#\.. ... ... .*... ..... . . ...... . # ...*.##*....##.#.  * ...#.. ..\*. \... . \...*  .#    *  .  .* .. ...\*.. . ..#
#...*.. .#....... . * ..*....*#*\.\. .. . .*\.   .*... ..# .\...... \#... ..... ...#..   .....*.....#....\...*\\.##.. .*.. ...#. .# *.. #.. .#*.  . ##
## . .*.. ...*...*.. .... .... \* . ... *   ..... ..*. ..##. #.#.\. ..#.......# *. #..*...#.\.\. \ \# ... *.#..* .. ..... *. .... . ...*..\. .#\ ...##
##.... . . ....... ....##. ..* .**. \*.#.*...#...... ..*......*...#.#*.\. .#. *. .#....\.  .... \.\.*.\.......#.  ..\.#.#. .  *..\#..#*\  \ ... .  #.#
#*..\. #*... .#... ..*#..*#*. ..  ... *\. .... . .   # **#..#\\..#.#*.\#..#.#.. ..#. *.... .**. \ ...*..  .*#..*..  .     .*...  ....#..........   ..#
# *.... \.. .... \ ........ . ......  *...*  .*.* .\   .....  ..\.**...*...\....#*. ##\..  .\......  * \...#*.*..**.. \........ ..# ...* ...##.... ..#
#\. .......... ....\. .\\*.*. . #.  .. \.........#...*.**. .. *#..... ......\...*......... \.. .*..... #.#. .....* . . ..  #..#. .. *...* .\\..#  \. #
#.. ........*. .. ..  . ... . ..  ........  ##..... * .#.#.#. *\..\...# .  .. ....#.#*. .\ .....\.*.\*#..*##\.*\ .......# ...\......  . ..*......* ..#
#....\ # .. ..*....##... #..*.. .* \.......#\..*.*# .... .*.. #. #...*.  .\.*.....*...##.*\#..# ........#..... \ ......\ . .* .#. .. ........*.* .\. #
#   #. .....*. ...*...*##..........\ .\ . .... ##...\...\....#.#\..#.#.. ....#. .#..##... .. \   . ..# **# . . #. #.. ...  .#. #..*.*. .* ..# .*.\ ..#
#.  . #  . . .. #. \#.* #....\ ...\..  #.\ ...* ....*# ##\....\#\.... ..##.* # #.. *....**#.. . *......\*.*.*. ..#.*.##\.##*. ..   .... *....#.  .. .#
#.*..\ .* .. .\ .....*.*. * *#. .. .#.#...*.#. .\ .....#....\...... . * **#..#...#...\.....# . .\.# . \.  ..*..# .  . ...\...\  . ......**.  . ** .. #
#......## .# ..#..    ..\***\\.... . #\..#.  \...#.......#\ #.. ....# .* .* .. ..  .. #*..**.......*. .. ...*... .#..      .. .  ... \ .. . .. .....\#
##.... .. . #.#*. ....# .. ..... ***#\...*...  ..*....... . .. #..# *.\. . ...#...#  *.\ #.... \.#.#.\ .....  .# *..*..*#.# . . *...*. #..*.    .**. #
##*##..## . *#* * . \#. .*.*. . #. ...*#..\*.#.....# \#.. #..\. # .. .. . ....  .*..  ....* #..*.* ..\...#. ..## #.#.\.. ... .#... .#.. .\.#.#.* .*  #
##.*.#....\. ....#.#   .# *\.*..###.... . #*#  .... .* .#  .*..\*.*.#\*\. . .#.. .. \.#..... .\.*......**.. ..*#..  #...#.# ... *..   .*  ##.   .. *.#
##*.#.###\..#........*...... # .#.\. \ ....#...  .#. .\.#.##. ...*... .. .*##..#.. .*.    *..*.  #.*..#*..... **.*. * . #\.*. ..* \ ..*.#..#..#..##  #
#.... *\*. .. ..#...#....\. \..#..#*..*..\*  ...* .#....#.. ........ .*. \..#.  .#*.#.# .. .#.....   #. ... .....*#....*...\\ ...#. ........ .# .*.  #
#.*.  ....*..#.. ..  .\. . #.*. * .\. .... \..\ #* *. # ... .. #.## *. .... *.* .* *. ...  *...#......*.#*..* .......*\.*...#...   *##.# .*....*.  # #
# .. * ..\*.......  .. .\.. . *.#.  ..\.#..#* . #. ..#.. \*.* #..... ...#.\ #. .# .. . ...*  ..*..* ...# #. #* ..  ##..*..#* .*...*.#*. . .#. .#....*#
#...#...*...* .  *...*# *..#.  ..*.. ...#..\ #.. *.##.......... *..\ .  ... ...*..* .**.... .#.. **\..*#......#...  ...*.  # ..#..........\.#....\.**#
#. ...#.. .. ...... ..*.#. ..\ \.*..\#.*.... .....*....#.#.##*\.#.*....#. *..*.......* . \. .#.#.* ......##.*#.... . . .....*. .*. ..#.  #. ..#....\.#
#... \#..*\ *. .#..#. #\##.. ..\\ ..#..*.. .....* #  #..# \.\...## .... .....### .#. . \ *..\#*.#...*. ..  ..*. . . \...... . ..  .#... .... *##*..*##
#.#...\ ...  .. .  ....... ..#*. ..  .#.#.. ...# . .*.. ...*...*..\...... ..\..**..#......**. *. ... ....*   .\.*. .. *..##.#\*.*. .#*...#..   *  . .#
#.\...#. *\#. #.\.  #. #. ...# #. ..# ..\.# ...*... . .# .. .  ..  #..*  ..* . # . \.** .*#. .... ....... .  \....#..*.   ..#\ ... # *..\.... ...... #
#...... .*.\.#..#...... .\.....**.......#...\.*. .**\....# \ ...*..#........... ..*#. ...  . .  ..*..#. .**..\#.. . #*#.........*...** . *#.... .##..#
# . .#. *.......*....\  #..\.#... ** ...# ....\..# #..  #....\  . *.....*..#..  .#.#  ... . .\. ....*.... ....*.. .* ....#****....\.. .  ... ..... #.#
#.**...  .# .##.. .. .***. .#*.*..... *..\..*.#..  ..... . *#..#. \ ....\.... ..**\..#. # .... . ...  #*  * *. \..#.#. .. . .. *  ..*........  #.... #
# .\ ....\...*.#.##.\   ......... ....\\ .#.*........ .## *. .... *..* ....# *   . .*...# ....# .*. ...#...*. ....*#.#\  ....#\.. #... ... ..*# .....#
#. ..  *...#*.  .. .#*#..*.#. .*...    .....*..#.\.*.#**..#.*#.*.......... .. .  *.#.. . ..... .. ..\*.#. . .#.. ..... *.***..*\#  *#.. # #**## \. ..#
#..  \...... ...   *....\ .*...* ..*. \ *... *..# ..#...#.*.* .##....\.. .\....#.....#*..*.*#....*.*#...... ...   ..#.. ... .........*.. ...*.. *.. .#
#.#\##. .*.\. . . .  ....  . .\. . #......*.#... #...**. ...#......\.\..... . *#....... .\* ..#\..#* .* .**...#. #....\....  .# *.#..\ .\#*. . \.*..##
#*.\#...#\ . *...*.. .  .... *. *#. #.#  .. *.\....  ...... .*\.. #*#.#*. *#\ . .... * . .. . . *.... #..  #* .  # .#......*.....\*# #....   . *.... #
#... #. ..**.. .*\....\.*.*##.** ..#  . .*. #....#... . .. **\ ....*  ..#..#. *    .....\..#....... .#..#... *. *#*\ ## ... . .*..*..#  **.. ...*\ .##
#. ..*.#* .*.\*...*  *\. #....\ .\# ...  *...  ...  ..# ....\.. ..#......#......*..#\...#\##\..#...*... *....#.# *... ..#..* .. \\...#*..\...  .\.*. #
#.#\......#.. ..\.......#** ....* ...* ...*#. .. .. *.....  .#*.. ...\#**.......... .  \\....**.\ *\..  ..* ...... ..  *#...  .......# .. ** .  . .\.#
#..... #............*......... ..#.#.*. .#.. . ... *.  ...*..\.... .# ...  .... .... .. .\.\..*.... \\ ....#..*.... .. #.. *..*.# .\*. ..*.  #.##..*.#
#....* *...*..#.... ..#\.#...*.\ ... *.#..#*..*\*..*. .\..*** . ...  \ #..\..#.#..#. .. ..#.  . ...\ #*#..*\.... ....#..\#...*.. ....\...*\  #.*.**.*#
##....*....##.......*.....   .#*.*#   ....... #..*.\#.**.#.. .  ##\. #...\**\\ ....#.. # #.*#.\ . . ..\* .#. .. ..........*... ..#....  ... .*.\..#\*#
#...##.*. .. .*... .* #.... . . # \ . .*...\* .. ..#...#.#.# #.#.#. .#..  .. ....#..#.... ...#..#..#..  .*\* ............ *.\.  ...*..*.. .*. ...#..##
#..... ...*..*.. .#...    * ## .  #.#.*#. #......# *#..*..* #\.*...# ......*.#.......\   .*..... . *# .*.*#..*....... ...*...#.\. .#.....*. .....#. .#
#....**..# .. ..  *\.#.*\   *. *#..\#. ......#*....\.  . ....*.*. #*......*.*. ##\*..#..#\.#.  ..*....*.  . # ....*.... . *\\..#. ..\\\#\..* * .. *#.#
# .. .... . .\##...*.#.. *.. # ............ \*...... .......#....#....#... \........ *  . ....#. .*#....#*.... ..#.#..* \#*#.. .\*....  ..##.#. ..   #
#  . #....*#. ... ... . . #.... ............ ..*. #.*.*#.#* .# #.\ ....\. ... ...*#..*## ..** .....#.  *  . .. #. . .\  . #* . *.#.\... ..#....*#..#.#
#.#. #\. .\... .. #... #...... ..\.....#* .#..*..\...#. .*.... \\* *.# ... . ......#. .#....\.\\ #.#*\ ..... ..*.*.*.#. \..#*....##.*.  \  ... .. ...#
#...  #...*. . ..#. #.*.#. ..\..\. ...  ...*..\.....*..*\*\#.  ..*..  .....  *....  .**....*.. ..#. . .  .... .*  \........... \ ..  .  .\\. . . . . #
###.#*... ..\...*.. .\ ..  .* .. .. ...... . ....#... .*   #.#  ...  .\..... . *#.  ...* .. .#.* ***...*. ..\  .\.*..\.....\..*....** . ..  ...... .*#
#. ...#. .. .#..#..# .*.....   ..\.**.#  .... . .... # .. ...\...  *.. .....#.#*.*. *.# .#*..#.*... #. #..  .*.\\..*..........*. *. .# ..   ..... . .#
L.... .............#..*. *\ .. ............#\* .# #..*#.#\*.... .... \*. .**... \.#*. . \....\ # *  .. ..\\#\...#..*.\ \  .. \.  ...#..... . ...*. ..#
#..\\......\ .* ... ....*#..# . ### *#. .*#. *.. ..  # ...*..*....... .** # .  ..#.\ #....\** ..... .\.... *..\#.\.....* .#...#. #*#..#*.... .\.. .\*#
#* ......  ..#* * .#*.#*. # \ \. ...#*. #\.*\##... ..*.. . .#.....*......#..... ...... ....#...  .......#.. . ......\.. .*\#\#...\. .\#  . .*  ..*...#
#*...*... .... ##...####..\.#..... *...\.*#.# *\. ..  . .  .*....\....#\...  # .#\*.. .. .....*.**. ........# ..#.\*  #...#....#...\.  .. .##*..... .#
#  . ..... ..#....#*....*...* .*......\.  ... # . \#. #.*.#...*..##.*........**.. \   .... ... . ...#..\*..#..#... #*.....*. .#*....*.. *.*.  \#.*   #
#\....*. . ...*. ..... ....... . ....**  #. .. .* ... .....#**..#* .#*. .... . ... .#. ....\....... .**\......\#*#..*.. **.... .#..*. .\  ..#*.......#
#.\.... ..*\..*\*...\*.\ ...*  *..*#..  *.# \.....#. . ..*.* ....#*.\    ...#.*.#  *...... **...#..*\ ..*.\...   ....* .* *.....#.  ..#.. \#.. ... . #
#.# .#*..*.# .......*......#...#.....#  .\#*#... .  ... .*.... .. .. .....*#.  .# ..*.... .....*... *.. ....\.... .....*.###  ....\\.#.   .....  ...\#
# ..**..#* *..#.......# ..#. *... ..... .#*# *.#.*  . ** .##*.... *\ .#... .*...#  .........*\.. # \*\.#. \.... \\.#... . ...\.#.#* ...\. ...\ . ..\.#
#. .. ...\...\..  . .\ #.\.. ......\ ..*..  *..   #.*.**... ....#.   .#.. .#...** *... . .\..#.# .**.\.# \ ##....\#..*###.*....* .. ..*.##\#.........#
#...  #..........*.....*..*#  #. ..\ .*...*.. ......*.\ \.*.. ..... .. ... . .*. .*.# . ..\*..#\* .*. ..#..\.*\...\..  .. \.. \.#*. \.*.#*.......... #
#.. *  #\**..\..#.... ..*.#.. ...#....#.#.... .#.. ..... *.. . .. ..\#*..*.##.*#. *..#...*.*...#.. .. .##....... ..# ... ...\.#......\..  #\ .  . #..#
#.\ ...#........#... *. ..**\.... *.. ... ..# ..*......\.....#..# ..##. #   .....*\.....#.#.....#.* .# .\.  *.# ..##..... # ..*#....\  .#. .. .*.  ..#
##..*. ... # .#... \  .# *.\...\.......*. \ .................. .** ...*.  \..# # #.. ....*  \*.. .# .. #  \..#..*. .. .\\. .#..\......   *.......#  ##
# *.. ..\* . ..*......* #..*.*.*. . ..* .. .   *...#... **...* *.*...   *..**#*.*#.. ...#......#...*\.#*.\.... ...#.* ##\. .#.\\...#.*.. #....*#*. .##
#.. ..#.  \*. .*.*..*#.*\.**..\\ #.#. ...\ #...#...#.. ...**..**.....#  . ... .\ .... ........ .*.. .#\ .#...#.....#......*.# .... .  * . *#.  ......#
#.....\#...#..\   . #..\**...*##.*.\.... .. .#.  #.#..  #.... #....  ........ .#. #  .#. #....\. ..# ..*.. ....... .*. ..#.\.\\* #.\. . *..... ....* #
#.... #.##....*..... ....... *. ..*....\\# ...##. #. .. . \....... .# ..  ......  *.. #..#.##.#.  \.*.#.*..* . #.\#\..........*..#. \..* .#*#. ...#..#
#......  #  .*....# ... .......## . .#.... .. *... # #  ...*.#.*   #.*.    ......  .  . .. ..#*      *. .#...**.. #*... #*..#.*.#\#...*.. **.#.....#*#
#\ ...\.. .*##*.... ....\....#.....\ .#*.## .*# * . . \.. .\ . ...\ *..\ ** *...\*....##\*# ... .##*..#*\*   . .*.  *.#  ...\..* ..\. * ..*#*.#   ...#
#... #...\#\.# .. ..#.*. ..#..#.\#.....* ..#\..*.\### ....* .. #.......*\.# \ #\*. ***..#..\.. #. ..\ .# .\ #.. *#.#. .. ........ . \..*..*... .*# ..#
#. ...#.. .. .**#**.. ...  .*. .*.*#.\.** .\...... #..#...... ..*...\* . *#*  ....* . ..*....  ....# .\.* .....#  *..... ..#..* .. ... .*#*....\   ..#
## .. ..#. *#*. ... .#.*..* ....*.#* ....... . ...# . ..#..*..\. #* .. .\..##..#... .. \..  *.#..\.#..#.. * \..\#..#.*\ .*.... *#... #.......#. ...###
#*#... ..#. . ...#..*\*\.* .\.* .**.\... ..*.. ...... ...... .  *.* \.  .....*\\.. .#...... ..   # ..... .... .\.. *...*#*#....... ... .*  .. *.*. . #
#.  *#\# #.. .... ...#. .\\ .#. * ... ..#*#..*.   ... *.*.\.. **...#. .**..* ... . . ..#.. \........*... *.*.#..#*.#..\. \\.  .*...\ \#.  .. **...#.##
#  ...... ..#.#\ .*...\ #    . ...*\.*\... \..... ....... #\\ #..#..... .#.*..##... ...  *..... .* .#...##..\.#... \..*.*..#.\#.  . .... .## ..* .. ##
#.#\.* \*.  ..*# *..**.\*... ..##..* ...... .. .....*.. ...\...*# **... . *. . #   .*  *# #.....*....\#..*.*..#\......\\##... ...*##*. ....... ##.**.#
#..#..\.*.\.*.*. *#.#.....#.... ....*.#.. * #..\....**. ..*.*  ... \..#.#. .# .....* . .#.*#. .. *.#.....\ .... \ ..#.. #..... .*##*# #.... .....# *##
#..#...*... #.......#.  .. #.#*  .*....#.. \ \.. ... ....*... .*.#....\. #*..*.#  . .##..*..\ *..* .*.#.  .#.. .*.....#.. *..\ *.... #.....#.. ..##..#
# *....   * ...\  \. . #.. .....# .. .#.*  .. . ... .*...*.... ....*... ..... \# ....\*.  *.....*...*.#.......... \.# #.*. ...  .*.* ..**....\ \....\#
######################################################################################################################################################