##################################################################################L###################################################################
# .*. ...*.##  \#.  *.*....   ..#.........*... .. #.\....*.  .#.*.. .*..*\ .. #.*.. ..*  .   *\#.#...\.. #.\.... ..# .#....... .. ###.\*. *##.. \..*.#
#*\....\..\. *.#.. ...*.. ##.*...... .... .*#. # . . \#... . .... ....\...   .*\.*.  .#*........ .#.#....\..\ ...#* \......#*.....\..\#   . ... ..* ##
#....*.\..*  . ...#...*..# ..  #.#  .*....#..*\ ...# ......* . ... # \...*.. .* ..*...\ .......\..*....*.  ##.. ..*.. ....\. .* *.. ..... # .. .   *.#
# .#..#..... .# ...* ....*\. .. . .... ....*.... .#.....#...*.* ..... #   ....#..\..# .....\.*\*.**...... .... ... ...# ........ ..*. # .... ..\#...\#
# .#... . . # .. .. .***....## .#.*... ...  .  . ...\##.\..*....... ...#...... .....#**..  *........ .*.\ #... .*. ....**#* .  ...*.#*\...\\ .... . .#
#\....#....  ..#. *#......... .. ..   ..##.*..*.#.. .. \ *........\.. .....**....   . ..*..... *.. *.#..*..*. .*.... . . ...... . . .\...# ..... ....#
#* . # .*.*.#...... .  ...\*#  ..\.....*. ..* ... \.. ..*...  ... . ##..*.  #  .#....... ... .. ..  .. . . #.*.*. .*.* . ...*.*.   *.. .*...# .*..# .#
#. .*.##..#.#.*. ..........*#..*..\... ......#.# ..\ .*.. #.\. .*.*..  .\.....#...... .*..#...#*  ... .. .  ..  \..#. *...#.#..#. * .  . #..*...*..# #
# ....*.* ....##.*... #.. \...  ...  ... # .. *. ..#.....##  .\...#.**...*.#  #.  *. .....#..\....*\#..... #..  .** ## . .*... \.#..* ..  . ...\. .*.#
#.* .. ...  . . ..#  .\ ....#... *. ..##.#.**.....#*.\.. . *. *. # #\#* .......#**  .. .##* ...........* *.**.\.# ... ......\*..\.......#.. ... ..  \#
# ...# ... *.  .... ... *.\.... ... .#....*.##...#. #*.#.#..#. \# ...**.....* .*.  #.\....*..*.   #.#. # #.*.*..*.#.....  **\.*..#. .. * .\........ ##
#... ... .#... *.... **\ .*.....  . \.\..*....*#. ...... . .*.... ... ##.......*.*.... \. .   .. .\.*....#*.*......\.* . #**.\... .*.....\ .....#..# #
#...  *..#..#.\... . .. . ... .*. *.*.# ... .....  . ...... . .. *.*  ... .. ... *.....##\ ..# ...  .#....#.. . .....*..*..#.  ...**  .*...  .# .*#..#
# . *.. . ..\\.#  *..\ ..#*  ... ... \ .*..  ..*....#.. .. ** ..#*..#..* .  .##.. *.*.* .... ...*.. #\ .*\. .. ..  . .#*....* * .*## *.\# ...#...\. .#
#.  *...*..*.#.*.......  # .. . ...*.. ........   . ...  \..#**.*.# . .*.# .. ..#\*#*..*# # # ..#* . # ..... \.*#.. .* *...\*.#. ..\. .*. # ..\   #*.#
# . #....# .  .....**# ... #.**     ...\..*..#.  ..#..*\.#*.  #......#. .....*. ....*.....  ..*#. .#.  ..\ .\..*......*  .#  ...##.#..\. ..\#  #.\..##
##*..*# ..*.   . .\#...* #.. .\ ...## ... ... ...\. *.**\ #.. ... \.. ..*# ##......\.\ #.#  ##*..... .#......*#...  .......# . .  *. # .  .#  # .\**\#
#... .. ......\  .......#..\..#.# .. .. ## .... ......... ......\##\  .*  ..*..#....*##*#*#..#...# .#....**. .#*........*#\#.....\*. .  ... *.*...  .#
##. **...*#.*.*\ ..\........  .#....   ...#..*..#* ...\.. #\**...    ..#..*.#.#..*# ..  ....* *... .#..*#.. .*.*.  *..... *...*##.... ...* . *#..# ..#
#. *..*....  .##.  .* .... #. *.. *......#  ..* ...... ..*....* #..\...#. .. ..*# *...#.. .*..* #.....* # .**... ..*. **. *.   \ ##  *.... ..  \....##
# . .#.\..   #..#... ... .\.\  .....#..  *. .\.. ...*# . .....#... .#....  *..*\. ...\...  ..\...*  #.#* . ..*.... .\.. ... . #   ...\...# ..##*.**.\#
#....... **..  .#  .\ .... *#..#.#..* .##..*..... *#.. ..#  .#...\..** .#....  . \ ..#*.... ..# .#..##..... .*. ....# .. #. .. .*.*.**.........  \#.##
#.*..*#. ... ..#..#\..  \ *... .*.... ..#.    ..#..\ ... . .... ...*. *..... .* .# .. ..#....*.. *.#..* ... .*#.  ... . *..#*........\\\*.*.. *.*#...#
# .\.\. .* *.  .. *....* #.#.. # .*#.....*.* ... * #...#...  ..#..*.. ....  .. *  .#.... .....*#. ..#. .#...*.... ..#. ...\.... .....  #...*.  \#.#..#
#. ..**. ..  ..*. *#  .... .  ....#*#...... ........#. .... . .*. ** ...# ..... * .   #*..* ..#.  ......* ##   .##.\\..\. .. .#.\. .......*.....*.  .#
#* #...#..... ..# #.# . ...*.... . ...   .......#*.\ ..*.  ..*.## #. ..  .#........ . .#..#.#. ..... .. #. .*........  ..#\.. .#\..*#\.\ .  . .\.  .##
#*. .*#.. .  .* ....   .#. .. ...#.. ...#.# \.*.. .\\...  ..#..#.#.. ....**. .  .***... #*.#\.  .  .. ....## *...\. .... *..* ..\. ...... # .. ....# #
#..* ...  .\.. ..*... ...#.#......**..\... #.\#. .##.......** *.*.. #...... *#\*.*.#. ** ...*  ...# ...**.#..\.\.#.#*.*  . .* .#*.......#..*.. .*#. .#
#*\ .\.#..#..\ ... ... \#*... .*.#.*........... #\.*. . \# ....... .. **#..#   ........#..... .* .*.*. .... .*..     ..... . ...\*. ........#.*..*\..#
#....#.  .\...**#.##.   *......\** #.*... .#*... *..#..\...*.  # \\*. .......  ...*.. ...#.. *.\ ## ###  #....#...*........ *..\..* .*.#*.*... ..#*#\#
#*....#\..\ *. ...* .*. ...  .... .\   .*. .....\.*.\. * .#.....#.. * ... \ . .... .\..... #.**. .. *#.. *  .... .\ \  . ...* . \..  ...*... #*.* # .#
#.\.. . \. ..**\..* . ..* \   .#... . \...... #.**.. .* \.. ..\....*..\..  .... .....#...#.# .# *. #..# .. *#.\....*.* .  . .  .##......\....*\.....\#
#\#..*.. ...##. ..#...*.. ... .# .. \..\.\..  #*....## #.  .....  ..*.. #.......#.....\...#...*.....  ..*#....#.. .  ** ... ...*#.*.*. \\*.#..**##..*#
#.# ... #... ....\#  ...* . # .#..... **...#.....\ ....*....... ...*.#. * .    .\... ...... . ...  \*....#....***...*  #.. #..  ..#.... #..  \.....\.#
#.*.*.\*\..#. ..# .. .. ##..#*\# .*. .#.. #....#. .\.*... #.\ ....#..#*#  ##*\ ..... *   .*.. .. ..\..  .* #. ..*. ..*.*\** ..*..#..## .# *..*.*. ...#
#..*... ....#.##.*.#. . . ..#\. .  #.. .#*..   ...** .. ........\\*... .#..*. .   .*.  #.*.\. #.   ....*#... .....*.*#....*.#.* . . .... ..#.##..#..*#
#.#.. .*....*.*........... . \.#..#..**..#.*\#.. ..#.....#*. .##   .*.. # #.*#..... . . ..\ *.##.\.\.   . ** *... .   \#*.# .. #.. #\  *...# . . *. .#
##*.\. .........  #*.....*... ...\....  *..#.....*.#*. ...* ... .. ..**... .....#.#. \.......\. .*...*.*\*#....#..*.........  .*. .#.... *....... .. #
#...* .** ...#..##* ........#.... \ ....#. .#.\.......\. .#...... *....#..... # .. * . . ....\....#\...   .. ..#... ....*.. * #.*.*\....#\...\..* .. #
#*.....  \.  \.  ..  ..  *..*\ ..*.*.#*..\..#*.*. .... ..#.........#..**..#.#.##.\#.#...... ...\#.#  ....*....###........*...#..#  ...**..*......  ..#
#*.# .\... .* #\ . * .  \*..#..\..*\.\.  ##.# .* .##*. \... .#.*...... .*... . ..\*.*#.. . . \..#.#..#*\.*.\.. .*...#   ..* .  \. ... \#..... ##....*#
# *   \.. .........#.*#........* .....*. #\#*.  .*....**..#.# .\ #*....... .....\... .  ..## *##  ... .  .*. ..#.# *.. .*  ... . #\* .#.##\..*## ..*.#
#... * ...*.... \ ##.# .......#. ..... . ..#..* .....*\....\. .. ...*.....*  * \#\*.. ...\..\.. # .. . ....*..*.......  #....... \    #*...*...#\.## #
#*...  * .......*   .... * .....\.* ..#*...\.\  #\# . ..  ..... ... .# #* #..  ...\.*.*#*#.#......*\...#. .#... #...#\...\...## . ..#*#*....\ . ..#  #
#......# \*#  .. # ... .# #. .. #*.\.. ...\  .. \. *..#. ... . .*. ..#.\  .*. ......#. ... # ..\.. ..#..... # .#. # ....*.\..* ..... . ...*.. ...*.*.#
#...\ .....# *.#.* *. .#*. #*......... ....# ...*. ...*...... \ ..*#. .... #....... ......#*  ..R.   .#. .#.\\..  ......#..# ...*. *.. ..*.#... *#.. #
# ....*. . ....#... ....\. \ . .. ....  *..... .#*   **#. .###..*...*....  ...  ..... .\. ..#  ..\ ..........*..  * \.. #.....*.. .#. ......#...* ..*#
#.*** .#.\. ..\...#. .... . . # ....#* **\#...... #..# .#.* #... .*. .*... . .\*## ...#. ... \. #. .... ..  #...#.\* #. ..# ... ...*..* *..#..\  ## .#
#......#. . \. ....#.. ..*...\. *........\...\. ..* * # *# ..\...  ..\   ..* *.*... ..##. .....   . .\ ..*..*. .##. ..#.\...... ....* #\*......#  . .#
## \....#\.* . . . ...  ..*..... ....*..*\*.*... ..##.\.\#*. .## . . ............*# . .#...  .. .# . .\  ... ....#. ..#..\ .*......... *.. . .*... .*#
#....* .\..*...... .....**. ... ....**.. ...\# ..##\\....*. #*.....*....*# ....\.*.. .#.* .#.... .. ....#\ *.*.......\\. ** .  ......\#  ..... .#* ..#
####.. ........ #..# . ..#.*.#. .\# .\\\...*....**.\. ... .**.***.##.. ... . \. \##.   ....#\... .* .. .. .. #.\*..# .. ...*### *. ..* .*. .*. .*...##
###.\.\ . . .*# *##..*.#**#.\.*\. #.. .. . *.....\ #.......#.*\ .\# ..*.*\#..*. .*.... ..#.... ...\.\.. # \.... *...... *. ..# *.* ..\ #..*\..\......#
#..... .*. . ##..... ...#*#. #*.*. ....*.......* ....\  ..... *... ..\.. .. ..*. *.......*.##\...#..#.\..*\ .. ..#..... . #.#*..\...\....... .\#..\#.#
#....*#...#.*.#\ ..... ..#*. .** *..**. ......#..\..\..#.*........# ...... ..... ..#.\.... . ...  ..* .\......\  *......\..#.. #  *#.... .. ###.....##
#.\\ . .....\..#.#..#*..*.*..#....*..\.  ..*.*.. #... .#.....*.. .......... . * ..* # . ...  . .. ... # ...  \..  .# . # .*.#....  .* # ..*.**.. \# \#
# .. ..#............. *....##*\.*#.\....*... .* .\.#.. . #....... .*.*\....*.**.\ . .## ..  .. ..... #\.... .. ... *\\.. #\.....*......*... #.. .. . #
#. ..#* .*  *. *\.\ .#.##. ...*.......#*#...##.\ ..*#..*...#.\ . ...  ..# *.... .#*.  .\##\  ....# \  ..*...#.  #..*## .. *.   ..... .\.*...*..#.* .*#
#... ......... .* .... ...##. .  ..#. ...\  ... .....*  #. #.#*...# #. ......#* *\ .*.   ..*# ....* .....\ .#..*. .  # ... ..#  ##.\.... . ..........#
# #*#.#..*..*..  .#.*......*.#..*..\......  ...... .*# .. #. #. *\.\. .#*. .....#.... ......... .. .* #.*. .......*.. .* ..#.* ... .*..# .#.. #   ..##
#...##..# .\... \*..## .#....*... ..  .* .#..*..*.. .   .*.# .. .##.  .....#.. ... \.* .*# ...*.. .\.. .. ....*....\.*. .....* . . ...\ *#*  .... .#.#
#  ....*.*. . ..#......\*. .*.*.   .*..  \.  .   * ..#.....\ .....\.#...#* ... . #.. ...\..* #.*..\#.#..  ..#. *  \. *..## .\*\ ....##* ..#...  ..**.#
#*.. ....*.*...#. ..#*.....*... #.*. #..... .......# .  \....*#*\.*..*.#. .. ......*.*.... #..*.. *.\.. #* ......*##. #  ... ..#.#..*.*...#.. \#.....#
#**.... ##..#... ..#.. . .\.\..\# . ... ***.\. \.  #...*.*.#. ....\#.. . ..#.#.   ..**.*#..*# ..... #.*.#. ## . .....#*...##* ..**   .*.#...* . #\.\ #
#   *\.\##. #.*.\.*\. ##.#..#..  ....* ..  #*..   ....*\ \*.*.#.*. .. ..*....... . #..... # **....... \ ..# ...* #.*.\*  # .... *... ... .  .  \.#...#
#.#... .*  #......#..... .. .##... ..*#.... #*.  .. .*.....   .*. ..\.#*. \.. ...  #.. . ..\.* \. *.. .... .......#.**...#....... . .. *.*   ....##. #
# .*##.#..#.\#...#.* *...... #  \..#. .#.... ...\ .  .* ..\*....#*\ #.. .*.. ..  .* ..## .*..\.* . \...#... ...#....  *.##\*..\..**..#.*#...* .#.. . #
#.#..#...\. .**.\.......*........#.*# . ##.\.... .#...#.#. ..\*. *....  \ .# . #.* .* *.  ....#.#.....*....#*#..* .. . #..  ....*\..#*  . .#... ..\..#
#... ...*.*#.. .#\\. ... . ... *.#.**#.##.\.*. .\  *..*\..*  .#.#.** * ........... ....\.#\.............. ...  *..*\.##....#. ...#.*#.. #.   .  .\ . #
#*. ...... ..... *#...*. \. *#...* ... # ......\..#.# ..#.#.* ......*. .\   .\. *\.... *.\. #*.....## ..*. ... ... ..**... *  ...... .  *#.#....*..*\#
#..*.#. ..* .. ..... \. #*.....  . .*#... # #\..\.... **...#.*  ...**.. . #....*..#.. .. .\. \...\...###.#..*#.. *\ .. .. ..#.... .*.\.. . .# .#. ...#
#*.*..* .###.. #...#... ... #.*....\...*.#... .... \...*..*.#...#. .. #..*.###  .\...\*#.....#...\\   \.#\.*  ....... ...# * ##*..\.\...#.\*..#.#*...#
# *..# **.\..   ...#....\... * **..\.*... ....**.#.........#\ #.* * ....#..* ...*.**#* .....##.. ...... .*..**..\# .##.# \... .. ... .*.....\ . .*\..#
#. *.    * ..\.*.. #...#...#* # .. . .  .*.##.. ...#. #  .*...*...#......###.# #. .*\.. .**.#..*...*.\....  ..# ....*#. ......\\. .......#...#..#. ..#
#. . \.\. .... ..#. . ... *...\..* .*.....  ....#... .  .. .*.#....###..*... ... ......*#....\. ... .. ..... # ... ..... ...\ ..#  .# \. .**..*.. ...#
#.# ... #*.*# ..#..*.\ *# ..\..\#\..\. ...#.#.*#...*.*## .* .* *.\ . ..#.. . ..  ..*#. .**#.... .  .. ## *#.. .. ....**..\#.# .. ....# .**# ... . *..#
#\. #. .##..\...\.\.**# #....# ....** .. ..*#.*.  *.\.* \...# ...... ...*..*..*. .\ .. *..\\..* ##.## #*. .....*.*.. .*. .*#\. *..****. #  .# . #\.* #
#. .*.......*... .*.  .... #.# #*..  # ..#\ .#.# ...*#*. ..*.*# ## ....*.*.. ...\.. .*..*...*#** **.* ..*...#\#...#. ... ..**#  .    ..... * *\.. ...#
#.#\...*#.  #.#.... ...... ....#...\........ #. ##.....#..#**. ..*.#. .\ \.* .*#. #.*.#.# ..*..* #..\ ..*.*.*.....# \ .\..# #... .  ..  ..**  # .....#
#.. .#... * ..#..*\...\.  ..#.....  .*... . .*..*  ... .\#.. ....\#.##...#  .*.*  .  ..#.*\...... ..#  \\.#. .... . \ .  ... ..# . \..#...\. .** .*\.#
# . .*.. ..  ..# .\.#. ....#. #. .. . *....\....  .......#. ..## *\*. ...*. . ...*..\..# . ... .**........ .***### . #*.... .#... .#.#.\ **\ . *\.# .#
##.  #.. #..#..  \.....#  . .\\ \.#.#.....*..\*..*#...\... ...##....*.\... . .* \.* #  \# .....*..*. ....* ....# . .... . ......\..\*.#.. * *.\\.....#
# ..*#.## ..\. .\.\\ .....\ .\*.#*###. . *##.\..\\  *. *##.....#..#..  .  ..\##\  .#.\\.....# **\.# .. ..*.  #.. ..\.#..  .* .*.. \.\ .. #..\#  . #..#
#.  .#.....\ ... .*.  .. .* #.... . # \*. \.\..*. ...#   #...#.. .......##.**..*..\.  **..*. ..\. #... \ ...**...# . * ..*  * *. ##.  .*. .... .... .#
#.... **##.*#...\ #. #\..\...\*.*..\.*.\*. ...# .. . . ..\..#*...#*...#.#*. ..\#. .## . ** ...* ... ..*.. ..*#.   .  *\... .....#..#.#...\  #...*.*  #
# *.**.*.*\.##.#. . .... .#...\ .\.......#.#.. ..... ..#.\.*.....* .....* # \#...#.*..\# ..# ..  **.. ...**#* .**.#**.#... \..*..#*.. .#. .# #..*. #.#
#.**.. .*.*.\...... ....   \**# ###...**#....*.##...*..#*   . .. ..\...... #  ... . ... .... ...#   ...*..#.... *** ....# ....#. .... . .....##*.##.\#
#\ *..#.\...   . .. .  #\ *.*........... .**.. ....#. .*....\ ..\..\.# .....# #*....#. . ... . ..\ . .. ..## #\. ..#.* . .. ........\. \. .\ #\. ....#
#.*....... ..#.**.#. .. . .\.. ....\.#...  #.....**. * * ......  ....... *\.. *#.. \##.*.##.. ................  \.#*...# ## *. .....  ...## ..**.\.*\#
##........ ...*..# .#*. .   ## \#*....  . .  ..** ...*.\*.#.#...*.... #.. ..# *.#*.##.*..  ...#*..#.*..#\.... .*.  #**. .. ...\ ..#*.##...#.  . *.. ##
#..  ...*.. .#*..   ...##. # ... .. #.**.. ....# .........*\...*** . ..  \ \.*. ..\.**....# #.\ ..\.... .....# ... . ... .##.#.\**. #....*.... ....###
##\.*... .#.*    *.*.. ..*  #. ..* ...\ .. ....#..... . .....#\*.. . ....#...\.\.* *.##...\*\  ..*. ...  *.#..**\.. #.\  .# #.#. .\  .*..*.....#. \. #
#.. .. ..* #.. ....##.. ... .*\ #.#... .. . ....#.\.  ...#. * .. . #. .\.*#. \.....#*..# ...# .*.*.. \.. .....\ . .*....\. ..\.....  .#. .#.*. ...#. #
#...*   ..#. ...*# .. . .. ....*\........\.. ... ...  .\.# . .*.*..#. ..*  #.*... .\\\ .. ..**. ....##*# .... \..*..**\. * .  .*. *...#  . .. ##...\ #
#...# .. .# * ..  #. # ....... *. .# .#. ... #..#....#. ...#*.#.*..... ..#.... #..*  . \.. .\.\  ***#..* *. .*... #... .#. ....**. .#..... . .#.*# ..#
#.\.*#..........  *  ......*. * . # ...#** #*..\.##\.*... *#...*...*..#... .......#\ ...# ...\. \.\..#. ....*#....*..... .#..\ ..#.\*..\.* #...*  *..#
#.. .. ...**..\*.. ....*.#....  ......*..#. * . .*..   .....*....\...# ...#.. .\.. #..\*.\ ...*. .#..\*.. .. . # .....*..#... .. .*..*.**\.... ...  .#
#*. . .. .....\*.. ..#.\. ...#.  .*...#*\.#. ..** *. ..#...... ..\...*.. #.........*........ #. #\ ....* .... . ....## ......... . . * \\*.\.*     *.#
#.   #. ..*..\..* #....#...  ..**#   # .  *....* ....\..***....*..... \... #. .....*.\  # .. . .*.....**#..... #  .#   * .. .. .* ...##\. \.## .... .#
#..*.#. .#** . . #. .   ... .*........# ...... ....#.  .##.*. ..*... ..\.*#.. .  #\ ..*\ .. **...*** .#..#\.*..*#.. .* ..  .. . ........*..# *#..... #
#.. ..\......\.#. ..*#.. .\*. ..*..... .. . * ...   ....# ...*...#.#*....* . .#.. .......#*.**. ...\.. #..#*.. ..*..   #.#.\..\#.....#*#.... .\. ... #
# ...##*.. *..\.#\ .......  \...*  ......**\*.# . ... . . #....* *......*...#.* ..# # .....\*. .*.. ..#....\  ... \#..  # ...\. .... .#. ... #. ..\# #
#.*.......**.......  #....#...*. .# .. #*.... ..    **.#.....\ * # .... .....*. . *.**##.  ...\\.\*.. . *... \.   ...#..\  ......# .. ..... \.\..#.\.#
#..*.*\  *.. *.. .. . *.*......#..*...#   #.. *..#*..*.  . ..#*# \  #.\ # ..#.. ..*... ..# ...##. **.\.....#*..#.....#\.....#  ...#\* .. * .#. ## \.##
#. .... .#....\...#..  *##     ....*#...##....*.... *.#...  \.. .. ... *... ....\ .*.*\.*.#..\.# . *..* # .. \ #.\.##*.#....#*..*...#.#.......\...  .#
#.# ..\   #....  .\\......* ..* ... .#*#..  .....#....*   \\#**.#  .\#. ....  .. \... .*. ..#..*... \....*.#\. . ..*..*.* ..#..#.#.. *  .. ... * .. ##
#*...*.. .#\... *.*## ...\#\.*.. .#.. .. .\\   .... ....#...*. *..*.*\...*.  . #...#..*.#. #.  . ...*. #  ##..  *   #......... .\###.#.*.   .*#.*. .##
#... .#....\..#. ... ..... \..  . ..# ... . ..  ..  ..#.. * .\.*\......#\..# ....#..* ...# . ..   .\\#..... .  *....*....#.#.. . *. ...*.\. .    ..*##
#* .# .#..\.# ...#. .*. *..*.#.#.. ....#...*..\...\...##..#\\*  .\.\..# ..* #......#  \...#  *.## .. * ... . #..  *.... ....  .  ........ #*. .......#
##.... .*.* ....  .* *##. .......\......\*. .\\ . ..*...*..... .#... .*. *.. .\\. .. # #.#.#. ..#... .#.. #...\ #... \*.#.....** ...# ..\.. \ ..##.* #
#\ #    .*.#..#.*... ..** .##.......*..  ........  * . . *..\. * * ..#. ..*.. ........... *..# .\ .*..\....  ....    .\.#  .**\...*...  #. .  .# . .*#
#.* \...#.*.\ .#.*.# . \ ##*#...  ** \. .. ..\. *\.# .*... . . #..  .\.\*..\...#.....*.. .#...#*#..\*..* .\... .....#.\   *........  . #.*#.#\.* . ..#
#. . .  ...#*#. .\.. . .. *. \\*# ...#. . .*. ..  . .. * . .#.. ......# .# . #.\ \.. ..*\ .. ............ ....#   .....*.\..#. ... .*#*...*..... * ..#
##.   . .#..  \. .#. ... ...*\.#... ..  .\.*..... * ..#...*.##  #.  **.........##..* .. .... \..#*.*....*.#* .*.\..#. ..*.# *.\. * #.\ *.*. #*...\. .#
#..\*.#   *...*. .. .\ ..... # . *\.... #. .**..*\**\ ##.... ..... .#  \*..\.#\ ..  .... .. . . .... ..\ . .... *#\.\. .# .. .  \#..\ .* *.#..*.. ...#
#\. . .   \.. ....*.........**#...... ... ... .. ..  ##..##...*\ ..\.........#.....*.......* . .##...#*... **... ...* ..  *..* #.    .#..*.#...*   # #
#.*....##.**......* #.**.\.  ...#.\.* *..... .. .... .#\..   ..#\  #. ..\  #...\## . ......*. ...... .*... .. ..# ..#...\#...  *. ........#.. . .... #
#. ... .##.*\#.*#. .#. . **\. .. .##*..#.**#*. .# . ...   .*. \\.. #...#*.. *..##*..*...     ...... .##....*....*... .# ##..  ..... * ....  .#.#  ...#
# .  . .##.*#..... ....*..#.. .*. .*...*..*.  .....*..#*.\..#..*# * ....#...#... *....#.*.*..\. ....\.#*.*..\.#...* **.  .. .*. ..#..... #.*...*....##
# ...#...\#... * \...*   ***\. \. #....#... ....*. #   .. ..#..*#.#...\#.\.. .. \#*\\ . #\ ...* ....*\  .. . . ..# ...#..... .. .*.#.....  .#.# . .  #
#.. .. . .. \. .#.. *.* ....*..#.. ....  .\.#\...... . **.*.\.** ..... . \   \ . # .\.. ...\.. \.*..... #.. ##.# ..* *.## .\.*\.#..**\#\.\\ ..... \. #
# ..*. * ....  #.. .. .... .. .* \* ** \. ..*..#..* .\...#..... ...#..  ...\...........*.......##.*.  ##.. ##\..  ..... ..*.\.*.*. .... .* ..  #*.*..#
#\#..#.\... #. ....  . # ..* ...#* .#. ...#  #. *... \...*...* ..\..*.. \#...*\......##.... .\..... ....\....#.  \.* #. **..*....# ..#  .. \*....*.. #
#.#. .  .* ....*..#.. .....##*#\*.*.##..#* ..  *#.#\  ..*..    . . . . .... .#*....... ...*..\#... * ...*........*.....  . #.\...*#.#\..#.\..**.#  . #
#... ...*...*... ..*\# **.# ...... ... ...#*.* *. #..# .....\.. . # .** *...#.. . .*\\#\... ..#.**### *.  # ... *....*.** .#....\    .** .. .#..#. #.#
#.  .*\ ... .*...#.....*..*.\..\....# *\#.*.#\.*  . .\ \.. .#. ...  .. . .*.....*.........# .... ... .  # .*##... ..  . \#  .##..#..#\ .. .*. #..*. .#
#.# \. . .. *#..\*.. .... *#.. **.#....#.#. ..*.. \......#  \.\.#..\..#. *..... ..# *.....# \.... ...  .#.*..# ..#.... . .*.#. ..... #. ... . ...*  .#
# ....#.... .*.. ...#........##.... \.#.# .##.*. ...........*..   * ...*\*. ... \...\..# . .**.....# .*...#...#..#... .#. .. . *  .  . *#.....#*.# .##
##...*# ...... . #*.......#.#.\.\..\....  *.. \# .#.\..#.... ... *.....##  .. ...*  #  .\*\.# #.#....#.# .\...#.*.# ##. # * **..... .. ..#*.#.**.....#
#...#.. .. \.. . ##  #..** . .\  .  . .. ....... #......** ..\...*# .*#... ...  .. #.... ...*   .\#.. * ....** #.....##.* .  ..\.*.. *...*.*.*...#.. #
#.\.**.. .# *.  .... \.#..... ..#.\.#.... *.... ...#.#.  .\.. #*.\.... . .  ..\....#.. .....*\... .*.. .......# \..  ..... .. .#. .......#...\... *.##
#.*.*.** . # .\# . *  #   ..  *. *.\ ...... ... ...#..#.. .......   .. ...  .*....\  .# ..\\ # *. ..*  ....*...  .. ....\*#..#.#... .*\.......*....#*#
#.#.\*.....#.   \#.* *. #.* .....#..#.... \# ... ..\..#....#**. ...#.* .#...\.  ..**.**\....#. . **.. .\ .*..*.**...*.#...* . ..  .\ ...# *#.. .#.. .#
#  *.\. .. .*.*#...* *...#  *..#* ...*.*# .... .. .*\..*#\..  ..#.....#.  *.*.. .#.. ... .#...#...\..*.  ** ..  # *. ...#. .. .# ....\..*.  .....#\ ##
##.##..*\.. **..#.#....# ..*.#... . .. .*#.....*\.. .#....*. .#\  *.... *.#.*   .. ...*.. \.. .. .... .*.... . #. \...\ .. #. *.***. . #....  . .  ..#
#... ##   .#.*.... ... #..#\.. ........*..    #.#\.... .#...\..\*...*  .........##....*.#.. #\...  *. #... ..\.** .\.  ..*.*.* ..  #.#...*..\.*......#
#.* #\... .* . #.  .#.....##...... ....\.#..\ ...#  ..*#..  .\ .#.**. # .#.#*..\.*...*..#........*......# .....  ...... . .\..\......#*....*.... ....#
#..\# #  ..... ...# . .#*. ...* *. ..\#..*... ......#. ..#\......\. .#.....###\**#...##..#......**....*.*...**. ......#.**. .....  *\.#.**#.\  .. . .#
#. .. .*.#..*......#..... ....# .*..**  \.# .*..... ..* #. .....\ . *\... .\....... . #.#..\*.#..   ...*. \. ..*...*.#..#..... #.\  \......*........\#
#.*..... ..##* ..  #..\ #.#....#...\*..*.. .. . .\....# ............ *. .#..... .#..*  ..... .. ..........  #. ..  *.   ...#*. *.. .. . .  .* .....  #
#.. .\*\\..\ ..*......* #.........*...*.* *...   .#.....#. #*. .*##.#...... .* .... .#..\..  *.* ..*.\....\....\..#...##* ..... #.#.#.. .  \... . ..##
#....#.. .# ..*.##.  ..\... . ...*..# ...*..\. #\ . *\\*##.. .   *.*.\.... *\*...\*...*  .... . .***. .\*.#*. #\   #. \ . *.... .*...\.* .*#.*.  ..*.#
#.##   .*.#.#* \..#.. .*... ..#*....\.. ........#.\# ..*.. ..*.. .. .... ...#*.*\.....**..**.......*#  ...........\*.* #  .\ . .. *. *.. #. .\*  .\..#
#  ..*........ . .... . #.. *#.. .. ........... ..**......... ...#.*....# ..   \#... ........#... ... . ...#...*. .......#\.. ... .*. .. .**....... .#
#..\. \\..# .. .  .. . ..*  ..#. . ..\..# ..... ... ....\.*###... ..... ..*..\..#.##..*....#...\.#.\...#.. ... ...\... ...*\#.\...#.#....*..*   ...#.#
# .#*#.**. ..*.. #... ...##* # \..*  #*.. . \..\ ....   .*...  ... ..*#. ....*... ...*. . ..*.....#. *. ..#........#\ .* *.  ..#... . . *#.. .#. .  .#
##.....# ..# \ #..#.\ .. *.#.#.\. .. *.* # .....\ .  * .  . *...*..* ..\.  \  **.....*..#.......\   #.  ...** *. .\.*#......  ..\ ...#. ..  ...*. . .#
#*. .  .#*..\ .##  .........### .\......#....\.. . .*\. \.# ....  *....\..#..  ....  .. ... ...... .#.. \* *..*\...##.#* .. .#..#\ ....  ....... . ..#
######################################################################################################################################################