###########L##########################################################################################################################################
#..\.. .*#*.# .\.... .. ....#. . ..... . *....\..*.#..#  . #.  .\....#. .#.* ...\.** *..***.  * #.....*..## # ....*.#..*.#....... \...\.*.  .#....\..#
##..... ..*  *.\*.\  ..* .. ...#.. #. *. \.\#..#* .. .  ..\. ..# *.. \\*. ..##....#*.\*\.\.  ....*.#.# . .\   . .#.  . .. #. ..\ ..*.# \.     .  ....#
#\... ...**\ #\.....#\...#*\. *.* ...*. ..  ........ .. ..#*#... ...#.*# ..** .... #  ..#. .....*#...*..* .... .*.. .#\.\.... \#*.*....*...  ..##....#
# .# ....#..\.\\\  .  .*.  .* ##..*  .\..*..*. #\** ...#.\. ..*...#..*. .#.\# *   ..#.*...... .. \.....  *....\  ...#*..* **#.**#....\.*....\. ...#. #
# .# *. ..* #..#*#.. . *. ..*..#...... ...... .... # ..# .  . \*\..#. .\.#..\. ... . ... ...... .*  \#...##..#.. #..  .. .... \..#.#\\#.. .*.*.  #.#.#
#..\. ... .\ # ..\..#\ ..   .    .# ..... .......*. \ ..*...*......\.*.\..... .. ...\ ..... #. *...#....*....*#.. #*##...*.# ..#* ... ..\.. . ..#. .\#
#.#. ...\........\...#*#  .\.\.***.  *....\...# *... .\  ....*. ..#.\.. .. . . *...#*\.#*. .. ..##...  .\. \...   *\..... ... #.....#.....  ...*...  #
#. ....... .....\#..  ....  ... ..\.#. . ......* *     *......**.. .. .. . .# . .#.*....*#. ....  ...#..#.#* *. . *# *#.#.. ..#*...*.  ..*.*##.\. ...#
#*...\\ . *.. \ *...*.#*.......\...  . #.*..#... .......*#..\.#  .\......#.\.*\...  ...#.    . ***# .......## .  . .  ....* ..*....* *....#\.....* #.#
## # ..# ......   *...\**.*.*.. ##*..... .... .....\...#...#.. .#.#.*  . # ###. .\ .. ..  ....\..  ...\*\...#.. .*#.. *.#. . ... .\..... . .#.\*. .*.#
# .\ \.....*..  ..*.* ... . .\....#*  ...#.\.#.##.\  \*.. # ..*\.***.  #.#.# .. #.  .#  . *. .#.*.*. * \...  .. ..#....\#...  *.#. #.. ...* *.*#. ...#
#........*..### \..* .*.# ...** *.... ....*#.....   #. ..# ... .. .\.*.  \\.#.... #. ** \..##...# ...*  ...## .##..   ....*...*.. .\.. #......*\.*.\.#
# .  \.\*..**. .. #..*..*....  ..*..##*\...##.*.\.\..  ... ..*.*#. ..   ....... #... *..*.. . .......*..* ..#.* #*. .. # \ ...*...*... .#..# \ ....#*#
##...*#.....\.* .*...   ..**\..\  .\* #. .. \...\***.  ..... ..#*...* .....#..#.. ..... .*.  . ... *  *... ..* . .*** .. ...*#*..  . \..#.... .......#
# ...*#.#.\.#. ##...#*. ..\.*...   .#*. #. .. **#....*    . *.. ...##. *...#..\...*...#..*\.... ..... ... ....... \.*.*.#.\.\#....... . . . ***. ...*#
##*..*#  .   .. .  *  . *. *.*\.#.... ..  ...#.*.\....#... ....#.*  #  ...#.# *. ..\.... .   .#..\\ ..  .... \...*  ...... .  .  # ....*.#. #....... #
#..... *..\## \#.*\...###..   ......  ..# .....*#.   .  .*#*.. .. ..*.  .. ..*. ..#..#...........   ..\... *#.\ ....   #..##.....#.. ...\# ..*. .....#
#...#...#.. *.... .\ . *..#.... .* ....*.  ..... .. .  *..*. .#......\..   ... .. .......* #..   ... *...*#........* . *#. \  ....*.# . # . ***.#....#
#...#. ...\.#........*#... *#..#\...... ....... # #*..#.......#.  .\.  .#.... .\.\... *..  .  ..*...  .....#.....#\ ......#.   .#  ****.*.. .*#.  \#\#
#.# ..**..**\   ..#  . .. .#. . . ...**. * \.....#*  .... * \*... * #\ *. . \.... #.## *.* \#  .. . ..*. .......*.# .#.... .....# *. .  ...\... *....#
#.***..#...\...*#.\#\ *#.*..*.. ...* #...#.## *.\..#.*. .....#. *.. . .#. #\   ..... ..#..  .# .*..# .*. .. ...#..#.  ...\\..#.*.#..*.*  ..  .#\  ..##
#..........\*..#. ..*........\##\...#. ....##  #....# . *..* .. . #.\ .  #   #..\..\......*#. .#.\ #....*...\#\   .... #..#. ...#*.   *. **## ... ..\#
#.. .#* . ..  #    *..#..... . ... .. .. ... ....  ..#.. . ** .\*.. .#. .. ..*. *..\*.** .. .  #.... ....#.* .   *..\#...*... .  . .. \..**. . ..#.*.#
#*....   . .......* ..** ....#\.#  .. .#*.........\....*.\.\ #*.. .**.##*. ..*#.# .#\...#.*.......#\. ..#. . *. \...  \ #..*\.... ...\... #.. .  . \ #
#..\.\*##......#*\.\...#*#. .. .  ......# .....  . .* ... #. #....  .*..\.#\.\.*#..  ... *....*#.* ...... # ..  ...\   .....#\.* ....#.. .....*......#
#.* \.*.. ..#**.\.. .   #....*..#* ......* ..** \\..#*.. ....*\. **#.*\ #*...#... ..  .  **.##.. . ..#.  .#. . ... ..... .##.. \....*.*\. . ..*....#.#
#...\..  ....\.\\ .. *..#.* ..#.#.#. . \\\ .#... #... #* *....* *#..*.... ..# ..*.\#.#. ........#..*.......**## . .....*.*..\* ..*.... ...\*.........#
## ....*...* ##   *.. ..**#..*. . . # .#.## *..**  .... .*... ........* . \.. \... .##. ..*#.*.  \ \..... #  ...*.......... .... ..#  * .\. #.# ..#.*#
#...... .*...... *...\\.\. .#......#\\..# .* \.. * ..... #.\**. ...*   .... ..*  .   .# ##.#... ...# .  ....\..#...#.....#....*##........*# ..*.#...*#
#.#.*..... .#.. .... .  ..... ..........  .........#. . ...\.. .... .. .. ..........  ..\ ##.*\.....# *  .*... .*.##.... ..... ..*.#\ **#*#...*... ..#
# .... .#....## .. #*#..*.#* . #.#. *.#.*. ...#.. .............*\*#. .  ...#..#.\* *........#...**\#.\.  #\....##* ..# * ...#..#. *.*.#\.. *.. .#*..*#
#..\.... . ...*... *... .*... . . #.#*.. *...#.#.\..*.  .##.#\... *.. .. ...* ....*. .**.. \*.. .... **.\.   .... ..#\ .##\. #..\ ..  .. . .....#... #
#*..\......\...*#*... ...#.   *..#*....\ ...#*\. * .*.\.*  ...## .... #.*\...* .*\..#.*#.*... .\........ \....*.*..* ..# ....... .  .. .*....#  \....#
#*#.  .. ..\ .* .#.*...... \.\.   # .# ...  ....*.... \.#*.  .. ..... #.... #..... .. \..*. ...#.\.....#.*.. .. * ...#  ..#....*.#.\. . # .. .... .. #
#....## .*.. . .. \....*\..#\..#.#.#. .... .\ #. ..#.# .... .#*.#* .....\*\##.*#* .. \.#.#. ....#.  *. .*.....* #....  ..\. #\. ..#* \. . ....###\.*.#
##... #.  . .*......... .#.... ... ...# . .  #....  ......\..* .  \.* .....*.....#* ..\... . .....   .....**...\.#....*.*# . .* ....#.. . *. \...\...#
# ... .#.**..*#* #.#.*.. ..*.*. . .. ...*. *....*. . . .. ...##...  ..*#...\#. *....#.*\\.\\...*... ...... .# . ..  .. .......*.*.*..... .#...#*..#*.#
# . . .#.**..*..*..... *.#*.#..*  .*.. .#....* *.#......*.......\..   .#\. .*.*  .\... *.  .   ....\# ....\ *##.... \...*.. # .\*\.*... #\. \.. .#.. #
## ..** .  .*#..\. . ...*  *.# . ..# .##..#... .#*...**. .........*.#\#........#.***\... .#.# ..\** ..  ##  *.#*.. ...*.*..... # . *....  . #   .*  .#
#..# #.\.*# ..*..\..\.**...*#*....#... \.* ... \ .##... ..*..\.#.....*.*#.\. .#.. *#... *.*.# ..... \.....*.  \..##.*  *.*.#..........#...\ . *. ..  #
#. .\ . ......#... ##... #*  **** .. ##.*... ##. . ...*. *. .. . . ...*#  .#....  ....... *..  \...#*...\......**..\.. ..***...\# .#.....**##.#. * ..#
#...* .#..#.*...... . . .... \... *.. *.. .*.. \.*.... ......   . # . \#......#.##. #.  ...\.. *.#...*... . ......#*   #.. *# . .*\#.*#.\**.#.. *.#..#
#* ....# ..\\ *.***... #.. .....*...\.. .\.. ..  .....####...*.*....#.... ..#. ..... ..... #. . ... .#.... ......* .... ..#.....#. .....*.... .. \...#
# ....\#. ...\.\ *..*\ \*..*..*.## .. ... . .*. *..  .  #*....\.##....#.....\....#*#..* ....* #*#.*\ \.*  .\. ..*.... #**....#*  ..** ..*...#.......##
#.  # .\...*#.# #....#*#..   .......... .. .\  .#..# . . . . . .#.. ..\#.  ...**..  \** ........ .... ..#..**....#*.. ... . ..*.* .\ \...*#*.#\... ..#
#\. .#....# #.\*....*.#.*. ... .#.\ . \...## ..... ..#.\. ..\....*.**. .. ..*###..  ... .. ... \. .... . ..#.. ** \# .. .*#\...  .....#...#. *.*  .#.#
#.#\\*.*.#.\*..#*...*..*....  . ..* # *.*...#\#..#.....\..* .  *.*..#..* #.\.. .*...* .\..#.#..#.#....  # .  ##. .   .*....* \..#.#\. ..* # .\ ..#...#
#... . . .#  . .*......... ##.# . .\.. ..#  #. #....\ .\.*.#   .....*... . .......  .##.   #.* #*..\  ##.#.*.\.*\\\ .  ... ....* . ..  .. ..*\...## .#
#\....#...* #..  .  ... .*..... #.. .*# ..#***... #.\.##.... \. ...  # ..#. ....*..*\..#  .#.. **.*.#..  #\  ..#. ...#..#  \ ... ..\.*\... .\....*.#.#
# ..*. # . . . ..*.\*.#..#...#..\\. #*..#. *\#. .*....*. .\.*  .\. .#......  \.. . ..\.*#.\ ..*........*....  \\. \*... .*.. ....*..\#...\.. \... *..#
##  ...#   # .. .##.. .**#.... #*. ...\*. ........*..# .*... ....\. ... .   .#...#  .##... #.....*  #. ... ....*.##.. ..*#... ...#.#\ ... .... .*# ..#
#.*# .#....#. \ *... *\ ##....#..   ......*...**... \...  .*..#.\ #.#.     ... ....# ...#...... #..  ..  #*#*.* ..... \*.#.#. . \\..... ..\# . * #...#
# .. .#...#.\... ... ..... *.#..* .. #*.. ... ...*..... *...*....\### .... ..*. *\#. *..  . . ..\ .*.*...*.. ... *  .. # ...#.. ...\\.. ...  *  .\...#
#*...\  ..#..***#... ..#. \.. .... ....\\ .......# .#.. #..*..*..*# #\  ..#\..#. .*..*....#... #*.* #.#. .*...* .. .#..##  . ...*\......#.*\ ...\#.* #
#*#.. .... .* .#.* ...*.... *.. ......... ...## .###. .... ... .........#......#*..**  ..\...*. .#.#*.. * **.\...*.\...\\*#\.#.*. .. .\.... .. ...*.*#
#\.... .....#.#.. .... . *.*...  ##..* . * . #.\....# #... . \\.. *    .#.##.#. ..* .\.....* #...*#....#.#.. ..\..* \*...#......*..\..*.*#*.*# ... *.#
#.*.\...#... ...##.\.*#... .*..* ...  \ .....#.#*...#*.##. .#. .*.#....... .# .. #.....  ## #\......  *.*..*... #..*.**..\   . ..... .. .. . ..\.....#
#.*\ . ..# ..\.\..... .##  .###. .*.*.. \.....*...# .. **....##..* ....#* .  .\*.\. ..* \# ....\.. .......  ...*.#... .. .#    ...... ..**..\ . *..  #
#* *##...*..#\.*....\\ *. ...*..... #...\.*\ *... *..*\\...# .\..   \.#.*......  ...\ \*.**#.#...... . ....##...... #...#. .**. ... ...*.*. ......##*#
##*....*. # . . ....#.. *#*.# #. .. . .. .. * ....  ..#.*. ..**...#....#......... .\.*.*..#.# ..... .\*.*......*... *..\*..#  ..#.\. ..\.**  #.\#.* .#
#. .. ....**.\\.. ......  ...#.  .*#..* ....\*#.. *..#*\..#... ...* ... .. . ...#..*..*.#..\.... ...\ \#.* ....*.\..  ***##..##\....  ..*. \.\.*.*...#
#.* #......* . .#...........#.\  ..#...#.\*. .#*..# \.#. ... ..*.**.......\...*#.*.#.. \**.*.. .. . ... . . ###.#.#...#. .... .#. ..\...  ....*#. .\ #
#.....* *...... . ..   .#..  #. .*.. ..... .... ...\.. .   .... ....... \.. ... *..#.#*...*#. .\** .*.*..#*.#....#.#.....  .....#..#*..... *..*... ..#
##\#....  ... ....#...#.............  ...\.. ...* ..   *#\... *\.. .*. **  ..***..##..*....#...... . . ..*.#..#\#.*... . ...  *.\.#.....\...  .... *.#
# .\. .. *\\....  ...#.....*...*.. #..**....\.. .*...  .....\. .  *.#.*..  .*..\*... .. ...#.#...#.\....\ .... #.#.. #.*.*\.*..#..\...... ...... .   #
# ..\\.*#.#*......\*..#  *.*....**..*...## ........... . #. ......#.*.. .......#.. # #..*#...#..  .  ..#. .##....* . . .\ .\..... ....#.. . .........#
# *... ....*....\..#...###.*.. *...*.... #.#* #.  .*#**...*.*.*..\\#  .##.. .\*\.... ...*.\.#.  ..#..* .*. ... *\\ *.. \\ *...\\.... .\. * .. * ..#*.#
#.#.\*... *#... .*.......#......# ..#.....#...*.# .*#..  .#... .*..   *..*..*.**....  ..\.* ..* ..\  ##.. . ..  #......*. #... * ... \...# . \. #\ ..#
#...* ... ..*..* .... ...... ....\.#..\.#..... .. \.... .*\#.#. \.\....\..*......# *.......#*... # #.......*... ..#..  *. *..* ... .....#..#.\.# .# .#
# . .\# .* .\.*#\ * ...#..  ..*..\.. .*...#  .. .  # *.... ....# .. .#.**..#**.##.*. .*. ...#. .\.   *. .....*.#\..* ...#.#. . ....# ..\..\#. *#...#.#
## #  . ... .#*..#.  ..#.\#..\........... *.... .*\..*. #\.##.... *#...  .. .*... .  . . ... ....*.  #.. .. #\  .#..*. # #. *** .**.*..  ..##*..  .. #
#*.#......  *\ .. . .  .*.\..#..# ... ....... ...#\.*..# . .\* #. *\.. ......#*....## ....*..  ...#.. ... *....#.......... *##*\##..*#. #* . ..\.##*\#
#....\...... ......   *. ..**  .*...#. #  ..... .....\#....* .* .......#.\#.. .. ...*\#... #. .. .#..  ##.\.  .\ .\*..\*....*.#..*....* .* . ..#.#...#
# ..#* .#... ....*.* *..*\.*..##..#.*.##.###.*#.. ..*.. . .. \#..*....\#*. . *#.. ..\..** ..*##\*###.#..*. ... . *#. .**. *. \ *.*....#  ..... ...  .#
# #. ...\.  ...  \ . ... ..##.*#.*..*. .#..*. ....* *. .#....*#.. .#..... ...*  #.   #.\.......#..*.... ...  ....*#  .*.. *##...*.#..... ...  .* #..*#
#..**..#. ... #* . #\#. .....#...*..*...*\.... ...    ......*# #.#* .*... ... .\......#..* .......#...*\.........* .. #. .*. #..\.......* . .. .... \#
# #\.  .# .. *. #.........*#*.*.* .. .....\... . *.*  ........ **..#... ....*##.\.....#. .*** # .# .. ...#* *\.    *. ....  #..#......*.* .*..\ #...*#
# ... \ . #.#...*......#..\   .  ## ......**\#.*.....#   *   . ...*. ..*. .. .# *. .\...*.......... .....*..\.#..##.   ...#. ...............*#*..... #
#\. * ... \ .... .... . . .......*...* *#. ..*#*. # ...\ ...  ... . ..#.*. #. . ....* ..* \   \ ... .    #..*.\ ..*.... ....#.#. . .. ..*... \. .  ..#
#...\ . \\..  # ...##.. *..*...\...  ..  ..#...#. #.#....#* . . #..#...#.... ..*.. .*..........\ # .#*# ...#     ......#. ........ .\....  . #...\*..#
## \...***.. .. #........ .\...\.**..*\.. ..... #*.. . #..*#*...\.*\.\. ... . #..... ....  .... *#.  ..*\.** ..* #*.* .....*#.  *#  \.. *   .*...... #
#.*#..\*.*.# \*.. *..\.#\..\#\..*....\.\  .. .#*.  . ..  . ....*\#..* *.... .* ..*....\.##.*...#.*.....# \...*.*#.. ......\*#.*  .  *.. .. #.\  . . *#
###.... ..*. ..*.....**.#*.. *\  *\ .# ....* #. *.*.. ...\ ..#\.*. .. . #*#  \ . ......\.\.*\..\ **.. .*..\..* ...\ ..# ... * . ......#.*.# * .... .##
#...#.#. ......  .\.* \#....**..* ...\*\.... #...*  #*..  .*.\ .*.. ... .* .\#\...# .   ...  .....*.#.\#\.. .# #... ..\#....#.... .... ...........*..#
#..*\.*. ... ..*. .**...*#*..... . *...\#...*...# ..\...*. .. .*#...* .#.#.... ..\. .*# .. *..... ...... ....\.*. \ . ...\#..\ ..*. . ...... .* #*\. #
#.\..*.....\\ .*...\. #.#. . # ##..\ \.*  *. .... .. .. ....... #**.#.*..\..*... \**..#*. ....*\#..*# ...#. .. .... ....*# ##..#...#.. \ . .......*..#
# *\ ..... . #. .. ...\.. \ . #. \ .#\.#\*..... .*##....  #.*.. . .* .   #  *..\#.#*#* .*  #  ......##..*..*#*....* ....*. .. . ....  .##\ .\...#. ..#
#.* # #..  \*#* #*. *.  .* .*. . .\ # .\.*...............*..*#.\......#.... ..*#.....#.#  #.### . ..\.#.#*....*\  .*\\.*.   .......\..#..**#....#.. .#
#\..*..  #.. ..*\ .* ........#.. ..*. .. .#  #.....*.......\ ... *. .# .... ...#. .#.... \...*#.. ... ...*.....*#.\....... .....  ... \*. ....# .#. .#
##..\ .. .. ...#\.#  ......#\. *....*.#\. ....#* .#.*.\\# .## .*.*.  ..  .....*....##*. # ..........#...*...\ .**.\. #..*. .. .......\....*#   . ... #
#...\ .\ . ... *.# .\.. .#.*.#. \*..... .....*# .... .. *... . .... .\ . . #...#\... .....#\.. .... \..\.. *..\*\ #.* *# . ... ......*....\.# ...*.  #
#*.\**.*... #.#..* *.*.*.....#.....*\.#...  ...#....... .. .. ..*.*.. #\.**#*#...#...#..\..#. .** ..*.#.* .  ...#.#..# .\ .. .. ..*.........*..* ....#
#...**..  .*  ..#*.\#.......  *...*#.. *\ #.  *.*...#.. ....... *.... ..*  .*..##.  ..  .. .\\ ... .*....#*#  . .......#...*..\##. ##. ..  .....\....#
#... ......*#.. **..#\ *.#. . .......... *.  .***.** . .*....**..\..#..* #...#\.*.*. ..*\....*#. . .\....#...#. . #..#*....*.. .#*..... ..##...* ....#
##.\#.\ #.....**###  .\ ...\..\. . .. .*\.....  ..#..  . . ##.. ...#.**.  ....#..# #... ...*\... ....  ...**.*#..\ ..... .. \.*.... .. *.#\..\. # .#*#
#**.......#*\......## #*.... .. ....# .... ... . \... ... .\. # .......\......*  .\ .  ... .*.. ......*...*  .....#. ....*............. #.#.\.. \... #
#..  *..*. .*   *..... ...... .. .\#..\ .#... #.... .#.# .  ..# # .#*#####.#......#\ \..#.#.\#.*\*.*...*.*##.. ..*  .* #...  #*.* ... .......*. .*..##
#. * . ..........*# .   *.  . #..*. \**##*...#... .\.. #*# .. .. #..#.\.* .\.\ ....   .*..*#... \...#. *.* ..*#...  .*......   .#   \*.  *.. *..* *..#
#*.#.** # ..#. . \ ....* .*. ..#....*\* . .#  ......#. ..*.*\... .*.*... **. \ ..\ ......  *.#. .  *.....  .. . \ .*...\. . .*\... .**#.#. # ..  ....#
#*#.*.. \. \ ...#.*....\\  .....# ... ...**.... ..*.# . *.\ #. *. . . ..\* .. .... . .. #..#  .#....... .........*.* * ... .*#*..**# ..## #...* *#...#
#.. .* ....*.*  ...#... .. ...*#*.... .........\.  .##*..\.*.....* ...*...#\......*..# . . .   \.* ....##...#**... .* **.  .**. . .# .. #\.  . ##..# #
#. ..* *......  .....#..  #..............*........\.#.. .*\.. ............ *# .. .*.... #*. ... *\.. ....*...*.. .... ..##..   ..\\ .#. ..\ .\..*#.. #
#..... ....*.\# . ..*. ... #. ..#* .. .*. ..*# #**.....#.. .## ...# #.\ ..  *. \..* ## \. ..\.. *....*#....*.. *  #.  *..*.. ....... *.#...\##.. ..  #
##. . . .**........  ..\.... ...##.*.............. .#. . ..#.*.# ......#. ...*. #. \  .#........ . .#\..\....* .  .* .\  .  ....... . #\......*...** #
#. .*. ........ . .... #*.**. ...**\*.. *... *. .. . .. #.##*... ..#....... \..#...* . ... ..... .... ..*#*...#. *.*..# .\.# \.#. .*#........  ..#. .#
#.*.. ....#*.#*. ...\... ......*.* ...\ .*##.. *.*........*....  # *. .#... . ..... #. *.*...*.. .. .\ ..\#....#... ..*#.    .*... ... ...** ..*.....#
##.# . .... ........*.. ..#.**.  # ...#.\.*#..\...\..\\..\.. ..*\....#  .*.  ....#\  #.*..............#... \ ....*#.....#*.*... .*  **......## . #..\#
#  # .#.\*# ##... .....##.. ...**.#. \# #.*\#* ... ..  ... .. .#. ...# .\.. ....#.#...*.....*.#..*..\.# *. ..*.. .\.** . *.... #*#.. ...# ..# *...  .#
##..#. . . #.\. ....# #..\..... #.#..\* .* . .  ..#.** *. ......#. #.  #....\...#..*\.. .. .# ..\.\.... #*.**#.. #.. ... .# ..... ......\...#.#......#
#.. *. .*.   \\ ..#. .\ ...........*......#.  .. . ...# .... ..##.... .#.... \ .#... .* \*.. ........#.#*..*.#.* .. ........#*.#....#..*. *..#..\...\#
## .\ ....#..\. .  .#...*..... *#..#*\##.......    ... *....* ... *\.. .....\  \ .#..*  ...#.#..*# .#.#.\...... .* *\......#*.....  .*.#....*... *..##
#..#.### \#...\.*.#.* # .. ..*..*...**...\..... ...*..  ..*.. * ... *.... . #.#.. .##  . .\...\.... ..*#.....*.#..# ..*.\...\. # .***#..\.  ## ###..*#
# .#.*.  \ # * ...#.... ... .*. . .. #.#...*...* *\**.... *.*#\..*. .#..\ ...   ..... .. # .... #.*\....#.#.\..  *.*  .R*\..*.#..*...*..#* .....*#. \#
#.* .......\ # ...#. * * .*.*. .. . *... . .. \.... *. #.. ... ...\\.  .\.# *. ..\..* #.....#.  *..#.*.\.*.\.* . . #..... #. .*. ..\. ....*.. .. ....#
#.... \.#.\*\.\ ....*.  ... *... . *. ..#.  ..#.............. .#... .***\ *  *...\ #....#* . ..  .  #.. ..#.\..#... #*.#. .. ...#. . #..*.#..#\ #.\ .#
#  ... . ...*. .... . . ......#*....  ....\ * #.\.\ .*\...# .#. *. .\ #...  \  ..... *#.#..... .  ...*...# . . .#*... ...*  ...\. .... #*.#.....\.** #
#..\*.. .*..##.* .*...#.... . ...\.. .  .*... ..* .#.* . . ..#.**...* #...\............... ...\ ..... .\\\.   .#*.\# . ..   \  * ...*#... *.......# ##
# ..*#.. ... .  ..\.*.  *.. . *\ .*....**.*......* .*\ .#.*...... . \*  ..........  \...# . ..#.*..#*.  #.  . .. .\..##....* ..\. ..\.... #..\. . . .#
#....\ .* ..***.. . #.# #....\ .. #...  .*..\...  .*..*  ...... ....#...#......*........    ..\..\.. \..#**.*  .......# .*.... \#\*..*.##.. .*.... **#
#**....*. ..  ** .. . ..#.. #.*...* *......**\.*... .#.*..*  .\ .. *. .. ..\# . ..  ##....#*.  ..  *#.\\ \......*.*. .#...** ...*\... \...  .#..# \. #
##  .....* ..\ .\\\   .. \##.. .  ..... .#.*. * ..* . .#.\  .**.*.\ ** *#* #..\**.. *... #*......* ..*.#.**.....#.. .... . .##.* \............. .**\.#
#\. ... .*.* #* ** \.#*....*\... \.. ...\*###*.......*\....**.# .#...  \#..**.##........*..*#......... . . ...*. .#...  ....#..#*..#..#\..#.#..* ... #
##.*..#.. ........*  ..  .*#...  *.#*.*..*...... ...  .#*#..*... .*.*.\.* *... *.**\. #.# . ... \. # .#.*....#.*.#**.#*... .....\*......*  ...  #...*#
#. .\.*  . \...#.. .. .. .#. \.*. *#.#.... *...#  .#..\  .   .# .#...   .# ....#.**.* .*#... *#**.#. #\.......*.# ...#... .* . ..#.*# .. ..\.... #.. #
##..   \.  ..\. ...* *\#.*.\..*#..**#..*. ..*  #.. ##*.**.......\..\*\  . ..#... ...# \.#.*.. ........ ..#  .* . .*.## ....  ....... .. #  #...#  #..#
#.....#....... #........#. .. .****#..*.##. .*.#*. . ..#.....# ...* ..... ........*.. # #...##.*#.*..#.......*.* #.#.. .....* *. *...# .# ...\..*..*.#
##. .#.....#......\**\......*.\#.\...  .....  ...*#.# . ....*..#*.......  .# *  *. .......*..... ....... #.*... \ #.\.. .....\ .#..*.*.....*..##.\.  #
#\\. ... #.*.. #..\ #  # .##* .\\#. .#. .. .... *. . .##\.\.*..... . #...# .# ..* #...\...  \\.  *. . .. . *... ..*# ..#.# \. ....  ...  ........#.\.#
#..... .. ...  ... .#.... . . *. . .. ........\.   ..#........  . #.\... * .**   .... .* ...\*......*.... ... .#. .\.*  .. ....\... *...* ..#. .#..**#
#.. ..\. .# . . . \. #..*....# .#....... \#*.** .#....##.##..# . ...\. .*..* .  *.\..# .  *. #.* ...*#.. .##.#.##*.. ##..... \.....**\*..   *. ......#
#..#.\..* ..\**.*.*... .\*#  * .\.. ...#. #. # #.*..##..#. ......#. * \..#.....*.#..*. .*\.  ...#...# ..*.....#.#* . . ..... . . *. ..........***...*#
#.**# ..... ##   *. #.....  .*....  ..#.. .* ... ..* .** ## #*  \\. ..\..\..   .  \# ......    ... .... .....#.\*.....\ . .. .  ...#* ..*....*.#*....#
#.*..#...  ...#..*..\. *  . **\.....*.##  .*\...\.   .*...  ...*\.*.\\.#....##\\\*\#*..* . . # .  \  ....#.. ...... *.  ..#  .## . .......##\. * .#..#
#*. *.#.*   . *.... .#\ .* .. .#.##......* .#.#\ .. # #.....  .#. ..*.....*# . ...* ...*.#..  .*.#.*..#...  ..*\.*....\...*\..*.  .\. #....*\  ...# \#
# # ..\*......** ...*.# .\.. .... . ...  ..\ # .*.# # # ....*.... *..\. ......# .. #..#.. ##.#.#\#..* . .... .#. ... .. *. .....  ...*..#..##**..*. .#
#..#...\. .#..  *...#..  #.. . ...#..#\.#.#.#.....\.......\.    *.#*.....#...#. .*.  ..*...**#.... .#...   .  . ..  ##*.... \.*....* ...\.#... .* .. #
# .... .. # *..\*.*......##. ..#.#.*... ....    ....\.\\...# ...* .. .. ...#\\. . *...#  *....*.. ..   . ...#.....\ ...  ..*.. .#. .. * \.. ###.  . .#
#......*. ... *.. . . .*.#.....*....... . #..... .....**.#### .....#.....**..#.. ..*  .  ...  ..\\.*..*. ..   .\ \.*. ......#. .#* *. ..\.. ......* .#
#*#\.....*.**.#....... ...... ...** ..#..#.. *# ##. ......#......*  ...##.*#**.**.....# *# .\...#... #.# .......... #. .... . . . #..... ..#..#.  ...#
#..*. *. #. # .# #.#*.... ..*. .#..# . ..*..  .......*......   .. ........#  *. *   .... . . #.... ..\. . ..*  . .....*... .... ...... ....\*.#*.* ..#
#..   ..#. ...*.. .    ..*.. . ... # .......\ .* . **....**#*..\.*..* *. * . .... ..#.#*.##.*...... . #..*..\.*.#* *.\. .......##. *.. .#*...... .#..#
# *# ...#....#\.......  \* \.*  **...  \..#.*.*. .#.#. .  .... .\  \..*......#....#.\* ##. #. #*\**.. ..* .... ....##*.\*.. .* ....  .*.#...\.. #....#
# #...**. .*.*.. *#.#.. . ........... ...\... ..* ***...\  *   .#...... .. ....*.... . ... ... #\. ..\.......*#  * ....  # .. .......  #*... *.#.#  .#
# .\.. *\... ..#..#..* ..*...... #... . . #*..*... .*.# ...  ...*....#. .\....#.  #*  .\#..**#....\#...*..\..*.*.\. #......\.. .. ..# . ...####\\... #
# .**...#*#..\  .##*....# . .* ...#  .#.. ..*...#  . ..*\....##..# .*.\ \\..*#... .#.  .# .. . .#... *....**  \#.. \. ....\.... ...*..\....#..  .*\# #
#.. ....*. ..   .*... *#.. . \#. . . \# . .#.*. #.*. ... *. . \.* . #..#**...#..#..*.#... ##*.... . .. * .\**..  *..  \\.* . .*.. ##**..# ...   ..#.##
#......#  .. .# *.#\# #.....** ....#. ..\... .#.*\. \ # .#.. .....\\.#.#.\#.. **.....***..  ..#.....  #  ..#.# . *\. ............*..* .*.\..*.\. ....#
#.#.#\...#..... ..\ ..   . .* ...#*.  *\....#. ........ . #.*..\#. ...**      ..*.#.  *... .# ##*. .* . .. ....... \..*.# ..*..\ #...###......#. *#  #
######################################################################################################################################################