###############L######################################################################################################################################
#... .##....##*.. .....# \... \...#\\.#\ *#.*... \*.....*#... ... .*..*. . *.*  ... ..*..##.#..#  ...*....\\..  .#..*. ........#*.\*. .#.#... ..\. .*#
#.. #.*.*..*...\ .....*..   ...#\# ....  .#    \**##...  . \.*#...#\... . **.\#..#....\\.*  *...*... .#. *..\\.*.. \. ....#.\.\ .*  * ..\ * . #*...#.#
##.......#\..*.. *. ..*....#.#..#... *\*.. . ..*.......*.....*. #.*.*... .....  ..\ #......*..  #. .#.*#.*#.#... .. ..... ...*.*..\#.. . .#.\.. ..#.*#
#. # . ##\ ......* #. .*.\..* ....* ....\.*.*#.*..*.    #.# *#.  ..**.#*.. ...... *\   ...*.  . ...# * ..*  \......# #.*.. ..# .# .*.#. \..  ...... .#
#.*...#.... ...#.. #..#.*\* . .....* .#..#.. .\ ..*... ...... . .#. . .\.#. .*.#.*....*..\\...#*..... ..## ..*... ...*.*....#..##*.#..*.##.#. .#.. ..#
#..*#.....# ..*....#.....*  ..\...  ..  *...*.##.. \\ #*.#...#..#\.....#  .# ...  *.. #. .\ ..# .*#*.#..* ..... .*.....*. ...*.*...#..\.#. ........ *#
##*. . .\......\.  . ..\##***.... ..#.... .#..#........ *. ... . *.**.... .#...*..\.. . ...# .. ......*  ..\... ..*. .#.. \.\..... ...    .  . .  .\ #
#... *#...  . ..*..\ ... . .#.....\..*#. ..\.*.#. .#. *...** .#...#*#.*. #* .* ....\...*.. . . ..   ...#..\.  .*..#..... .  .*.... #...##.... .#. #*##
#.. .#  #.........*..\ .. #..##..\.. . \.*. ....#.#   .*.#.. .#* . .*.......\...*.. *  # . .*.... #.... ...#..*...#*..#. \#..........*.*.*#\  \..... #
#.#.  ..*.*.. . ..*. .\.\##.*..... ....*..... ....... .\..... .* ....\. .*  *# .#* .*. ..*.* . *.... ...* \ ..#... .\ .*.  *#...*...#.* \.#*..... . .#
# .##  . .   * . .. . *..\*   ....... ..... #*..##\...#.#.. #  .... .#..  .\... \#... ...*.*..## #.*....**\. .... ........ .*.. .**  \* *.**. #. ...##
# . .# #......... ......... ..... ....*.*.\..\..\. #.#.... .  .*# . \# #....\*..*. .*....  .*  .*.*..#.*   .... .. .*  .*.  .\.. ..........*   .##..\#
#.... ......*. ..\*...   *  . . ...\# *....  * *.*\  * .\.. .*..\.#*.. .#.\...  . .... ...... .....*.*... ......... .. \..\ ....#.... .  .. .##.##. .#
#.  .... \.. ... .#.*..#. . ..* . .......  .#.* .*..... .# ... * .*.#....# .  .. .* .\ ....* .. .... ...... .\............*###........*..#. .. . . .##
#.#.*. . \   .......#...  \ *. .#.*. .. #.*. .  #  .* *#...* ...*.*.. .\... .....\...# ...*\ *..\\#. .\#  ..#. *.#*........ . ..# .  \ .. . .   .*...#
#.*.\...... \..#.... . #.*..\.  .#...*...... . .. \.#...  ..\.....* .*.##.*.#..#.**..#....* #...*  . ... #  ..  #.. .. ..   \.#..  ....# ...\#.. #.#*#
# ##*.*. . .  \..... .*\ #. ..**.# ..*.\.....#.#.#*. ...  .....#. ...... . . .........#. *.# .. .# .\.#........ * * *#*......*...\#*... #. ....* #.#.#
# *..... \.#.. # ## ...  #* ...\ .. # .  .\. ## .#...##\. .\.* . . ...  ..\##.*.*....\.\..#..#...##.. #... . .#.. * #. .........#. ..##..\....*.#.*..#
#\.#.\....\.. .. .#\..#. ...#...   *........ ....* **.\. \. ##*...\ . ** ...\  .# * ....* *.....* .. ..#.* .. ..  .. *....   .... .... .\..*\. *..\..#
#..##. . .#.... ###....\... . ...#    *..#.*.....#.* ..#* .\\...\\*... .    *\..* .*.*.# . \ ##... *...# #..#\.* ..\\ . ..*#\ ...... ....# #*.. . .* #
#.* \*....# ...* ...#.  .##  \.* ..##.#..###........ .\.*..#... #.. . **.#\.\.#   ..\   .*. #..\... .* ...#..*..*#.. ..  . .   .#\*.* .  \.*\.. .*\.##
#. ..#* *.. #. .....\ ... ... .  .#......*# .....** .*. \  ...\.#.. ......... #.*.... .#* ....   #*  ..**  ...\#..**#  .#.  ...*......#**.#. .. .*\ .#
#.... * ....#\ ......*..*...... .*......  *# \*.....*..# . ....... ...* # . ..#.*....... .\.. ......#. ....#. ...*..... ....#  ..*..  .**...... .. \.#
#\. .\ .## ... . *.\.*. \.....#. .*.*.*#* *. . ...... #.#.\...    ** #  . . * ... .* .\... *. .. #. ..#..*........#*.... ...*. ... \#\ .#.*...#  \\..#
#  . \.  . .#.. #.#... ....#*\ .#.*.\.\... \* .....#... #..*..*\*.\.\..* ##.#    . ...#.*. ......... #. .. * . .#  *..........\. \.. \. *...  .  .*..#
# *.#  \.*#  .\..  ... .  #...\.. . #........\ .*##  ..*...\..*.*...#.*#*. . ..*.*.**. .. .... * \. *....# .   *.......#.**.#\..*.*\.#*## . .#. *#*..#
#*\#.....*...\.#..... ... .## .\ .. . ... ...  ....  . ..\........*....\. ...#. .\ *...#. .# *.#..#.\. *..*....#...*\.*.. ..**...* .#.##.. *  .......#
# *.#. . .#.\. \.. #.*\.*..**#...#.*...**. . .*.#.. # . \**\** ......###*.....*.... . \.\ .... . * ..\.*.. \. *\#.. #.*..\\  ...\.\.. ..*.*#*  ......#
#**. ...\ *.#...  *\......* ..*..*..... ... . . ...# **\**..#..*... # ..# ..\... *........\..* *  .\ .\ . ...#.. ..... ...*  \*##... ....#....*. . * #
#*# ......\..#... .#.\.#\ . ......* .#. .. . . ..*.\..........* \ *..#  * *........*.. ..\ *. ...#  ..#*..#. ... .*..  .\... .##*....** .#..* ...*...#
#.  . .#.#*......# .   ...#\ .\.*. . ..*. . ... ..**\ ..*  \.. .\. *  ..*.*... .*......#.....*\....... \. . ...#...* . . .. .#....# * ..\.*..##..**\##
#. # **.    .......... .. ...*..... . .#. ..  ..####*.....\.#\...# . ..#.....*....#. ... \*...#*#...*  # .. ......#.#...#.#. ..*.. . ... . ...*.** ..#
# . **. . .\*.#.. . #..\..... .#. *   *. ...... *. ##.**... .#...#\#...\\ ..*#..#..  ..# .. .  .. ..#.... . . ... .. ....*.....  #*....#.\*......*...#
#.....#* \. .. ###. #...   * \.#..*. .. . #.*.. .*  #.. ## ... ...... ... .*...*. .*... . *.  ...*.# ..#.#  ..#..*...#.\  #.   .* . ..\*.## ......\.\#
# * ..#..\.\*.## .##..... .... .\.*   ..#.* . . .*.\ .. #. .** \ ....\. .  .*......* ...\##*    ...**... .... .#*.\ ...  *.... ....*\#.\.*. .....#. ##
#  ..#.. .. .. .\...#.*. *.... ..   .\..*...  \..... .**.#.#.  ....##.#....  \.......\.... . .#*.\... **..\ . . #..\.*  .  . .# .  .#..#*.... ......*#
# ..*. .\...*.. . .... .* .. . #.*#\ *  #. #*... ...... ..   #. . ..#. #.\..\#  .. # . .#. # \..*#*.  #.... *..*... * ..\... *.##.. \.#*  ..* .\. \. #
#..#.\#.. .. .. #* . \# .\#\ .#.#.  .  ..#..##.... ..*....*..\*..* . .*  .....*. *.#.##*#. .#.. ...  .#..*.\..   .. . .*...   ...\..  \.*...  .*.....#
#.  ....#\..\... #..\.  .\.\  \\. .#.#. . .....### .**.\..#. * ..\.. . ...*.. ...#......# ..#.*.......#.. .\ *.. ..#.. . ..* #.*......\**...  ..**. *#
#.*##.#*...*  .***..#... .\... .*. #  . . #.* ...#..#. .... \  *#..*.*.*  \.*..  *..*.   .##\.. .... .*. *.\ .#.*.# #....#..... * ... .\* # ... #. . #
## ..*...#\....\...#.*#.. ..#.......#*##*.. *..*.....* \ . ..#* ....  .#**\...*.*  ......  #..\#*..**.... #  .\\.*.. .... .#....*.#..*.\*#...* ......#
#..*.\.... *.#.. ... ..*# #*#.#.....#..\......*..*.. \...\ . .....\.. .\*\.....\.  ... .*.#*.*. #.#.\ ..#. .# . ........\#.\#*. ....*#*.....  ..* ..*#
#... . *...\.#..* .*# .# ..........*\..*.. ....#.*.. .* ....\ .#\.  . .....##.*.*# \. \.\#.\.. ...*...#.#*# *.........\#\.#\ .\... .. .. .#. #.\.#.#\#
#...\... ... ... .. .......#..*. ... .. \*. .*.#......* #* ## .\.... # ..\...*.#\.....\.    ..#  \*. *\ .. #.  . ......\.. .* . . *..  .#.# .#.. #...#
#. . ... .##..# .#.............#.. ##.  ..#...*.......*.. **\**#.......#.  ..*.#.. .*#.. .#\..  .. ..#*. #...#*..........  ........ .  ... .* *....*.#
#.. \. #*#.. ....#... ..  # \..\....  ...*.#\...#..\.....  ..#*  .. ....\\. .. #. .. .... . #\....#..* *  .\#.\. ##*.#...* \.\#*.... . . #..# *.. #. #
#.\. ..#. #..*# .\* .#  ..\. .. ....*. .. ...*..\*... .#.##......   . \.* .   .. \....... ..*#\.**.*.*.*#...\*. .  ..#  ##*... . ..... ...#*.  .#. .*#
#...#..#..*..\\.... .. .#. \...    . . .#..  *..  *..##*.# ... ..\  .......\  #..\.....*.#..   ..#.\ ...* ..\.. * ...*... .... ##...*.#.. ..#.#. * .\#
#...**.\#.*.#*. .. .... ..**...#... ...........***\...#.*.. # ........\... . #.\*..* #. ..#....#. ....   ..# . .... .  . * ...*#.# ..#\ .*..... .....#
# .. .......#.*##....  . ..##....\...\. ...  .* ... ....#*\...#.\..*... .  .....#.#.*...#. **.**#.\ *##...**...#.*.  .. #. .....*...#.  ......#......#
# ..#.*#\ ..**.. *.... .#........ ..... .*.*##  .... . .*.....#*.*...... #... #..#.** . ...#*#....# ##.......... .#...#...###  .#  . \..#*\.*....#.. #
#*..#... .#... ...#..\. ..  .... . .  .....*...\. ..#*...*... \..... #. .*  . ... ...*...... #.. # .  .* .  #.. #\. ......#...\.*.....**.#*. \. * . .#
#... .. .*.# ....#.#..   ........\... . .. ..*....*# ...## . . *.#..*. ..* . ..*#.. ##. #\* *...  ....\ ..*... . #**...\\......*. #  #*  *...*.*.....#
#.   .....*#.  *.*..# ...\ ......*.*** .  .   . ..*.. *.#......*.....#.**#*.*....#.#..*...  .*\ .... ... .\......... *. #..... ..... . .....# ..*..*.#
##.....\... . *...... .#.*#.*\... # #.....\...*.. ...* #..*...*#........\.#.  .. # . *\...#**.\.#\*.\\...##. \.*.*. .  ...  #..  ... ..#. .\.#.. \...#
# ...... # .......\*..* ...\ ..*....#* ....  .## .*..... \##. \ ..*.....  .# .. ..##.* .*.#  ...*.*..#........#.\\  ... . . ..R.*.  \# ...#...#.#...*#
#.  ... .#*. * .*.#. .... . .. ....#.....* .\#. * *  ... .# #*..... *.. .... # .#. #.... \  ..#*....#.*........*. .....  .. .#.......  . ..#.. ......#
#.#....*.  # \..## *.#  \\. #*.* **.#*###.*....#.#*.*\\.*..#.*..*...\.. .....#.. ...  .... .*.  ..#.......\.  ..... . .... *... .\\. ..#..  . #.\#...#
#. ...#.  . ...**.. .*.*...#.*... ..*. .#...#. **...*. .#*.*. ...  . #... . .*.#. \ *... . ..#........ *.\ #.\*...* .\    *..*..*#\ ..#..* * #..##*..#
#...\.. .....#.*.*.. ...*  .   .# .  #. ........\.. * .. . .  ... ......  ...\. \ .*..\ .#* . . \.# .#.... *. . ##.#.. *...*.*  .\#.#..# .# ....#.*.##
#..* ..*.... ..#**..\...*.\......*..# .##..#. ..\.. ...\.  ... .#. #.... .# ...... .....*..\  #..... \*  ... ..#...\\.. #...*...... #.*..#..*....   .#
#.*.#... . * .... ....# \....\...##. \ .\*........#.\.*#.....*...*..#* *... ..*  \. ##. .* ...\.\.. ...  ...*...#.....*...# .*#..*  ..*.  *. ..*\##.##
#. .*   ....# . ......\ ...* .. ..\.*\..#. *.   #.##*  .... .\...... .*.\...  ...\...#..# ..*\.#.... #  ....\\ . **...\ . .\..# .\.. ...#....... #. .#
#*..* \..  \.*.\*...\ #...   .#  #*...##..  .. ##.#... \.  ... ... ...*...#\*\..#..*.\....#..*...*.#..*.   *... # . \...*....#.  ...* .. .   ...  \.##
#\. *....... .*... *#.. ... ...  #.#....   ..#......*#  . .... \...... ..*# *... \\.. .**......... * . #\#.. . .#*...* *#. . ...\ .... #*..  ... #.*.#
# #*#.#. ... #.#.\ ..# . ## .*...... .\  *##\.. *.. . ..#.*. ..*........#.*  .. .  . ..*.. #*#.\. .. .  ***  ......... # ... ..#...**..\..*. ** .*. .#
#........*. . \. ..#.... .....#.*.#......#.....*   ..* .. . *..##.#....*..*..#.. .#*.... .. ....*..#... .*.#.* . #*..... # ..#.. ......#....\#.*.... #
#.*#.  .  *. ..\ * .\*.* \\**. #*..#  ..*..... \*. .. .. ....... .  ..... .. ..  .#.# ... . ..#...*. \#  .*#.... ..#.\....\.#.\* *#*.....\.. .*.***..#
# ....... #*....#.  *....\   # #.#*#.... *..    . .\\ . .#.*.. * .... .#..#. \......*.#..... .... .\..\#* ......\..*....*..#\*.*. #*..... ...#.#.* ..#
# .**....#......#*.. #...*.#.#..... .#.. ..\.. .  #.....#.*...#.*#.... .* #.*..  .... ...\...\#.......#*..## ..\ . .. . *.........#..* ..* ....*..#.\#
##.. ...#.... \..#*\...*...*.. . \  ......*..** .. . .. ..*. .#  .*#.#. # ......\... *.......\ ..\#..#.. .....* .. . \  .  ... .  *# .*\ ...  .\.....#
#.\\.*\..#...... .#.. .*.. ..\....*\..*....... .......#.#\ ......*#..#. ..* .. *.. ...*.#.\.\# .##*..*#...*# . \   .*....\\.. .. ...*... .\...*.#*.  #
#.. ##.#..###.*........ ... ##.# .#  ...  .... #.#...  ..#... * #.. *.*.. .* #\...*..\ ......*......*.......**\..#.# * .#.... *..  # .*.........\..\ #
#.\...*....\. .**  .........#***#...*#..* .. #.# ***..# ...#...#....  .. .  .#*  ..#. \*\\..\. \. ....# \*#.* ** ..*..* *.#. **# ...........*.\...*..#
#...*..  . \.*.**#. .. .. .\#  . .** .*..*.. .... . \.* .#........  ... ...*. .#...\*\   ...#.\#*. ...#.#.#...\.** \\.... ..   * ... .....#...\..... #
##*.  .**.. . ..\##.*.***  ... .#..*.# #....*..#..*..\. #.. ...#.## ....*..# ..# ..... .#*# *..**....#\..*...#  \..  .#..# #....  ...#.. *#*...#...# #
#*#. \.... \.*....#.  ...*.#.. #\... *\ *#. ...\#.. . #*#.*..* ... *\#.#* # # ....*## . . ..  #\.. ... \ ..* ... .....*.. .#..  #* .#.*....\.*..  #*.#
#.. .* ... .#   #.#  .. .. \.... . *#...#.... .#. .**.\......#...   # .\.. **.*#.*..##... **. .* ..... ...*#.....*# *.... #*..... \.....\.#... . .\*.#
#\  .\....#\*.*...#. . ....*.  .#*..*... \*..\...#...*   *.. .. .#\*..... *...** . .#.*.*.......* ....#.#...*.*..# .\#...*. ...\.....\....#*...#... \#
#...#.*..#.*.....*#.* . .. ..  ... .##\..\...\..*...*.# *..#..#.\##. ...\\ ...# . # ** .**.....*...   .*.\#....* .*### ...  ... .  # *.#.** ...... #\#
#.#. \. ...###......*....* .**....*....#..#. . . ...*.* \# *##...  . *.#. ..\*.. #. ....*.. \.#.. .\ .#.# ..#*... .    . . . .. ......#. ..........*.#
# ..\ \\..* .#... . \.\..* .\*#. ...##... ......   .... .....#*..  # .... \. ...... .. #*.#.*..*. *## # #\*.. .*#   .**. .... ... ..*....\..#..... #.#
#..   .*# . ....  ..**..# .... . ..*\.... .*\ ....#*....*..*. ..* *.....##\*. .\. ..#...\..*. \...... .. .*.#.*.\.. .* .\..#.*\\...#.*.... ..#..\.  .#
#  .*....  .#.....  *...#.*... #*.# .\# .... .#..\.*...##..  .. .... ...# .. .. # ..*#.\ * *.. .. . ...#...... ...# *.....###.#.\###........# .... .##
#.. .. .#..*.#\\. .  ..\.. .....*\...#...* #..*  .......# ..# . ....\........*  .... *..# .**..#..\ .**....#...*#.\...#.\..*.....#..... . .....*. . .#
#. \.... *..  .*.#..#.   ....  *** #*..*.  ##. .#.##*..*. ..\..# *# ...*.\..  . #... . .\... . ...*. #..* *. . ...  #....\*..*#  \*.. *..* ....\. ##\#
# ..*\.# \... #...#\*\.# ..\... .#....\ *..\. *.#...*.  *.\***...\#\ .....*# \..#... ...\*\..**.# #*.. .  #......\.  ...*.  ...*   . .*\....  .\#..* #
#....#.#. .    # \... ...\.    .....#...... .* ..*. .... *.# *...##.#..*...... ...\\..... ...#.#..**#. . * ....#.....*..... #...*# .#...*# .* . ..*.##
#*.*# ..*..#.#.......  .\#. ...*#. ..........  ..**...*. ...#\...#...    \   . . .*.   ..#...#*.* \*.*.#....#*#... .*\. ..#...*# .....##.#...... #\.\#
#..    .#\... ..*...\ *.#. *....#   #.*.* ...#.#..#  .. ..#. .*. ...#..\# . .. .  .#.....## ..*....#  *. *...*.. .. ..# .#*.\#*.#*#. ## .. .....*... #
#...*.. ..... *. ... ......\.**... .\##**.... #..\.# .#.....#*.. \.*...........#.\*.*..*....#.. ..*.. .. \.. .#..##.# . .. \ ...*. . .. #.#\...#..* .#
##\ *...*..#*.#* #.* . .\..*...#*. ..\*.... ...\ . .**...*..#*....* ..#..*..  .*......    ..*. #\.........*\. #... .... .\# #.....#.*..*.*.. #....  .#
#.#  . ...*.\#.## .#\... .........  .#*...#*. ..#  \.  . .#.......*. .\.......#\ #*\....\##....#...... ...... . #.....\.*.##...* ..#.....\... .... . #
#*.\...#*.*#........ .. ......#. ...* \ .*. *.***.. ...*#*.. #...#... .........#*.. ...# ..*......   .... .*\.. . ... ..... ..*.# .....*  ..   .\... #
#\...#...*.#.## . ......  ...... ....  ......#. ## ..   ..#\ *..... .#.......... \...#  ..#..*  * # ..\.*#\. #.* \.  *.. # ..* .#...#.*.....  .. . ..#
# \...\.... . .......* ..#.*  .......\..*..\.# ..**\..  ..#\*..\. .#....# . # *#.....#\.*#. .. #.....*.# ...*.\.\#.  # .#..#...*.*\.. #. \*.. .#.\...#
#.#. . .**... #\. # .. ...#.. ..... .**..#.#.#..\....#....  ... .. #..*... \.. * ...#.*. ..* ...\... .*.#\# #.  . # . . .# ..* #\*..*.*\.. ......  . #
#..*#... *. #... .  \... ..\.   ....**#  .#. ..  .  . ..     ..*. ..*.. . .......#\. ..*.\ ..*..# ** \ ..... .\#..#..  ... ## #\.#  ....*.. *........#
##.. *  .#.#*.......*. .. .. ...*...#*..* ..*.. *#*. .. ... ....#.*.#\...*.**.*...#\* . \.\ .\ *# .#. ..  *.*.*....  .#\..*\*. .\.#**.#...*....   *. #
#. #. ....# *.\* .\..#.....* ..*.*  ..#.. ... #\.*.. *.... .    .# ..#..*...##.....# .*\\ .  .... .. ..*  ....* *.\.#.\# * .#.......#. *** ..*.......#
#.   . .. ....... . .... ...  .*#.......*. #.*.... .\*........... .. ##. ..# .\.*.... #*..*.. ..**.\... .\.\*.... **...#. ....\.** ..*.....*.# .  # .#
#\. #.**. *.. *.#.. \.  ...* ..#.*.  ..\.    .*# ......... ...# #  .*.#\  . .*....**  ..#...*. .#.*. .... ... .#.*#.#. ..#. .**.\..   \.. .. .\... .*#
#.. .#.. #.#. . \. .... .   ... .*.#....... #\ #*.##...##...\.# . #...\.\. ...\ .  #..\..##...* * .*...#.*#......# ...\* \... *....\...\....  ....#. #
##.... #\\*  #.\ \.....##..   .**.  .. ......*..#*.........#.*. .#.*... #... .....#.* \**#.........  ..\..*.*. #....#. ..  .  \\ . \...... . \.... *.#
# ... ##*. .*..  ....#*...*......  ##.....*#.*.  .#.*.#.\.. \\..    .\....*.\. *   .. *...#*..#*\.*.#..\..#...* .. .*.*\.. **.....*..*..*  .#.  ..#.*#
#.#... .# .#.# #. #**.*.. . .. . ....   *#  ....# *# .  #\.#.*#\.\. . ..#....  *.*.\\\..* #..#.  ..\. . ..   .... .#*. #..*\#... * .#  # *....###... #
#. ...*#..*....... \....  *.. .*#.*.. # \# .. \ .....\. .  * \* *...*...*. .\.. *...*\. ....\#*.#*..*..\. . #\.#. *.*#....*.# ..#\..# \...  ...*.#  ##
##*#...*..\\... .....\\.###..... #  .... .......#\..*#  ..\ *. .. ....... .#.#.....*.  ..\#.#..##*.....#.# # .*  ..\* # ... #..#  ... #...# .*..*.  .#
#... .  .# .*\.. * . .# .. .  . ..*... #.\ .**\.  #* . ... .#* #..#.\#.. . .\# *.  ..# .. ..*   * # .. ... .......**..   ..*.#...\* .... ...\.**\....#
# \. ..*.. ....#.*...*.*#..**#.#..*.\.. #..#.   *.# #..*  .#*...**# ....  .#........ .*.. .......*.. #..... . **....\# .... ........*#..  * . ..*..* #
#..\....\*.....  #\.. * ............#\ .***.. #*.**....#*.#.  #..*# . .*..* .#.........* ..... *....#...... ...*...\..*..  \.**.#.\ .........#.. \. .#
#*..   ***. .  ..*...* \  . ..*  #.#... **. *.#.*#.*.* \ .  \### . ... . *\* .. ** .. #. ...#... *.  \.\. #.* .#\..## #.*. ** .***....**.. ..\ ......#
#.  *.... \.*.#....... \ .....*#..#**.. \...# \.\*.#  .\#......\.*.\....   ..*#..*\ \.*.#...* .\.\ ... ..#.... .... *   *.#*#\ .\.....#.  .... *# ...#
#  ...*\.   ..# \..  .*  .......  . . ..##.*.  \*#*..   #.*......* \ .  . \ ..*..... ...*....... \. .....\.\\\.*...*. ..  ..#..#..# \..*...#.. ....\.#
#...#..#....#*.....*#..#...... *. ......**...* ..*... *  .. ##.. . . \..**..\##.##*.#.. #\.... . . \.## ..*   #  # ..*  ...  ......#. .\ .*.*.#. .*..#
## ..*\ *  ...*.*..... .... .. ...#*...##\.. ...*\. ...*.... *#.#...\..  .#. ... **.  .... ..\.*#*.\.. .*#.  ....#..* ... .. .*... *.*.  *......#....#
#.* ... . . .#*. . .*.#..... *.# .*.... #.\..#.\ * . .. .. *.  .*\. #. *.*#............ \..#.* *.    ......\*\#...* .....#.... *\. * *#..#. ......*.\#
#\..*.\..#.#...*. .#**..#*# #......#... ... ..\*...\..*...*. .\ . ...\...#.*.. .*. \...**.....*.....*.* \.# ... \..*.#*..\..... . \.  .* * ...#..  .*#
#. ..*#.  .#.....\... .*.*.* .*.. .#.. **.**   . *.. *.....#..#.# .*. #*..#*...\.#.# ...*...#....*. ..*. ##.....\. ..*\#.... . . .\ ..#* ##......\. .#
#...#.\ .\......\.  .\ \.. ##.. \*##. **.....*..  . . #.#..# .\......... .\.  ..#* .#.#.... ..... #*.. . ....##...# .. .. ## \#.#.. .*..\.  *. .*.* .#
###.. # .....##.. ..... *.. .... *.#. \  .. ..#...# .# ..#  #.* . ......# . .# .. .#.....   ##.  .. .. *.# #*.#..... . .........  \.. ..#\\...#.   \ #
#.##.##*. . *.*\*....... ..*..\*#*. .. . \.. ..* .*  **. ....\# .\#.  .#\##.... *#*.....  *.. ..  ..*  ....#\.*\. .\..  *#... ..*  *  . #..... ...\..#
#. . *...#..*..*... . \.. .\...#. .#\.. #*#.#**..\.\. . .. . .. \.  . #\..*## ...... *. **  .. ..*.#\.\.\.. .# .   . * *. #.....*.... \#..\\ .#..#. .#
#..#.. ..*. ...**.###..  *#..#.*#. *. \#*.......... ##..#..*..  ..*.... .  ... *.#*. *.  #.....  ...\ \..\... *...##*.. #.\. ..#..*..  ...#.# ...   *#
#....#...*.\ *\..*. **. ... .*#....*. . \..  . #..... *....\#*.... .......#.... ..#.......\.  #.. * .....#.......\*.##.##...  ..#.#...... .\*.... #..#
#  ...* . *.# .\*..#.... *.. ..#\##.. # ......* .#*.. #..*..  ..*  ..#.. .*....#*\**.# ....#. ##*..#  .*# ..# . \..*#... ...   ..* #*..........   .* #
#.#.. .**#...#\....#.##....... *. *.. .#. .. \*#.....#......\..... .#..*.\. #. *\#..#..#... . *.**...\.#....... . #.\.#. ..#*#...\* #. *#.#..\ .#....#
#**#. .#*.. .\.\\...   #.. ..# . \   .  .  .......... ....\....*..#....\...*   . ...\. .  * .\. ..   #\.....#...*.#*. ..\...## .. .#.... .## ..  .#  #
##   *... . \*.*.#*..  #.#.  .\\#.*# .*.#*....* *.. . ...*#....#. ...* .. ... . ..*......*.. .. ..#. .. ..# .*..  .*\. ..*.... . . ......*...#......##
##....\**.*.#..*. ..#.. ....*.*.  #  # ... #..*....#.. ...#..... #. . . ..\..#*..*.\*  ....*...\......*..##. *...*\. ....*..  . ....... *.#.* * .. *.#
#*#...*..........*..*..\. . ....... ..  ..*.\......*.#.#.#.*.*\.....##. .*.\ ..#\..*..*\.. . \\.........\.* #....*..* \#*.   .... ..... #.\..\.* ...\#
#....#. *.\ . #  \..... *..\*\ . ..#\\.. ...........#....\*.*.\  .*\..#.\ .. *.... . ...*..  .   ..  . .**.*... ..# ...  .\*...#* .\* #.. *.#..\. .*.#
#...\..*..\ ..#...##.......#.#.#  ......  \.   ... #.... .#..  .#. ......# *\* . \....# . ...#...\ ...\ ...\. . ..#* . . .*  .##.*..... . *..#.......#
#* ........*. .\ ..\#..*#... ..\... #.*. .. .. . ..   *...* ..... #...*. .\ ....*#..#..#..*. .\. .*.. ....#. . ..#..#.. . .#..\   \. #  .#.*\.*... ..#
#.....*.#... ..#. ...... ...*. #\.  *.. .\\\ . . . ..# * ..  .*...\ \.. #. .*. .......... . #.# \#.... .#....*.. .. #... .. \.....#.#.#.....#..\.....#
#. *... ...*.....  **  . ...*  ...#. ...*#.*.... \.#..*.* ....*.......*.. # #...**...*  .#.**... ..... .*......* ..*.#* .#.. . ........*..##....*.*.##
#.**.#*#.\.... . .. . ...*...* ...#.#.... *...*....#.. ... ........*.....  *.  ..# .... *.. \. *.**# \..* .*.... ....#..#...........*...... .\.#*.# .#
#.*.\... ........ .... ...*. *#*#.. ..# #.....*\  .#. .... #*  .#.*.. ....*#*\**.. .*.#   .. #...*.........  . **.#.... \ .*.......# \........ #  ...#
# ........# .\..*  .....*.#.*...* ...\.*..   .. *\.  ..\.  ..#.** .**..#*..\.. ..##. .*#**..*...#. . \  ....\...  .**#. **. . . .*.**.*#  *#*..#...#.#
#.\# *...  .. #. ..## . ..\. .#### ...*   ... . ... .. ..#..##  *.*.***\.\  .. ....\#.  . .#... .* # # . .. .. ...##.. #..*#.*# \*.....\......*....#.#
#\ \ *#*. ... #... #  ...#. .#*.*... .#* .#*# #\.. .... * ..#..#.**....*.##.....*##.. ... .*.*...# ....*....*. ..*...\ .#... .... *.. .#.. #\..... *.#
#......  \.  . ..*..*#...\.....* .....*..#. .*..#...\..#\  \*.  *\.*.  .... .............*#.......\...*.#\..  * .  *... .. #.. # .#..* *... . \.#....#
#.   .#*....\*  ..# .. #...*... ... *. ..#*..\.#.......*.* . # .#....*. .\.. . \..... .. .....#.**\.#*.....    .#.*..\.#  .#..  ...... .  .*.......\.#
#....\ ...  \.#.* ..*..\*. ..*  ..#.#...  .. .##.**.. #.  .. *. ..*...\. .. . \.... \#.. .*.. #  ....*. . .. \... #.. #..* ..** .#  **.*.*....*#*..#.#
# .#\* \. ...# *...*....#....*..... ...  #...... \ ...###\ #..*. *..*.  .  ...*#..#...\..#... .....\ ..#...... * \\#.. .# .#.\...  .. .#*.*.. .. #. .#
#\#.*.#...#.#* *..\.**#.*..  *..* ** ........#.  .#..*#.*. . .......*  \.#**.....*\.*...# ... ... .. \ .... . ........#.** .. ..#..  #*... .* .. #..\#
#. *...\.*... ..... ....*.* .. .\* . # .  # . .# ...... .*.# *.  ..\....*..\..*. #\*#. .*...... . *   .... .* ..#  .#. ....\*# #..*..*\  .. .#... ##.#
#. ..*. ...#.##.....#\ #......#**.#.\ .*.. .. ..*  ...  *.#..*.#*. *.# . .* #  ........ ..\.*..#*....#..... ...*.\  .##...# ...  .. ..*.. .......  ..#
######################################################################################################################################################