######################################################################################################################################################
#\ . ....#.\. \. ..... ..#.\. ..##..*.. ...*. ... ..\* . . .##*......\\* . .#..#..***#...  ..... ... .#  .#...\... .  .# #. . ....\ .. ..#.....*..*.*#
#.. .*.  ..  .\. ..#..*. ...#....... #*..  ..*.* ...##. ..*.....#\#.*...... .\.....* .  .  ..*...#... ...\...#\. ..... .... \*..#.... **.....#.\...\.#
#.\##.  .* ..#*...  *   ..#..... *.*.... .#.. \....#...\\..##  *#\..\......#..#*...#...\ # #.  ..\.. ...##.....#  #........ . ..*#. . *.#**....*.. ..#
#...***\.... .#.*\.. *.*.. ....\......#\  .*.##.*  ..# ...  \. *.... .*. .*. ..\\ ..*.... ......*..  .#.*.. #  #. .  ##.**.*.#. .....  .. . ....## ..#
# . ....# .  #..#\. *.   ..*...\ .\\.* #. .*.\# ....\.#.# * ..\.\* #. .....\.. .  *.. \. \.....**. .##..* . . ..  ........\....... *....\#.......*.*.#
#.....**....#. .\*. .#......####.\.....#...\.*#...  ..#.  . .\....*#..#*.#....*.....\#.*......  **.*.*\ *.. *#...*..*.##.  \...  . *# ..*. ..*..** # #
#.#..\.... .*..\. ..**... . ** .\*.... # #....*..*.  ..... ..#.\*..#. .  .*.#..*.\. #. #...\.*## \ ..\ .... . .. .......*....##*..... .##\*. ... .. .#
#.* ....\.... *.# #....\..#.......# . \ *..* ... .#  .#.#..#  #. ...#.#.##\*#.*#.. #... \ \.. #..*. .  .*  *..*... *. . #\.#........\\ *.#..\*..*.# ##
#\*. ......*..\*..#*.\ ..#*..\.*. *\ ..##. #. ....#. .*.. .#.  .. # ....*.... *. ....... ..#.# . .*..#.#.\ ** ...*. . .# #. * .*.*# *..*  #.*#*....  #
# .*\. * ..* .. .   ..**#*... ##. *.*#.....# .......*...#  \..\ .\#..\#.......#.\..*.. ..*.# .*.... .*.#..#..*. .##  . ..*. *..##.\..*... .  .. *.*#*#
#.*\#.*....   ...#.  **..#...... .. .. .....**#.* .#.#.*  ..*#.#*..*#..  #.*.... .#... .\..\.*. . . .. ..#\#..\ .. ..\.*\. .  .*.*. ...#\ . #.*.*. . #
#*... ....#. # # .\.\#.*# ... ..#\..#...*....#.* .* ... ..  .  . * *..*...*....#. *\ ..#.. .#..***..\*...**. ..\... .   .** #..# ..*#. .*..  *  ##.*.#
#. *##........#...#..  ..*..\.... \.\*** *...*...... .. . \*....#\.#. ..\#.*. ...\\... ..*##...#... .*.. .\....# .#...  .. .\*\.\.*......*...*.*..*#.#
#...#...\* ..*....\  ..\#.. ...#... ...  .#*. .. *...* ..#\#..*... .# .. ...#..\ #. .  ..\.. ....\ ....... .* . .**  .*. ..#...*.*..  ...\........*#*#
##.....*\. .  #. ...# .. * #..... .....#.. ...\.#* .. ...#..*.... .. *.** ..# ......#.....#.#..\.\. .    # *....*#.. .* **...... ...... .... ..* .#..#
# ...... ...*.....  #.##   ..... ..#.. * ..... *#*. #... \*#.  *... ..*.*. ** \.\.. ..... .. ...*#\...\....*.... ...#.. .*.*.  ...... .*......#. ..#.#
##\..#*#.#... .# *#.*...#.. *#\... .. .. ... * .. ... ..#.#.  #.. . ..*   ....  .. ... .... ..... ..#..*.# .* .. . # .#....#.. .*.*#.#..*. *.*.... .*#
#.#*.. .....\.....*#.#.... ...  ...* \\.\... *.. ...#.#.##.  #*..#...\.   .\. . ....\.*.. ....#....*#.#\ .*..##...*  .... .*.  .#\#. **#... .. *\.. ##
#.#..# .. ...#. ... .#.....#* .#.*#. \..... ..#*..#. *. . * # #....# *..  ... #....*.....\..# *\  .#...#.  *.... *\. .. ...*.. *....##..*..*..  .... #
#. . #*....*.\*#.#. . .#.\....\.***.**..\.*.#.*.. ...***.#. \..#.. .\# .*. .**...#..*........ .#*. ...........##*.. . .# .#.*..#.* ...*...##. ... ...#
#. .. . . *.*. .*\ ...*.**...\#\*#.*# . ..\**.*.  \. .... .....*.#..*.....# *#*. .* * .. .*.##*.. **. .\# #..*.. \....  ........ .  #*........ \*... #
#. ....**. #.. ##.#.......*.#.    ....#.. .\..##. .\*..**#*..*\..* .....# #.#*.. #.*..*. ...... . *.. .\.. #......#... .*.......#.... .\..  #. .*#...#
#.......*.   * .##.. .... .  ...\..  #..  *. .. .. ...* .. \*# .#.... #.*...\.*\....\....\ ..# . ... ... .*..#.   #. ..*......* #..#.. #  .   .. *. ##
#\........ ..###..  ***..* ..# .....\..#. .......... . *\.\... .. ...*..#  .* # #\...... ..*. \....#.#..\. . \#.. .# .. \\#\..\*.  .. .**#.....*.....#
# ....#..\...#..... ..   ...... ..\. .* #*.\. ...##. #*......\. .# *. *....#..\.. .*...#  #.* ...... .#......#. . #.. ..... ##\...\**.#. ** ....... .#
#......# \. # #.#.# .\*.... .#......#\*. \ .# .... * . #. . \ .*..**...... #.. ...##.#.. .. * ....\ ........\... ..\..\......  #....***.. *.*##......#
#..*  .  . .#..*#..\#... *.#.. ...*.. .# ....\.... . *. . .... .  .*.*.#.*...... ##.\*... \**.#..\ *....#. . #...\....### .*.. ..*#\. \#\ ....   .* .#
#..#..#.. *# .\...#. ... #.*.\# . ....#.*.#.. *.*......*. .*.......*#.  #....** .\\....#.\  ....  . .\# #.... . .*.\*\* ......*.*. ....#. ###...#. . #
##.#.*......*. .*..\...  *.*  .. ......... ..##........** **..#..... ... .*#..#*..... ...##..*\..\......#*. \* *..#***...#.\  .**... ...\.. *.*..* . #
#. \ .. .  . .. ..*..##.*.\*......#*..  *. *.#. .*. ...... .  *.#.\...  *\ ....*##\. .#... #. ##\....*....*..*#.#.    . ...\..*##.\*..# .. ... ...\*.#
#....#.*..*.#..  * *.....**.*#.#.. ...... ....#* .*#*....*\.... *.#. ...#. \. #   .. **...#... \..*. .*... .\..* .# ..\...\ \.\..#.....##* #..*. . .*#
#.#\...###  .......  ..   #.#.  *.* #*..# ..* . ..*. \.........* .* . #\**.# # .*...* *  .\...... .#. * .. ## ..*....# *.. \...*\...#\ ..\*.. * .*\..#
#.#...* ...#..*...... .#.*.*...   . *   ..*\.... ..\..  ..*\.#....   .. #.\ . *#.... ......... .\.. #.. ..#. .. #.#.*......... #.....##....#......\..#
#.#..\..*#. .. . #*... .\  *. .. .. . ...# ... #. *..*.\..# ..... ......*#.#......\. .    .....*  .....#.* ..#.  \.*\..*..* ...# .....  * ... .*  . *#
# ....\ .... .#  .\...#*..# . \.*..*. .. .# ...  ..\ ....## ...*........ ..    . ....*.. #...*.   .. . .**... ...# #. #*.......#*..*.\.**.. ..# .*. .#
####.*.... .. #.. ...  ..\ .... .*....*# ..#.  ...*....... ....#\..*... .. ..*.*#*.....  ...\* # .# ...#..#.*. .*..\. * .#... ......\...#  ...  .* \.#
#..... . ...\ *...*... * .... . ... .... ##. .**\##***#... .#\.  #.  .\*..\*...*..* ..\..   ....**  ..\* ...*...... .\.....#.* *  .*** ......... ... #
#..... ... ....\.\\.. . \..#......\ *#*..* .#...\.#....\*.......#. **.......\   .. *  # .#.. .\*##*...*.. ..**. . . ## *...#\....*. ....#...#.# #**#.#
##...   .\#...**..... ...**. ...\...**..... #...#\.#..\.. *.. .... . ... ..\. .....\... .\.......*. .#...\. **...* ##.*..\ .##......   \..*. **..#...#
# *.  \\.\. #.*\.\....# ... ...\ ...#*...*...\.....\.#....  ... *..#..\.....\#...... . . ....* . .. \.##.. ..*.*#...#.*#* .##.. . ..#.. ......  . ...#
#. *..  # .  .. \**. . ...... .*..*........# ..#.......*\..  .....  ..\....# ..*#.*.. .....\\..*.*.\..#\ . .\... ...\*......##....##... .\. #.....* ##
#...*.#     ..... .*##. .... .  .*..  ... #.. .#. #. ..# ..#..  ...... *.#\... .. ..  ....##  .##.#..##.#.* ...\*. .. ..#\... .#.#.. ...\.. #.\  .. .#
# ....*...  .....*\...     .*. .*. .#*..*.* \ ........*.*......# # .. ....#.# .#..# *...\..*...*. .\ *##*..\..#.#. .*.. *..*#...*..* .. \...\ #*.  ..#
#. *. . * .\....   . .##.#..... .##.#... ...  .#.... . ..........#.#...*...... ..   *.*...#*.. *  ... #...#.*. .#*... #.... .\.#\.\.  ... * \.. #...*#
#....##..*...#. .*#..#.. ...#.*..#....*.#.\   . ....\....*.#  . ..*..*..#..*   ..#.#. .. ..\. *  . \.*.  #\ *. #.  * .#. .....\........**\ ...*..*...#
#..#*  . . ....*....* ... . \ * .#. \..*.. \...  .\... #.\. . ..    **. ...#..*..#..#...#...\#.*........#.. .....*  ..**.*... ..... . . **.#  ## .. ##
#*..*.....\  . ..#..# .  ...... . .*# .. ..#.#.  . *\. ...\\.... ... .\...\ .\......\.****..\.. .\ .#..#.  #* #.#..#\* .....\. .*....#... #*  . \....#
#.. ..**.#........\\... . #. .*... #...*.# ...  ....... .*.. ...# ... ....... .. ....##\* ...  .\.. .  ...#.#.. .# *..   ... #\..  *.*.*.. * .# .....#
#.....#....*.*. *#...*...  .   ##....#*#. .*. . ...*..\.  ##.  ...**..*\..\..#.*..\. ...\...... \.# .. #  ....**..\... ..#  .. \..  ... *.#  .*\*#.###
#..\ ....*. ..*.. *.\...  *##.. .*......#. ...... . *...\. ..#... ..#..  #.......#.*.. .....#* . # . .* .....# \... .* .#.*.#.*.\.. *.*...*.....#.* .#
#\..#*\#....\ #.. ...#... ....*. .#  .*. .\  # ##.....# ...## ....  *#. *.* . *. .*... ... .. ..#. ..#..#...#   . . . **... #.#\ ..... ....  ..#.\*..#
#*. ...#*.*. ..... .. #.**. *.....#...\.\.. ........*. .\ .\.**.* #.. ... .#.#.*.\ .\....*.* *..#.**.......*#. ...*.... ...* .*\..*....#. \ #.. *.. .#
#*...*  ..**.... ....##....*...#*.\*. ..... ... ..#. ..# .*  ...\*.. ....... ...*.. ...* ... *.**# ...#*\.*.   **. ##..#.....*. \\\*.*#.#\ ...#*..*. #
#... **.. ....#. .*.#..**.\. \..  #  \..*  .##* ...*#..**.*.*#...#\........#.....*.#*..*.. #**.#.\*\ *.\##....\ ...*.#.*...\##.....  ##\..#...  . .#.#
#..... ..\.*..... *#\\...\.* ...  ..*...#...* .#....\*#... ... ..*....#.*. *...\.# . .*..#.\..*...*... .\\. ... *\...\..#.. .*..\.  .#.. . *..#.*# #.#
#....# .\ .* *...* ##.... * *#...\*  \  ...#.. . ... .*.........  #. .*#.##.....\#*#. \.. ...*\ ##. .. .. .\ \.. \.....# #.#\ .*..* #..*   ..* #.. .\#
#.....** .... \. .. .. .......###...*... .. ..# .*\ # ..* ..#.#..*.#*.. .#  \\..** *# .*..*... *#.\. #. .#.#.. .#..... .... #...*...*......*.. ... ..#
#..#.*..*.\\.##..\ ..  ..  *#.....\........* .*.. ... ..#\...#...*.  *.\.. ....#*.... .  #.#.. ... . ... #...  .#. \ .\.\#. .#. # .... \.. # ..#..*..#
# ...  \##... ...  ..... .#...*. .\*...#.   ...#.*. #. #... .. \.  .\...**.. #.. .\# .#. .... ..*\.#.  #**. \..*.. ... ... ....\...*.#..#..  .# .. ..#
#.... .........\.**....*.... ..... ..# # \. #... #..  ..* ..*#.....#.. *# #...#*.* .#.#...#..\ *.. .#..*...  #  *..*.# #.....*.\ .#.\ . . .. . .#.# .#
#.\ . .#. ..*#*\*.. \....# #.. **........#\..##*\.\.....# .#. ..   .. ..#\*.\....\ .. .  .  #.#... *. .\..#   #.  \*# # .....  .\#. . .##... *.#.\.*\#
#..*.  ..... #.... ..\.....*.**... .. *....* .*.\. .. ....   .#...#... ....# .  ...#   .\.#**....... . #* ..*. #...*. # ..*.........*.........   # *\#
#.... .*.....*#.# .*.*#\ .... .###...*..*... * .  .\\* . ..#.\*.* \.. . #.. *.  ...\\\. #*   ...\.#. *\#..  .. . . #. .*.\. ..\.....# ... . ..#... \ #
#. **. ##.. ....*#.*  #*. . ...*. .. ....* ** .\. \.. \.\.  \. *. ..*.*.. *....##*.*..*.#**. *#* ....... ..#..*.#   ..#.*...#.\.....  .. #...*.  ... #
#. *.. . #. ....\#..........#...# ....#..\ ..#. . #.    ..*. ..#.....*.#\###. .# #\.\#. .#......**. ....*.#......#......#..*...*....  *..  #.# ....  #
#..#..  .. # .. *...*....*.  .*. #\*.. ... *.\...\ #...\.*....... ..  *.*. .# .  .*.. ... *\...*# .*.*..*#.....#. ..........# .* . ..#*.. . \......# #
#.#..*... . . ..*.... ......... ...  \\ .......   #*..*#. . ...\#.  . *#**.***... \ . #......# ## .... . .  . .*.* ..#.#..#*\ ...*.  **....#*#.  .*# #
#\.....##.* .....\..\..*# .*...#.\. .. ...   #.. ..#. .  \  *.\* ..#.*....  *\......#.*    ..*\......#.* ......\.# .  # . *#\......#..*\..#.\#. .....#
##\.. . ...... .*\.# # .#.#. .. .* ...... # \\ *  . ..***\.*...*..#.*\*..#..*....... .. *#.. #\**...#...*... *.. .\##....*..\..\ ...   ...... ..\**..#
#.*..*.. ..* . .#.*#.....*###..*...*#...  . ...\\ ... *.*.* #..... .  .........##  ..... *.\*..*.*#...*.... .... .#.*..# ...#.**. #..*.*.... . *** . #
# ..##\... .#*.##* \... #...#. . ......  ...\. ..    * .   ..*.*. # ..*...*\ .#*.#.#. ...# ...  ...#..... ..*.. #.*. *..*..*..*. . *...  ..  *.* .*..#
#.....#*#...**...**... ..#* *..**.#.#.**    *#.. .. .. . *.#..\ ##.  \#...#.....#*   **  . *..... ....#....#.. .*..# *....... .#....  #*.  *#. .#\...#
#* .#  . ..\... #... .   #   #. *#...\*.. *.**. . #..  . \. # .\.. \ #..  **.\...#. *...*...#*.. . .*\.....\.......#..*  .#\...#. ....... #  .#... ..#
###...... . .*. #.. ........#. ..*..#..... ...*..#.**..#..... ....\*.#. . *..# .\....\.. .#... ..  .....\. ..#.. *...#.#*..... .#..  .##. ....  . ...#
#.. . *  .*.\* #........ ...#. .. .... .*. *  \*...  .#.#*. .. .. #.*.#  .. .\..#\\  ..*..... .#.*........*.*.  .. #. ..  . \*#........ ... .#.*..####
# . .* ##...... .  ......* ...   ........#\*\ *#...\.  .. .. *.. ##\. ... # .. #.. .....*.#.*#\#.\  .#*.*.*... .#..*.. ... ...## .. ........ ..\. .*.#
#... . *..# ..  * ..# #* \*. .**\*.. \*\..\ *...*#.\.. . ...#... .. . . \.....#...#*.. .#...*\ .#...... .  #.. .......#.. . ..  *.* ...#..... ... \ .#
#\.* #. .#.#... *##  .*..\ . *.#.*.##.*.#.# .....   . .* .\.....*. .#..*... \..  *...... .#. * .  # # \ #*.*. .  #. .... ***.#..*.\ **.. ..*.#*\**.#*#
# *...***. .*..\..#.**.\. ...... *.  .... .  ** .#  # ##.#... .#..#* ...\ ..# . * .. .....\.. ... .#.......*.#.*#. .##. . ........*\.##*  .. *.\# ...#
#. ## .*...\   \. . .*..##..* .* .#.  ....*. ** ..*.\ #.... \#.#..* *#\#.#.....* *.#\ \.*....\..#.. ....* .\\ ....\# . . . ........* . . ....\..#\#..#
#  ... ...*..#. ....# ... \..##....  . #.. ...#** ....  # . .*\.#..***.*....* .. *...*  *... *. *.#. ......\...\.\*... # .. .\... .#*.* ..* ...*...#.#
#. ...*.  .*...#... ...**.*\*  ..#...* \.....####*#. . . ... ..**.. ... .....*#. .  \...#...  *...**..* ..*..#....#.#..#....\.* ..# ..*.*. .\. \.\...#
#..... .....#*.*...# .#.* .*..*. ...  \*  ..\..# \\.... ..*....\#\.... *\ ....*.*. .. ...*...#.....# ..... #.. *.*\. ...#*... . .. *...#...#..#....*.#
##...*....# . \........ .#*# .. . .... . ... ...  *.*...*.*\....... .. ... .*.\.**.*. ....# # ....#.\#. .. .#..*. ..#. #. #...##..... *...*.     .. .#
#..*.#.*.. .**##.*. ....*. ...*. .   \.. .**....\...   ... \...#. . .* ...* ..*.\ *.#.. .. \. \ ##\ \. .#.#...... .*. ..\ .#..*....*..*.#.\***.  ..*##
#..  .\....   \ ..** ...#...**. ..... **.*#.##....# *.#* . .... .. .#. * \... .#.\.\. .  ..\ .*..* ..#....*  .....\ .\... ......#.## ...... # .#..\..#
#.#.....  ..**.........* # .*.......**...\* .. .*.. .**.#... .... #\ #.#* . \.. ... ..*.......#..... .... \..#...### . ..*\.. .*##...  .\ #...###.\..#
#.\........ .....#.    ...... .. . ..*#*#.  .. . #... ......\. .. # ... ... .*. ..#..*\.\.*.#...\ *.#*.* ** ..#...#..**...  . .*.\...* *#...\.*...#..#
##* .*..#  #. ... #..\ .#..#..\ .... ...*. ...   . .. . .**#. ....*.* ..**. .. #* ...#... . .\*#.**. \..*\. .  ...*  ..... .  \\   *#.#. ## .* *.*  ##
# ..#\.\.*....*..\...*..* .#.#...* .*.. *. ##\*\*..*  .... .. ...#... . ***. ...........*.. ...##... ..\...\. ..*.## #. #...#\...#..*. ..#.....# ...*#
##... \..*  .**... *. ...* .*.# .* .  .....\ #.* ..#  . . .#. *..  *  . #.. .....##.*....... . ..#... ........*. ... ............  \... . ...\.. .   #
##.  ... .. . .  .#......*. .*..\ ...   . ..#   ....... #... #.*.*. .. *#.\..#. ..**. . .#.  . \   #*   . **.........*.. #.*...*...  .*..\.......#.*.#
#.*\  .. .. \  *....\  . . .  .*.. ... ..  #.#.. ..** . .. .# ... ..*..  *. ..#  . . .. *..* ....#.*#.....*# *..\.....  . .... \...*\ *  \. ....#  ..#
##..* ... .#  # .\* . #. ..*......#......\. * #..  .   *... .*. ..#..\...#. . *...#. .#........ ... . .*...#*.#... \\\.\.......#.  \..*.. .\.#. ..#..#
#...#  .*. * \..*...*..  \..... #..* . ... \\\\. #.**... ... . ** .. ....*..# .#..# ..... ..*......#......*..#  *.##..#....#..*. #..*#    . *. .. .. #
#..*.. # . . ........#.. .*#. ...#.\...* # ...... . .*... .**.... ..  . # .*\ .*.. ......*... *...\.. .... .....* ... \..*# ... *  ... ... ..*\.#. ..#
#. .*#.   ..* ..... .....#. ... ...* . .#..*...#*. **.* ...* *.. .#\*. .#.....## ....*...##.#......*#. .. . # \..\. #.*.  . *. .. .... *..* ...**.#. #
#..*.\.... *.. ...*.. # .. *.#*....#.* ...*. .#..#..#..\.......... . ..*#. *  #... .*.....  ...*.* ...* ..##*..\... .. ...#*......**. ......*# \. *. #
#....*. ..\ ... ....# \.#.......  .*.. ##* . .. .....*....* #..* .... ....# .\ ...*.  . .**......#...*. ...*\\..  \..#..*  ...*.........* . .. .....##
#..#.#. ...* \. .  .#**.  .....#.. .. \. . . ..*.* #.# .* ...  .. ..*# ... .#  ...*...\ .......*.*.###*.#*...#.#\#. ....\.   #...  #......* . .  #. .#
#.\..... .#..#..  . .*#...# #  .. .*\\.... #.\..#.   .. .#  ..  #. *. ..*..#\ \.... ....#**. .*.*.. ..#.....#.\*. * .. .# #. *.   .*.......* ......  #
#.*  .. .*.#..* .* \ ##.  *....###.. *. ##*... *#.  #. .  ..**     ..*#.. ..... **.. .. *#....... #..*...*  .*.... ...**..  ..* ..#.....*. *.. .*#...#
#*#.  .# ##.*...\*...##\\**.# #.##..#... .....**.##..* .#..* ..*... *.#.  #...... \# . ..  *.\*..... .##.. \**.#*.*....\. ... .\*. .#  .   * *.... . #
#*.....*......\...  ...*. ...#.. \  ... . .  ###.. . *..\..\#....... .*#.*\ . . ........#\...*.... .. ...#....*# *....*....\ ..# .\... .#..#*.. ..**##
# *#....#..\.\*.. ...#.. . #........* *.. #... #  . ##. . *.  .*.   *#..#*#..*..\..#*.*. ..#**..  .. ...   .* ...*.. #\. .. ............*...#...#.#*##
##.#   .*...\.....    .. . #..  *#\..#. . .. **  * . .#. ....# . ....\... *...*..*  ..\.#. ..\.. .*...# * .#... *  ..\.  . ..*\. .. . \   ..... ..#.*#
##... . *...*.. .....   . \.*.\* .\......#  . .... ..#.*.\ ... . .# ...# .*.*...#....... . .\. *  \...\.... .. # ....#....*.#.#\. .....\.#.\....\. .*#
#..*.# *..*.. ..#..... .*. *#*.#* #.. ..* ..   .#.  ...# ...*#.......*.*.. # ....*......*. *..  #..# .\#.#... .#. * .*  ..... . #.\.   ..#. . #. ..**#
#.*...*.  * ..# ..... ... .*.*. ......   . . .#. *. ##..* *.... ...# .\...... .  ..* . . #..#* ...#..*. .. . *.*. .\ # *..#.* ..*  **.#.. ... . #. #.#
# ....... . .#.... .#*.#...\  ..\...\ ... \.......#\..  . ..*   #.*.#.\. #...*..**.*. ...... #  .* ....# ...*.#*.. .... ..#\\..#    ..........**.. . #
## ..#. #.....\. \.* #...#...#. . ..* .   \.. ..\.. *..**\*... #*.\.#\. ..\.\\**.*.*#....... ...... #  \..*# . ...*..\..\ ...\*#* .#.*###. ... #.  . #
#. #..##....**....... ..#\ .*\..*.. ##* #.#....\#.. ..  .....* \* .\##. .*.  ..   ....... ...  ....#*. ........  .*.#. .\*. \... . . .**.*.....*#...*#
#*... .*..........* ..#......*..# #...... . ... ... ....*....#.\..*#..# *.*.#....##.. ...... #. .....#... .*...*.#..* ..... . ....*....#. # *....* ..#
#.. * \ .. . .\...*... .....*...\.#.#...... *# ...#.*\* . \ #.\.. .#. *  . .....## ...#**.#..#...#..   .\ .*#. *. #*\..*...* ..# .  . ... .  .. *. # #
#. .# ........ ......#..........##....  #..#. . ..#. . #  .....   ......#.*...#\\...\ .. #...... ... .#.....\\...#....# ..#.  .*#.#..* ..  \.* **\*\##
#.  .  ..#*  ..*.  .......*.# ......# .#..* . ... #*.. ..#.........  #.*## .* .....#.. ...... .**#.....*..\.... .. ...\......\........ .. .  .#*#....#
#*.....##.. . ...#. ....**.# #....* ......   . #.. ..  #.\. . ..#..*... #..#. ....##.. ..##.# .** #.**.. .*..#..\.#  ..*#..#.# .. ....   .\#*... ..#.#
# *.\.. ..*.*..* .*. #.. ...# ....... ..*...  ....*.......\.. ...*. *. ..*.. .. ..  \. . ....#.....*  # ..#... ...  .......\.. * ...  ... .#...  ...##
#**....\#.. . * *.##\*..#...* ...#*. . .... # \*. .  .. * ..\ ...  .**........# * .*.......\#. ..*. * ....* ..*.\.* .  .\*.... *  *....*.#...*\ ..*. #
#......* ....#.. ...*. . ## *.#... # \\...#\. *#..##...\#...# .. . .\* ............\. *.*.#.*.\  ..** .... \#. .*..#.*#.***    .. #....# .  ..#.....*#
#.# * ..*. .... #.....\  \\.*.. #..*... .. # ...... \.\#...#...\..  . #.##..*.#*.*.*..*.# ..*. . .\ ...*. .. .*...#.  .#. ..* R* ##...*.. .#\.* ... \#
#.*. ...#.. .  .  *#..... .\..#...\. * \ .\ . .. ...##.  *#.. * ..* #.*\..... ...\.. .. ..........  #......*.\... *\ \. .. *...##*. ..*  .#..... ##..#
#... ..#. ... \  .* ..*... #. .*.....\.#  #.\ ...  ...*#.... .....***.....*# \ .. .#*. .......  .  . #...##..*. . ....... ..  *.. #\.\ ...*.#.\..*..*#
##.*  ...... ..  \. .*....#*..#.\.... .  ..\.*.. ..... .. ..# ... . .. .... ......*.. .....  .**#..\..\*. .#.#..*# .*..  .#...... # ....*. ...  * .*.#
#*........ ... ... *.....*...\#.. .#..**..* ..# .#.\. .# #.*#.#.... #. ....... #..## .....* #\*.\...... ...#\..\..*..#..... .*#*... .*. . . ....\*. ##
##.. #..#...... ......* .#..... #  #*  ..*.#...  #.*  ..#.. *.#.# \ . \.\ ..*. ... ..*.... . #***\... .... .. . *..... . .** . #*.. .*#..# ## ..... .#
##..* ..\.....\... . # .... ...* . ...#. ..........\.  .*..*.#  \.*.\..   ...* .. .*.....  ...*.**\.  ........ .... ...... ..* .... ....  ##*** .....#
#. ..*.#.. .. ....\ .\...... \#..\*.*.*.. . . \ ..#\ ....* \*    .# .\ ...#. .*#....... . ..#..* . ..*  **.*\.#  . \.\ * .\. .*...\..#..* ...\#..** .#
###..* .**.# ..**. . ....*.*...*.##\....\* ...... ........#. \........ ........  .#. #. ..#..#.  .*. ...*.......# ..  ..#..  \...*..# .  \...#.. #.. #
#.*...# .*....\*. ..\*\.  . *....  .# .\. . ....*..*.# \.. ..... . . #.. .*.*.*...#. .......\... \ ....#\ # .#   * #..#. \..\..#.#.*#. ....  .*..\#  #
#.  .. *...#.\*. .*..#*. .#.. .##..\ .. *  **#....*. .#....*   .*...*  .*. .. .**.*#. *..# \..\# ..\.....*.... #... . #*.. *\...# ....\..#*...# *. .#L
#..  . \...#. ...#\..*\ ..#....    .  # #*... . ..#*...#\... .. .*. .# . #.*\......#....**#*.. . .... **..*....#..\.. .** ........###*..# .*...\.. . #
#.\..\*#. . ... ... .#\.    ..... .. .. #*..\\.....*.  ........ . .*....\...*#.\ ..*.. ..#*... . ....  ..#..# .  .  . .# *. .*.\ .#. #.. .  .\#.....##
#*. ..*..\ .. *. ...\...#. \.  * ...#....*..#*  ...*....#*#. .  ......  . ......\......#. ..**......#..*.\ .  *.**\* #......# .#.   ... .. .. .#.* ..#
#.#.  . .*... ..*#.\.  #* # #*  ...... . .. . .*...*\...\#. ...... *...#........    \ .......\   ..  .**##.\#... ..* ..*. ..*.\ ..  ..........* **...#
#.#.*. *\  #.... .#..#....... * ... ..  . *......# .*. ...#...#...... # ..#.... . . ......#....   .. ... .*\\\... #... **. .. ..#..   # .. .#  .*   *#
# ..*... .. *.##**... \...*.  .\...#.#. ..... ##.  . ...##* .  ##.  * . .#. . ..#**.#. *#.\ #*....# #. ...#.\. .. ... ***..#. ****  .*...*.. ......* #
#.. . .\  # ..*........#...*... .*.#. #.* .... . ..# . .*..# .##..  .*. \. ##\ ..#.\......**.  .\.....*#. .  . *\ ...#  ...*. *... ... . .. . .. ....#
#. ..\ # *#  ....##*.*....\  . #  ..   #.. .*#.  ... .*.#. ...*# *\ .#* ...\.#.\*.. . .\...#**.** .. .\. .... .#.#.. #... .\*..#....#... . . ..*.. ..#
#.#.\.* .# .*  ..\##   .#  #...... \ . #.. .. ... .*.*\.....  .*.  ..  ..*\*.#* .  \# .\\  .\.. .* .. **.*........#...*.#.**. ...*..*. .\.* .......  #
#. * ....\.#.  .*.\.*...#... ...\..*..*........#.##.. .....  .*.   \ \..\#...\ \.. . . . .    .*.. #. *. ..*.\ *.... .. ..\.....#...#*..*.. ..... .\.#
##* . *.... . . \. ...\.\.. .*....* .. .. .. *.. * ...*....*. .*......*.# ..#.....#...*  ..\. ......# *#*..*.. ..*. #....*#*..... *. ...*  ..\. * .#.#
# .....*.\.  ..*.\..**...\*.. # . .\\.*.  .   .... *.....#..#.#   ..*.\. .#.# .....* *...* .*..##. .\.#*.* ......###..... #..* .#***...*. ..#.\*.*  .#
##. ...#......*....*....#... .... ....  ..*...#.##..*. * .\ #... ......*# \..  ** * *\.\*. ..#. . .* .... .\*.. ..*\  .\#..... #..#.   . .*... ...##.#
#...  ...  . ..*....*#*# *..\...*#..\....# .* .*..\... .. \ .#. ..\.*..\...*#*.\#.\ .. .\..*...*.* . .# .*.*.*.\##. #....# ..  . ..  \...**. #*...\. #
#  \. . #...*...* \..*.....# ..\... #.... . .*.. ###.*\\ \. ....   ...#.\..*\*  #.#\ ..* .\# . ...*#..#.... \..  .\.# #.**#....**\...\. .\* **\......#
##. \*. .. .\... ........* .. *\... ...*...*\.\...#.......*.... ..\.##*.#....*.. .. *...\#... ..#..#..*. #.......  .... ....#.##*...#.\. .#.....#.*.*#
#### . \ .  ...\...  . ... ..*....#.# *.......#*.# .. \* .#..  ... \....\ #...\.. *. #.*...*  ... .#.*.. ..**... .*#.\.....  .# . . *. # .\.*\#.#.#. #
######################################################################################################################################################