######################################################################################################################################################
#. \# *.#.*.*..... #.   ..#.. .. \\ .# .#. #...  ..#.... . .*.. .. #    .  . *  \. .#* . *. .#.  * ..* ...#.. . ...##.#*\ # .* \. * .. . ....#..\... #
##.**.. #* .......... *#*.#. ....*..  ..#..** #.#* ......\. ............ . .#.*  ... *.*#... **..\ .*..  \#.... ....\.*....  .. ...*..*...\ . . \.. .#
#. .#.*#  #.##........*#........*\... * #.\......**.......  ..\*#.***.\...*   ........** *.   ## ..*..\.......\...........* #*.* . *.**#. ... *......#
#. ..\.. **.  .*. .   .**..*. .#\.*.*...... .#..**# . *#** #..   ..*#.\.**  \....\* .* #...** \* .#..#.*..#* .\*  .  ... *......*  \ ....... .#**....#
#..#.\.*  ..*#.. \.. .....\#.##.\.#........ .....* ..#*\. .#. # *  .\.  ... .......*.. ..*... \ ...... . .. .# ........*#*.*... .... . .#..*.*....*..#
#.... \. .  ..*  *....*.. .\ ..\... .*....#.#... #..\.# #\ #. .\.. * ..\.....*.*#\ . .\... ...... ....... ........*.. .  \ . *##..... .*\. .......   #
#...*......#...*.* . *..##  ..** .  ..* #.\. ....  . .#..##. ..\ .*#**... .*  ..#...#..#.......# . .. #*....*#...\.\.*.#..* *  . .. #.... . . . . #..#
##\#.....*.#..*.... ...#.#.... ..#..# *.. ..* *.... \. . .## ..*#. . \ .. .. ..*...#....##...... ** #..... ..*.. . .... ...##. . . . \.. .*. *. * ..##
#.*.#.\..\...... #..\*......# ..  ...* .*.#. .*.*....#.... ..\.... #...#**  .#. ..\#...\*. . ##* .#....#. .#\...\ ....#.#*...*........**..*.   ....\##
#.#...   ..\.\...* . .. ## **...*...*....#... .# . ... ...#..\. **.....\\.\..#.#. . .... . ........#.. .......*. *. *\ ....#\.#\\..\***. ...#.. *... #
# *..  .. ##..#.   * .....*. .#.*#.#.# .. # .*#..\....#*.. .*.... . ...\ * . ..#*   ...*. ....#.*. *.  *........\..*.*# #...\.. . ..#. ..  . ......*.#
#  . ..#..#. ..#.#.. ....\ .. .. ..*\\ .....##. ...* ....*#..  ..  ...  ###.*.\.\.. .. ......# \...\*.##* . ....*.. *  .*.##.  *.*.\**.*... *.*..\.* #
#.....\\#.. ... .....* #*.. ....# # .*..**.... ..* \*.......  ..\#...*  .. ..**...*. .#* .*. ...#..\..*.#   ** #  .*....# .. #\* .# ....\.. *.#.....*#
#.#.  .... ..*.#..... #  . #.**  ..#.. \...... # . ..*......*.* # #...#.#..*. #\...\...* ...... # #. .*.\.\..  . . ..*. .* ...#..*.\.. ..**#..* * * .#
# ..  .  .  .......\.. * *... ...*\..# . .. .*#.  .. ........\. ..  .\*.... .*.*..##.*..*..*.  **#..#.\\.# .....* .*   #... .\ .*..... #*...**#....*.#
#.*....*.*##...* ...##.. ..*..#..\..   ..\..#...... . ..#...* ..##**...\ .... **.. .*  \*  # ...  .##. ....#... ....\.\**.. .. ..*.\.\..#...\..# *#* #
#.##.  #...*....#....*.*###.## . . . . .#.. * #.. ..*. .*..*\\.*.# #.  ..* \.......*. *.. ....... ...*.*.\....*.......\* . . .* *.  # #. \.*# . .# .*#
# .....  .\ . . .*.##..** ...##....*#...... .  .#.... . ..## #.......*\.*\...*#.\.. ##.  . ..**.\...... ..  . #.*  ** *.. ..#\#\. ..#........* .*#*..#
# * .#\**...**...*\.. .#... #...*#........*\.. ....#......#.. ... #. . ..#...##\\\ ......#.# ...#.. .*.#... ..#. .....  ...#.# ........\\. .* . ..*..#
# \.. . .. . #..\.. \*.\. ..*#\*\ #.... .. .*........  .. ...*. #*\.*....... \# .  #.#.. #...  * #.. *.....# ....##.**#*#... ... *#...#. \\.# .#... .#
#..# .... ..*#...*.* # ...\ ...* .*.  ..*#.... *.# .*... ..\ ... # *..  .. .*. .##. *. .....  \.. ..... ..#.#  #. .#..##...*.. ....* ..... ....... *##
#. .#* .... . #..   .# \#*. ....  .... ..  . .* .*....#.   ..*..\... ...*... # .....**...**#.#... . \.....# ..  #..#\.. .#.** * .. ....*... ...**. ..#
# .. #.. ..\  \##.*# .*.#.#...# .. ...  * ..#.. #... . ..\.#..\*.. . . ....*#..## .#...# .** \..#.*. # . ...  .\. ..\....#.. . # .*...... ....# ... \#
# ..... *.#... *#...\...   .. .... .*##....  .*....  .#....# ....\........#..\ .........*  ..  ...## .\ **.#......* .#. .. \..*.*..*.* ..  .. ...\...#
#..#*......... \. ... # ......*#.. .. .\\.#..# .... .*.. . ...... . .*.. ##*... .\....*..... \ ..  .\.  #*.* ... .  ..* # .*... \\*.  ....  ..#.. ..\#
#... .  #*#*.\.  ....#...*.* .....\. . . *#.. #\ **...\###. .#\... #* ..#............* *.  **.. #  *....##.. *#..*....#....... .# *..\*. ........**..#
#...#\ * .\\ .  #..\ ....  .* ........*##.*.  .# .. *.\.*..***##..#... ............  . ....*.\#. .*... ..  ..*.*.*.... . .\. .\\* . \..#........ .* .#
#* ....... ..*.... **. ... ..*.*  *. #.\#* ...\#..# .. . .* .\...  \. ...* \.#\. .. ...\.* ......... #..\.. ..#..*.*. . .*#. . .\.#  .* ..*#. ....*.\#
#\##. #\*. . ....\ .*.. ...\# .#. ......#...*..*....*\ *.#  #. ##.\.  . #......# #..........\.. ....*. .*.*##.. . \..#*##.... ...*..... . *.\.##*\.*.#
#.. ... . *..#\........** .#.. .....\.\.. ...#.\ ...... .*.*.*\ .*....... ..... #...\.........* \.#\.#.#\\.#.   . #.#.. .*... #....*...... . \.. #.. #
# *......#.#.**#* #  *. ..*.#.\.#. . .\..*.*.. .. . .*. .#...#...#...\\#. .   .. ..*..... \...* ....\#... .. .... * ... .\..#\..*. .* *...#.....\\  .#
#.. \ *\..#*# * ... .#..\ .*.... .. \ .... .....  #*  .*. . *.\. \\.....   ..#. .....##*  #.#. ....* ..... # ..#....#.#. .#.**...#. .. .......* #.\ ##
#..\.  . ...**##... . .#......# ......#*..#\.*  .*.*#....\*\..#.* *#..\  * .**#.. .**.*\ ..* ..\ .. * *. . ..*\....* # . ..#.#. .#\.  .  #.\#. *.. ..#
#. .\#.*....  *...\.##* . ..*. \.\.*##\.# *.......*... .\.\*... #*#.#.  ..... .\..... ... . .*#.....\ ........#. .*... .   #.*.#...... ...#. .\.. #..#
#....* ..*....\. .....#..*..*\.... .#.*.\* .# ..# ........ ..*........ #*  #.... .\ .##\ .*..#.... . #*....# ..** .  #....\.....\ #.# .. ..#.**.*...*#
#..  \\#.*.#.*\.#..#.*.... *. *# ..#\...*.. .......\..........*..  ....\. .#.* ..*... # .*  ...#  ........ . .* .** .. . . ...**....#.*....* .... .#*#
#.# * #\..  ...*..\....#*...*...#*... .. .   .# ... ....#. #.#.# #\ # .. ...# . \..*...  . ....... .\  ..* ... ## ..*.#.#\. . ... ..* .#.. .*# . .#* #
#.\. .. ....*.#\... .....# ... .. ..*\..... ..##... ..#.* ... .. #..*..#.....*#. .#.. #*. .\... .  .#. .\#...##..... .*...\....*...#. ....\. .. ..  *#
#*. .\. ........# \\..#.   . #....*.... . . .#\ #....\ * ......\.*.\..* .. **#**.*...#.#.#..#.**.. ...\ .# .....*# .#.  ...#.. *.... .#*. .....*.*...#
# # . ..  .. .*..#.\.*# .....   *..  # . *.. \.. ... ....... *#... \.... .... .#..*..#.... ... ..#..* #**.###..#* ..\. ...#.....#*.*.... *.  .... *. #
##....# ...*.#. .#. .....##. #.  *.. #... . \  . .\#.#  .# .... #**...#..**#.. .*...#.*. #\..... . ....  ..#*###...#.... **  * .. .#.#. .\ ..*.#.. . #
#. *.##*.#. .**...\..*#.. . *#.* \.......  .#..#... # . * .* \..##*   ..  . .\ . *.#\.. * #.##. .\ .#*  .#.  .\..\. #\.  .\.*. . *..* #.*.. . \*... .#
#.#.......* \... .\\#...   . *. *..\..*...*. *#  .*........#*\. .*...\.#.. \.#. .#.*#......   ... .. .\....**#... ..#.*.*     .  .*.....\...... .# ..#
#..  .....#  *. .#.\*  * ...\.\. . #. ....  \........ ...**...    *...#..\... *..#..... #. #.. ........#. ..*...#....  #*...*... #* **.*.... .. .... #
##*..  ..#..#\ .* . . .. ...*....*. *..* # .*.\   .* #. * ..#*... **.. *. #\**.  ...**...*...#..#...#.#.#.*.*.....# .  # .. ..* .... ....*   .. * ...#
# ..... \.\.\.....\ . **#.# \# .*.*...#..\ ### . \ \ \  .. .. .\....   .. .  .*.*.**.\..#.... * ...#\. # * .#.   *........... * ..#  .\ .. ........ .#
#*. ..*\..# .....\. ..\.#.... .....#. .... ......**.....\.# ..  .... .... .## \* ..# ** . ..#. ..  ....*.#   ..... .\*.#. * .. . ...  .*.  . ......#*#
#* .....# .*\.#..\\\. .*#....*.. **..\.... #.  ..* ......... *.* .*. ....  *.*\.# ..*. ....***\.. #* . ... ....* ..\....... \..... ##  .. .*.#\#....##
#..#...  . ....*. ..... . ##....## ... .  .\  .  #..**....#*#..*.**..*#.. .....*\...* ..\*. ...#. \.. ..#. .## .#. .#..# .##.\**.\....\. .. *.... ..\#
#.#.**...#*.#.. .\ ... #..#*\* ...\ . # *.....\.#.. * ..\.**#. .... . . \. . ... #.\*... . \. .\...#. ... .... .... .# ... .... ...#..  .. * ..   ...#
#.#..* *..*...  ..   \..... ..* . .\*.\.*.. ..#*... .*#... ....*..*.. *. .\... ...# ..*\*.. ...\  .* ...#* ........ ......  ....  ..**. .\#.#.#..*...#
#. ... .... ..*.*.. ..#. ..##  . *....... \.....# .#....*..# *.  *..#*..........#.. *.#..   #.#..\. *... ........*\ ..*#...* .. #.*\#.#... ..*.\.*#..#
#. #.. ..... .##....\# ........#  . #\#..*.. . *. ..#.........* .  ....   ..** ..# .* .\..... ..*.. .....  \ ...... .*.\#. ...\# .\. .....\ ...*. ...#
#.. *... .....*\..\  . ##... ..... \*. ..   ....\.....\#\..#*.**#..\... ..\.....*# \ *#.\#.#.. *..  ...*#.......*..# \*... .  .... *.*. .. ... #..#  #
#.\##. ...   .#**.*...*#\\*. ....*. .*.. ....*.*  ..\.*.#.#*. . \..#. .#\.. ....##. *...\....*.* . #....#.. *...*. .  ....*.#...*...* #  *.....#..*..#
##.#*  *.\.. .#  *.\.**...#...#....\...........*\#.. .\. #.# .*.#.* .. *.  .*..*. \.....*\.#\.* #. . ....*...\ .#...#  ...**  . ... \.#.......*# * #.#
#\. *.*. ...\#.\ \*... ..* ...#*. .#\.*...... #. .......*..... ... ##.....*#..... .\. # .\#\.. .*..*#..#..*.....*.. ........##. .. ..*.....\  ... .#.#
#*.** .# . . .# ....  *...*   .. *# #. .#..*... *.#*..  .. . . .... *..*.# #\...\...#... ...# . *..... .# ...#.*#. .*#.*..# .....# .  ...* #..\......#
# ..\ .#.#.. ..  \ ..* ..**\ . \.\.# . #*\#. .*. .* *#.*#... *...... \.. . #.\#\.*..*....*. ...........#  ...#....... . . *. .*#*.... .. .*  .....#..#
#.#\ .*..\.*.. .\.*. . ...*..*  #*.# .. ...  *.. \..... .  ...\\.... .##.. .....  *.*...#*\ . ..\.#......**....... **... #...# ....* ..* .*..*..#.*\.#
##.  \. ..*.....*..\..# \......#....#. ...... * #.**..... ...... *.  .......#* ..*...... #.*. *...*..... # ... ...\#. #..   .  .## .*\.........*..* .#
#.. . . ......*..\  . .*..#.\.#.....*  *..#.*\.. ..*...*..*. .....#.*\ .\ ... ... \.*.... ........\.*.. #.. .  #..  #.#.. .# ..\.#.*.... ......#.....#
# .#. ...#* #........ . #.. .# ..#. .. ** .. . .. .*. . .......  ..*. #*......  *  .. . #.  ... \#.\ .#  ...#  \.###  .. #.#. ..#. . ... *.........* #
#. #..... \  #...*....#..# #*. .#... ...   ......#\. .\.. ..... . ... ...*....\.. . .      * .##. ...##....\..\.#\... #.#..\...... ### ..  **  .. .  #
#... #. .*\.. \... . \ #.\. .*.* .\. #..\ # ..........*.. .#*.**..*##.... . ** ... ....# ....#..\**.  .# .* .  . # *.#.#.. *\.*...#\..#*#.#.# .   . .#
#.# **#.*.....\\#. .    .* \.. .. # ..*. . ....  ...  .#\ . . ...\ ...#......\...**.#. ... .#*#*.#  ..*# ..  . # #\.. ..#.#\.. #... ...\.#  #.....*.*#
#*..#.#... *.   \ .\.*.*.....* ..# . *   .#..  \  #. ...#  *.  ..#....* #. . ....  ...... #.*.*##....... ...... . *# ..*##\\#.  ..*.\... .*..#... ...#
#...*\.*.      .  .*..##  .. #....*#. ...#...# \.#. .....**.#.*.*.*.#.*.  .......\. **#. ..#*.... ...# ....**.....*...*.  \.... *# .# *...*.#...  \\*#
#\..* **.. ..#..#......#.#.. \ ..... *..... . \...  * .\#\ .**...\..*..# #  *\.\. .....*....\ ..    .*......\.\.....*.*.##.# ...#..\  .. ..... . .. .#
#..  #.#..#*...  .#**\*... *    *..#.. .   #..* . *.#...*..*... \.... * .#.*** \. \.. .....*. *.*.\ .# .\......*..*.....  \ .\..#...\ .. #. *\ .*#...#
#........# ##.. ..*\.#...#*. ........ .##..*. .....\*.*#.* . ...#.  *.#......\*..*\. .. ...\.*.\.*. .*..  ....\.*.#..** #\.#*... .. ....   .*.  .   .#
#..*#. ........ .. ..# #...#... .*\ . #. #.*.. *#. .. ...#........  .... ..\.**. . . ... #...\.. *. . ..  #...  * ..\.#.# .#**# \.*..\*.......#.###..#
#...*. . .. .##\ #. #.....##.##* .#.# \ ..\.. .. .\...#..... #*..****.*\....#..... .#**.  *. ##.## *.\ ...#..   *#*. * .#.# . ...#..* #.  ..#..  . # #
#..*..... ... #.*.. ..  ...\.  ..  ...#...\...  ...  .. .. . #*#..*....   .* .* **......#.#. .*#.  #.* .*.*..#........*# ........... .** ...\..#  .. #
##.#....     #..#* *.*  .# . ..*. #.. . ..# . ..*### ... .. .....*. *... \..\.\....#... .. .... . .#. ....  \#   ... #. *  * .......   .\ . .*. *. ..#
# .....*#.. .*.*. *##..  ........ *...# ....#. #..* .#.*..... \.....\..#.. . #....*#..#..  .. ... . ...\. ............. .#...#  \.#\***.. \ .. ......#
#.  ..#. ..*..*..*.*....*\*.....  * .. ..\.*...  ..*...**.## ....#..*   . *.. ....** .*.. *..#.  ...#.....#....  *#  .*..\ *#..#. . ..  ......**.....#
#..\.#\..#*#*.. #  ..\ #..##.\.#......\. ..   ...  ......*. * .. .*##..   .\. .. *## ..... #.#.......# #.  ...*..*......  .... #. #.. *.....\.*. ...*#
#...*#* .  ..#\......#.....\. .# ... .......#... . .# .....*  *.* ..#.#. .....\..*.#..*.\ . . .*.. #....*\ . .....*.......**. . .*.... #.. ....#. .*##
###.*.  ....**. .*.*\ .*.*.....#......#.##\  .##*  #..*.**.. ...*.......\\... .*.. #. # . * ...  *.**..#......*#.. ....*.*.#..\.\. ..#... *. #*..... #
#. ...\.\.*** ..#...\...#.   \....  ...*.*... ...#...#..  .#. .\. .  ..  ......#......**#..  \......... *... .. #. ..#   ....# .\*..\..\* .#..* .....#
# .. . .*. .*.*.. .  . *\..*. *.*# ......... #..*... .*..*. .*#.#.###*.....## .#.#.. ..\.#. #.. .*. .#*.\. .*........#..*..\.#... .# * ..\.. *... #. #
## .....*.......**.#.............. *\\.*.* # \ .\  \*.\**..*...#.. #.# .... .. .. # .*..* ..\.*.# ..... ....*#.*. .#.*.**. ..##.*..#. .. \...... ....#
#.\# ... . ..#*......#... ...* ...#.#...\\.\. .. .# #..# ..  ...#.#...... . *... \... ..#   *.. ..*#*.*  ... . ..  .#\#. .  \....##....   ..*.. .....#
#.\#...  . \.\\. **.\.*. ...\#... .#...# \ ...... .\ ...#. . \**.\\  ...... . .*. .....*..#. ......\.* *... ..... . .. . ... ..* *.....\.#..#. .*. ..#
#\.*...\. .. ... ..*#.#.. ...... . .*.. ## #...* ..#.\#..  .##.# *...... \ # .#. . .....\# ...#.\ ..#.. ........*  .*..   .. \... .*.. ..#. #. * #\. #
##..... #.\ ..#.*... ..  .*\.....\# ....#*.\*...\.#\  **.*....#. .. .*#.\.*.#. .#. #......  .. ..#. .....# ...*..*##. ....##.  . ..\ \# ..#* \.. ..  #
# .\..  .* .#.*. .. \.. *.*..****#.*#....... .. # ..#..##..\..# .#....#\  \. . .. #..  .. ..\  \.#..*..*..#......... .\...*.* .  *.*. . .#  ....... \#
#.##... . *.**.* ..  *. .\..#....#*..  * ....*. .... *.... .  . *. ..\..  ##.#*\ .* ..\..#. ..... ... \.. ## .........\.**......... # ... .\..\.. \. #
# ..###\.. ... ..# .... . .   *. .. .. ...#... * .\..**.....* \....#..\.#...\ ...... ##... .  .*.. ... .... ..\..*.#.... * #. *#. #...\#.#..  *.#..#.#
#  * .#.# ......*.* .....*   .#...  .... *#.... . ..*. ...##..\ . ...# ........\.\ .*. ......#. **.#.# ...\ ...  *.\ .*  ..*...#.#.\..#***....**....*#
# ....\ *.\.. ..  .#.....\..*..... .# .*....\........#  ..*. . ......*. .#.# *..#..#  ... *.*...*....*...... ....*. ...*#*.... ..... ..*  . \......*.#
##..* ...... #\#..## .#.. *. . *..*..*  .\.\.*.*....... .. ..**...#* *.. ...\... ... ... .. *.#***....**....*.\.#* .#.#.. .. . ... . .. *.#...    ...#
#....*.\*.*....*.\....  ..\*#.#.#..\\#.#..* ..  *.\ ..*.*\.*##..*...... .  .. ..#.*...... .... ... *.. \ #... ##...## . *.\.#.  ....\.* \\. ..*.. ..*#
#...*.*.... .  .*. #.. ..\...*... .#.#..#.. **.... .#. *#. *.* *...*#..  .. .###*.. ... #..** *..##.*#.\\.\.##** .......  . .*  . ....\ ###. ## .\ ..#
#....\...*.  ....#*. ... .... \*.\..#..*\...#\ .. #.  . . .*. . .#. .# * .**...#.....*.\\......*. . *..*.\....* .. .* ......* .## .*....... . #  ..#.#
#\..\..*.....*# ..*  ....*.. .. .*..#*.*.....  *..   #..##.* . .  .\..... .   #.. *..... \..*   *.. ..*..#*#. ..   *....\\.. . # .. .  #.  *. #..\...#
#. ..#.. *.. .*..*........* . .#\\.*..... . ..#..  .\#..\ #.*#.*. .... ..  ...* ...\.**.*...  .* . .*.   .#.#..\.#.. \. ..\.. ..#.###..\ .. ...#  #.\#
#....#* ......*..  .#..## .......#*\...* #*\  ... ... ..*##.... .......  . .. .*#.*\ *\..... . .#*...\.#.  .. ..#. .......#...*..\...#..*. . .*..*..##
#.*. ..*...*. .#.#. ....# #....  .\#. ..*.*.. \#...*.\.. ..#.. # #.#.  ....*.\.... *.  .......*.\....\...... ........#.*...#.#..#. * .. ..#\..# #.  .#
#.#..\...# #  *... .#... .#.. ....\ *. . #...*  . ...##. ...  ....   ....*....#\*..* .* #..#..#**..\#.*.#.##...**..*.**.....*. #....  .. ## ..#.\.#  #
# . .... ...#. ...#.....#.*.##\.*..#..\..*  ..#.\.. ...*..#.#\ ..#..  .... #\. *  ......*....##..\. .. .*..*..#..\.. *....#*# .**...*.. #.. *   ..\ .#
#..     ... .  \.#\... .#.. *#.........\.* \##..*\  #.\.**..#.# ..* ...  . #.#.......*. *.#.. *... .... .# ## ..**#......*.   .  .. \*. \..*....*...*#
#...#**...#.. ......\....# .\.#...##  ...##.....#   ..*..*.#.... ....   #...#*.##. *#.** .. ..#.....# ## .. .*.* ##..   .\..* # ....#*. ......*.* *.##
#.... ...... \ # #.#....\. .\.. .  .*....  *.##...#.  . *..*.......*\..\..... ..#. .\.\....# . ..*..*.. ..*..# .\....*.... #......**.##.#* . ....#..\#
# ... .#.\# ..#...#\#. \..... #..\\..#.. ...#.. ....   ..# .#.. ..... ......*...  .##. ....#..   .......#\.. #.... .  ..... ..... ..#.*.. #..#.. .. .#
#..*.\. . ...#.*.**.... *. ..   ....\# ....... ..#......# .# .    #..*.\.....\.. . #..*# .#............#....\.#.*... .*#... ....... .\... . .*  .. ..#
# #.#.....  .*.###...*.. #. ... ..* .\..#..\ *.. ..#..# . .*   .. .*.* ..........\.  ...... #...# ..... \.*\** ....#.  #..###.... .\.* .....*. ...*.##
#. . . ..\... # *.*......*\  . ..#..# #.* ......*.......# ..  ...*.. . ......***#...... ...* . *. *\*.   .....*........\*..*....# . ..##.*... ...##..#
#.  .* .#  . ..*.\\ .*.......##.....*\..##....*\..#. . .*#..#...* *...#.\*R.*#.  .\.#... .......#\.. \.*..#.  . ##...#.*.*..\... .* .*. #. \#... .*..#
##.......*..* ..#\**..#\\...*...*.......*#. . .. .. ..\*#  ....  *. .... . *..\## .....#.... *.......\. ... .... ...*.. ....#..  ..*. #...*. \..  ...#
L..#.. .#. .....#. .*.#.#\ . . .\\\.... **..... ... . .* #* .... ..*.  ..#*. ....*.#  #..#..........#*  .*...#.* *..#. ..\....*.* #.\ ..#*.#\......# #
#..# ....# .. .* ...  .\.... *...#..\..   ... .**..\ ....*...#.. .  ...\ ....# *# #\....#...#.  ...*...*#.#\. \...*. ... . ..*\#.**.*** #. *#*.#..\. #
#..#....*...*.... *#...\.....#\ .  \ .**.*.. .. ...# *...\ \ #..# ..# .* ... * .... . ......#*.\.#..*. * .. ..** *......* . .# .....#.#.*....#.#...*##
#*....**\\#***... ..*.\ #...\.#. *..  . .... .*..##. . *#...*.*\. .# \.#..\.#.  . . .# \. .... . **.*\.*.   .*#.#..#....   .*...*#*\.#..# ..**.**# \.#
#.  . .... . ..  #... .... ...#\..  ..*  \*..  .......# . .\.#..\  .#.....  #...\#.\ *..*... .. ....*..#. .*....**\..#... #.. **..\....*.....# . # ..#
#.##..#...#. \#.#..#..*. . ... #. *#. \. .\..#.  .#*......#.# ..#* .#. \... ..\\ . .*..#. ..\ ..... ....##.**  .. *.....\   .. #. \...#. ...*..###...#
#.#\. ....\.#**. ....*.... \..  \#.....  .#...*.. . ....##.. ... .. \...  ...\ *... ..\   #..*.. #....... * ..\. .  ..........\#...*\. . .. #.#.#. . #
#..\.*... . .#.#.. ...#.. #.. ...*...... .*#......*.*#.....\*....#*..* .. ....   . ... **\....*. #.. ..##*.#.**.#.#..... . . .##....\...#  .... . .#.#
# .\......#.#..\\ #..**..\ \.#..  #..*\*.#.#.. . ..*\... * .  .# . ...#... .*.#.##..* ..#.#**# ..*... ...* .#..**#..     ...\..... #.\#\....\. .*.*..#
##*#.# ..* .#.#.** . .\.\..#. .#.*..... .....*#*. .....#. . *#....  ...*..#..#. *  ...*.\ .\* .....** ...... *. .#*.. #*..##....* #. ... . ...\..*..*#
#..* #\ ..*... *.....#*. .\.*.... ....#*.*..#.....  ###..... #\* ##\. *..  ..#* .* *.. .. * . .\#.. \.#.* *.#... ...#........*...#.\...#   .##.* . . #
#..\#\..#**#.## #.. .*..##\*...*.#.* . #* .....*.   *...... ...*..#..*..**... ... #.. .*.** . *..\ #. . ...##.#.. #*.*\...* * ..*.#**.. #...\   ....*#
#. .. .... .*#......\  .. *#...* *..\*....*.. ... .. *.... .*.#..# . \ .   #.#....*. .\ **...\\....#..# \. . .#* ..** .....#. ...*.... ..#..#........#
#. ..* *.....  .#..#.#\.*..# \  *. ...\.. ... .... . #..*....\....*..* .. .. .#..*.   ...\.  \\   #\. * .#......\....... #.   .......#...*........#. #
# #.   ...*\...\# ..*..\...... *.* #..#... . .. .#. ...## .*.*\##. . ..*...#.. . #.*.* . \#.#...\..\#... #....\.#  #  .#... *#*.... .*........#.*## .#
#.. ....\.* .**....*\.#..\ ....#. . ..*#*\.*.*.\..... .**.\. . .*. .*#\  ...... *.\.....#.*.. ... .  .\. . .* #.#*  #.\ ..*  .....*....#*.#* .\.*... #
#.. . #.........#........... .. \*........ ..  . ...##.\\*. ....# #...... .*\. * #. . *#  .*  .*.*. .....*.......#.. .. .#*....\* ...  * ... *..*.##.#
#. #*....* ....**.\.... *#..... .#*.#.**. ........ . ...\#..\*#.......##\*#.. .    * ...  *.#.. ##. #\.*#.*\.. ....#.*...*. .*.... .. ..\. . ..*.#  .#
#..*#*.  ..... .#...*..#..* ..#  .. ...#...#..# # .*...*..#. *.*.. \.*.........\..#.##....*....#.....*.#.* ..#... ...\. .. .#.  \ *.. \....*.#. \\..*#
#. .#.*..... *\.#**. ..\.. ...#.#..* ..............*. \.*..**........ ........ .#*\.#.\.*.... .#.#  ..***#...#...*.# #. .##...**.  .*. ##.  . #..**.##
#........*.. ..\...... *..   . # .    * .\.\...*#....*#\\.*#*... .. .... #\*.#...\. \ .*...*#\*\.#  . ##  . ..*...\.#..\*.**.... .. ...\.#.#\.. .  # #
##..\. ...*. \#..#.\.\ ..\.* ......\# ..*..\#..*.....#... ..* .\*. ..#\. .. \...... ... . ......# ...#... .... . .#.\*.....#..... .......*.*. . \*...#
#.....#.#.#*....  *.\...\.......... ** * .. . .. ......  .\#*#..  . .#...*....*...  .... \.....# .... . #..#.....  . .*..  .*. .. *.*..#. .. ..*\.#*##
# . *.. ...  .#. . . ...#\......#..#.*. .....**.  #..  ....   .... \#. .\*   * *..*\.. .** ....*  ....... \.  ...   ..  #*....#.....#..\ ...#.*.*..\##
#..\...#.*.... ..#*.\#.#.. . ..... ...... . ....  ..*... \.*.#... .  . ....\. ..\.. .. \##.\  ...#*.*. ..* *..\.#.**....*\*.*. #.. *..*. *.###\..\...#
#....#*# .\ ...... ..*#..#.*.#* ..#\.#..#.... ...... .  ...**...*.....#.. ....  ..#...  ..... #.  .*.#. *. #..#.. .*..*#.*..  .....  .##..** ..  .*#.#
#... .   *... ... \.  \... .. ....#.*.\. ...#.*#. .\ ........ # .#..... .  . ..\.*... .. ***#...#*....\  #.. .##\.. .. .   ..\..# \*#  * #*.#... ....#
#*..#...#.#.#.. ...\*...* #*..\....*...... ..*. \ . ... #....  #..*...#... . . ....\\ ....... ...*... .\. ...*....#*.  . ..... .... ..... ...........#
#*.*.. .#....*.*.  ...#.**.#..*.##.#..#..*....#.\.## ##.. \...\....#...#.* ..##*#.....\#...*.# ........#\..\.....\\**#.......# .. . *\... .\ . *#  #.#
# ... .*..*#..#*.....#... . **.# .##*\*.\...... .*#..*.....#. . *..*.#\ * .#.#. . . #.#... . ..*. *#.#.. ...... ..#*#..*  \.......  .*\.# .#. .*. ...#
#.....#....  . . \  .*..*.##*... ##..\.*\.. .*\ *. ***.....\\. #*.#...* .**.. .\. .* ..* *.  .\#....#*...# #*#..**. .   .\.... .\ .\. # . .. \ ..**.##
##.#.  ... . .. *.*....\#  ....** . #... ....*..... .*... \#.\... .. .. ...\*..*...# . . # *.#*..  ...*.. .#.  . .  *\.#.  .  #.*.*. .*..*..**... ...#
# ...#.# . #.. .. .\.*.#.*....* # *. ..  .. ..\ #.. ..#....*. .**. \.*..... ... . ..#.. . .. .*#.. ..#..#.. . \#............ #\ \.....*#... *.# ... .#
#.. . .#.#**.. ...#.*.#...\ ..##. ...\.#. .. \*. ## .*.. ...*.\ . . \*. # .\. ...... *   ...   . .. .. .. .#.   . .#..#.#.. . \ ..   \ ....#\.... *.*#
#.\  .\*. ... . ...##*.*... ........* ..#  ...#...\........ .#. #*.. ....#.#.\\#\.#.\..  ....#  ... ..... .. *.  .\.. * \.. . .. ...#..*.\ #. *....# #
##..#. ..##.**..  . .#  ...#....  \.  *# . . . .##*..#.. \  ..#\.......\. .\#*..\. .#. .. ..#.#\.\**..... \. ..\ ..*#  ...*.. ........ .... .  ...*..#
#......*... .... ...  ..#.. . .  . ...#....#....*#.* #  ..*......\. #..#\.. .  .\*. .\#*......#. .....  *. #.*.. ...#**... #. .#..#..   ... .\.. . ..#
######################################################################################################################################################