######################################################################################################################################################
# .... .\*.... *...  . ... # .#* ..  .... ...# .\ ##.\# .. * ...  ..#**.*. . #*.....#. #.*#. ...... *   #... .\...*...#  .  ..#.*.  .\##**.#.... .  .#
#..*..*..***\*... ..*....\...\...   #.\#\ *..#.#.# .... . ...*.... ....*.....  *.......#  .. .#*\.\ .*. ............. .#.*# .\.....#*..#..# .#.....*.#
#..##......#.. .... .. .  .#*# #* ... ...*...*.\*... .* .....\..\..#  ... .. #.....  *......*. .*.#. . ... .#..*\.*.  . ....\..*..#...#. ...#... * ..#
#... *.# . ...\ . ....... ..... ........#.*.....#.. #**....\.... ...    .* .**  #*#.. *# .. .* .\  #......*. ..* .. #... #......... \ ...\\..  .  .* #
#.......*#.#..  .#... *...  *\.*......   .... #.... .*..#\. # * *. .. .# .\.#.\.#..#.....#..  ..# ...\\.#.... .#  .  . *.\... ............ *..\ \. ..#
#  .**...*. #.#..*.##..#..\.\**#*.#.*......*..\...**.. .. . . .. ..#.\.* ##.\.#*#.  ..#. ... * #...*..... ......#* .#..*..  .... .#..\.\.\   ..*#.# .#
#  . *..\ .......  . *. . .*.#. .\....* .#. .\  . .#..  *#. .##.# ..*..  . ...#   ..\#.# # ..  . ...* *###. ....# #.** .......##  \..\ *. . *#\.*  . #
# * .*.. .\ ...#..*.#*# #. **...  .  .*.*..*...\ ... .. #.\\..\ ....*.*. .* *  . .........\ ..........#*. **...# ...*\........ #. ... \.\ . . ...* ..#
##.. ..#.#.. .*. *.*.....#\.#\.... ......   .....*.....\ .#.* *..  **..#. ..##. .* ...*\ *. . ...\..#...*#. #... .\...*.\# #. #..\*#..##.\ . . ...\ .#
#.*...#**. ..#...  #  .*... .#..####. #....   *... .* *#.#...\\..... ..*.. .\...  ..   *\..#* ..#*... *.. #.*..\   ....\*..*. ... *# ##. *\ #.  *   .#
#..... .... . *.  .##...... ... \#*.....  \*.*.....# *.... .. . .   .#.#.......#.\..*..##.*.*..* #\..... ...*.\.  * ..*#.... .  ..**..* ..#.  ..* .*.#
#.# .#... *. . *. . .. ** *#*......*.#. *\ . .....\.*.....# .* ..*.. #. ..... ...**..*\...#.... . # ... .# * # .  **.#..#..#......#\.#. *. *\.** *#. #
# .......#\ . *... ..*.\.....  ..  . ... .\...#.. .*.. .#*.*....* ...... ......#\ ... .... .#\ .#....  .. ..... #.. ### .. ..\#.#\..*...  ...*. .... #
# *\ .\... .*......*\.#. ...#...\*.##.*  . ..*... *#.. *.*.* ..*..\.#....**..#...#....\ ..\.*... ......*.......*#...#*.#\#\.. .#.... .. ........ . ..#
#... ...#...  ##...   \. \# ..*. ##.. \.....# *.. ...*.... . .... . #* ###. .*............. #...* *#.* *..........\...  ..*.  ... ...# .# # .#.   .. #
#..\. # . .*....*. #*.*\...........** \.* *  ...***...  ....* .*..*. *...##### *.\*....*..\.....\ ....#.....*#  #*#..\......#   *....#.*  #....#. ..\#
#  ..#.. *.\. *.*.\ *...#...  ...*.....\....#.....* .  .... . . ### ...*...*#. . \..\.*....\\.#  . ...###  .*#. ..\....... ..\\..  ..  .  .. .  ....\#
#\. . .#* ..*. ....... ##....*.*\ .\.\ .*. #...###..# .. . .#.* . ....#.. .. . .#*.....# \ ....*.*....#.....*... # ... # .#...*  .#.\*#.** .. .....* #
#....*\\..*#... #.  ..\##..*..\#...#..* ..\#. ...... ...* ........\.#  .... .... ..  *. *.* *...*.. ...#.   .... . \.. ..#..#......*..#...*..  .....*#
#*. .\*.....** #...  ##.#\.##..#**  ..\.. ...*# *.*#. .#....  ........#.. ......# *...#. \*# *.*..#....*#*..*... .*. # .  .   .\...* *\..##\.# #..*..#
# ..\...*\.. .#*.#*.##...# .* *......*.  . ......#*.. *....\..*  #.#...#.*.. .*.  .....*..  ... ..#...*\  .#*.*##.*  # ... #........*\\..#\... .#.# .#
# ..* .....*..#....\..#.. . *. ..**#*. ... ...*.\.  #.* \ .*..  ..    .*\##....*#. . .  . .......   \  ........  ...... ... * *..#..  *... *.#.. .#.*#
##. ##.. ... .# .#. *# *.  ...  #.#.....*...... . #\.....\.# # .*. ..*.. #\ .*\\...#*....  ..#...#**.. ..\... .. #. .*.. ....#  .... *....*#. . .....#
#* .. .....* ..#. ..*# #...*#*  *....*.#.. ..#..#.. *...#\.*... ...   *. \\...... .* * ..\*\ .\....... *...* . #  ... * .. .#. *. *.... .......#.**. #
#..* . * ....#.\..\#..\.. . .. ... .*# #. ... .#..\ ... ..  .  .....*. #.. . .... .##... .#.# #*. .#.#   .. ...  *.......*.. .. #..#..#. \...#.*# ...#
#.....#.*....\# .. ...#.... .\.... ..* ..# *\..#........*...\ .  #..*.....# ...#  .\*\.*.# ...#...  .. .#.\..  .* #. ..\ \### ......*.    ....* #....#
#......# . ..#\ .....  ...... .* *# ..#* .\\.. . .#. ...  .* ... #...#.#...#\\  #*.\*.......* . ..\..#... ....*..\.... . ....#\..*.#*  #*.... .*#*...#
#*..# .#  . ... ...... \*.#...   .. \.. ......**...*..*#.\.. . ....\...*.  *. . ... \.##.   .......* ...... *..... \  . . ##......... \..\.# # . ..#.#
#... .#. . .... \ . ..* . .#. #.*..#..* ....\#  .*\.\.* ..*.\* #..  .##...#... ...\.* *# ..*  #....... * ..#..*......... .....# .#. . *#....... #.. .#
#..* . .. .*..\.\.. *#....    ...#.. .  .*...*.. . * ...##..#..#.  .... ...#.... . \. ...*\ *.*. ....#..**.\. .*......#.. ....#.#. .. .*#....#..*. .\#
# * .....\......*\ \.##\ . .  ......\#. .\...*.* ... ...#..#.... . . .. .# ##...*. . . ....*..\  ... . \..\....* .\#. ... *..*.*.............*#..  .*#
#.\# ...... .#.... \ .*#* *.#... ... #..*.#..#.....#..## ..... .#. .. # *.. .#..# ..... ..**. .. .. .# .. #..*\*.... * **.# .......  . *\ #...* \....#
#..... ..#.  .\.#.**\#..*. . .....#.***...*......  .#....**  #\.\ .*  ..*... ..**... .  .... .\... . *#.... .#.  ..* \## .. ..**# # .#..#\.**. # .* *#
#.*.\.....*.# .#*......\ .. *#  . .  .. .# # ....*.#.#.# ....#*........ .. ........*. .   ........ .. ..#.......  ..#..*. ..\# .#..... ###.#.** \....#
#...#\..\..\. ......#**.\. .*..##.# ..... .. .*\...\#.#.. ...  .......  #.*\.* .. .. . .. .. #\. .#.\  *.*.\..#..  ..\ *.# ....*.. .# .*...* ........#
#.*........#....#.... *....*#..##..#.. \. .\#.... .* \.* ... **..# *.\.... *.\..*. ....#...# ...#. ........# *\#..  .*..*.# \. #. . .#.\. #.. .#.....#
#...    .. ..#..# ...#.##..*#. ..\.#*# . ....*  \  *#....*# ...... .\. *.*.# .. . ...*. #\.*...  .*#\.# *... *.. *#.  \.. .\ .\#.\.....  \* ...\.. ..#
#.. **  *.. #*.. # #\ .**\#.#..#.#.#.#...*...#**.  # ... ...   # .. * .#.#.##. . . .*...#....\\...**.* ..... ##  ...#\.* # .\.#..## .. . ..    .*... #
#..*...\..... . #............#. .... .** .. *.#* .......\#..* .*.. ..#..*. ....*. ......*.. .** \....#.. .  ..* # .#  .\.. *..* ...\.*#..\## # .*.. .#
#...#. ..# .#... * .#.  . .\ # ......#*  #... \.......*  ..#.# ...*..*.\.#.*...... .... *.. . .....\....... .*.\.\..*#. ...\  \ ..# \.\.... .....#* .#
#.#. .. **..... . . #\   *.#.\ #  *#*\#  .. .. ....*.. \#...*.*.#*#...*.#.. ..*. #..#.*.. . \. .\.#* .#...* ..\...... . #  **......#..#*\ ..*....# *.#
#..*....*.... . **.  .#............ ... ..... # .*#.  ..#..#.... . ..\#*\#.......** .# .*  *.##.#.. ..##.*..*.#\#\**\.  *.......... ..*.. ..#.*..#. .#
# .......#.. #.##..\..#.... .*.* **. .*.#....*.  \#.......\#..#*#..* ... ...  #..#.\.*.  ... . .. ...\.\.. .. .\. ##.....#...... . . **..**.. ....  ##
##.*#.#\........ #.#...#\#* #\*.##.#. *... .*..#..#* ..... .#.\.........*..*.* #**..**.*##........ . .....\..#  #......... *#.... # .* ...* ..... #. #
#......\.*......# *  .*.# . # ...**...*.... . . .#.*.#..# ..#..** .#.  .\...*#....*. .# .. .*.*# ..#.*. *.*.....#.#.....*....   ..#*\...\.. .\.*... ##
#.*.... .#.. . . .  .##.. . ... ...*... * # . ...*.##..*.*. ....#. #..#*\...##..\ .. #...\ .. \.\.......... ... ....*  .   ..... . ...... \ . ... ..*#
#\  ..## .*...#*.... *\#..... .\........ ...  . # #..... \.#.#..#.... .* .# #.... \\*##. .#..*.#....... . .*#.  ..*#.....#. .\ .#.\\*##.* \\...  . . #
L * *.  *... *.  .* *.# ..#.\.. # *.. ..... ..........**.\ *.#..*#.\ .. \.. . *......\*....*....... .*.....#\...* \.. *. ...*.*..***..*.\* ....#.... #
#... .. .*..*. ..*....*#.\\...#..*...#.....\.\.. ..* #...  ...  ..#. \.. ...... # .**..****. .\*..#. ... . *. *.#...# .. .*........#....* .*# . ... *#
#....#...#   .**##*#.*.\..*..*\*...* ... .. .... ....# . ...\.... ...........#.. .. \**.#*...  *... .. ...#..... ......*. #.*#...*. ....\* ..#* #.\..#
#. *.. .\* \. ....\*........* * # .#.#.# . #*....... .\#.#....#...  ..... .....*..##.. .... * . ..#..#. ..##... .# .\ .. #..*.# . ...# .\... .. . ..*#
#. *...* . *. \  .. ## ##.## ....#..# ..#*. ........* .#*. ... #.  # ..*.*...\...... .....\.*. ......#. *.. .#...#.\* . *....*...  .... . *.  .#...#.#
#... .... . .#..... # .. .#. **#. ... ..#..#..\.  .#..........#...\.*..*. .# * #..\..*# ..**..... ..*..#... .*.....\\...*...\ . .*. \.  *.... . ... ##
#.. #... .*.......\.* . . ..*#......*...*.# . . *.... . ..*##*..# .*.# .#..*. # ...*. .. \#\.....#. *...#..#.. * . .     . ...... ..*. #*. .. . .*#.\#
#.##.#...* ....*\..... .#......*..   .*..*  ......\.\#.. ##.\ *#.    # .##. # * ..  . .. *...##..*.  . . #**#.#. .. *...#.# *#.#\*#...\.#......# #. *#
#* .\ .....#.*.#\.... .. *...#\. ...  .#..*.* ***.... \..**\.   \.#.*......*#*...# . .. .  ...#* #\...# .* ..........*.*. ..#..**......  ... ... *.#.#
#*##.....#....... ##.. \.. \.*... . .* ## # #.. .#* .#....#..#. ..*#..  *.#... .  .**. ..*\ ......#.# .#.\. *\........*.......\. .##* ....#\.. .*\. .#
#. # #..*# ...#.. * ..  \..# .... . .. .*......#......*#. *#... #..\#..##* . . . .. .. #\. .  #\... \# . ... .. #\......# * .# \\..*..#. . .\..# # #*#
#.... .  #* .........*...   .*.... ..*.  ..... **\\.. # .. .... #.*.*.. *.*.*.....  #  ...  .## **.\. ....* *....* .. .#.. ..*.. #..#. . ....\.....*.#
#*.\#.  .. # # ...\..*..# ..\.**.  *. ...*\#. ...#..  . ...#*...#.\... \. . *..*. . . ....\  .....  *.... *.\\.*   .\. *..#.... #. .# #..\*.#... ....#
#.. ....\.#*......\. . ....#.. .#. ..*. \... ... ..#...#  . . *.. . # *..*#.*.. \.*# .*##\.......*  ... .*. .. \*.\... \* ...#*\.*.  *... #...#...##.#
#  .*... .\..##....##*. .. .*. .#\.  *#..# .*. ..*.#.  .. .**..  .*##.\. \ *...\... *.. *#....#.    .\##..*\#...  #... ...# ..#. ........#..\*.  \  .#
#.#..  . .# .## ... # *..#..**\. *\.# #*. . ... ......   \ ...\...  .........\.......*.* ..*.*#..*#.#..\..#........ ...\....  .*.   . . .. .\#. . *..#
#.#... .**##.....\.*  ##.#..\.#*  . ..  ....    ....*...*  ...   .....# .# .##.*..* .## \... ..*  ..\*.. .*....***.\. ..#.. **...* ....... \#.... .  #
#*#   .. \....\..\.. ..  ..* ...... * .....*...*#.. .*# ..* .. ...##   .\.. * ..\...**   #.*.#.. ..*. . .\. ...... .*##   .. .. ...* ...#...# *. *  .#
#..#.....#....*... \. *..\#. .. ..... #.*....*....... ..#. *...\.. .  . \.. \.\ .....#.*. \** #.\.. .. .. .###* .. ...*.. \. *. .. R. . .#...... ....#
#. . # ..*.... .\.\# .\.. ... \..*#...**.# *...#*#.*..  #...#\\....#...*.. \.. \..... ..  .... \.**\ ..*.#............**...*..# \.\. \* .  ...  ..# \#
#.. .\*.. # .#. . ...    ..... ...\ \. * ...\... ... .#...... . ... .. .\#  .#.*.. ... .. . ... \. \  . *. ..... . #.....#\ ..... .  ...*# ...\.*....#
#.\...*.. .... . .....*\#. .**  .. ..*#*.#..   #.. ...\#...*.*.. ..*.. #*#.... ....*.*... .#......... ...*..#***..#..#.*... ..* #...#.\.  . ......* .#
#.. \ *#.  ##. ...**. .. .*# ...*....*..  ..* ....* \*........  .#...\......##*\.#.. ...#...*#....*\*.#....*\.#...  .*....#. . ..*.* ..*    . .*.  \*#
##.....\.\..#*#..*.\#\..........*. . ..#.  . .  .. #\. .*#.  #....... . ...#.. #.  .#.#.....*.. ...*........#... #. . ....#. #.... * #. .*###*. ...* #
# #.. \#*... ...# \.. .*\#*...##.* .\ .#....*... #.. #*..\#....*\#.#. .. \.\...\. ...\*...*... .\ ..# .# .*..#.... ***  ....*\#* .#.... \...... ...#\#
#. \...*........  . *.#.\  . ......#.#... #... . .. * #*.###*... *  . ..#. .*  .#. ..**.. ... .#..  \#.*..** . .*.... .\..# .... # .*# .. . ## *.  *.#
# . ...# *.\.\   #... . . * \  *### # ... \\# \.....*. ..*. \* ... #.....#......* .*.. .....*.\ ##\....#.#.**.....  #...*. .*\... .......# .\. .. . .#
# .*.*.*..#   #*..* .... ..\#..#..... . * #.   ....##... #..*..... #\#*  \.. ...##...##. # #. .# .   . #* ...#\..*#.##..##.... .\ . #..#.....*.......#
###.##..* .#..... .. .*...\#..\#*..... .....* #...*. . #..*\...*.... #. ..* .\ #. #. .#\#....  .**  .* ..  ...   #. ... .#. \*.*#  . ..# \ .\ ..*# .##
#.*.* .  # *.#** \*#.. \.*.#..... # *.... #.. ....  . .#....# \\.#.*.# .*.*#.........*.. ... .. # ....   *....  . . .* ..\...\..\..... ...\  ... .. .#
##.#..** ........\#. # #...*... .*  ... *#.\* *.. .. ....\.** *..*... ..\#*..... .. .#...\ ..\. .#....\#....# .#. ..*# . ...... ..#... *.*..*###*.*..#
# ...  ##* ...  . ... .. *.*. .#*.\....   .#\*** . ....#.# .# ..*#..#.* .#.  .\.........\..*. .## **.. #.#... .*.* .**. *..*..# ...*... . .#... ..  .#
# .. .*.... #*..* *.  .##. .*.#...  ... * .*\..\* #.. ......*....\  .... #.....\#*...... . .#* . #.....* # .#.......   .*...\*. .... #.....##.#. .. .#
# \ * .. ...... *.*.*.....** ....#  ..*.*  . .. . ...*... .\ #*# \  .....*#.#.... .#.* .    # ..* # .\..#..#\..  \... *. #.. ... *......*... *....#..#
#*. ... .......*...... ..#. \.... ..\. ......... ... #..#  . . .. #*..###... .. ..\..** #....\..#.*... ...... ....* \..##.##* ...  \#..  .*.**#. ..# #
#\.\ .*..*##....* \...***.#....  .*.*.  .... \. #.#.. . .. #..# ..\#  .\ .  .*... . .. . ..*.. .#...# .\... .. *   . .#*#.*  ..#......#.\ .....* .  .#
##...\*. . ....#\....#..... .. .**..#. . . .#* *.... .##..\  ....#.. ..#. #* .#.\.. .... ..* ......... . ... .\*.....\.  . ... ..# \\ .\..#*.\ ..*.. #
#....*.## ...# .*.\ ## .. ....*  ..... ...*... . #  ** #.##.. .*\ **..# **...*... ....\.... ...\ .....  .. .\...#..* #*.  .... ........  \.#.* ..\.\ #
#*.*...*....* ...... .#... .. *.# * .*. ...*#...    . .## . * ...  ...#. \....\.......\  .....\.* ** .***  \ .#..... ...... #.*.... *.. ..#*.. *.. ..#
#  .. .. .*...#..... ..* \*# ..\.   ..  . .....\........ *\.. ...##. .#..*.. ..* \.\.......*. ..#... . .#... * .. ...*......\..... .\.. .. **. **..*.#
#.*.#..#.. .#.*..*. ..*... *. ..* .... *..... . *#... # *.#.#..\*..*...*....  ....*..#.## #* *..... .... .#...#..  .. ...*##\.....#..\#. .*.#.#.*....#
#.. *..\ .. #.**# *. ......##.\.*..  ..*..#\\* ....#\....* \...**...\. .. *........#..... . .#......**\.\\ #...* ..... ..#...#.....#..*.......  ...\.#
#... . ... .. . .\....*\*.....*# \.. .\. * ..#......... .#..# #... .#\* ...\*..\......*  *.......\....#. #*..#.*.*...#*...* #....... ...*.* ..\. .  *#
#  #.#.\.. # # .#. #  . . . #.*.*. ... .#\ .... *   .. ... .*...#..\ ...#..\*..  .**  ..*. ..#*\..\.. ..... ..   * #.  .\...#.**.\# ...*.#. ...**#..*#
#..\...#.  ....*#   *...*. ....#... . \... ...   ..*..# *.*.# *.\.*#*.*. . .... *# .\.*.*..*  \. .. #...#*..  .*.#. *  * .*. .*\ \\.#.  ... *#.#. ...#
#* .....#.. \... #.#.##.. ...#. ...*...#.#.* . #.... \. ..#. ..#......\  ..\  .*\. .#.\..#*. ..............* .. *.* *. .. .....#..\*. . ..\ .*.###.  #
#...*# .*. . .. ...     .\* #.\..\.. ..\. *..*.\.. . .#.. .... .......**. ... ... ..# ....... ....# #\ ..#....\.. .... *....*...#..  ...\.  #.*.**...#
##.   #....# ..*#.\.. .... .... ..****. ..  .*.*...#.....   .#.... . .......*. ..... #* ..\....#. ......*.*.**....#..*..... .\.*......# . .*...... ..#
#.  ..# *...* .  \#.*......*..  *...*..#......##.. ..\ ...* ...*....\ ... . #.....*... ... .##. ..\.#.#.. .#..# ....... .. \  ...\\....**... . *.\...#
#...*  #. ...#.# ..  . .#..... . .\...\# *......... .... #...**....#. ..  .. #..#. .. \...*.#*..# .# .##..# #   ..*.#. ....#...\.  ..**...#.. .*#.#.##
#.* \.. ...*#\.  .#..#\\. .*..\ ..#...\. \\ ....#.. #... ......# \.#.\*...*#. ..  #.# .#\..... ..*.  ..*...... ..   .#.#*.. .\..#. ... *....#......*.#
#  .  *\ .#\  ....*.. *#.  #...\........ *.....#* * .#.. \... .... .# .#..*  .      *.... . ..*.*...\...#. . ...##..\.# \ ..... .*#.* ..*  ...  ..  .#
#.# .#. *. .......*\#.. ..##  *.. *.... \  ... .*.... ..* . ...#..\*..*.. . . .. *  . .  .# ..*. .##........\ .  .#.....* *.... . ..  . . . .. #\ ...#
#.#*.  .#...\ *. ..... ..* ..  . .  .. #\... . .. *.  *..........# .#   ...# ..........  *.*. .. .# .*.*.#*...## . ..*.* \. *..**. ....# \*#.# \.. ..#
#... \...*.... ..  ... ..#..* *  . . * #.#..# *....\. .....* *....# ..........*  ....*#..# .*.....*.. .*   \*..... ### .#...#.* ..\.*. #*...\ #.*#.. #
###\...*\*\.*...*... #*....  #.......... *..#.......*.*.......* . #...\*.*.** *........ ..*#. \ .*....*.  ...# .**. .  .#*\#..\.\\....... .  .....#..#
# .##... .#* *.*... .. *.\  ...\.  .. . .\#. ...#...## *. ....... \***.*...  . .. ...\\.* .#..#.. ........ .# . . ...  .....#. #* ....*.\  ..#....#..#
#....#.. .. . .. .*# . *..#. .## .  . .. ..   . ... .#  .....  . *\..*...#.....*#*  .. #...*.* *#.*.#. .. *  .  #..#..#. *.#.. ....\.*...    .. #\.. #
#..*.*..* .  ...*.. ..#. ...##..  ...#.*.\ #.# .. .**..*.. ...#..##...* ...* ......#... .*#.*.... .. .... ....#... #..#....* . #........**..#*.... ..#
#..... .  .. ...#* .*\.. . ...*..  ... #.*\#. ...\#. .#.. .#.#* .*#*... .###*\# \.#\..\ \.........* . #..# .* * ##* .\..... #..#.. .\..##..*# .* #***#
# .........*#  .\ ..... ... ..#..#.  .*. ...***. .*.*. . . ...#\.*\. *#....  ...*\ . ...##*.#.#... ......#.\. \...*....#....#.\#..\ ..#...*..**......#
##.. *.\*.  \#  \\... . . .. #.#....##.*. .  .* ...# ..*##. #. #.\..\ .\.# #..*#..  ..\...\.**....#...*..\##. .##. * \#\..#.*.    . \\. .* .* .*. .. #
##...\...\.... .......... \. *#.. ...# * ...*#.  .... ..* #.....*..**. .....# .#. .*....... ..*. ... ... ##... . .... . .. .....# #. .... .#..*. ..#.#
#\ *..*..*#...\*. *#.*.. .*#..... #.. \\... ...#..\*#.. .\ ... .\ *.# .. .*..#.\\.\ \ #..# . .. *.# \..*...#.   #..* #. .. *\.\\.*\.....*...*...... .#
#....#.\## .*... ....# ... *..**..* .. ..\*. .....#.  .*..   #**.#...*. . . \.#*#.*** .. ..*\...#..*.*.....#***.*. .... #..##......*#*#...\ *...\. ..#
#. .... #.......*   .* .... ..  .##  . . ..#....*. .\..... ....  . #.# \*.*...#.. ....*..\ ...  .#..  *... .. ..* #.#. \ ..*.#.  \... ....##.*..*. ..#
#.*... # .#.\..  .*.# * *...\.#. .. .#..*...#*.* ..#.... .... *#.. .#. #..... .\#...\ .#.*..\..#*#.*... .. \...\ ....#..# .*.... ..........*...\.#*..#
## .* *.*..\\\#.*..*.. * ### .*.. \*   . ....  ......  ..\. #...#\..\ **..# #*\*.#.* . .#........ ....*... \#*.*...*...#  #.** .*..\#. .# ...#.#..*\\#
# ...# \ ..... . *.\ ...#    .**.##**.   \..\.     .\..* ...*\   . . ....#  ... .... .   .    ..*#..*# #.#......  .#  *..   *..*.....  .. ....#  ....#
# .*# #. . #. . \.*..#.  \.. .  *.. .*. .# * .*\   . ....*  *.#\ #. .. ...*....*  .#.  *.\ ..#... * . .*..* #.# ....*#.*.#....#... #.* ...*... ..... #
#. .. .. .. .*..   \*. .#.. ..# ...\\.\**.. ..#..... ...*  .*.\...........#*.#*#...*..#.... .....\#...#...#.....#.*...#..# .... ..#... .. .#..\ ... *#
#..#...#.*.*. \.#..  .  *. .*...* .*...... ..*.*#..#....*..*. ... #.*. . .. .. .\#*.\.   . ... .#  *.#\...**...*..\... .#.*  .#.. *.#.*. .....\....\ #
#.. .. *#. .....*.\.\\*.\.#.\\*\  *..* **... * ..#\.*..\* #.....*..**. .....\.#...*..#..*.......*...#*#.*. ..\##......\...  .. .#*.. . . .... ... .. #
#. ....**.#** .* .#.  .* ..*... .. *. .* # .....#... .\# ..*..#. ....  ..\ .*.* ......*.*#*..#. .\.#  .*.. .*\*  .....*.. *.. ...... ...  * ........##
#.....  .... ..\\. .. . .\ \.. .*.. \.....  .\\..*  ...   .*.\\.\. #.\...... .\....*. \....* ..... ....# \ ..# \#... .* \.#........\ ....#*\## .. #..#
#*\*# . * #*...\. ...*. *. .*....\\.  .*...## #. #...*## . *.#.  .#*..*. *.# ..# ........*... .**#....    * #. *.   **...#.... .. \ .* ..##...#..* ..#
#...*...#* .# *  . .... .... .... #..*.#. .\... .\.*.....  *\\.*... ..#...\...*..#..#.#..*.. .*#..\. #.\ .#.* .*..#..... .#.#...# . ...  .*. . * . ..#
# ...*.. *#..#* .#\... *..  #*.**..\ ....* .. # .##.\ ..##   \.\... .* \.# .*.. ...#.. #...#***#*.....# *.. *.. . ##.*.\.  ... ..#.#..*.##.. .#.. #..#
#.....  ...*.. #...... *\. .**..... ....*. .*.*....   *.#*..... ....#..#......#.#. #..*..#. ......\..#.\. *. .#......#  .....*.... \#\ *\...\.. \ ...#
#.......*.*#* *. ##..\# .  ....# ..*.\* ...*. .. *.....#....#...# ..... . ....# *... #. #... .. \..##.   ..  ..#  ..#  ... ... *.*..#.\  ..#. .  .. .#
#..#*.  ... .#. *.. ..##.#.*.*.....#......\ .#..  ..#...... . ** ..#\..*... .. ..\\ .. ...#*\*..*.#...#..#*......#.. # ...*....*#.......*....#.... # #
#... *.**\. #.   \. .. . .#*#. ... ...**. #... ..\..\ * . #.#....*#....#...# \.. *. .. .*.  ..*#.....*..*.*..#.... .#. .#.#\#.*.#.#.\...*\... #......#
#\.. ..**.....\. ....*..**..#........*..... *  .....*\......  .#  ..*...#...\#...... ..*.......  #**. \.*#... ..# .*......\.*..* .... ...........  ..#
#.. *. .........  *  #..*  *... \. #... .\#.#. ..#...\.# **.#.#  *# #. .#. #... ....*#.*.  .*.. .. .**.*..#*...#*....#. .#\.. #.##..#. ...##.#... #*.#
##...*.#. *  ... \...#\......*. .. \.##.  .....*..........*.....*#.. .. *.  ... ##  . .. ..  ..*#...\# *... .#..# *.\  ...... ...... ............#.. #
## #....\.#......*..*. .*....*.*.. .#.\*..... #\........*\\.* ....#\###.###.  .. *# .. #... . \.\.......*..*.....  .#.#.. ...#..#*...... ..**  . ....#
#... .   .\ ..*.. ..***#.#. ... ..\..#.... .#..#.***.\#.*#...\.#.....*. ... . \#.\.. ...*\*...\.#..... ..# .*.# *  *#.\ .\.*. .**.....* .......#\# # #
#* #.#.#.*#... .\..  ....*\. .. . . ......*#....\*.#.   .*.....*\...# *\  ...\...\. ..##.*.#. \.* .**  \#.. .. ..#....*   *.#  ...\\...*.  ..*....# .#
#\. #.*#.#*.\.  ...*.. .. . .#....## ...\........\* #. . ...##\#....  . ..*......  *#\. .\\..#..... \#. ....#...*..#.....# ......#.#... ..........*..#
# ##... . ...*.......#\.# ......*.#.\..#.#....  ..\ #*..#*...# \ \....\#  ...... .. .#..# *.. .# .... .. #.. ..#..*.\...\.... . .\....*. .  . *.\ ...#
# *#..#... .... .....  ..*. #.....* ..#.. ..#  .*\... ..* .*....  *. .. .\#. .... ..#.# \. .*#. . \..# .......#*. .. #..\#*#\.*.  ..\\*.* ..\...  .  #
#**... * ....*  \..#\.. .**. .......... ..*..#\ .. \ .. . *..\\..  *.....#. .... . . . . .. ...\  #.#*.  *  #..# .#.*. *#**.*.. .#....* .......#\*##.#
#.*\...#...**.  #.*. .... ...*. \#....*. .  .*...#. ....*...#..*.......  .*. #.#\\.. .....\*..#..* #.. .# \.... ...*... *. #.*....\  ...*# ..  #.....#
#. .. ..*.\......##.*.**.. \.# .#. ...#..... .\ #...... ....# #. . ..   .**.#*\.  .. . ....**#*.*#.. \ ... . #..... .... ..... # . *. ..#.*#...... ..#
# #...#.. \..* *#..##.*. .# .#. ...*.. *....*\. ....* .. ...#...*..# ...  ..*#......*##.. *.... #....   ..#..#.*..**...# ...*# *........# ..#.\..** .#
#.#.. ..*........ .. #. \#  ......#.  \...#*...\# .\\....* . ..\* \ .##... * ..*#.. .........#.*  ..##.........# .  *..   \ \\.*.  # *..#.#..*#*  .#.#
##..\.#*#. .*.\.#* ...#.... ..  . .*# ..  . *. ...*\. *#. ..\..  . .. \#.##*#..... *  ...*.... ....*....#...#.# . \.... ##..#\#.*##.*#.. .. .*#*. #..#
#*   *.*.... \\.*..#..##......*..  #***.#.#.. ...*... ... ##\........#...\ *. *.......*.  \*.... . . ...##.#\...#..  \....* #........*... .. \*....#.#
# ..... .. ..*..#.*..#...#.... # #*..\...##. \#  \ ...*..*.#.. *..#.*..*. ... #..... .*..\.*\...  .... ....   #*.* .. .\ .##.#.#.#\# .  **  * #..* #.#
#...#... . .#.  .**. ....##..\.. .*.* \.. #..* .*.. . ....... \ .\*# .. *....#.....*..  \#........\.\.. \.....*.*. ... .#. . .# ... ##* ..*. .*#.. .##
#*..#*#.  ...*. ..\..*. . .*..... . . . .. .... ... . ... ..* . ....#.\ ....*. ..  .\ ....#. .  #.  .###. \. #.## ......  * *. **.*.....\#......#....#
######################################################################################################################################################