##############################################################################################L#######################################################
#..* .*....##\...*. ....  #\. .. ......# .**...#  #........*   .*...........\.. \.#... ... .. .#.*\*.. .  * .\ #.\ ..   ..  ..#\ *\#*.   . .## .*....#
#.....\ .*.# *....*..*. . .. ... *..#. .*. .*\.....* .... ...#. ..#.... .....#...\..... \.#.  #.#.*\..**\#  ... .. ##\.   #.   . *. . ..\.. .#.#\ .  #
#....* ...\#. #*...... \. \.*. . \*.#*.*...*. .. #..  .#.. .  .*. ..#.* . ...  \..*.##.... ...#.. . . ....**..# .......#*....*.#. ....#.#. ..   .# ..#
#. .\.. .  *..*  ..  .*\*.*\..#.#*#..  .. #. ...\*... * .........*  ....*. .\.. #. .....*. ... ...  *.....  #..*. . ...#..\.*..... #\ . #*... . .....#
#.  .* .*..*...#.. \...#\.#.*...*#*#.. #*.\...\ ......... *.... ..*.\*... .* \.*#*...#.\..#.\ ..#.. .. .#*.\... \ . .... .. ...#.#*... ..#.. .. .... #
#......\. .#.#*#... .......#. ...  .. .#.. \.. .#..*.......#. #..##....   .... ....**. ...  *. .....#. . .... ... .#...... ..\.\*# \#\  ## ..\. ...#.#
#*. *...   ..*...*..*.. *. .*...**.#...\...# .*# . \... * # .#.....\#.. .  .. .....* .#..*# .*.........*..#. .\  .  ... #.. .\...  *.  . ....... .. .#
#\.#..*.. . \#..**.... .\......#  \*.....#...\ . ..\ .#......* #.\.....#.# ...#..##......  ..  #.  . .\. ..#.  #*#....\.#*   ..#... .*.. *.* .##.....#
#... .. .##\*#...#* ..\....\..*. .\    *......... .#.*.\ ....*. *...##....  .*** \\..#... ...#..*.*#.\....* *##   .# #....*#  .. ...#.....  *  .. ...#
#..*. #..#...\.. . .*. ....  .#..#. *.* .* *. \** .. * ........\. . ... *.......*.\  *\*.. . *..*\. . .*  . ..*  ...#**.. .. ........#. \.*.## #...\\#
#...#.#.  *... .. .*#.# *...*....#.# ..*\.. *. ** ... ........*.* ...*.##*....... ..*....*.*. .* .##  .#\....**#.*.. *. #..  ... ##...   .*... \# \ \#
#.#.*. ... .#..........  \......##.*.#. .. .\....#.#  .......*. *. # ..R**   . ..* . ..#....#. .. ..... \#\ ...#*\*....#.####.*..*..#. . #.\..*. .*.*#
#....  .*# *.\*.*...\.. . *.. .. *. ..  .. .*. .  ... ..#\....*.. . *# #\*\\.# ... .  . #.#.*.\*...* ..#..#.#\ . ###.#..##..... ... . .  **#.. . .  .#
# .*....*.\ ..... *.. ....   .*....##.*..#. ..#. .. ## ...#.. .\.. ... ... ..*...*.  . . . #. .#*.. ..#*.. .*#..# .\.#..**. #...\#..... ..#*. \#.. .*#
#... .. .* * ...\ . .##...#....\#. .#.#\ #...*#....#.*. . .**. ...\  . #.. ... .......  ..... #... .#.... \.* .. .\#. ... .## .*..*. ...\.\ .. .#.#.*#
#..  .#.\ ... .*...\.... ... ..  .*\....#..#.  .......*. ...*. .... *##. ....#........#  *. ..*..#. .*...\.. ...##....#..*  .\  .. *.....#..#..*\\ ..#
#*.*.# ....#.....\  *#  .*.*\*..#** .*..#... ..**.**## ....*. .\*.. .#*.#..... ....  . . #\# .# .. . .#**.#.#*..*. #.#\..# ..........* .  .*... *.#* #
#.\.  .##...*..* #****.. ....##\..  **...\.# *..*.*....*\.*. \ .. .\#.* \... *....#..#* .\ ....\...*...# ..*..  .*.#.# .\#...#\*.  \ .*. ...*..*.\.#*#
#.  .*.#  #...#. #...*..... .. ..#.\.\  . ..... #.. . .. . .#...  .... . .**.   \ ..\#..**.   \.\ . ........\#.*. \*....  . ......#.. .... .*.. . #. #
#.\ .. .  . #.#. . .*..........#..  .  \ ... .. # *.. * ...*#.\.*... ....... \.#..\.... .*..  ...#*..# ..   . .#..  .. .#.....*. *.....#* #..#.... ..#
#* \*.#.. . #.* *.#*#...  .*.. \..#... * .# ..#..#... \..* .. . .#..# ..#. . .. .\. . \.. \..  .*...  #* *. .. #*.#. .#.#.. #*. ..\ . #.*. .*.#.\*..##
#   ......\.*... *. #.. ... *.. ..\.\ ..  ... .# #.....#..\\.#...#....... .\.. #....  . .*...... ...*   ..  ...\#*.*..\ ...\.. .#.#.....\..*...\.....#
#.. ...*.. .. . ..*......#..# .  ..*#....*..*.... *.*.*.\. ... . . .  #..\.. ..*.\..\ .....**#. ...#\#\...*#... .** ...#. \...#.. . .#..... .*.#.* .##
#*#..#*.  #.*.#.*##*....*.#. ...#...* .**..\\..... *..*\.. #\... .#. .#*#..*  ..  .#  ..#.  ...*..**#*.# # #.\.. \#. #..... ........ ... ..**........#
#*...*.\...#.... . ..  .\ ...  **  #. ##..*\\\... ...*..*#.  ...##..#.....* ..#.#...*.. ... .....# . ..*... ........#. .. \\..##  .*.\ .* #.*#.*.....#
#* \ ..   ... .. . #. ....\.*..#. .....#... . .. .....# ..*\..  .#..  ....  .\#...#. .\ .*.  .  . .. ..*.....*. .*.......\.. *.....*#.. ...#\.*....#.#
##...  ....*\.#..#\....  ..  .... ...\..* ... . ..#...\#   .. #.#.. ..## *... .   . .. *.... .. *. .. ..   . .... #..**\\......#.. . . #*\.  ........#
#.# # # *...*...#..  ...*.  .**...\.* .. .\\* . . ..#..*# . . .*..#*.* ... ..#...*..... ......##..##.....##..... .*...#*.*.#.....   . ..#*... \.*..*.#
# .*.*.#*...\.   #.*\..#..... * .#....*#.\.\..**..  .. ... *...*   .* ... .*....\.. .#....  ...    .#.*\..#  . .\ ..**.*# .......*..*.....  \.# .....#
##.*  *..* ..#.*....*#.* ...#. ..... .. * .*...*# ...# ..*..*.. .##.. \.## \.. ..#\* \ #..#  .\#.. #**........ # .# * #*## #....\..#.. ..#.. .. *....#
#....\...#. *\..  \ \ #.. *\#  ..#. ..#.. .. .\  # . \#...*...#.# . .\*#.*#  ..* #.  # ....*..\.....#.\ . *. # .*.#***.... ....*\.#.# .#  #\..\\.\*.##
#*.*..##\ .*.**# # . .. ...*#* .*  ...* .#.#... .**#\*...... ..*...# .  . #. .*.*...*. *. .  ..#....*... .\.\.....   #... ......\# .. ...##..*  #..###
#...\.... . # ....*.....  *\  ..  . .*. .#**\.*..... # *# *.#..  ..\......*#...*.....*#..#.#..  ....# . ...#\#.\.#.###..#*#.. ..\. #*.#  #...# *.....#
#. .......... . .  .# *...#*#*..* .##... .*............*.*...*  *# *...#..*.\. \...#..#. ..#..*..\.*# #... * #.#. *......*..#..*.  #. .... ..#..\ . .#
##  . . ..*....\*.  ..\...... ....*.\* *#*#...  ##...*  *. .. .#\........#..*.... .#. *.....#...**...... . *...\ .. #*.#.\**...... ....*....* ..\... #
#.   . ...#.... ..*.\ . .#...#* ..* .  *..... ..**...*.......*. .*.   ....\*...\.\**..\.... ..*..#.#. # *. *\..#.  .\. ..  . . \*.*... .. *...#.... .#
##. ... .....\........#   #*....  #..*  .\* #.#....#.. ...**.. ... ..*.#\.* .*...*.. .....#.**.. ..# ..#. .. *. \..#.. # .......*\\.#.. *\#\\*.....#*#
#  ......#*....  ..... .* .....#. .. ....* *.#.*...#...\. \#. \ ....** \...#..... ....### . ....#\ .** *.... *##.\. #.#.#.*.. #.\   #. ..#....\\... ##
#.* #\.......*. ...#.##*#. ... ..  \.##.*. #.# #.....#...\. ... *...**.#. .* ...*..... .........#.## ..*. ... ..  ###.\... \#*. .#\**.....\* .. . #.##
#..*.. \#.**....\\...#.. . ...*# ..*.#. ...#. *..#...# .. . ..#.*..**.*..#   \.*.*..#..*...*  ....**. .\.#*..   .......#. \  ...*##......... . *.....#
# .* \#\.#.....*#. ..#... ..#  ..* *....#.. . . ... \.*** ... ..###. .. .....* .*. . . ....*.. *...*....*..  . .#**.*..*.#... .  .*# .*.*.  .#......##
# ... . ...  ..\#.##... .*.. *#...* .###.*..... \..*..*..#..* ...\...#\  ..*.**.*. .#.*#.  .  #.#.. .. #..#..#....*.***.  ....#. #. .##*..  .. ....* #
#\.*... .\ #... .\#... ....*. . ...\ #....*.#  .# ...*.. ..#.#.#...  ....\*.#.\*. *.#. #..#.**#.##.. #.  .. . . ..*.. .\.. .  ....\*.#*.#*.. # ....\ #
#\.*...*.#..*.. **.*....... .. ....... . .... .*  ...*.....*.\#..\.*#..\.*#.#\#\  ..* *....*.....\. *.  \... .......# . .\.##.*  ......*.. ..* *. .\.#
#.... .\ \....... ..#\... *.# .\..#. . .. .#.. ...#*.* .. ..*...* .#..*...* ...\..  .. .......#..... ...* #.... ..# ... #.. #.##. .#.\#\. .... ..#\#.#
#...\..*..#.\#.#*.....*..#.*.\...#.. . ..*#\..\.......  * .  ...... \.\*. *#  * *. # . ..*.\. ..\.....\..*.\. ...\...* ....*.... ... .. ..**.*\.# .  #
#. ..* ...*\ .. #...\...  .#.#.*... #*.....*#.\.\..... ...#..   ...... *.* .* ... ....* .*#.\... .*#.. ...** .\. *..##.. #\...#*   *........ .#..... #
# \.   #... ..#.. .......#  .*....\#.\. \  .*#.*.#. #..**.......#*  .* ..... * *#.. ......*....#  .#\. .#..*.   . # .#.....#*...*.#.*.# .\...... #. .#
#.....\. . .#..\.*.*..\..#... .*#....#*...#* *#*.  #...  . . *..  .. ...  #.. . .\.*.#.*..*..  #. .. . .*.##.*#..#.. #  .. *.. .. .*..* ..\.##*......#
##.\#...    ##. *..#\#. . * . \ .*   \.. *.  #..\.*.  ... ..# . . .\*...##*\...#.. ...\*#...# #..\..   .. * #*\. .  ..#.. ... *. .  ... . ... .....#.#
#.*\.*.... .#\.\.*. ........#..**#. ....*#  .. .. . ...*.## ... . .. ...##. \...#.  *\*  ..... ...*\..\\.**.. .*\#.....# .......\\#  #*#....\ ..#*...#
#...  ... *......##.#.*. ......#   .*.###### *#..# .........#*...*....##.....     .. .. ..**.   *.\\*#**\#...... .# ..*....... ..#\.  .#*#....... *. #
#...*. #...* ..*.*   \ ......#  .. #*. .#.. .\.\*.... ............  . *....* ...#..# \.. ....*.\.. . .. * .....*#.#\..... ..\. \......\ .. ....\# *\.#
#  .  .#*# .*.. **..#  .*#...*.#..*..##\...*..  #..*\....*#..#*. ...  .*#\.. .  # *.*\.  .......*.# .**.# ...#. \..***...*..\...*\## ...*......#..#\.#
##.. ..... *...* # ....#... # .#. . *.. *.\.. .\*\.#.  ..**. .# ..*# . .*..*....#\.. .#.\...  ##....\.....  .*..#..#.... *.## #.*#. ...##\.* \.# \. .#
#..... ..\....... ...  .. . .*.......#....#.#  ..\.....#. #. #...#.#..... #.. ......*##...* #.*..\\##...#  ..#\\.*.. ...\..*.*.\.**...\.. ... .# ..# #
#...*..#*...*.. ..*..* ..## .#.. * #. ...*..*....*.*... .......  ....*#.*...*...#.  . ...#......**.# ...\.*... .... #.**...... *#.. .....*.. ...\.. .#
#...*\ #..#.\ #..\.#.#*.*...* ... .*............ .....\.*. # . .# *.....*.. ....*  ..\.*#. .. .... **.*.*   . .......\.* .\ ...*. .....**. .*** # #..#
#*... . #.. ... #\....*  . ...... ...*.*#.\# . .. .#.\. ..#*..\......\. .# ....*..\ #.... ....#..  ....\..#*...##...\*. . #*#..#. ...\#  \ ...#..# *.#
# #*#.  ..\#..   ... .# \..* ..\*......#...\..  .*. . .#..*#.#  ..\... *...*..... ..#*..  *.#*. ......**.#.\.. . ... . * ## ..*....\ .\#.  #..\...*.##
#  *#. *.\  . ....\.....*...## ....*..... ...  ...##... #..* #  *...*.\ .....*.#.*  ... ..*....#... ..  *......*.\.....*.*\.#...*..#.... #.*\...... *#
# .\ ..\...\ ....   .*... # ..*  * #.#..*.** #..  ....  ...*...#.  ..  .# ..\. #. ...*...* ..#.*. #.. \..\ .#..... ..#  *..*... ..  ..#.. .#....  #*.#
#. .* .#... ...... ..  ..*  #.. #.. #  .*...**..# ..\* ....#.. .# *. *#... .  . *\ *..# #*.. .. ..\.  ......... #.. .#.....  .* *#*..#  .*......**...#
# . .*. \ . ## *.... ..*.*.#.#*..........#....\..*.   #*\..#. ........#\...*. . . .  .*\  .....* #\ *...  \..  \ .... . ....\..\\....*  ........ ...\#
#.* ..  ...#*....  .....*.. #. .#..... .  .##...  ...# ......\ ............#. *. ....... ..*..#.#  ...# *##*..#..*  .\#... .#... .. ....  #..\## *.#.#
#... .#..  .* .. .\  ...\*   \.* \......\# .\.*.  ... ..**.  \. #. .. ## .#...# ##.....**.. \ . #* ... .  . ..... .. .*. .#.. .....#.# **.\.##..... *#
#.*. .\..\\ \#\... ... .###.. .......* . #.......#.\.  .#  *.*.*.. ..* .*..#.#\. *....  .*....\* ..*\.. .*.*\. ...  *.*..# . #*.\# ...#*... .#**\ ...#
#... .#\..*##....   ... . .\....#.....\*.* ... ......  .**.*.  ..#*.  .*.. . \*...  ..*....#  *.  ...*... ....\. #\ ......  .* ....#.. .. .... . . ..#
#.* ..##. # ...#...*... ...  .. ....#.#  ........*. . .#. *#*  .*...# ..# ....**\...  .#. . .##....*.#\#.###.  ##\ .\. .*#  #....* ..  ...#...\..* ..#
#.\..\ .. ..... .... *.#..  *  ..**.. ##.\\.#*#.... ..#  .#...*.#..#  ... ........#... .. . \......#. \... .. ... #. ... . #.#.. ..#.. .    **... .###
#..... ..............\#*.\.#....#\. ....#..#..#.  ..*. ...*\\. ......  #\.#.**.. . . .*.\.. .. #.# ..# .#\. ....\\..**..  ...\.. # ..*....#.......#\*#
## *  . ..*.... .. ...*.  .#...*..##.*\ .....\.  ..*.....# . . ..#.* .**..*.\..... ... ..#..# *....   .* ...\***.#*.*..\*.* .........#.*\. ..  ...*..#
#*.  ...* ...#.* *.....  *\.*..##. ..#....\#..\#.#  \ .  .#\  ..#....#...# . \. .... .. . ..#.. .* .*. .....  ..**.  .   . ... *#...... ....  ..*..* #
#....*..  *.*....*\  #.. ..*.#.*#.#...  * *   ... #.#   ..**...... .#. .\.***.... .*. *......*.#. #.  ...\...*#.    ..# *..*.*##.. \... # ..#.. ..#..#
#. ... .**........#...  .. .# . *.# #*\# .....*..#*. ..# .\...  ..*.\....*.  ..#....\#  \ .*... #...  ** ... .\..* ...  .. .\.*  .#.. .  *..  .\..#.##
#.. .... ......*.#*#...*..  ..*..*.. * .. \ #\.  .#.* ... *.\ .*.... ..# .. ..  .### . .* ..#.. .\*......*...# ..*.............*..#. ..*  ..##.  *...#
#  .\  #.*. \. ... ..#**.##\.#.....* .#*..#.#*\* ..##\#.. *. ...#....\...... *..\ * .*\...*....#. ..#..*.....#. ..*...*\ \. ....* \*.. .\..... ..*.. #
##.\.. .*.# .*#...#.# ...\.*..*..\*.**.. .........*....*  .#...# ..  ..*#.....\....* .*** \.## ...........*...#.*  *. . \#.* .. *......#. .....**..#.#
# . ....*.*.\....*..\. ........\   . . *\ . \.*.  .............*....*..#..   # ... \..#..#\.#*... *.......\.##.*.... #.... ..\....*. ...**. \.  \ ...#
#....... .  ...*. \..#....*#..*...#. *..#  .......*..\#\  \. *.#... ...  .... .. . .*.\**.....##.. ......*... \. .##  ... *##*#. .\#  \##....\. .. . #
##.#.....  *.      . \.**.. ... #*..\. #....*..  .....  ..*\.#....#  .*  .#\ ..*# ... .*##..*.#.*. #......*..#.*..*..\\.*.* ...* ...#....#..#.***. ..#
#\  ...\. #.#   * .#. ..\ #..... .\.#.. ... .#.\....#...... .#....*..* .. \#\# #....# .... . .#...... ..... ..** ..* **  .. .. #**.. . .. . . .... .*#
#..#.# \*....#.**... *#. \ \.... .#.***.... ...  *.\. .....#.# .. *.\#.....#.... .......\ ..*...*.# \....\..  ..*.\.#*##...  ...#... ... *.... ....#.#
#..... .. . . ..*#.*.... .#. ...  \*... ....*...## **.. ... .. #....#.  ##. ..#.#   ** #\.\..... *.. .......   ##\.....*.*. ....  .... ......*#. ..*.#
#.... *....*. ..... .*  * ....*.\......  ...# .\#.....*. . #.\  *# . . ...#.#..*...*....#....# ..*.\  .*.* .... .. .  ....* #.. .. .#* #. #..*#..#.#.#
#.*.....\.#..** #..  *..*. .* .* #..   .\.. .#.#. .. ..\..#.\.\. ... #...#...... .. .. #\.*.*....#.  .*..# ..*.. ..#.  .  #...##.......\....*.. ..* \#
#*....\. ........* ...*\.* .....\ ..\. #\. . ..*...*. . ... . .....*..* #.... .#..*. .. .#..*.. .#....\. ...\..#..**..\ .. ..*..# . .#. *#..#... ..\.#
#*.  ** ..    ..* ....*... .....\*... .##...  .......*....** ..#  \*.* \*... ...*. .*.\   *  .##*.. ...#... ..* .... .##  .# *#.....*..  ...... ...#.#
#.*. . . .....  .*...*.* .*.. ...   ... \\.... ..... *  *...\.*# ..  . .. ....#.........##** ..\.\ ...... ..# #.............  ..   .*... #*  .#\. ...#
#.....*#*.#..#......#..\.**........* .. ...# . .*.#...\......**.*.. ...\...#..\...#.**..\...#  .... ... .#*.*...# .. #\. .# *.# ........ *. . .... ..#
#.*..#.. ..\.. ...  .*...\#..* ..  \*.\ ..\.. .. ..  ........  *.....# ##..\.  ..*.#..  .#....\#. ..#. . ..#*. ...... .##..#.# .* ..\#.....*  .\.\...#
#\.......# .##..#.\..*.*.**...*........*...#.\...# *... .# ...## .. #.#....* .. ...#. *.*.....*#. # ...* *. .... .......... **#\  \.\ .# .. *... ..* #
#. # ...   *..\......* \*\..*.*# . \#.\..  . .# .. #\.  # . *..##  .....#  *. \..#*...... *## *. * # *\.#...**.\. \.*\........  # .#*. ... . . .  .. #
##..#..#\.#.......#.\. .\*##   ..\..***.*.#..  ..#..... .# #\*..* *.  .*   .#.*.*.  ... ..  ##.. .* .... ..*.#*... *.. .....*...#\. .. .#..* .\.*#.\.#
#. .*....###  .......*#*...*.*. #..  .*..\. ... .....  *..*#*.. \.*#.. ..\#... . .#. #..#... *.\..# #..*\*....\#.*\ \......\...\#**..#..... .....#*. #
#.#.**.*.*. .*#\#... *...\.#...*#.. . #.#. .*..\#....*...*#.\.# . ....\.#...#.... * ... .#.#......\.... .\* ..*. #.. . .. ..#......*. .. ....*#*...  #
#..\.#*  .......#.......... *... \ **.#. ..*...*... .#..... \ **  . .#.*\ .  .# . ##. .\. .. .....\ ...\. . \  .*# #....*#. * .\ . ......\...#. .\. .#
#*.#.. ...#.#.*.*.   ...*....#  ..* . .#......\.............. ..\.##*# \#*.* . .......... ...\... ......\ #...*...*... .......#...#.... .....\. **\.\#
#*.*.. ... .\ .. .#.#*#** ..\*.# .*\ ......\.\ ... #.. . ...\...*..*.*\.. ..... ........ . ..#.. ...*#. # ..#.# . .......* ...\\ ..\\ . .*. ...#* .\*#
#.*.. .#\....\. * #...* .... . *.... *. .#.....* #..#...*. *..#...#..... ...*..... #..*...#. . *.. \...# \.#. .. ##\.....  *.......* .. *.#\.........#
# .*..#  .. ...#*...#*....*...#.*#...\.  * ..#. .. .*...## . . ....... \................ .... ..#..*...*. ...*\.. .. \.* .#.#..\##. . ....  . #......#
# .*.**.*.**... .  #..*.#. .\  **. ..*...\.  ...#.  * .. .#....** # .....* ##  ... **..# . . ..\#.... .*...\**#.* ..\......... .*.#.#...\  #...*.. .*#
#\ ...#  .# .#####.#.....#..*. .. . .#.\.*..*.*.#.. *.*......#.........*.  .. .. \..##..  ...\#..* ..\.. .. \  .*.. ..\...  .\...  . *#..#\.  .......#
#*..\ *.*..* ##.\ .*. #.. .. ....#. *. * #\.  . .*... * # \#....#.....\*. . *##.#......* . ..\..\* #..... ...#.#*.#..*...\..*. .  ..*. #\...#.\\.*...#
#* ...**.*#....\* #*#.. ..*....##.\. ..#.#.*...\...*#*. .*.#\\ ..*.*. .\...#.\**.*..\...#. \.#\.\ **...#*#.*.##\... #*#.  \.\  \* #.. \#.##*\...... .#
#..  ..#....*.\*#.....\#....#.. ..*. .*..*\..##..*#\...*...#.....#. *.#.*.#...#. .. . .  . \\.........#... . #***..\ ....*..*. .  *.* .   #.* .. ... #
# .#...#\.# .  .*...#......#. . .* ...*..* ...*.. #.... *#. . #.... .....#. \.. .. ...*..... #*.#* ..*.. #. ..... *...\.\....*..#..*\. .... ........\#
#.. .    *. ... .. . . *.*.*.#.\.......#*... .*..#. ..##.#.\. ... . ... .*... ##..#. .# .  . .#.....*  ..*##.\..  \*.\... ..\..*. \....  .. .  ......#
#....  .\.....##.# ..* #*. #...\.*.\..*.#.*.*#\.*.# ..**... \ #..............*...#.. .#\...... ..  .* .. *....  #....*..\.\#...# \.... .# ..\ .#.\ ..#
# ....#\......\  ..\ *......  ...# ...*. #.\. *..*#  * . .*..... .\ .*.......\.*#. .#.... ..#..#.*.. ..*.*.. #  .  # \.  #. ...  ... ....*.* .......##
# #.\ . .**\.   . ....... . *#.. ....*.*..*. \#. .. .*..*#. .#\*.... * .*. ...###* .. #..*#\..* ... ....#.  \\...*. .....*# . *........\.*..\.  .. *.#
#* \.. . .*#..## . ..................\... #....*............\..# \.......  . ..... ..... ... ... \.*# .. ..\*...*.......\*.#....# ..\\*# ..  .*......#
#.#...\.*....  ..*\.... ... ..   #..# *  .#.#\#...*  . .*..........\...*...  \\..* ....... ... .* # .#.# ..*\........#*. *.#.# ..... ....* ..\.*..# \#
# ...*.#.#... ....#. .#..... *. .. ..* .##.. ..#.  **... ..  ...#..*\......  . ....*.. \ \.\ ..\..  ..\... #.......#.\...*.\.*.*..\..... #..# .*.#.# #
#. . .*  *. . # #  .\..#. .*.*......... #.*... ...\*... *..#... ..\#.. #. . ...*#.**#.  #....*.\**......#*.#*..*.\. .. .# ..*\ .#\....#...#....# ....#
#*...#..#....#. \ *.#\##.. \. .....**..... *..*\....\.##.##... #...*..*...... *.#...\.. * #.. ....#*.. . .....\..#..  ..  .#....  ... ## . .. # .\...#
#.... *. ...*  \...*\.. ..\#\... \# ..#...\#..\..  .#. .*.....\.*\    . .\#. .* .*  ..#..  \..##.....\..... . *...#***#\.  . ..#.... **........#....##
#.\....  ..\...#. ..#. . # .\. . .  .*.. .. *..  ..\.*   . #..*. ...#..   ..  . ... ..## .#. .#.##.#. ..*.#... \\..**   .. .... ....*..**##... ..*.# #
#.# .*#.*.\#* .....*.. .*#.*....*.*. *  ..   #.#.... . .#.*... *. . *.. ..#. ....#\. *  .......*......  ..##..\.#...#  ....*.* .\\  ....*..# .. .  ..#
#.#* .#. .**.\..#.#\.\ #..   *. . ..*  ...... ....#...........*......#....*.*##.  .\*..\.\ \\....#.\.. ##\ *.......# . \.... ...  ....   ...* ..##.\.#
#*#.*.*\.. #  ..#. ...*..\...\... ......*. .*.\.#...... .. \#.... ..# .  #.......**.#*.. \...#... ..**#.##. ..*. *..*...##\  *#. .. .. ..\#. \....*..#
#*..* .......*.#.... *.#.......#  .. .*\.  ..* *....\ . ......# . .**.*  ## # .. *.... .. . ....*.....\ ... .... .. . . .. * \*.. .# \* ..#.\#...* . #
#.#. ..... ...*.. .#.. ..#.\#... .*.\*..# ..#. . ..\.\# . ...**.*. ..  \  ... ...*.. ...   #*  ..... ..*.... ....#...* ... *\.*...#.......# ....... .#
# ... ...*.*.. ..... .# ..*..#\....#..**. **.  .... ..*...*... .*\.#*    * . \*.#***.. .... .*#  ...\**\   .. *##..\#.\..*..\....*. ##*..#..#... ..*##
# ..* #.. #...#   ..* # ..\.\ *.** ..#  ..* ... ..#.\*. \#\ .**.*..... .#......#   . .\..* .......... \.. ........... ..#.........  .... .....#.*.# *#
##.....#\......#.\..*# ..#.# ........ * .\* #...**##..\ . ...... . .     #  #..*\.. \... * ...*...*.....*\.  #............* ###.  .. .\#*  .  ...\. .#
# *.*. ..*. .# ...\.....#*...  . .*** ...... * .\.#  **....#..\.*##......*.*...*... #..*#.  ## .*.  ... . .\. * #.....*... .\  ..#..\....*. .*... . .#
#.\.\#\ . ....*...#*.  .* . . ...# .  *\....*. ..#..*##\\ .**.#..*.....#..\#. ......*# ...#. ......\#.... * \*.... ..#.*#.*.*..  .#*..*...*. .. .*...#
#. *\..#.\. ....*#\.. *. #*#... .*##... \\  *..***. .....*. .*\.*... \. .... #...\ *#\*.*\# *.  ..\ ...#\#. .# *.*..   .*.. *.*#**... *  ..#..*.....*#
#....*  \.    ...*..# *..# .*  ........\.\...*.......*.#... .\ ... #..... .#..  .. ..##.\ .#.... . ...*. #.. .....#... #..... .  .\.... ..\..\.#   ..#
#...... #..*.. . .. #* .*....#... \#. *\ . .. .... * #...   .... . . ... . ...... . .#.\..*...  ..*.#..**\\#.#  .**.* .#..\#.#\.* .#.#  . # #.# *...##
#.... .#.*....#..\......*... . ..\.\........  .  .. *...*... .# ...#\ .... .*.#...*.. ....#..\.... . . .#*.#\..*..* ..#\..\##... # ..##.. .#. . **. .#
#....*.... * . .* \#.*.#. .........*....\#...*  .\\....\... .#....\ ...  #..     * \\*........*. #\...*.#.  *. .*...\*\*.\. ... #... . *\ \.    ..#. #
# .#.........#.*  ....* ..*. ..#...  . .\. *##....#.. #.. * .. #  .*..*. #...\....#....  #...\.* . ..  .......#*#.  ...... *.........#... ..... .  ..#
#.#. ...*...#..  .  ..*.#.. . *.*#\.*... .# . ... #.\...*#.*.  #.**\.\*#....\   *.*...... \. * ... .... .. .#. \.... *#..*... . *........\...\..*.. .#
# #..*....\.*..# *.. *\...#*.... #  ...*...#.#....... .*.  * ..*...*....##. *.#* .#...\  ..#### . ....#..# .*..*.*#.. ..*#.*..#\..  \\...#. \ .#\#.\.#
#. . #.\. ... .   .#. .#.*.#*  . ...#.. .. ..  ... ##..  \#*. .# . . . \.**..\   .*..*.\... #***.......\.* .#*.*\ . *... ....#. ........*...# ..* #..#
# .*.\.. # .#....... .....#.*..\ ..   \.  # *.* \.. .. \.. .#..*.... ....**.*#.....  ..* .... \. ......\.  .#...#  .*#.  ...*. * .........    ..*.*..#
#...**.....*..\.  *..#.*... *#*\*#. . .*.*. .........*\..\......*... .\ .*.....#... .....* ##.  .  .#...  .... *#.#*##  \#. .. ..... \*.....\# * ..\ #
#..*\.* \\.\.* ###..*. ... .\.... .\. .*.. . # #. *... ..**#.*..*..#.\#*.. . \**..\..\\.*.* ...* \..#. .. ...# ###.# *. . ##..#....#. .*.#  .*#.* .#.#
#...#  ....  .*..## .... ..##*.. .. #.. *#.# .... #. .\*.*...**  . ....##.#..........\**\ *..\........# ...#...*#. \ \ .\.#.*.  ... \#....  ....#....#
#.*..\*.#. .. ......*... .... ..... .  .\.*..#. * .....#.\#..##.* .  ..*.#. . .#..#*...... *#...*. #\...#   \.##\... .....#. .  .#.*..#  .\...*.*.*.*#
#.\..  ...#...\#.\.. .# . .  #. ..*. . ...#* #*.   .\. .*..##...# .#\... ..\ *#... .. ... .. ....#.  .. ...#....\....#.#*.. . . ..**.. ..*. ...##....#
# .....* # #*. ...#..  .**.. ..    .  ..\*... .\\.#.....   ...*...  ....*#..   ... ##*\. #  ...*.  .* .#.#. .#.# #..*.#.##..* ....#.. \. . *.... #.\##
# ....*.. ..# ... #...\.  . . .  .*.\..\. *.\.\.#..  ....\*. . .  #...#. ..... .. *\*..... #\.\*.\\.  .... .# . ......#...*  . ..*........ .#.... #.##
#... ...# .. #*. #*.\#.. ..\# ..\......#.#. ... .#*##* .\...  . .# ....\.*#.# \  *##.. .#...\..*.#. ..*..#.#. . #.. .. . .*#.*. ..\.#.#.. ..#\#*\...##
# ...  *#..... .....#  **.\.. .*....*. ....\\.. ..#....*#. .. *.......... \  . ...#.\.... ...  .** ##.\.. ..#... ... .  .. . .. ... *..  .*.  \.#*.  #
#.*  .#........ .# .....*.....*.\.\.*#..\.\.....*.\...... .   .*... .\...*...*\\.  .....#........\#...  ##.*# . .\# ......*\ ....*.. # ... ....#.*#. #
######################################################################################################################################################