######################################################################################################################################################
#...  ...*..\\..##.#*...* #*.*...  \.**.# ........ . #..*. ..*.#. .#*\ . ....#..*.#. # ...#. .....#*# .....#...*..* # # .*....*...#..\.#..* #\#.#... #
#...*.....* *.#. \# . *#..  .\  * .#...#*#.....*.#* *..*..#..#\*.#.. .  ......*....*.   . *  .\..\.. . * ..*....\. #....*.. ..** \ .* #.*. \.. .*.. .#
#.. * .\.\**. ..#\.*. *.\. #. .  ... .#  ##... . \*. \. .*.# .*#.#. .... #. * *#. .\.. .*\ . # #.#*#.. .....* .* #*...*. ....* .\....*.*.\#.. * ..*\##
#. #.. #\.#*. .#...... .*.#..*... . *....#\. .#.... .#*..#... *#* **.*  ...#.... #.#*.....#.  # ........#....... .....*.*  #.#. ### #. #\ .  \ \....##
#.* *# \*.......#\.*.. ..\....#.#*##.\..**   .#..... ...#.*...*.\ *......**. .*..#.\. .# *#.. ##.* . ..  #..\.*..... .#...*...  #.* ..#.... .. .... .#
# *.\.##.  ......# .#.  * ..#...\ .\ ..#...# . .....#......#.....*..\.*..*. ** ...# * .#.. #.. .  ..\... #.*..#.**. #.. .*..*\. .#  ..\###*....\. . ##
# ...\ . ..........\..*#....\ . * .....  ..   .**.#.**#. ....  .......*#.. ..*#.*....  ... .\  \.. . *..\..#. ... ...  \ ##.. ..*..\.*.*...\#.# #*# .#
#.*\. . .. .  ..*..... .**.*...#...... . .#*.    .... **.#... . ... . ##*....#..*# *......  . \#.   ... #..... * #. \.. ..#. *. #. . **.# ......#.*..#
#..\..  ... ...#..... .#.. ....#...\.#.* . ##*#\. ... ..*.. .. . ..*.....*..\# .  \...  *.  ....# .#.#  . ...*#.#* #.  .#..**... . .\*\\  #.# * .....#
#. ...#..#..##.\....\. # . .# .. #.   ..#.........  * * .*. .. *...*...**#...*#  ....\...*... ..# .... * .. \..#. ..  .. .# *.  ... . .......*..  ..*#
#.*#*. .\.  . . .***... #.#    .\ . .  .. . .   .. ..*. ..#....\  #.#..  .....  \....\...**.*.  *.. ........ *. #.. ... .\# . ... .. ..   #..# #...# #
# . .##. .#  . \..#.\... ......  ..\ .... .*...# \ ..# ....   * ..\\* ......\.#... ..*\.    ..* \.. .##. . ...  #..#... ....#...#.. .*..\*. .. .. # .#
#..... *.\*. . .   ...#. .\.*.* . *##  *...## *.  *..\* ...  .\ ...**  ...#.*... *....**.....#.    .......#.  .** ..  . #.....*.. .....*..\#.* ..*. .#
#. . .... .*.**... ...  .....  ....\ *...*....  #...*.*....*#. .#*....#*.. #...... ..#.. ..\... #. \..*.*#... .\\..*#....*..\..\.. \#. ..\\# *.** .\\#
#    .... .. ..*........ .* #.. *..*.....*# .. #....# ..#*#.....\.. .. .  . \.#.. ... .* *.* *\.. #  #. ..#. .. ...  ..**..# .  . ###. \.* .. ....**R#
# .* .\\   .*  .\..\.. . .... # \. *.#. *.#... *...  .#. . ....##....... *.#... .. #. .*.#\.# ..\.. *....# ..#. . ..*  *. .. *..\. *.. ..\*...    #*\#
# *.......*  . *\... ..*.\...\  ...*..*.#\..*. ...#..  #..*....*.**..#..##..... .#  ....    .  ...\..... ....##.#..#. #.....\#..#.. .......#..\....\*#
#.... .......#.** ....  .  . . .#. ....#*...\ ..#......#.#.. ..... . .#..  *..... ..* #*.. .*.... ....# ...#\..*..\ .\ ..\.* . ...*......\ .....  *.##
##  .*  ..#....\..\ ..* \  ..... ...*#***#.##..#.  ..\.....*.....\.\ . .. ..#.\*..\....  # ...#*...*# .\ ... ....   ...*...  .....#. #*.. \*. ###. ..#
#.* * \*\..#.. ...*# *#\. .* # # ...*...*#...   ......#. .* ..*  *.....**.*.*. .**. # .... .#.......#..*.#... \. ..#...  * #.*\*  # ... .*....#.* *  #
# ....# #. #. ......  ....**  ... .......*.. ...    \#..#..  .# ... .*.#..*.* . *.*.......  * *. #. .. # .*..**. \##...........# .*  .  .**.#.*. .\. #
#. # \.*.#*.....  #....#.*..*.#..\..\*#.*#...#....*.. #..  .. #..*.* .\..#..*..... \##.  ...\..#..#*.#......**........*..#* #.....#.. .*..* #*# ##  .#
# . ##..*...*.\.#.... ... *....#.#...##\..*.. # .. * ....*. ...\.. ..\.\.... . *  .** .*.. ..... .\. *......** #....\......   ...*. #.*. \. #.. \#*..#
#.. .*\. ..# ..#..  .. .#\.  ..\....  ...**.#.. . .## * # ..  #. ..*.\.*.#. . #*.. . .*.*..#...  ...*... ..#..\..  #.\.#..\  \.#.. ##. .*......\\*#  #
#..# ...* \. ..#...* #\*.##....* # #*.. ....*... ...#. . ###... ....  ...#....... .... ............ \. *.*   ...\#*... . ..... .\ .##\*......... ...##
#. \\ ...  ..#...*#..*\..#.\.. ..* ..\.........*\** .*..#..#.. ..* ...  . # #.#*... .\.. ...*..... .*.\*.*\ * .**.#.. . .#. ..#.*...#.... . ..... .#.#
# .## ... .#..... * ..\.#.#..#.*.... *.....#.\. *. # . \#. ..\. . .. ..*.. .  *.....*.## .\.#..*.*....##*...#..*. ... \*  #\..\...#. #\ *....#*.#....#
#. *.\.*.. ...**. .*.\ ..\ .#. . .... \...**.#.#. . .# .....\.....\ *. .# .#.. ..# \. *.  .*#*..#....\*#.. .\.. . ..#..*  . . *.. .#*.. ........ ..\ #
#.*.*..   . ... ..*#...*...\...*.. ... ..*..#...  *... . \ .*... ..\..\ .*.  ...*. \ ...\ . ..\.**.*.  *..*.#. .. ... #.\*#. ...#*.. .   ##.#.. *.*.##
#...\.. . ..\.**......#\ . *..  .. *  .....#.*.\  .*.. ..... .....#.\.... ...  .** #\* . .**.#.#.\\...*# # . #..*.  .....**..#.* \. .....\. .#*...#\\#
# .*....*\. ##\... *#.\.\. ...* . . *...**..#  . ..\##\ ...*.....*.## #.*.\......#.#... ..*. .#....  \#. #..## .. .. .. .. ....#... #.... . \... .*..#
#...*.\.#....*.   ..\#.\..*. . . . ....\.*....#.. *...#*.\#....**. ..\. #.. *#..# *...*. .#. *\.. *..   .\*.\*. ..*#.#.#.#.*..\. .#. #........ #...\\#
#.*......*.\*#.##.#\.. . . ..\\ #*..    .* ...... ...*.* ## . . #......*  .#  .*.....  .#....#..... .\..#.\... ..... .*.. ..#.\  .\ ........ .... .#\#
#. ....*...........##. .......*..#... .. .  .    .* .  ....*.  ..\.....##....##  \...... *.* ... #..\. # * *.\..*.. # . *....# .# ....#...*...\.#... #
#.....\*.  .... .\*.. ........ #\. #\#.\. .#.#....\#.#.. . # ..\*# . ##. ... .. ...*.#  * .* .#  .# \ ..\#.... .. ..# \..*#..*..  ..*...##.*#* *..#.*#
#.....  .. ..#\#.... \#. \ .. .*.. .*.*..# . .#  .**.. ..##\# *#.... .  ..... #....... . *.*. ... *. . ..*. .. . ...*... ..*  .. #... *..##.##.# .##.#
#\.. *.#........#*.\...#.#....*.#.  .\#...# .# ..\... #. . *.* .  .*\...\*# ....*..*... ....... .\# * *... #. .... #*#. #.... .*# .*.#. # #.....* #*.#
#.. .#*\..#.... *........... ...*   . .#  \** . ...*\#. ............. ......*... ..   . ..#.. . ..#\*#...*. #.. ... . \.#.##.... .#.....*#.. . . ..#.#
#.  .#...*....#. ..\ #*#.\....#.\..   ....### *.\. *...##.. ..#*#. #.# . \....* *....\.#. .. #..*. ** .....#.*.......*..#\ .#\....#*\# \#* *.## #  .##
##.. *.#....\.... *\. \ ..   ...  #. *.\ ..*.#*.#.. . .*. * .....\ ... .# .  ....*. *#.#...##.##.. #...  ..  ....... ..  ... ......*..* .#.#..*.# . .#
#*....** . *.*.#*# ... * * .* *.*  .# ..#..\.*....#.....*..#....#.\*.#*. ..*..*.. ..  .*..#.*...#.  ..*..*.## .....\...*.\. #.#  .  ##....##*#.*  * .#
#. ...#\.... \...  .#.#...... *.. ..#\#*.\.    ....* \\###..  .*\#.#... ... ....# #....*..#. ...  *  ..#.*. .*\.. .#.. . ...........*. ...*..\ ......#
#.....#....#. ...  .....* .. . * \....  * .  .\#  *........*\.. . .#.*\.............# . .. ...#  ...#*...\......* .#.....*..  #. * ...#.. #..*...* .##
#..... \ .#.#. .... .#.....#...  .*. #...*..*#. . ...*.#\....##  .. .##.. ....*.  ...\.. #*.###..*.#*..#\ ..#.......* ... *.#..*..#...#\# #...*...# ##
#*..#.#....  \.. . *  # . .. .*.. ....*  .##....  .....#..... ....*..*  *  ...#... .  ...\\ #...*. .#.......*#\*..\* .. \. ## .. ...  .\.  \\.#.# ..*#
#...** .#..** ..\*....##\#\.*..#..**...# . **... ## .\\ .**....*...... . ..#*.**...#.#*.... \.... . *..*.. ...# ...*.#...* .#......*.* ..#.# ...*... #
# ....\..*..... \ .....  ....\  . .\. #...*....#...\#..* .*.\...* .\...  ..*\#.*... #   ..#......*.#.#...#.*........ *.. .\....#. # .... ..*#*...  .##
#\.# .##*..\.........# #.*..#.*\..   . ......\.... . #....*.# .\#.#* . ...#. ............ ....*#. .... #.#* \.##. ..... .#.\  .   ... ...\.*\..*....##
#....#*..*. #.\...*....  ...*..  ...\ . . .*..*.. ....*..\#.........\......... .*.. ..........#**..#...... #.\\..... .**  ..\.. * \...# . *.*...#....#
#*\*..\...... . \.*.. ..*.*...*...\..#.. ....... \.... .*#*. ..# ..*. .......\..*. . *#...  .. *.........#. #. ...#.*.#.\.... * ......... \#.*..\. . #
#*#....# #.. .#.....#.# .*...#...... . ..... \.. #.#.  . ...*.. **....#... # #..*..  ...#. .*\.# \#  * *##.\.*.\#... # .#\.......*\..*\..... .#....* #
#.\..###.... *..* .....##.... **.. . * ..#...*.... .*. .. * .  # *#...*.*..#*.#.... ..*... \ ...*...  ..*. # ..#  .... .. .# ..  .\.. .. ..#  .....\.#
# .*.. #..\......## .#*#...#. #. ... ..*...*... ......*...*.... .#..  #....*...*.*.\. ......... # .#..* #...#......#  ....*. .#*\ .#. ...* .. .*#.*. #
#. * ....#. \.. #.*.*.. \.....\.\*. . ... *... ..\..... . .*#*.. #..\... ... ... .**#..#.\.#\  .. #\ #.  *.. ....#... #.....    . .*....#.#..... ..  #
# .....*. ...#\....  ........\  ..*#..#*.*.  .* * #.* #....\..#  ...#.#.*.**  .# ..\ .\\*.*#....  . .* *# ...... . . ....*.#.# * ....#.* ...# ....  .#
#....#. ..  . *# .. . . .*.\..*.\#  .....#* .. .   *...#  \. .* ..... # .#..#. ... #.  .  ..*.*.**.*. . .* ..\ *.#.....# #\...*.. ..*..* \* #..*.*.*##
##. *. *.\.   ...#.\#.*.#....**.#..#...*.*.*#*.....#.. ...#\.......#.. .. ....#. ..#....  .*.* . ***......#* .#*#. . .\..#.  .. .* .* .  ....*.# . .##
#* * . .#*..  .#**.. *..\.\.  \*..*\ .. #. #..##*.* .#..#.\ .*.#  .   ....\*#*....# #.........\ ... ..\ ...#.\.*..#  #. ..#.#*.\.#.. *.\   . . .*... #
#.. .... *.\\....*.  #...... ..##...  #.#... .* . .*. .  *... .#. . #. .  . \* ...#.#.  \....## .*.*  .. ...##*.# ....*#.  .\ \\*....**.#*.....# #.  #
#. \ .... .  .*.\   .....  .# . .*  *#.....#.....*  **..*#\#..#\..........  . ....*...  # ..*...#*..#* .. ..**# ... ...* . # #.# ...#.# ..\.#\.   #..#
#. ...#..*.. ...... ..#*  ... . .\.... .*  #. *.. .* .. .. ... . #**#.**\.\ ......#.#...\###.....# ...  \ ## **.... .....\...*..* *..## ..\.*...\. ..#
#.....\.#.*...#*. .* \..# \.. *..* ..# ...*..*..... ...*. #..*\.#*.......#. ... *\ . ..... .**....... .#.#.. .. ..# .*.*.*. ... *..#.#.#. ... . *. ..#
#..\ ..   # ..\.\ ....# \.... ..*  #.. .#..#...... .. . #.. #  ...  ..\ \... ...  . ...*.... . .................#... #.   .#. .#..*.\.. .. .....*..\.#
#. ... ....   \.  #.*.  # ..#\ . *.........*..  .*..#..#...\*\\.#.....# ...\....*#*. ......#*#..*#. .\#.#..*..* .. #*.. *. .....*.... .**. #..#. ...##
#. .*#. #..\.  . .*........#... .  \\..*#. **..... .\..*.\\ .......* # #\# ..#.* .  .#.**. **\. #. # .#.*.#..\. ...#..   .#*....\#.*..#\\#.   #. ..###
# \.#\ ...#*.....    \.* ....* \  #\..#.#.... ...***.*.....#\...# ..*.#.\ ..*.#\ .. . .* #. #.. . .* *......#* .#\*..#*...  ..  .#..\... .. ..... .* #
#... . ..#. ...#*.#*#....  .*. ...\ .*.*#.....##.# ** ......#.   ..# .\.....  # *# ..*... # ....*.. . ..  ..*..#  \# #.* # #  .. **.. .. #........**.#
# . ...*.  . *#... . ....#. ......... * .# . .\\...  *\ #....*..*.*.\* .\.*....* ..... .#  #  ..   ..\... * \.. ..**..\.\ *...## .\....... ..  *..##.#
# # .\.*#   .....#...* . #.  .##..........  ....#.. .*..* ...#*.....#.#*.*..*#..*..#..... .......\... ..\ . .... ....\# ..*.*.#..  .. ......\**. # ..#
#..*..# ....# . . .*. *#\.. . \.....* #. ... .\* #\   ..\.#... #\. .*.  . *..*##... .* *..*..... *...#* *....\...###. .# . \.. ...# \. \..... **.#\.*#
# ....***.#..*..##.*..*..    *\...*##.# #.*..\...........#....#...*.. .....  *.*.* .*. .... . #.*  .# .#...*.****. ..  ......... ...\#* . .#..*.*....#
#...#... .. .. *.*..#. #....  .*. ... .*... \# **.*..* ..\#*.#.*..\\#. .*.#.##.#\.*.\....#\......\*#...# .#. . . .\*.  ..*#  ..*....*...#\..#. ..\#..#
# .#..# #\. ... ..*.....**\...* \ .\. ....# .#.. ...\#\....... .. \.#* ..*.**#. #..*.#\  ..*...* .#.*...#.... .. ....  ...\ .# *......#.. .#...#*. ..#
#.#..#. ..*.*... . ..\#......#  .#..#....... .. \.   *#. *.\ \\...#.. \... #.#.  .. *... #.*... .#.* #  .....\. ...  .#. *..# ..#...*  ......#.. ....#
# #....*#..\   ...\ .*##....#*.**\*. ..#  ...\ . ..... ... .*..* ..*... .. #. ....*#...\ ..  .*.. ## ...#.   . .*.\#.# . .*** *#.**.   .\....#*.. ...#
##..*. ....   \.. . ....# ..\... # ..#....#*..* ....*..*...#..#.  .....* . .*.. .. .# ...#\#  ..*.* \ *.... .* \.#*  .#. # ... ..  .....*##..\ ..#  ##
#*.... .... #..  *##..... .  #.  #...\. #.   #.. \. \..*..# ..... ......#.. .. .\*  .. ..*......#\#*. ..#...*.# \*. **......#..* * .\...# . .... .. .#
#.. . .*\.*....#*... .* . .\ *.. *......#.* ......**..#  .. *......\..##... .\..\*...... #. . \.......## ##.  ...... .#\.#.\.* . ....  . .... ...\...#
#.. .#........#...# .. *...... *... ...#*... ......  *. ..*\...*# .  .#.........*.. . . *.. *.. ..  * #.*  ... .....   ..\*.#  *.......#...   ..*..#.#
#. ..#.  ..  .\.... ...... ..*....\.....*.\... . .*. . .#.*# .  #* ..#.*..  ....     #..\ ..# .*.. .##.#.#.  ...... .   ...... ...# . .....##*.# ..* #
#....# .  .#. ... **.....\##** . .##.\...#.....#*....   ..   #...\.*...  .....*..*....  \.. #.... ....... .....\.#\...\ ...........*. #.*  ...##.  ..#
#....##....#..#. . . ..... \ # #.*.\**.## *...*  .*##. .#... ..#.*.... *.. ... .\..*..... ..... . ..#. . ..# ..# #.*. *.## .. ....#.....\ .......##. #
#\ .* \* *..#* .....*. ....#...  # ....... .#\*.#.\... .* . ...* .....# #. ..*.... *........... .**.......#.*.  ..... ..  ..\\... *..**. #*...*.*#...#
#*... ..\.*  ..#.*  \. \# ... #..\*\.* ....*# . .... ...# .*.* #* . ..#.#   .\.\.. ....###....... ....# . #..... ...*#\.*...*...*.  .\.*# *.... #*#.##
#*.....# *.*.....*. ......... # ............\.*....# # . ... ..* ....#  ...*.*... ...*. .*. ...# .**\#*.*.*#..#.##.. .# ...#  .\ .\... *##....... ...#
#....#...\..   #.\\  .... #*.....*.. \#.*...........\#. .*\. .### .. #. *...#\...  \.. . *.. ..... . . *.##.#...... #.. *  ....#...... *... #... .* .#
# .*..\... .*\..... .#.#...... . . ##  \... *...  .#.....\  .*.. .   \*#. *........   .  *.. ......\*...*.#.*.  ..... .\\..##*.. *...\#...*...*. . ###
#..#. .. .*#\# * .. . **...*#......# .......   .#.*.. .#.#...#*. \..*...\##... .........\. .\.... #..\* *......#. ..*. ..... ..#*  #. #..# .*#.\  .*.#
#......... .\.....#..*#.....#...#...  ..#*.#... # .\..........\.\.......*** ##.. ## .*.......\*.\ #..*#*.......*. #  *.....#*..\. *#.#..# ..#  .. ..##
##.... \ ..*#. ..\*#.*...*.# *#..  . # . .....\...\ . \ \.. ...  .#... .. ... *.*.* ..\.\# .*..* #*.#... * .  .*\#.#..   ....*.....*.. * *.  #\. .*. #
# ..\. .. ...#.......#..#.. .....\. ..... #.#..*\.  .... . . #\ .....*.#.........*#. ..*..#.*\..#\\.. . #... . . *.  .**#. #....\.. .*. .#. #. .* \ .#
#.. ..\* .#.. .  .**.\* \**.\ .#\....  ** .*. #.\ .  * ....*....*  ..*. ..**.*..*.......  .... .. #... #   # ..*.#. . ..\.. *.. ..# . .#.. #....##...#
## .*...\\  .. * *. . # .#... * .##* . **.  .*...##.\   #....**.  *..\#  #...... ....  ..... #.# ....... ...#... ....#** \#..*...... #  ... ..  ..#..#
#...... ....... \.*............ . .... \ ........ .  ...*...#....#....* \.. ..* *..*......... # ..#. .*.  .. . \..# ... .. ..#.\...*.* .#* .#.##.#.\*#
#...##...*#...* ..* ...# .. .#...   .. .*.*... . *....\..   .....  .\ .. .*..##.#..#..*. .\. * . ... ..# \....*...*.*. \. ...#..#..   .#......#*.## .#
###.\*.. .*.......*.# .... #.\. ......#*... . .*....*.  . \ #.#.. .......*...# ...\..\ ..... .##..# .*.\. ...#....# ... #. . # **...#.  *#. . ..... .#
#..*..*..... #.##..  . ..#.......\ ..*. #.......#. #.  ..*\  ..#.\.#.. ##. *.....\...#.. .**\ .... .#\ .....#.\*.#........\ *.*..*.. ......#...#. \ .#
#*#  . \.....##. *.  ..*.\.* ....... ... .##. * .*.... . . .....\\... \..*#  **.*.\\......#.  .\....#.. # . ..##.  . #.......* *.. .#.... . .  ....* #
#..**.... ..**. ..*. ..**..... . .#..*........**. .....#.  ....#.##\.# .#. ....\\... #. .... ##..... #.*.. ...*#.\... . .#.... *#..*.#...#*.....\ ...#
# ... .*##.. . ....... # ..... .. ...* ......... . .*.....\.#.....  \....#*.\....# .# *.   ....... ..* #. ..* * .... ... .. ...\.*.*... .*..*. * #. *#
#..  ..*  ..* . ......* #...  *....*.# .* .#. ..\ *..\#\....**.#..... ...##....**. \ # .##.####.....  . ##.. .*...* .\* .*.\\..#.# .. \.... .......#\#
#.. ..  ....# *####\. .. *#..#***  *...*.*. . ..  ##.\. ..#..  **.*.....*.##...#.... .* .....# ..# ....#. . .* ....#.... .##..............  .. .# ..##
#. \#  ....*. ....#.#..*..#.\.\*..\ #*.  *\#..* ..  ... \ .#.....#.......  .. *  *#.. ....*# ..#.....#.# . .  ... .....#*  *. .## ..*.*... ..##.*....#
#......# #.** ...  #*..#. . ...........# #...  ..\..# #*...* .. #...*.\.... .**....* ....\.* ..#..#. . ..*....**  . #*.... ..# .\#..#.....#*.** .##.##
#* # .*#. ....  \....#\..\.\. \\ .... ...\....\*#..  .  . #. #.##### .# #. .#*..# .#  ...*##.*  .\* #*...#  . ......*...**..#. ....#..* *... ..\*.# .#
#. *....#....\... .\*.....* ...#....... ......#... .. .#. ... \.  #*.. ....**. ....#.. #..#\.#  ....**.*.  ... ..#\...#......\.. *. .\....## #..*. ..#
#....... #\. #......#  * .. . # ....*# ...#  ..* .. #\. * \\....*... #........# .## \ ..... . *. . \... ...  .#.#  .*...   #*. *..*#.. .....   ......#
#.#. ##..*.. .. .\  .* ...........#...\.\..#.*\*...#. *.\.#..\....#  *. .... .#. .... *..# .*#...*  .... .....*\#\    ....  . .*..*..*#...# ..**#...##
#.\  . ...... ...*.  *..\...#..\. *  . . .. .# .*. ..#... *.\....#  .*.\  .. ....** .#*\#\#.*........   * . ....  .#**    #  .\...*...\... .* .#.\\..#
# .*.   \. #  .......*... #..*...**\*..  . . .....*.... ..  . .... *  ...  ....#.*.....*..#*.. ...   ...* \... .* . .   ..  . ...#.#..*#..# ....  ...#
#...**...*.#.. ..\.. ... ..... #  ...*. .. .#..\....#\. .... ..#*.#.*.*.# ... #..*...#\...   ..  . #.**##. #...*.   ..*.  . ..##..\#.#..     ...\. \.#
#..\##..... \.*......... .  ..* .... .*. **. *...\... # . *... ... ...\. ... ..##.#.*\**.... *. ..#...\.. *...#.#....\#........\...... .*\ * \.......#
#....#.#*.... ..* .#. *....*...# .*... ...... ..  . .....  \...*#*#.*  .    . \*...#.#*...#..#......** ..*.. .*....  .##....*...  .... ***... . **  .#
#.. ...... *\##.# *... #..#.........*... . .*#. *\.**.#.#.......\.... .#.. . .#*.#. #.**...\.#..\...#. *.  #..*. *.##.....*#.\#... .*... . . . .*.*..#
#. ....\.*......\.  ......... .....**.. .#.\ ......*.. .* ..*..   .*.  ..#. . \#\*...\.....*.......#.*. ..\* * *.*.*... #.#..... ......#.. ..*#\.....#
#. . .*..\ .*#.#..*...*...#. . *..  . ....* ..... ....  .. ...\. ....*.#.. .# . .**.* \.. ..  . .. .. .#...... *#...  .\. ..  .\..... *.\..*.#*..  # #
#....\\.........#..... **. *#.. ......#.. .**..... #*.*.# . ..*..\ .. ... ..\..\ . ...............  #. ...#...\..\ #.. #*. .....*.... .#.....#....# *#
# ..*.# ##.*#* .. ..... .... .*.##...*. ... ....#.. #. \.# # .*#.#*  ...**.. . .. \ ..#..# #*...#..........*\. ... . ..*... .*.*  .... .#.*..# *#... #
#  . .....  ...\#.*. *   ..  ..#\ #...  ..*#.\.#. ....*.\. \... .... ..... **# .  ..*##... . ...... . ** ...#.  ..#. .....\.. ... \*..#*.**#.. .. . .#
#*. * .**..  . .... #..#\..**.*.#\***. ....#*..#*... .\. . .**  ##.#.... \..... ..  *.* .... .  ....... . ..\...#.  . ... ....... ..#*\.*......*. ..##
#. ... .* .. #.\....*...*\..*...#... .   ..##..#... .*#. .**.  .....*..*#. .*..# ... .##....\. \.# *#.. #*. .*... .\# .* .. .. .  .... ....#.  ..... #
#.  #...... .   #..##*.....# . .\. .#. #.# .\*... ... \.* \#......***. ...\...\.#..\#.. ..#..\.#. ..*..........#*##...   . .\. *..#  ... . .......**.#
#.# ...... ....\.#..# \*.. ..** \....... .*#.#* .\ . . . ..*. ....*#*.  ...\..#.. ... # . ..... .. #\......#.** ..# .#.. #*.*.\.  .#... ..## .\...#..#
#...\*..***... \## #*.##.......*.*.# ..... ... ..# ##..  . . * .\.. *#....#.\ *....*  #. *.  *..*#..\..... .....* ..##... .#..#.....  .\ ..\#.#..#\. #
#...\ .\. *..*.* ..#.#... .... ..**. ..*.* *.. .....*. . .. #  #* ..* ... # ...\.. ....... #.# .#. # .#.#.* ...*... ... ....# . .\. *...#..  ...\....#
#...*\# ... .... ..#   .# . *... .#......#*..# ...** ## \ ...\.*.#*....*.#. \. ***...*....*...#..*..\. ..#..  \.... . ......  ....  ....## .# .*.\#..#
# ... ... # **. .#...* ....###.. ..#.*.#.... .. .#. . ..*#   ...*\.. ..# .. ...# .. \....\. ..   .*.....*. .........   .**..*#.. . *.. *..   . .*..*.#
##.... .# . .. #... . .#.#..#...\......##.. . .\. . *.\..... ..\..... ..\*. # ........\..*##\.*..\#...\..##\ #. .. *..  #......\.. . ....\.# \...... #
#...*. .. *....*..  \.. ...# ##.. ...... \..#. ....*.*..#.....*... ...##.  .#.. *.#. #..# .#*.*#. .  *...**....  . .*#. #...\   *. . ##\.  *. ...  .\#
#... ..\#.. .*....* . ..  *.............. . *.#* ... \#..  . .......\.** ....#*.\... #....   .  . .#..* * . .*.   . #..# ..* * .\.........\....  .*#.#
#..  \#.   .. . . ...#..... . ....... \.*.... .....# .#.*.. .*..#*. ..\#. ......*....**......# #.\... .... .......\....*.. ... #. ....*. .. ..\# .#.*#
#.##\ \#.*. .\#\ #.. ... . .\. #..#* * .. ..  . *  ... .#.*..  ..#.#.#*.... ..* #...###..  .\. #  .#.*.. . *.. .*  ... ..*. .*.. \# .**#.. #  .#..*..#
##..* .#. .#.. .......#.....#...#...*.. #.#.#.**#..#.#* .#. .* ..... **.#..... . ... .. #. **.*.....\. .*.**.. **...... ...* #\ .*#.. .** ..#.*..# *##
# . .#*. \.*.... .. .#. ..*..........#..  #...#.\**.# #.#.#...... ...*.....#   #*... #..\\....... *#.\*.\.*....* ...#. *.*..#. \... .\*.....*#.   #..#
#. ...... .. ..\\....*#...#*.\ *... ..#.. .*. .*.. . # .....  #.. #..##  . ..#*#* ...  .*...#.#....   .\.*. #..#. *.*#.*...*#......  # ..  .   .\...##
#.... ... #..  . ... # . ..##.#. .#..*#.##..##...*#\ .#.#.. ..**.....# #...*  ... ... . ....*# *. . **.. ....# .*. ........*. *.#*... ..... ....  .. #
# .#. . *. *..#. . ...#. .#* ..*.#*..* \ # \# ....#.. ...... \. ..  ..  .... .\#.# .#  # \\.\*. .*\  ...*...* ..... ....\  .. *\.*.... . \.#.  #..  .#
# *. .\.. ...##..\ . .  \....*. * ..#.. . .#...\..* *. #...... .   ....#. . * ............. .*...*. ..#   #.#.# . ........ ..  ..#.# #..**.#.## . . .#
#.  .. #*.. ....  .\..#..*....#.\.... .......* ...#.. ..* * .\.. .  ...\....... #...# ...*.  ...* .#. #.**..  . ... ....... .#.*\#.*....  ..#.. .  ..#
##  *. *.....#...*... #.*. .##....*..... . *.\#\#. *. ##.\ ... .*\......\.......*  .#..*. *.....*..* .. . *....... .##..\... #...  .**\*\.#.. *... \*#
#..   .. ...*#\...   . * .#.. ..\ ... \ .#.*\..#...\.. .*....*\# .#.*... .#.*#.. #.*.. \....  *.*.##. .......*. *\.*   ...# .... ...........# ...# *.#
#.. . . *...... ......#**.#. .#..##.\ * ....... .* . .....*.# **... *.......*.. .#.*....\.**.....*...\... #.. \.\.. ..# .*. \#.\..\  *.  . * .\ .... #
#.*.\ .# ...# #**....*...*#..* . * .....**.....*.. .*.......*....*. .\##.....**  .#*......#  *   #.#\. .. ... # ..  ... .# .* . #\.#...*.. ##..#.. #.#
##\\.\  .. ..\.\# . # ..* .***.. .... ...*..... #..#...\#... #. . *# ...  .*.** #.*\ ..##...  ......#  . .. .#*  ..*.* #.....##..  #***\....#... . ..#
#. \** . ...#  ... ...*....... . .... ..#. \. . * .# ...# ..#.#  ...  .#. .###*\#..#.#*. ....\ .\#.. ..\\#..#.. \**. .... .. .*.* ..  \...  *.##  ...#
#......  #. ..... .*... .\. .*.. ....*.. ... ..  ..  ..  ....*. ..#*.. ..\.. ..\ .# *.#..#..\\ #.*  *\....\...# \\. ...... . \.\  # \ ......... #*. .#
#*....#.*... . .. #*. ..\..  *\.. ***. .*   ...... * **. .. \.*.***.#\.. ..\..... .\..........# *....*....*# .*......*.......*  .#.  #..*\.*. .....#.#
#. \...\.. #....#  \.* \. ...... .\  #..\\.\ \...\ ..#.#......\#..* *# #..#  *.*... ... .#*.#.  ...\...*# *..#.....  .... \* *#..#.. ..#.#  .##..  #.#
################################L#####################################################################################################################