######################################################################################################################################################
##. ..# #..  ...#*..   #.. . .\#.# *..# ...*#   ....##... #..#...\.#. **.....\.. . ..*...# . . #... ... #. .  .. . .#....*\.. # ..#......##..*.. *  .#
#. ..  ..##.#\. .*.#..#  * ##.... ..\# #.. .# .  .\    # . .  #.#. .  *.... ...\ ....# . ##... .......*..#...#.. ...   .* ...... .. ...\.......*..*#\#
#\ ....*.\* ..*#*. ...* . .*.#... #**.. .#\*.... **\ #.\   ..\. ... .... .##.#....#.#. #. ..#*..  . .* **..*. . #\ .# #  * * .#..*. ....#*  .\  .*\..#
# *......... ........... .  *...*#\.  ...* ##.#  #...*. * #*\ .......*#*.***.  #.#....*.... .  .# *..*#  .#.... .. . ..###...#* .. ... .\ \ ..... . *#
#...*#*.. ..#..\ .*... *..#  ... .#..  .  *. ....#... *.. ... .*###.*....*.. #\# .....\.......  \.\\ ..... ......... ..\#\#... ......#\  ..\#.* .#*  #
#**\  \*. .#...*\#.#*.*. \#*.##.\..*#    .#*.... \ . .# * ...#... .\ ... .... .. ....*. \.*#.# ...#... *.#..*#.  . ....\#..# ...*.....* ...\#...\*#.*#
#.... ..#...#..#*# .*##.... .  \...*....\.. ...\....  .* .........\........ .* ..#...** .. .  .. *  ..   *.*........#... #.# # . . .#.. .\...*...#. .#
# .... # ....... . . . .*....\...  ......#....\.# ... .#. ....*.. .. ..  .* . #.#.#.......... ..* #.\....**... *.....*...##..\#*..* .\ *.. # ...... \#
#.#.#...*\ .#..# ....*...  ......... .. *....*\.. .. . .. *...#\\ *...#.*.*... *...#. \#*\. \.\..#..\#. \.\# ...    ..#.#. #\..\... ...... .... \  . #
#.#........*.*#  . * .*.*..\.. ....* * . \ *..... ...... . .\. .. ..*\..\...#..\#...\...*.. ..*##\ ... ...#..\. ...\#*...\.. ..\.... .#.#*.......#...#
#.# .*..... *.. **.  ...\.. \ ..........#..  ...#.........# .#..  \..** .  . .. * ..#...*. ..... .*..... .... .. .*  ..# .*.*\\....# .  ..*##...** #*#
#............ ......*..##.# .\* . *. .\\\........# ........**.. ...... ***\ .*.....*.. ....  ..\* \*... #. *....#..*##..#..**#**...*.* .. .*.....#.#.#
# #...#..*..**......  . #.\.... .. ... \##.#..*\ .. #  #. .   ....#  .* .*#*..   .. .... .#.  #### .*..#.*......#.... ........#.....\##.#. #..#......#
###........*.*.#. ... * ... .  .#\...##. \ *.. ....#.... .... #....  .\*...*\ .# ....# ##.\*....***. *#.*     .. .. ..#..*  .* # . .R.\..# #...\.....#
#.. \ *..#....#.. .#*.*.  ...*#.#..#.# .  ...   .*#.**\. ..........##. . ..\.#* ..... . ..*#..* . # # .  ...#..*.*#. .....*    . #.\....\* .*.**.#. .#
#..#... .. *\..*  ..... *#*....#\.# \. ...*.. . . # .\. . .  *  ....  .... .  #...... ..*..\ . ##* * *... ...#  .\ .#.* ...*.*. *  .*......* .. ** ..#
#..   .......\# . .*..\.\ . .# .*#*.\.**\.*#.. ...#.... # ....*...  .*..\.. *.*###..   .. .\ .#...#......# . . ..##.. #*.........   .... \#\.#\..#..\#
# ...*. .\...*..#...\.* .*..#.#...* . . .\..#..*##. .\ .... .....#.*.*.#. ..##.*. *#. #..#.. ..\  ... \.*\ ... ....\ \. . .....*....* .. .#   **.\...#
#..*. .*..#  . . *..   .....*....#.*#.... *..*.*. ## ...* \......*....# # #....... *.#. .\.... #.*......#. ...#\## ..... ...*#...* *.... .... * ...#*#
#...*.\#*..*.*.#.*.*#\.. .#. \#.*\. . ...#*. #. \...... . .#.##....\\.\*\* ....... *\ . ......  .## \.*.   .. .... #.#.\ .##. \ .** .....#. .*.....  #
#.*.*.. ..# #..##..*.\. ..\..*.#.*# ..#...*.# ..#.. .\. *...# .... ..*.*. .\.  ..\. .... .\# ##\.... .*....  .#* . **..  .\...*......* *....\...*..  #
#.. ...  ... .. .\*. .. .......#. .. #. \. ....\*. .#.............  ##..#....#....\\ ..#... ... .....*  ...*. . ... .#* #.#  .  ... . . *\#...  .\.**#
#. .#. .*.*.. ..#.... ..**...#..*... #.##..*\. ..*....\. #. #...* .........\ .#  .......*#.*.#...**  *. .*..  .**..*.  . .*. ..\.*..#... *.. . .. ...#
#\.#.. #*.  #....*..*.\.* .*#.....*......  . #.. \. .#....*#*...*... **.... . \.....**#..*. .... #..... \#. ..\##. ...  ..\...\ . #*...*#.. ..*...  .#
#... ..  ..#\......   .* .\....#*... .* \\#.##...# .. ...... #...\ .#....#. *....* #...... .*#..*  ...**..... * ...#  #...  .*.#\.*.\...#.\.*#** ..#.#
#.. .\# *.** #   ......#....\..\.#. .\...\#*#. ..*.* ......\. .*.. *....*..#. #. ...\  .#....\*. #**..*..##.. ...*.  .*\. #   . .. .....* ...* .    *#
#\ .# \*..*.... .... #...*#\#.. .\..*.##. ..    .*..#.*.*.*# \.# ....**.*.#.*# .#*  . ..... .#\\*.*...#...\ . ..# ...\#* . .# ..*.. . .*#. .  . .#.  #
#  ..\...*\...#. . .*.. #. ..#.*. *#.# .. #*. ***.. ** ..##..*.#... .. *#..\ .#  #\.#...*# ....... ..*.... \.#...#...\ .. ..##..#. \. #....*#... *.. #
#.\....*. .* .. # ...*. #.*# . .... ...... ..#.\.. \ .....##...** .# *....  .*##. *.#.*.. *....... ....*. .. *...#. .*\ *. ... . \* .  *\ ..*# ....  #
#....   ..\#. . ..* .. ....#\ .# ....  \\.... .... .. #  ...\*#. .... . .\.*\.....\.\....*.. * .#.#.... . ... *... . .#*\ .#*#...*.........* ...#\ ..#
##..  . #.\.  **. ..#  .. .. .#.. # ..**. *.# .......\... \... \.\. \. \...#.. *.*#*..... .#.# *  ...\ \. . . .....##**.. ..*....#.. .#\..#..... .*..#
#. .*#.#.# *......\ **\  . .....*..*# .**   .   . ..... .. ....  .# .\..#.#*... .*..\ * ............ ..#...# .#.\# . ..*.  ...*..**.\ .....*.. ..#*..#
#\...*\..\... . . #*.. . * ..... . ....#.*. *.*#..#..*... *. * ...#... .... ...  .*.......*.*....*...... ......\..#.  .. #*.##*.\.#.#  \*\....* ..\..#
# *.  ... *..#.......** ....# .##.. . \.#\#*.. .#*. ......... . .*# .. . . *..*.#   .##..#\..# .# .\.\*#\ ..*. *. ...#. #......\..  ....**.#**\.*....#
#.. *.*..#\.\....\#.#.#**.\.....*.  . .  .*...*\*\.*..*. ### .. . .#..*  .    ...**... ##. . ... ...##...\ .. .**.*\  ...\*..  ...\..*..   ..  . . ..#
# . ... #. ..\*. #.*\. * #   ..*..*. #\.* ..#...*.##.# . .. ..\.*#...... .\... \ #.*....\....#. .* .\..###...#..* ..#  . . ....#.... \ #*#*#....  ...#
#*.. .*.\.. .. ...*...  .....*..  ...*.. . * ....*.. *#**   .   *.*\........ #.* ..... .\#.. *...*... *..* ..   ...# *.......... ....#.*..........  .#
# . ..#.......*..# *. ###.*...  .\. .... ..*#.\...\..#.* .*#.  \ \.  #*#.#.. ... .\*. ....\........  #  .#.**. .... ..##. ...*.. \.\\..####.*....*#. #
#. ....#*.#.... ..\.\**..# .\*.#*....**. .#  *..\...........*...* .\ ...   .**. . . ...\..*. .*.... ..\#.*...#. .. #.#* ...\\..* ..*.. *.#....  . .* #
#......#....\ .....## ..\*#.#.**#.   . #...#. ... ..#....#.. .\... #...\..*.#*# ...#\. ...  #..*.\.##..*#.... ...#.*..*  \#.##.     .. .. #*.. .  .. #
#.....#..**..... \..**..#* .... \ ##.*..  *... .#** # ..\\..  ...*.#. .  ........ ....#...##....#\...##. ..  ..... *.\.*. .. # **. . .* *.\..#...\ \.#
# ...#..#.#. # .... ...\ # .. \#...#*##..  .......... #.... .....#*.... ...\. .. *.#   .#. .... .... #.... .....#... .\\.\*....*\.# .* \ . ...* ##.*.#
#.... .\ . *.... . .. .**\...**..**.....*\..*   ... ... .\.. \#.*\ . ...\... . .* #..*.#. ....... \..*.*\.\...  ..#\....\#  .....##\#...  *#..\ . .#.#
#.\.  ..... .#..#.. .* . \. \... . *.\#. *.. .\..... ... \..* \....#*.. .. ..#* ..*.. *.* ..    .*. ..*#..\#..#.#. .#.... .  \.*...*\.....# .. ..\...#
#  .. .. *... .\..* *....*. ...\.\.#.# .. ..*. ..*.. . ....#... *. #...\  \ \.  ...... ..  .\#..*........*#*...\.*  .  ..**.. .\.* .* .#..##\.. * .*.#
#.\ ..\\ #.\ .#.\...*#.#*\.*...*.*.... ..#.# ...\. .\\. .. ....#....... . .* . . .....\. ... .. *..  #*..* ...*...\. \... .**  *.\ .    .\..\  #*... #
#..#.#..\... .\ .\ *  .... ... .*.*   **....*...*...... ....*..*......#  #....* *#..** ...# # .......*.....#. *.\...*.  .#\#.#. ....... \  .#  #..  .#
#.#.... #...\. ..#  .# ..... . .\... \  *#.....\.. ....  *.*..#*\*\...#....#\.  .... #.. ..# .* #. ........ *\#\.* .....*...*. ..*#\.... ..\ ..*.#.*.#
# #..*  .  \.*... ..**.\ .#*.#....*  .....*..*.. *..# \ . ...... ...*.\.*  .  .. ....\#.. .. .#*.#.\ .#.\\#. #...  #..*.#\.#.....#.....#. .* #* .#..*#
#.*..... ...... ..*....... .. .*......\.#... # ..\ . \\.....\. ..\ .. ...#...  .# .........*...*.#.... . ..#.*#*# #.  ..*. * ..# . .   *\...*\... ...#
#*.*\ ......*... .* . .......  . ..*....\#....*.. ..#.# . .#......##..#.... ...*...... *........*.. ......#..# .. ...*.   .#.*#\*....\. \ .....*. . .#
# .#.  ..**\ .........\.  *. .. .....\  . ...   ......#.* . *.#\.*.. ....*  .. #...#* .*...# ... .\.  ...\..\ ..\.....**.  * *# .. ... ...*..#.......#
#...  .. ..*.\#. ....\..*\.*##..*. #*\\ .. .. #. ##.*. ... . \.....*..#.*..*......  #.*.. \..\......#. ....*... ....##.#..*..*....\.*#.. ... ..#\. . #
#* ...... .... .  #*.#*....  .... *... . .\ \#.#  \ ...... .... * .. \#.#.*\#.. #.......*.......  .*.. ..#.#. . ....\............ ......\**.. .....# #
#............. ...  . .. \... .. ...... .  \ #*#. ..... ..\*..... ....  ....#.*. *.# #  ..\ .##. \....... *#. ...*..#....*.#  .  ... *#..#*.*#.*.. ..#
# *..#.  .#.\#\.#..#*..\.... **#. \*\.... ...# #. #* ... . ..... ....\#.......\  \.. .*#*.....*. #.\#.\.... .#...#. #.*. .*\*. \\....... .#..... . ..#
#.##   **  ........\.... * .. .\...*......... * #*# ...#...#. *. \. .* ....*...#......*#\#*.#......#...  ...  *\.. ... .#.#.... .. . ....... *... .#.#
#..*..#  ....\* . # ..#.   * *\#.\. .\#..**.* . ....# *....... *.# .#* .. \#. \#... *.. \* . .**.... *#*\.#....##.. .# ....#.*...\*......*\.* ..#....#
#.#\..*.* *..* #* * #...*..\*...#....... .   ....  \.##..  ...#..\.. .#.....*\.#*..#.**. ... .*. . .*  .... .*# .#  ...  .\ .\*#. ..*. \ \  \......#.#
# *. ...\  .\*..   ....  ...#..  *    ..\****.\.\........#\#..*.. ... ......*...# .*. . ..#\.... .#.... #. *\...#..#.* *. ...#.... . .... .  *...\.. #
#  ##.*...#...*. \#. ...*.\......#**#...  ....### *...*   ...* .#.** ##  ...#.......   .. .. ....*.*..*..#...  \..... ..... .  . ..*# #..*## ......*##
#. ... .* ...   ...\. # #..*.\.#..*.#....#.......... .\.# ..#  .#.*.. ...\. ....*\#...* \....\.*\....#....*.*  \...# \ .\.*.   \#.....  ##.*#.. *..\ #
#. .  .#..#....#... .#.... .. ..  ..... #.*.. ..... \. .. # ..#. *.#..#.  ..\..*.. .#........#.*...\ ...*.\...#.. ....#.# .. . ...   . #\.*  .. ..*..#
#  **# ... \. .. .##*#*#.. .**.##..\. ...... \. \.\ . ** *. ..\# ... *...**...  ....\..... .\\.. . *#.... #.\.*. ...\ ... ....#..##..*..\ *....#..*..#
#..#* ......#.#.... *.*. .... #.*   .\.*...  ........ \ ..   ...*...***.*.#.. ....*\\ ... #....* \#*....# . #* . .# .*...*...   . ..*....\.*..*   *\.#
#.*..* . ..** .#...*  . ......  .*...\ ..##..... .#...*.\*#...# ......*..# ... .\....*.......  .. #.\.\# .... *.  . .  .#**.. ......*. *. ..#. #**.\.#
#.**.\...# .. ..#*\.*...#. ...*.##*..#..#*\#..  #. ... ..##..  ..\ .....*.. ##*.. .. .#........ . *.*# .\ ...*. .. . .\..#.#.. .... . ...    ..#.....#
#...  \.....* .*. .....* .* .....#..  .  #........ . ...  ....\.*. ** **.  ... .... *....* ...  ..\.  .... .... .*.#**.*.# .... .. .*...** #. ..\.*..#
#...*#  #\ ##...\.. ...*.**.#. .*...\ ....*.\... .#***.*\.* .... .*... ##... # ..*\  \ #....*\** \# # *. . ...  * *.. ... .#** ...  .....*. \...#..\.#
#.. ...*.. \.. .*.#..#..*.#.\.. \\*.\..  . ..*....   . ... # .\*.# .#........ .*. . .\ .  ...*.....\....## *.... *.. *.. ....\. \ .\ *......*.......\#
#*... **. ..#.#.\...**...  \* .\ *.\#......*...*.*    ..*# ..*....\.#..  . .....#.**..\......... *.... .\...#.#..* *. *...*. ..\  ....#\....   ....*##
#..* #.  .**    \\.*.#.. .  *...#\*  *\...... ...#. \......\*.#   ....*\## *.** .*#..#\#\ ..... .......... .....  ..*..*...#* .*....... . . *.*. .*\ #
#... ...  .# #.....*...... .......*...  *# **....\...#.*# ...\\*....  ##......*.. .\. .. *.... .#...#.# .* #....#.#..#.. * ....... . ..* .... ... ...#
# .#...*... #*.\#. .#\ #...... #..\...\. ..  . ..*.....*. .#.*\.    ..  ...... .. ... ..  .  ....*.*..#.\...\.**..\#........ .. .   ... *..... #\....#
#..*.  ....\..#..... ..#.#... ....... . .* #. ... *#..##.  *... # . *..*...\\.* .\.... ..  .*...*..\.#* ...\* .#*...#.. .\.**\...#..... .  ***.. ....#
#...#........ . .#...*.. ..*..*.. .. .. \\.... *..#.  .. #\..\#..#  ....*.........   ...# . ..#.*  .... . *.#... ..*.* .\.# .....# ..... ...# .. ..*.#
#.......#. ..*... .#\.#.#..... ...  .*.##. .#.**..  # ..#...*.  ...#  *.........#.*\*.#**. .#.**... \*... .. .. ..# .#.. \ .. ...\...#* **.*.... ....#
#*# #.#.#**#....#..\.  * ...\.........*.*# ...*#.. .  ..# .... *.* *.   ..# ..*.*.    ....#..*\#..\\...\....... .\...#*#\...# *. #.. .....\ .#. ..*. #
#... ..*. ...  *..#\.#. .#\#. #...#  ..#....*\*.\.  .... # ..\. \  ..#... ...\.  *.* ** ... .. *.***.  . *.#\.  *....\\....... ...#.....  ....... . .#
#..# ..  . ......#. .##. .* ..   .****. ....\.. **\....#. .. ..#*........ .  .###.*.*.*# *.#..#.#.*\\#\*.*.. .#... .. .#*.. ... #........  .*** ...#.#
# *..#.#.*. *. .  * .# .\#... . ..  *..#*...# ...*#... . .\\.. ..\..#   .## .\. .  *..*#.#. .*\\. #.#. \.*\ **.#...*  .#...#  *....#..... .***.#.#...#
#.\.. #..*# ...... ##  # .#.## ...#*.** ........\.\\....#  .#.. .\.. .\*#. .....#.*.##.... . *. ...*.. ... ..\ .... #..*.#  ...  . . .  #.. *.* .*. .#
#* .  ...*......*.... *.\...*..\. .... ..***.. *.*   ..  .# #  . #..#*.... . .*. *##.    \.*......\\#.# # #...#..\.. .#.......*... *.....\ ...*.* . .#
# .  .#.....*....*. ..... #.#.. * #....#..#. \*\..*..*. \. ....\## * .*... ... #..\.#. #*..  . . ** ..#.#. ... #.\.#. .. ......# *#.  ....*.\ \**. *.#
#...... ...#\.**\  .. ....   ... #. .\\\. \#.#.# \.. ...*... *  .*#*. .* #\   .......# .*. .# ..\.##  .**.#* .  *.. ...#\.*..*....*...  .. **.\...* \#
#..... .*.*..#.....##.\#  ........... #.... ....   *.*..#....  .. *# \\....\ .......#  .  ... ** .. #*.*....*.*..#.*.. .*#.............#* ..# **# * *#
#.....*.. .. . .# . ....*... \#..........\ ..*.\##.   . ...#..\...... *.  ...*. ...#\..**#.##.##.\......#.# .. .. ..  .  #  ..#. ...**#.\.*..\. .**#.#
#\.\.... ...*.# .....\**.. ...* ...... *..#\....*....\\\....#......#..#..\    #..#.  ...#.... . #* .*. #. \* ..*.....*\..........\... .... .** .# ..*#
#..#*  .#\# .. *..*.. .. . .\*..\.*..**.* #**.. .* .## ... .  ..  #*#.*#......  *. . . . .... . .. .\ ....\#.  .. #** .  . *...\.*... ..... .. *. ...#
#*. . #..#.\...# .. . *\.... * *.... . \.# ....*#....... .. ...#.......##*.... .. .*.. ....#..\#.#...\... ...*\.*.  .. ...* .#....#.\\ .*..#.#.....#.#
# .*.. ..*... *  .*.# . *. *..#..*#*...#.\.*........ .  . .#*.#  ..... . ..*.* \...*..... .#*. *#.*##  ... .* *.*.*....#.. ... .*..#.#.....#.* .....##
#.....# . ....* .  ..   *..#... .*.* \..*.. *.   .... ... . . .. .##*#*.#......\ ..*.*..#........*... . ... *. . ..# .............. ##..*.  \.\* . #*#
#..* ..  ..##.*.*.    .*#*.#... .#\. . .....* ..## ........****..*. .#\..  # .##..#.... \...... ...** .#.. *  ... . .# .*.  ..*..#. .......*. . ..\..#
#*... . ....**...\\*..**..#.#... .....**.....###..*.*.#.**. ....\.*..... *....*. \.  .\   .#....* ....#..\..##..##*.#.*#   .#...#.. * . ....\. .#.  .#
#.....  *\# ##..* ..* # .......#... * #..* ##..* *.#\.#*.*.... #....# \..\...*.\.*..\.....#..... #..# ..  ....  ......**.....\.\.#..#...#.... .** \* #
#.\...#  ##*.....##.... ..# ..\ . .###.\.... . * ..** \.*..#....* #\.#...........#.. .. ...\\.. *.....  .\\\  .    #... ....\. ..*............#.\\* \#
#.#.*.. * . *..*#. ... ** *.#.. ..#*.. .... ..*....#. ...   .  #.#...... *.# ..\   *. .\...\.  *. # . . .... ...*... *... \ # *... .#\ # .....  ..#. #
# *#..   ###  ...... #... \..#.  ....  ## .. .. *....#*\. *** \... .*.. ...*....*#\ ... #*..\.... #. * ..  ##.# .#**#  ..... #.#.*.. ..#....  .*. #\.#
# .. .....* ...##.*......  # ... ..#..*. .. ..\ ...\.\..*.\.. .... #.. \ ........# ...#...#..... *\#. ..\. #  *..\. .. *.. ...#.\.#. #. ..#.##..... .#
#...........#.. .....*.*.  .\  * \ # .#.. *.....#.  ..#. . *.......##. .*. .#.....  #.....##*.*.*...\.#. .......*\...   .... .......... ....\#.. .. .#
#  ......#..*.\.. \*...  #.**#....*# # ..... ..*.*... ..*..#... * .... . ..*..#.*... ...  *. .... #.. . ..#..## .....#..\...# .#........ #   #. # \ .#
#..*.#  .....\..\\ ... .. .#.. .\ ..*.\#. ..#*\\...   .\... \.** .#.. . *..##. #. #..*.. \...#. ....*..  . . .. ...\ ..... \. ....  ..   ......*.*...#
#*.. ##....#  #...###*.  . ....... .\ . ...\ ...  * ......** ..#.# *. *... ...\..... ..*.. .... ... \#..#... .   .\*..\*##* *..\##.. #...# .* . .... #
#..#.\#.#.*..*. ...... \......## *..*....# . .#. ...#.*... .\ #...\#.* .*. .*...*....*. ... ..*.#....... .. **#. *.#.# ..#.. .... .. . #..***.#\.....#
#....  ...... ... *. .....*.#.. . *##*#*# .  . . . #. *#.  \....*\\.#....#..  . ..\..# .#.\....  *.....*..*# ...# ....\. ...\##*.*..*..#.\#....   ...#
#*.*\.....  . ...\ ....**#.....*. .. #.. . ......\... ....# ...... .# ...\#...#..#.. .##...\. * ..#\..*\ ...* .....*....\#..#. \ . ..**....*.. ...#..#
#*..*.*. *  #.*\........ #*..#...*.  ** * \#..  #.##.... . # ... .#.*#.**. \# .....#.\\#. .*. ....* .. ....*.##...#.#.. ..*..#...#......#.. \ .\..#..#
# . #.. ...\  . *# .  # ..*.\.#  #  *#...#.* ....#. #.......#..*..#*\..#\.#.*..**.......*..*. .##.#* .*. ..*. .**..\*.......*  ..  ..# ....*. . .* #.#
#.*.. . .. *.. .. # *  ...#..*.\ .\*.*...\ *... . ... *........##\#  .. ... *#\. #    \\.  ...*.\.# ...\*....#.#..*\.*...   ..#..... .#  .*.# .#.... #
#\*#.#*..# #*.*.##.. *......\ ..#*\..... * #..  ...*. . .*..#. . ..#..*..*.#....\. .. ..*\##.  ..*.*... *.#.\ ...# .\ .....#...*\#.. ....** .....#..*#
#.. .... ..#.#. #..\.# .....**\*....\.\...... ..  #..... ..#.##.  *.... . .  ..* #*..  #..*#. .#. *....*.#\.* #. *.*.#. .\ .... ..*....*..#  .*\. .#.#
###... **#. #.#.\.. *.... .. ...  *. ....#....#\*.#.. ..#.* *.#.\..... *\...*#.....#.\ ..\  .... ....... .\*. ..\\*\..   ....#\#...#...... .# ...... #
#. .*.# .* ... .. .... .* ..\.....#.....#..*  #. ...  .#.*...*.....*** *....\. ....   ...#*... .#.*# *  #*. .*. ..#.. *...*.. ...*... .  ..*.*... \..#
# .*.   .... *..*.. *#.....# .\* ..*#  ....#....*.. .\.*##..*#  . . . .*.#....\#. #.#..* .\*. .    .*.. ..\#\....... #.\ . *.. \.#.##**..\......\....#
#...#.. .... ##. .... ...   .. ..\.....#...*.....  ..  ..  .  .#.*\.# .#  ..#..*.   .\\...\....#... *.*#*#........ ....** .. .#..# .**... ..**. .*.*.#
#.... . . ..#   \. #..#  ....#.\.*\* .\ ..# *.#*.....#..* .  *# ..*. .. *.. .*.#. .#.. ... *#...#. \..  ...*..\.. .... .. .....#..*\. #.#.#.\. .  ..##
#. \ \.. \\. . ......  #  .#.#......*#* .#.#. ..  .. #...# \#...  *..\.#.# *.........\  *#   . .. ... .....\##.\ ....  .... ..#....... * ...  ..*..#.#
##.* *.. #.*#.......#..*. .#. *.. #\ *.  ...\..#.* . . ... .*....*. .#..**\*.# ...*#..... ......\......\*# ... #..*..*. ..#.....#*.....#.*.....  ... #
#. #.. \  . . ....*...*. .. . *. .. .. ......#  .......#.. .. ....#. .**. .\ ...#* .*....*  .#**.#. .#*#........ .. .... **.\.* *.. *. .*..#..# .....#
# .* .*\*.\... ..#..\*..\ .  ...*.\. ...\... \.. ..\.#.. .#. \\.. #..*\. # .#   \ .#. ....*#.\*\**.. .. ... .*#. *\.\. *.#. *...*  ...*..  .#\**.*\.##
#.*#..*..** .* .. \...... ... ....*.......\.#.. .. *...*... #\ * ......*..\.*.#.....#.##. \#.\ .\#...#.....##.*.. #. ..#.  *.. ..#.*. .\.. #.#*.\*.* L
#.. #. . ..* ... ##.   ... . ... *.....*.....*. .* ...... .. .*..... .. .\..\... .  #. .#.* .*.. *.#.... ... .......** #  .#...# ..# *\*.#.. ..   ...#
#\ . ##\...\#.. *.#.*..... ... . #....\ \...# .  \   .#*   \. ...*....** .*..*.# .... *..... . **\. #. ..# .. .....\..##.\.**.\. .\. .. .*....\....  #
#*.*\. .. ..* *.#..*.** \ #...*.... .**\.. . ...*\.** \\*.. *. ..  . ... ....... ..* #... .*# **..\ .\\. .#*.. .##.* *...*..*....*.* ..\..*... ..#...#
#..#.**... .# *.*...*.......###\#.  \ * .*.*.*....*.. .\. . # *.......\..# **** #*.*\.....\ .....#.\.... \#. #.\*..... ..# ......  ...\........#\\  .#
#*. .# *. .... ..# ..# . .\.*.#..##  .... .\...#...#..  # *....#*#. .#... * * ..... . ....*#.#...  .  .  \. #.. ..... .#..#.. ....\.\.. .  .#..... #.#
# #.#. #\.. ...... ..#. .**.##...##. . .  **......\*... # ....* ###...#...\.\. ... ...\ .. ..*...  ... #..#.\...#*....#..*# ...\*\.*.*#.#.... #.#... #
#.\. . . *  .. * .*.. .... . . *....* **...*#\*.... ..\....*...*.. #..*... ....... #.  . ... .**#...#.. . . *.*.*.... .... ...*.  #.  . .#.*  \#*.\.*#
#.\*\..  *. ... .* \...# ..*..# ..\ #*.** .#.... .  . ...... . *.....*#. .##.\*....#. .. .*.*.*..... .......\*.. \..*   ..\\\.  ... . \...     #*#...#
#..\..#...* .*.#.......*....# ...#. .#.#......#.*#... \..\ ..#.  ....***...# .\.\#**.#..## ..#.#.#.... ..*\.. \.#*  \. *\.*\ .#.. . .... ...*#.#\..#.#
#.. #\\.  .. . .# *.**  .#\... . .\#..*..**.. ..*.*. # #..#...\...#..... ..*\* .#.. .. . *......*.*.......\*.#* \*. . . # . .. #.*..*... #..*.....\\ #
#.#.\...# *...#..\#\. #.\. *.*\*......... *#.*.... . \#**#*... .# .* #.* #... .*..*. . . *.#....*..## *   ..#...*   ##*..*..#.# ..#.#.  \  *....... .#
#. .. ....*. ..* *##...... .. .... .\#... ..*....   .. **...\.....** ......*...*.*. ..  ..*.*.#...#*... ...# ..\*.. .**.\.#.*.. # . . .\#. *#..  .#..#
#.#  \.** .#..#.##.\ *..*....... ..  ...\*\*.*....#...#...*. \*.\.......*  #..  ....  ... #....*  .  ..\.. . #...*.* .  *.# ...#....  *.##..*.#.\###.#
#.*...\..\...... *..**...# . ...*#....#.* .....\#.. #.. .... \#....* ..*..\#.. .#   .*. .* ***..#.. ..\....*#* ..*.\ . #.*...\ *\. ......#.   #  #...#
#.. .* ... . ......... .*..\.\.##..... ......  .*.\#.#... .##\   .. \.\...#.#.# #...*.*#\  . .... .# .. .*....*... **..#. ....... *.\\ ...\#*.. . .*.#
#....#.* ... ..*. .#**...... .....*..#.. ......#* #\ .. . ...\ .   #* ...* \\##  .. ... *..#* *.#\ \#.. #..  #...**#..*.\*..##.\.#\   ##  .......# .\#
#*.*..* \........#.  .....#. ....  .. ... .. . .*..#..** . .\\ *..\#  ... .. . * . ..*.  *.\ ........**.....\. ..*.  #. .\.\.#...*. .\......*.**#\\#*#
##.. .*... .  .# * ..* *.. *....\##......*... .... *\.  *....*.*\..... .**.*..#..\...\. *..*  . #.. ...*.*..#.. ..\\.*.............. # . #.*......#*##
#.....\..##\.. #..**....*  ...*.*. \ . .*. ..#....#*.  . ... .. ## ...\  ..*.**.#\.. ... . .# .. . .......#  ....*\......... .......*...   .**. .... #
#.. .#.. .\.. ... . *\#......*.#..*  ..*.. .. \... .. ...#\# ..# ... . .. ..\......\*...  ....#....... . #.......*... . *....... ....*.....#. . .#. .#
#*..*.#.  .  \.*.\....#\. #\#.* . ..#  .*..\.**....*.#.. .. ...***.#.#*....\.*#*....# .##.#..  .*\.*....     .\ .* .. #.......  . .  # .....* *....  #
#..#....... . # ....# ...*# *...\........*. .  ..  ...# ........ \.\....*....\* .. ..* . . .. *.... ..... . *...  .\....\*.*   \....#**..#..*.. . . .#
#.. .*...* .#..*.*...... . .. .# *.#.. ..##. **# ... .#. *.. ....## \...#. . .  . . *#. ........**.... \. ##.# # . *\ .#.\. .. . #*\.....   *. .\....#
#.\. *  ..\.  .\.. ........#..*#* .\. .*#... .#...#.\.. *.  .. .*#* .. .. ...*.. .... .*...#.\ .  *#..# .  .. #.*.*....*#..* ... .*..\..*. #. .......#
#  .##*.#..* *....  * .   #...**\.*...#....  .* *\ # #\*.\.#\*.*# .*.#..#..* .   ..\  #.#....  ..... .. .. *.\  . ...*..#.*.. .*.\. ......     .. ..*#
#.....*..  .....*....# \*## ....#   . ..  ..#.....**\ \..* ..  ...\..  ..\ . ..#.*.*  \..... \... . \....#.. *  ..#* ##.  ..#.. .#....#.##....\.... .#
#.. . .*. *# ..#. # ...*\* \.....\.....\...#. .. .**..*... ....*..#*.*#.. ..*... . . .  *..#.......##.#.*  .*#.\\... . .\.*...\.... *..  .#...  * ##*#
######################################################################################################################################################