######################################################################################################################################################
#.#.#\...#..... ..\ ..   . .* ...#*.  *\....#. ........ . #.*..\#. ...**      ..*.#.  *... .# ##*. .* . .. ....... \..*.# ..*..\ #...###......#. *#  #
#......#  .. .# *.#\# #.....** ....#. ..\... .#.*\. \ # .#.. .....\\.#.#.\#.. **.....***..  ..#.....  #  ..#.# . *\. ............*..* .*.\..*.\. ....#
#.. ....*. ..   .*... *#.. . \#. . . \# . .#.*. #.*. ... *. . \.* . #..#**...#..#..*.#... ##*.... . .. * .\**..  *..  \\.* . .*.. ##**..# ...   ..#.##
# .**...#*#..\  .##*....# . .* ...#  .#.. ..*...#  . ..*\....##..# .*.\ \\..*#... .#.  .# .. . .#... *....**  \#.. \. ....\.... ...*..\....#..  .*\# #
# .\.. *\... ..#..#..* ..*...... #... . . #*..*... .*.# ...  ...*....#. .\....#.  #*  .\#..**#....\#...*..\..*.*.\. #......\.. .. ..# . ...####\\... #
# #...**. .*.*.. *#.#.. . ........... ...\... ..* ***...\  *   .#...... .. ....*.... . ... ... #\. ..\.......*#  * ....  # .. .......  #*... *.#.#  .#
# *# ...#....#\.......  \* \.*  **...  \..#.*.*. .#.#. .  .... .\  \..*......#....#.\* ##. #. #*\**.. ..* .... ....##*.\*.. .* ....  .*.#...\.. #....#
#..   ..#. ...*.. .    ..*.. . ... # .......\ .* . **....**#*..\.*..* *. * . .... ..#.#*.##.*...... . #..*..\.*.#* *.\. .......##. *.. .#*...... .#..#
#..*. *. #. # .# #.#*.... ..*. .#..# . ..*..  .......*......   .. ........#  *. *   .... . . #.... ..\. . ..*  . .....*... .... ...... ....\*.#*.* ..#
#*#\.....*.**.#....... ...... ...** ..#..#.. *# ##. ......#......*  ...##.*#**.**.....# *# .\...#... #.# .......... #. .... . . . #..... ..#..#.  ...#
#......*. ... *.. . . .*.#.....*....... . #..... .....**.#### .....#.....**..#.. ..*  .  ...  ..\\.*..*. ..   .\ \.*. ......#. .#* *. ..\.. ......* .#
# .... .. # *..\*.*......##. ..#.#.*... ....    ....\.\\...# ...* .. .. ...#\\. . *...#  *....*.. ..   . ...#.....\ ...  ..*.. .#. .. * \.. ###.  . .#
#..#...\. .#..  *...#..  #.. . ...#..#\.#.#.#.....\.......\.    *.#*.....#...#. .*.  ..*...**#.... .#...   .  . ..  ##*.... \.*....* ...\.#... .* .. #
# # ..\*......** ...*.# .\.. .... . ...  ..\ # .*.# # # ....*.... *..\. ......# .. #..#.. ##.#.#\#..* . .... .#. ... .. *. .....  ...*..#..##**..*. .#
#*. *.#.*   . *.... .#\ .* .. .#.##......* .#.#\ .. # #.....  .#. ..*.....*# . ...* ...*.#..  .*.#.*..#...  ..*\.*....\...*\..*.  .\. #....*\  ...# \#
#.*..#...  ...#..*..\. *  . **\.....*.##  .*\...\.   .*...  ...*\.*.\\.#....##\\\*\#*..* . . # .  \  ....#.. ...... *.  ..#  .## . .......##\. * .#..#
#.**# ..... ##   *. #.....  .*....  ..#.. .* ... ..* .** ## #*  \\. ..\..\..   .  \# ......    ... .... .....#.\*.....\ . .. .  ...#* ..*....*.#*....#
#..#.\..* ..\**.*.*... .\*#  * .\.. ...#. #. # #.*..##..#. ......#. * \..#.....*.#..*. .*\.  ...#...# ..*.....#.#* . . ..... . . *. ..........***...*#
#.. ..\. .# . . . \. #..*....# .#....... \#*.** .#....##.##..# . ...\. .*..* .  *.\..# .  *. #.* ...*#.. .##.#.##*.. ##..... \.....**\*..   *. ......#
#..... .. ...  ... .#.... . . *. . .. ........\.   ..#........  . #.\... * .**   .... .* ...\*......*.... ... .#. .\.*  .. ....\... *...* ..#. .#..**#
#\\. ... #.*.. #..\ #  # .##* .\\#. .#. .. .... *. . .##\.\.*..... . #...# .# ..* #...\...  \\.  *. . .. . *... ..*# ..#.# \. ....  ...  ........#.\.#
##. .#.....#......\**\......*.\#.\...  .....  ...*#.# . ....*..#*.......  .# *  *. .......*..... ....... #.*... \ #.\.. .....\ .#..*.*.....*..##.\.  #
#.....#....... #........#. .. .****#..*.##. .*.#*. . ..#.....# ...* ..... ........*.. # #...##.*#.*..#.......*.* #.#.. .....* *. *...# .# ...\..*..*.#
##..   \.  ..\. ...* *\#.*.\..*#..**#..*. ..*  #.. ##*.**.......\..\*\  . ..#... ...# \.#.*.. ........ ..#  .* . .*.## ....  ....... .. #  #...#  #..#
#. .\.*  . \...#.. .. .. .#. \.*. *#.#.... *...#  .#..\  .   .# .#...   .# ....#.**.* .*#... *#**.#. #\.......*.# ...#... .* . ..#.*# .. ..\.... #.. #
##.*..#.. ........*  ..  .*#...  *.#*.*..*...... ...  .#*#..*... .*.*.\.* *... *.**\. #.# . ... \. # .#.*....#.*.#**.#*... .....\*......*  ...  #...*#
#\. ... .*.* #* ** \.#*....*\... \.. ...\*###*.......*\....**.# .#...  \#..**.##........*..*#......... . . ...*. .#...  ....#..#*..#..#\..#.#..* ... #
##  .....* ..\ .\\\   .. \##.. .  ..... .#.*. * ..* . .#.\  .**.*.\ ** *#* #..\**.. *... #*......* ..*.#.**.....#.. .... . .##.* \............. .**\.#
#**....*. ..  ** .. . ..#.. #.*...* *......**\.*... .#.*..*  .\ .. *. .. ..\# . ..  ##....#*.  ..  *#.\\ \......*.*. .#...** ...*\... \...  .#..# \. #
#....\ .* ..***.. . #.# #....\ .. #...  .*..\...  .*..*  ...... ....#...#......*........    ..\..\.. \..#**.*  .......# .*.... \#\*..*.##.. .*.... **#
# ..*#.. ... .  ..\.*.  *.. . *\ .*....**.*......* .*\ .#.*...... . \*  ..........  \...# . ..#.*..#*.  #.  . .. .\..##....* ..\. ..\.... #..\. . . .#
#..\*.. .*..##.* .*...#.... . ...\.. .  .*... ..* .#.* . . ..#.**...* #...\............... ...\ ..... .\\\.   .#*.\# . ..   \  * ...*#... *.......# ##
#  ... . ...*. .... . . ......#*....  ....\ * #.\.\ .*\...# .#. *. .\ #...  \  ..... *#.#..... .  ...*...# . . .#*... ...*  ...\. .... #*.#.....\.** #
#.... \.#.\*\.\ ....*.  ... *... . *. ..#.  ..#.............. .#... .***\ *  *...\ #....#* . ..  .  #.. ..#.\..#... #*.#. .. ...#. . #..*.#..#\ #.\ .#
#.* .......\ # ...#. * * .*.*. .. . *... . .. \.... *. #.. ... ...\\.  .\.# *. ..\..* #.....#.  *..#.*.\.*.\.* . . #..... #. .*. ..\. ....*.. .. ....#
# .#.*.  \ # * ...#.... ... .*. . .. #.#...*...* *\**.... *.*#\..*. .#..\ ...   ..... .. # .... #.*\....#.#.\..  *.*  .R*\..*.#..*...*..#* .....*#. \#
#..#.### \#...\.*.#.* # .. ..*..*...**...\..... ...*..  ..*.. * ... *.... . #.#.. .##  . .\...\.... ..*#.....*.#..# ..*.\...\. # .***#..\.  ## ###..*#
## .\ ....#..\. .  .#...*..... *#..#*\##.......    ... *....* ... *\.. .....\  \ .#..*  ...#.#..*# .#.#.\...... .* *\......#*.....  .*.#....*... *..##
#.. *. .*.   \\ ..#. .\ ...........*......#.  .. . ...# .... ..##.... .#.... \ .#... .* \*.. ........#.#*..*.#.* .. ........#*.#....#..*. *..#..\...\#
##..#. . . #.\. ....# #..\..... #.#..\* .* . .  ..#.** *. ......#. #.  #....\...#..*\.. .. .# ..\.\.... #*.**#.. #.. ... .# ..... ......\...#.#......#
#  # .#.\*# ##... .....##.. ...**.#. \# #.*\#* ... ..  ... .. .#. ...# .\.. ....#.#...*.....*.#..*..\.# *. ..*.. .\.** . *.... #*#.. ...# ..# *...  .#
##.# . .... ........*.. ..#.**.  # ...#.\.*#..\...\..\\..\.. ..*\....#  .*.  ....#\  #.*..............#... \ ....*#.....#*.*... .*  **......## . #..\#
#.*.. ....#*.#*. ...\... ......*.* ...\ .*##.. *.*........*....  # *. .#... . ..... #. *.*...*.. .. .\ ..\#....#... ..*#.    .*... ... ...** ..*.....#
#. .*. ........ . .... #*.**. ...**\*.. *... *. .. . .. #.##*... ..#....... \..#...* . ... ..... .... ..*#*...#. *.*..# .\.# \.#. .*#........  ..#. .#
##. . . .**........  ..\.... ...##.*.............. .#. . ..#.*.# ......#. ...*. #. \  .#........ . .#\..\....* .  .* .\  .  ....... . #\......*...** #
#..... ....*.\# . ..*. ... #. ..#* .. .*. ..*# #**.....#.. .## ...# #.\ ..  *. \..* ## \. ..\.. *....*#....*.. *  #.  *..*.. ....... *.#...\##.. ..  #
#. ..* *......  .....#..  #..............*........\.#.. .*\.. ............ *# .. .*.... #*. ... *\.. ....*...*.. .... ..##..   ..\\ .#. ..\ .\..*#.. #
#.. .* ....*.*  ...#... .. ...*#*.... .........\.  .##*..\.*.....* ...*...#\......*..# . . .   \.* ....##...#**... .* **.  .**. . .# .. #\.  . ##..# #
#*#.*.. \. \ ...#.*....\\  .....# ... ...**.... ..*.# . *.\ #. *. . . ..\* .. .... . .. #..#  .#....... .........*.* * ... .*#*..**# ..## #...* *#...#
#*.#.** # ..#. . \ ....* .*. ..#....*\* . .#  ......#. ..*.*\... .*.*... **. \ ..\ ......  *.#. .  *.....  .. . \ .*...\. . .*\... .**#.#. # ..  ....#
#. * . ..........*# .   *.  . #..*. \**##*...#... .\.. #*# .. .. #..#.\.* .\.\ ....   .*..*#... \...#. *.* ..*#...  .*......   .#   \*.  *.. *..* *..#
#..  *..*. .*   *..... ...... .. .\#..\ .#... #.... .#.# .  ..# # .#*#####.#......#\ \..#.#.\#.*\*.*...*.*##.. ..*  .* #...  #*.* ... .......*. .*..##
#**.......#*\......## #*.... .. ....# .... ... . \... ... .\. # .......\......*  .\ .  ... .*.. ......*...*  .....#. ....*............. #.#.\.. \... #
##.\#.\ #.....**###  .\ ...\..\. . .. .*\.....  ..#..  . . ##.. ...#.**.  ....#..# #... ...*\... ....  ...**.*#..\ ..... .. \.*.... .. *.#\..\. # .#*#
#... ......*#.. **..#\ *.#. . .......... *.  .***.** . .*....**..\..#..* #...#\.*.*. ..*\....*#. . .\....#...#. . #..#*....*.. .#*..... ..##...* ....#
#...**..  .*  ..#*.\#.......  *...*#.. *\ #.  *.*...#.. ....... *.... ..*  .*..##.  ..  .. .\\ ... .*....#*#  . .......#...*..\##. ##. ..  .....\....#
#*.\**.*... #.#..* *.*.*.....#.....*\.#...  ...#....... .. .. ..*.*.. #\.**#*#...#...#..\..#. .** ..*.#.* .  ...#.#..# .\ .. .. ..*.........*..* ....#
#...\ .\ . ... *.# .\.. .#.*.#. \*..... .....*# .... .. *... . .... .\ . . #...#\... .....#\.. .... \..\.. *..\*\ #.* *# . ... ......*....\.# ...*.  #
##..\ .. .. ...#\.#  ......#\. *....*.#\. ....#* .#.*.\\# .## .*.*.  ..  .....*....##*. # ..........#...*...\ .**.\. #..*. .. .......\....*#   . ... #
#\..*..  #.. ..*\ .* ........#.. ..*. .. .#  #.....*.......\ ... *. .# .... ...#. .#.... \...*#.. ... ...*.....*#.\....... .....  ... \*. ....# .#. .#
#.* # #..  \*#* #*. *.  .* .*. . .\ # .\.*...............*..*#.\......#.... ..*#.....#.#  #.### . ..\.#.#*....*\  .*\\.*.   .......\..#..**#....#.. .#
# *\ ..... . #. .. ...\.. \ . #. \ .#\.#\*..... .*##....  #.*.. . .* .   #  *..\#.#*#* .*  #  ......##..*..*#*....* ....*. .. . ....  .##\ .\...#. ..#
#.\..*.....\\ .*...\. #.#. . # ##..\ \.*  *. .... .. .. ....... #**.#.*..\..*... \**..#*. ....*\#..*# ...#. .. .... ....*# ##..#...#.. \ . .......*..#
#..*\.*. ... ..*. .**...*#*..... . *...\#...*...# ..\...*. .. .*#...* .#.#.... ..\. .*# .. *..... ...... ....\.*. \ . ...\#..\ ..*. . ...... .* #*\. #
#...#.#. ......  .\.* \#....**..* ...\*\.... #...*  #*..  .*.\ .*.. ... .* .\#\...# .   ...  .....*.#.\#\.. .# #... ..\#....#.... .... ...........*..#
###.... ..*. ..*.....**.#*.. *\  *\ .# ....* #. *.*.. ...\ ..#\.*. .. . #*#  \ . ......\.\.*\..\ **.. .*..\..* ...\ ..# ... * . ......#.*.# * .... .##
#.*#..\*.*.# \*.. *..\.#\..\#\..*....\.\  .. .#*.  . ..  . ....*\#..* *.... .* ..*....\.##.*...#.*.....# \...*.*#.. ......\*#.*  .  *.. .. #.\  . . *#
## \...***.. .. #........ .\...\.**..*\.. ..... #*.. . #..*#*...\.*\.\. ... . #..... ....  .... *#.  ..*\.** ..* #*.* .....*#.  *#  \.. *   .*...... #
#...\ . \\..  # ...##.. *..*...\...  ..  ..#...#. #.#....#* . . #..#...#.... ..*.. .*..........\ # .#*# ...#     ......#. ........ .\....  . #...\*..#
#\. * ... \ .... .... . . .......*...* *#. ..*#*. # ...\ ...  ... . ..#.*. #. . ....* ..* \   \ ... .    #..*.\ ..*.... ....#.#. . .. ..*... \. .  ..#
# ... \ . #.#...*......#..\   .  ## ......**\#.*.....#   *   . ...*. ..*. .. .# *. .\...*.......... .....*..\.#..##.   ...#. ...............*#*..... #
# #\.  .# .. *. #.........*#*.*.* .. .....\... . *.*  ........ **..#... ....*##.\.....#. .*** # .# .. ...#* *\.    *. ....  #..#......*.* .*..\ #...*#
#..**..#. ... #* . #\#. .....#...*..*...*\.... ...    ......*# #.#* .*... ... .\......#..* .......#...*\.........* .. #. .*. #..\.......* . .. .... \#
# #. ...\.  ...  \ . ... ..##.*#.*..*. .#..*. ....* *. .#....*#.. .#..... ...*  #.   #.\.......#..*.... ...  ....*#  .*.. *##...*.#..... ...  .* #..*#
# ..#* .#... ....*.* *..*\.*..##..#.*.##.###.*#.. ..*.. . .. \#..*....\#*. . *#.. ..\..** ..*##\*###.#..*. ... . *#. .**. *. \ *.*....#  ..... ...  .#
#....\...... ......   *. ..**  .*...#. #  ..... .....\#....* .* .......#.\#.. .. ...*\#... #. .. .#..  ##.\.  .\ .\*..\*....*.#..*....* .* . ..#.#...#
#*.#......  *\ .. . .  .*.\..#..# ... ....... ...#\.*..# . .\* #. *\.. ......#*....## ....*..  ...#.. ... *....#.......... *##*\##..*#. #* . ..\.##*\#
## #  . ... .#*..#.  ..#.\#..\........... *.... .*\..*. #\.##.... *#...  .. .*... .  . . ... ....*.  #.. .. #\  .#..*. # #. *** .**.*..  ..##*..  .. #
# . .\# .* .\.*#\ * ...#..  ..*..\.. .*...#  .. .  # *.... ....# .. .#.**..#**.##.*. .*. ...#. .\.   *. .....*.#\..* ...#.#. . ....# ..\..\#. *#...#.#
#...* ... ..*..* .... ...... ....\.#..\.#..... .. \.... .*\#.#. \.\....\..*......# *.......#*... # #.......*... ..#..  *. *..* ... .....#..#.\.# .# .#
#.#.\*... *#... .*.......#......# ..#.....#...*.# .*#..  .#... .*..   *..*..*.**....  ..\.* ..* ..\  ##.. . ..  #......*. #... * ... \...# . \. #\ ..#
# *... ....*....\..#...###.*.. *...*.... #.#* #.  .*#**...*.*.*..\\#  .##.. .\*\.... ...*.\.#.  ..#..* .*. ... *\\ *.. \\ *...\\.... .\. * .. * ..#*.#
# ..\\.*#.#*......\*..#  *.*....**..*...## ........... . #. ......#.*.. .......#.. # #..*#...#..  .  ..#. .##....* . . .\ .\..... ....#.. . .........#
# .\. .. *\\....  ...#.....*...*.. #..**....\.. .*...  .....\. .  *.#.*..  .*..\*... .. ...#.#...#.\....\ .... #.#.. #.*.*\.*..#..\...... ...... .   #
##\#....  ... ....#...#.............  ...\.. ...* ..   *#\... *\.. .*. **  ..***..##..*....#...... . . ..*.#..#\#.*... . ...  *.\.#.....\...  .... *.#
#.....* *...... . ..   .#..  #. .*.. ..... .... ...\.. .   .... ....... \.. ... *..#.#*...*#. .\** .*.*..#*.#....#.#.....  .....#..#*..... *..*... ..#
#.* #......* . .#...........#.\  ..#...#.\*. .#*..# \.#. ... ..*.**.......\...*#.*.#.. \**.*.. .. . ... . . ###.#.#...#. .... .#. ..\...  ....*#. .\ #
#. .. ....**.\\.. ......  ...#.  .*#..* ....\*#.. *..#*\..#... ...* ... .. . ...#..*..*.#..\.... ...\ \#.* ....*.\..  ***##..##\....  ..*. \.\.*.*...#
##*....*. # . . ....#.. *#*.# #. .. . .. .. * ....  ..#.*. ..**...#....#......... .\.*.*..#.# ..... .\*.*......*... *..\*..#  ..#.\. ..\.**  #.\#.* .#
#* *##...*..#\.*....\\ *. ...*..... #...\.*\ *... *..*\\...# .\..   \.#.*......  ...\ \*.**#.#...... . ....##...... #...#. .**. ... ...*.*. ......##*#
#.*\ . ..# ..\.\..... .##  .###. .*.*.. \.....*...# .. **....##..* ....#* .  .\*.\. ..* \# ....\.. .......  ...*.#... .. .#    ...... ..**..\ . *..  #
#.*.\...#... ...##.\.*#... .*..* ...  \ .....#.#*...#*.##. .#. .*.#....... .# .. #.....  ## #\......  *.*..*... #..*.**..\   . ..... .. .. . ..\.....#
#\.... .....#.#.. .... . *.*...  ##..* . * . #.\....# #... . \\.. *    .#.##.#. ..* .\.....* #...*#....#.#.. ..\..* \*...#......*..\..*.*#*.*# ... *.#
#*#.. .... .* .#.* ...*.... *.. ......... ...## .###. .... ... .........#......#*..**  ..\...*. .#.#*.. * **.\...*.\...\\*#\.#.*. .. .\.... .. ...*.*#
#*...\  ..#..***#... ..#. \.. .... ....\\ .......# .#.. #..*..*..*# #\  ..#\..#. .*..*....#... #*.* #.#. .*...* .. .#..##  . ...*\......#.*\ ...\#.* #
# .. .#...#.\... ... ..... *.#..* .. #*.. ... ...*..... *...*....\### .... ..*. *\#. *..  . . ..\ .*.*...*.. ... *  .. # ...#.. ...\\.. ...  *  .\...#
#.*# .#....#. \ *... *\ ##....#..   ......*...**... \...  .*..#.\ #.#.     ... ....# ...#...... #..  ..  #*#*.* ..... \*.#.#. . \\..... ..\# . * #...#
##  ...#   # .. .##.. .**#.... #*. ...\*. ........*..# .*... ....\. ... .   .#...#  .##... #.....*  #. ... ....*.##.. ..*#... ...#.#\ ... .... .*# ..#
# ..*. # . . . ..*.\*.#..#...#..\\. #*..#. *\#. .*....*. .\.*  .\. .#......  \.. . ..\.*#.\ ..*........*....  \\. \*... .*.. ....*..\#...\.. \... *..#
#\....#...* #..  .  ... .*..... #.. .*# ..#***... #.\.##.... \. ...  # ..#. ....*..*\..#  .#.. **.*.#..  #\  ..#. ...#..#  \ ... ..\.*\... .\....*.#.#
#... . . .#  . .*......... ##.# . .\.. ..#  #. #....\ .\.*.#   .....*... . .......  .##.   #.* #*..\  ##.#.*.\.*\\\ .  ... ....* . ..  .. ..*\...## .#
#.#\\*.*.#.\*..#*...*..*....  . ..* # *.*...#\#..#.....\..* .  *.*..#..* #.\.. .*...* .\..#.#..#.#....  # .  ##. .   .*....* \..#.#\. ..* # .\ ..#...#
#\. .#....# #.\*....*.#.*. ... .#.\ . \...## ..... ..#.\. ..\....*.**. .. ..*###..  ... .. ... \. .... . ..#.. ** \# .. .*#\...  .....#...#. *.*  .#.#
#.  # .\...*#.# #....#*#..   .......... .. .\  .#..# . . . . . .#.. ..\#.  ...**..  \** ........ .... ..#..**....#*.. ... . ..*.* .\ \...*#*.#\... ..#
# ....\#. ...\.\ *..*\ \*..*..*.## .. ... . .*. *..  .  #*....\.##....#.....\....#*#..* ....* #*#.*\ \.*  .\. ..*.... #**....#*  ..** ..*...#.......##
#* ....# ..\\ *.***... #.. .....*...\.. .\.. ..  .....####...*.*....#.... ..#. ..... ..... #. . ... .#.... ......* .... ..#.....#. .....*.... .. \...#
#...* .#..#.*...... . . .... \... *.. *.. .*.. \.*.... ......   . # . \#......#.##. #.  ...\.. *.#...*... . ......#*   #.. *# . .*\#.*#.\**.#.. *.#..#
#. .\ . ......#... ##... #*  **** .. ##.*... ##. . ...*. *. .. . . ...*#  .#....  ....... *..  \...#*...\......**..\.. ..***...\# .#.....**##.#. * ..#
#..# #.\.*# ..*..\..\.**...*#*....#... \.* ... \ .##... ..*..\.#.....*.*#.\. .#.. *#... *.*.# ..... \.....*.  \..##.*  *.*.#..........#...\ . *. ..  #
## ..** .  .*#..\. . ...*  *.# . ..# .##..#... .#*...**. .........*.#\#........#.***\... .#.# ..\** ..  ##  *.#*.. ...*.*..... # . *....  . #   .*  .#
# . . .#.**..*..*..... *.#*.#..*  .*.. .#....* *.#......*.......\..   .#\. .*.*  .\... *.  .   ....\# ....\ *##.... \...*.. # .\*\.*... #\. \.. .#.. #
# ... .#.**..*#* #.#.*.. ..*.*. . .. ...*. *....*. . . .. ...##...  ..*#...\#. *....#.*\\.\\...*... ...... .# . ..  .. .......*.*.*..... .#...#*..#*.#
##... #.  . .*......... .#.... ... ...# . .  #....  ......\..* .  \.* .....*.....#* ..\... . .....   .....**...\.#....*.*# . .* ....#.. . *. \...\...#
#....## .*.. . .. \....*\..#\..#.#.#. .... .\ #. ..#.# .... .#*.#* .....\*\##.*#* .. \.#.#. ....#.  *. .*.....* #....  ..\. #\. ..#* \. . ....###\.*.#
#*#.  .. ..\ .* .#.*...... \.\.   # .# ...  ....*.... \.#*.  .. ..... #.... #..... .. \..*. ...#.\.....#.*.. .. * ...#  ..#....*.#.\. . # .. .... .. #
#*..\......\...*#*... ...#.   *..#*....\ ...#*\. * .*.\.*  ...## .... #.*\...* .*\..#.*#.*... .\........ \....*.*..* ..# ....... .  .. .*....#  \....#
#..\.... . ...*... *... .*... . . #.#*.. *...#.#.\..*.  .##.#\... *.. .. ...* ....*. .**.. \*.. .... **.\.   .... ..#\ .##\. #..\ ..  .. . .....#... #
# .... .#....## .. #*#..*.#* . #.#. *.#.*. ...#.. .............*\*#. .  ...#..#.\* *........#...**\#.\.  #\....##* ..# * ...#..#. *.*.#\.. *.. .#*..*#
#.#.*..... .#.. .... .  ..... ..........  .........#. . ...\.. .... .. .. ..........  ..\ ##.*\.....# *  .*... .*.##.... ..... ..*.#\ **#*#...*... ..#
#...... .*...... *...\\.\. .#......#\\..# .* \.. * ..... #.\**. ...*   .... ..*  .   .# ##.#... ...# .  ....\..#...#.....#....*##........*# ..*.#...*#
## ....*...* ##   *.. ..**#..*. . . # .#.## *..**  .... .*... ........* . \.. \... .##. ..*#.*.  \ \..... #  ...*.......... .... ..#  * .\. #.# ..#.*#
#...\..  ....\.\\ .. *..#.* ..#.#.#. . \\\ .#... #... #* *....* *#..*.... ..# ..*.\#.#. ........#..*.......**## . .....*.*..\* ..*.... ...\*.........#
#.* \.*.. ..#**.\.. .   #....*..#* ......* ..** \\..#*.. ....*\. **#.*\ #*...#... ..  .  **.##.. . ..#.  .#. . ... ..... .##.. \....*.*\. . ..*....#.#
#..\.\*##......#*\.\...#*#. .. .  ......# .....  . .* ... #. #....  .*..\.#\.\.*#..  ... *....*#.* ...... # ..  ...\   .....#\.* ....#.. .....*......#
#*....   . .......* ..** ....#\.#  .. .#*.........\....*.\.\ #*.. .**.##*. ..*#.# .#\...#.*.......#\. ..#. . *. \...  \ #..*\.... ...\... #.. .  . \ #
#.. .#* . ..  #    *..#..... . ... .. .. ... ....  ..#.. . ** .\*.. .#. .. ..*. *..\*.** .. .  #.... ....#.* .   *..\#...*... .  . .. \..**. . ..#.*.#
#..........\*..#. ..*........\##\...#. ....##  #....# . *..* .. . #.\ .  #   #..\..\......*#. .#.\ #....*...\#\   .... #..#. ...#*.   *. **## ... ..\#
#.***..#...\...*#.\#\ *#.*..*.. ...* #...#.## *.\..#.*. .....#. *.. . .#. #\   ..... ..#..  .# .*..# .*. .. ...#..#.  ...\\..#.*.#..*.*  ..  .#\  ..##
#.# ..**..**\   ..#  . .. .#. . . ...**. * \.....#*  .... * \*... * #\ *. . \.... #.## *.* \#  .. . ..*. .......*.# .#.... .....# *. .  ...\... *....#
#...#. ...\.#........*#... *#..#\...... ....... # #*..#.......#.  .\.  .#.... .\.\... *..  .  ..*...  .....#.....#\ ......#.   .#  ****.*.. .*#.  \#\#
#...#...#.. *.... .\ . *..#.... .* ....*.  ..... .. .  *..*. .#......\..   ... .. .......* #..   ... *...*#........* . *#. \  ....*.# . # . ***.#....#
#..... *..\## \#.*\...###..   ......  ..# .....*#.   .  .*#*.. .. ..*.  .. ..*. ..#..#...........   ..\... *#.\ ....   #..##.....#.. ...\# ..*. .....#
##*..*#  .   .. .  *  . *. *.*\.#.... ..  ...#.*.\....#... ....#.*  #  ...#.# *. ..\.... .   .#..\\ ..  .... \...*  ...... .  .  # ....*.#. #....... #
# ...*#.#.\.#. ##...#*. ..\.*...   .#*. #. .. **#....*    . *.. ...##. *...#..\...*...#..*\.... ..... ... ....... \.*.*.#.\.\#....... . . . ***. ...*#
##...*#.....\.* .*...   ..**\..\  .\* #. .. \...\***.  ..... ..#*...* .....#..#.. ..... .*.  . ... *  *... ..* . .*** .. ...*#*..  . \..#.... .......#
# .  \.\*..**. .. #..*..*....  ..*..##*\...##.*.\.\..  ... ..*.*#. ..   ....... #... *..*.. . .......*..* ..#.* #*. .. # \ ...*...*... .#..# \ ....#*#
#........*..### \..* .*.# ...** *.... ....*#.....   #. ..# ... .. .\.*.  \\.#.... #. ** \..##...# ...*  ...## .##..   ....*...*.. .\.. #......*\.*.\.#
# .\ \.....*..  ..*.* ... . .\....#*  ...#.\.#.##.\  \*.. # ..*\.***.  #.#.# .. #.  .#  . *. .#.*.*. * \...  .. ..#....\#...  *.#. #.. ...* *.*#. ...#
## # ..# ......   *...\**.*.*.. ##*..... .... .....\...#...#.. .#.#.*  . # ###. .\ .. ..  ....\..  ...\*\...#.. .*#.. *.#. . ... .\..... . .#.\*. .*.#
#*...\\ . *.. \ *...*.#*.......\...  . #.*..#... .......*#..\.#  .\......#.\.*\...  ...#.    . ***# .......## .  . .  ....* ..*....* *....#\.....* #.#
#. ....... .....\#..  ....  ... ..\.#. . ......* *     *......**.. .. .. . .# . .#.*....*#. ....  ...#..#.#* *. . *# *#.#.. ..#*...*.  ..*.*##.\. ...#
#.#. ...\........\...#*#  .\.\.***.  *....\...# *... .\  ....*. ..#.\.. .. . . *...#*\.#*. .. ..##...  .\. \...   *\..... ... #.....#.....  ...*...  #
#..\. ... .\ # ..\..#\ ..   .    .# ..... .......*. \ ..*...*......\.*.\..... .. ...\ ..... #. *...#....*....*#.. #*##...*.# ..#* ... ..\.. . ..#. .\#
# .# *. ..* #..#*#.. . *. ..*..#...... ...... .... # ..# .  . \*\..#. .\.#..\. ... . ... ...... .*  \#...##..#.. #..  .. .... \..#.#\\#.. .*.*.  #.#.#
# .# ....#..\.\\\  .  .*.  .* ##..*  .\..*..*. #\** ...#.\. ..*...#..*. .#.\# *   ..#.*...... .. \.....  *....\  ...#*..* **#.**#....\.*....\. ...#. #
#\... ...**\ #\.....#\...#*\. *.* ...*. ..  ........ .. ..#*#... ...#.*# ..** .... #  ..#. .....*#...*..* .... .*.. .#\.\.... \#*.*....*...  ..##....#
##..... ..*  *.\*.\  ..* .. ...#.. #. *. \.\#..#* .. .  ..\. ..# *.. \\*. ..##....#*.\*\.\.  ....*.#.# . .\   . .#.  . .. #. ..\ ..*.# \.     .  ....#
#..\.. .*#*.# .\.... .. ....#. . ..... . *....\..*.#..#  . #.  .\....#. .#.* ...\.** *..***.  * #.....*..## # ....*.#..*.#....... \...\.*.  .#....\..#
###########L##########################################################################################################################################