######################################################################################################################################################
#.....*.*\.. ... \....*#..\.. ...   .# ..#.  ..**..#.. ..  *....#.#.....  .*.*..*.#. ......#*...*..##..... . ..... ..*..\... ..  * .. . . ..#*  ... \#
#.#.#. ..... .# .\###.**##. ....*#..#.. *#..#**.#....#*.\ #.........*... . .. .*. .#.....\. \. ...*#. .#..## .. *\#... #.  ... #.* *# \. . .#......*.#
# # ..*. ..#.#....*...... . **....*.....*.. ..\.. .*# . . .. ..#...\.... \..*.. #..... .\.. #*..\*   # .. \ .#..#. ....  . .... \. . ..#. .. .#*..* .#
#.**. .***.*.*..\.......#...#.*.*#..*....#..*.......**........**...#..*...#.#*...#.... .\....#. ##.#.# .....** .\..\.... #....... ..# ..*..#* #     .#
#.#. .#.... ...#.. .\.#\.... .# . ...............* . # ..... ...# #....\**  * .... #.*..#.\\.##... .. *....#. \ *  . ...... .*.*..  ...\...\.....*.#.#
#.*###*\.....* *\.**.  .* #.. .. .**\... ..#.* .  .*.## ..*.. \..##. *#.*. \.\# . ... \.**  .*\#....\.* ..  ...*....  .*   .**.... .\.*.*..... ...*.*#
#.... ....*...  ..#.... ....#. ..  .*. .....#..*.#   .  .*.*..***...\...     .*.\ .#..* ..#. #...*#.#  .#*....*.... *.... ..#.*.  \*\. . ....**.#   ##
#* ..# .##.. . \.\.. *... *... ...... .# #..# .  .#... .*.. ....... .###. .*.. *.*... . * .*.*...#  ..*.. .*\.\... ..  #..#.#*\.*.*.* .*.... .*.\.\..#
#..###. ...\*... ....\... ..*#....  .# .......# .\.*.....##.#. .. .. .*  ...\ .# #*    .\#. \ #.....\..#\#\.. #.#*#...#*...\..*##. \#. .. ..# *..# . #
#\.. *....#....\. .. ..   .... . #.* *#..*#  #...##..*..* #*.*\#  *.*....* *\..*\. .....\#. . ..\* .... *. \ #..... .  ...   * \.. ..#. #... .  ##.**#
#. ..\**##\.*#. ..   ....#.#*\ ..#\  ..#. .....*\...   ...  .  ..\....*.....  ........\.*.#.#......*## *##\.....\ ..\*..*..#. .#..#\.......#....*....#
#. \ .##.\. . \ ..#.... ..  .\.... .\* .*. *\.....#...*....# \..... .*##\  .#.#*.. \. #**.\\...... .  ....#..*..   ...  .\..   \...\.... .#.#\#*... .#
#*#*.... .#  ....\. .#..#*.\\.\.. .\. ..\... .. .# .  #.*#...* .*... *...*... ..#*... ..  *...#...\\............ ...#..*.. *  \. #*.*..... ..#*.\ \..#
#   .#.   .*#..*..  \*. .......... ....... .*.#.\. # .  .#  ....#..\........ * \\ ..*#..#*\. #..*.. .......*. *. ..#.* *...#*.##\. .*.. #*#\.* . ..###
#.  *.  . #..## .  . ... *\... #...*..*. ...* ....*.. *...... .. \...\ *.\ .\#*.\.#..* ...*.##.\.*..* ..\.\.#..#*.........##...*.. . .....**    ..#\\#
#. ..*.*.*......\..#.#*. #. ..*.#.. . ..*##.#.*...#. .* .....\.... *  *. #...........#  ...*..*...... ...**...*#....*.#...#  ..\.#.\ ... . ..# . .#..#
# **###.#.#.#.. # . . ... .* .* .... ...#. #. * .#..*#.*.#* * ..#... .. # ......* *.##  .. ... \  .*.. *. .*.*  .#..*.*#.* ...\ .##.\.# .*..#*.*. #..#
###.. *. ......* *  . .\.\.#..##.*. * ....#. .....\.. ....*...# ..\ .* #..... * .#..\ .*.#.*.*.# ...  ..R*.  ...#*...  .\.*..*\ . .#...#*...   .... .#
#*#   #\. .*..#.......\ .\..#.*.* .*... #* . #.. ...*........*.\*..*.*.*#.\..\# .* *\.......\.*.  ... #.\.. *...  #.....\*#...... ... #*.#\. \ .. .#.#
#.** ...#. .....\..  * .. #\.# *..*.#*.. .*.\#...*.*\.**.... # ....*..*..*.....#.. \. ...#*..#\.*** .. ..  .#....*#..\\\.#.. .*....\#..##..*  #* ....#
#...#*.#..*..#.#.*.#. *.**. . .... ....  #. . \.. ..#.# ...*. *.. *.. .. ..*  .#.*..***.**...\ .. .... ##. ...*.. .....* *. ...*...   \..#..*.*  .##*#
#.\ .\.. .....*\ .\ ...... .* ..*.....*.....\..**\.\. ..*.........*.  ... ....#  . *..  \...#..#..*..... ....\..#. . ..**.#.\.#..#......#...  ..\ .\ #
#..#.#....* .**..   .#........#..  .. .\.\\#\...#...##..#.# .\  ..*.. ...#.#  .  .#.**..# ..#...  . .. ....\* ... .... ...# .*. ..#..\. #....**..\*#.#
# .* ..#* . . *.*. \.. .#.*...#. ..#\....*....*.\......##\  .*.....  .. .*... #........ ... .  #..*.# ..* #.* ...\.... #\..* \ ..##..  ..*......#.#. #
#.\.*. #. ..**.\#...*.*... . ...\#..  .. \ . .   ... .#...#. * . .\...\ # . .#.... * #..\  #.. #.#.. . \.....#......*.# *#...\.\*.*.. \.  ..#....*. .#
#...\*. ... .#.  .  *.###. .*..* #*. #...#..\..**..#.....#.. ...... .. ..**# ... . ....#...\ .*. ....# .#.#. .. * \ . * \#. ...\##\.......*.  .*. ...#
##*#.\*#\ .# .. .... #  #..#.. ...  ...* ...*.# ..#*.\*...\#.*....#\.. . #.##\#. .  * *\.*#..#. .*..*.. . .*# ..*...#..#....**.#... *...#..*.. .*. #\#
#.. *. ...* . ....#.\#.....#. .*\**#. *. .. #\ . ..... *. ...... ..... **....#.# ....#... \.*. .  ....# . . ##...#. *...\ ..*\#   . .# ...#..   ..**.L
#*.......... .... . ....... ....\...* .....\..#*..\*..**\**.*  \........**.*. ..#.*..*. *#.. .  .. ..#* \ ..  .   \.\.##. ...*.**#.# ........  . ##  #
#.#....  \..##.*\.*## ..** .**.\.# ...# ..# .#.# .* ..#...#  .*# ..\* *..\## ............. .#.* *.... . *.**. .* .\..\.* ... #...... ..#*.**.##...#\.#
#..#\#..*... ..  \.\.#*.#* ..* ..*.  .   ....#.........**# ##......... .#* ...*.*...#....##.. # .  ......*.. ..*\.*..\ ....*.....\. ...#.*.\ \*. #**.#
#.... *.*\.\.\.*.\.#...\.# .#....*** ##.#  \ ..#.. ..#* #...........   #...\.\ \\ . .#*.....\..*.*..# ...\ .### *.\...*.\... .*.*#...  . .... .#... ##
#..\#.#\*#\..*... ..#\.  .. .*  ...#.#.\#..*.#*#.\. ..\.. .#....#\  .#...  ... ..... * ... .....*. .##..#* .    ..#*. #...# ......*.*****.  ...... ..#
#.. .* .*# . ..\.  .. *#\*....#... . \\..#*.. ...\*..#.*....\ .. .\ .*....*..##......\..#. #..... ............ \.. ....*.... . . . ..* ... .*.*...#*.#
# ... .... ..... ..   ... ... . ... . #\#\.....*.. ....*\.\\...*.*....*#....*.#\ .. *  . ....#.*.*.....#\    .#*. .. ..\ #...#.... #.# . *\..*. ..\**#
#  .# * ..  . .\..#***\*\ *.**.#. ..* .  .\. . \... .* ..*..##  ....*.#.*. .*..\.....*....##.. ..*.\*.*...*#... ...\#.. ..... *.. ... ..\.... ...#.*.#
#...*.*. #.....#.# #.  .#. # ....\. ..  ..#.. *.... ....#.......* . *#.. \...*. .. # \ . .*  . *\\ ..#..  ..... .\..  ....... .. . ...#.....  ...\# \#
#\*  .\*. ....#.\..*.. ...\.. . .......#\.#.  *#..... * .* ... ...\. #...#. ...#.*... ..... .. .#... *..# *##..*..\..  \.... .  *.##.......*.. #..  .#
# .\. .# #\...**# .... .\ ..... ##.. . .....  **.\....... **.* .  #* ...#  *\# * ....*.... . .. #. ...\. ..# .. .*.. .. .... ..* .#.#\.. ....#.    ..#
# #.. . \# ... \. #. .. ..#...* #.\.#....\ #. #*....  \.\#... \... ##.*...  ..#\.#......*.##\.* .\... # . \ ##... *.....*....\ ......#*....\* *#.. ..#
#....*.   .. . *.. *.#\*. ..\*.*.#.. *... # .#....\....#. \*. ....* . ..#\. #.  ... ## . #....#..... ..*\..  *\..\ .*. .##... \.#.   .*. #*. . ...  .#
#*..*##..\\ ...#... ..*... .\ #.##.##.**..\. .#.\.. ..   .... .*..  #.#\. .   #.\.. ..# . ..#. * .. .... #. .. .....##....#*.*.. *..* #.*.*.#.*. **###
#. ..#.#*#*...\\.\.\.\ \.\.. *.##. *.. .\..#.. .\.*..\  .  #. . ..* #.##. .*#.\.#..\#..  .**......  .....\... .. *...... .\.#.. ....*......*#  #**..##
#......*.* .. *..*..*. *.#.  *... #*.......#.. ... *.  .\.. *. ..# . ..  ....#......# .....#..*\. ............ ... #\......*.#. .##.. .... .**..* *  #
#*#.\....... *...*...*\*....*....*.* ..#... #  *......\#. .* . #\*..*.. ... .  .#..#. .#.\.#.#.# ...*..#*# *.##*...... ##*..#  ....\\#... \.. . ..#..#
#  ...*...  ..\*. . ...... #.....#   ..... .#. #\.. .. ...*.*# \.**.#.*..** ....\\* ##  .  .... #  .\. #*#..*.....# .*...   ... #* *\#. ...*....\*..##
## . ...*. ..   ...* .\\ \.##..*.\ ......... ...*..... **\....*.*.## .....\... . . ....*..#.... .# .\  .*#..#. .#.... *....#**. .... ......# .*. . #.#
#.. ..#...*.. .##..... ..#... .. ... . #.... . .. .  . #...\....# .##*.... . *..\.. .....*   ..   * .\....... ..* \ .......**.#... ..#.# *..... .....#
#\*#.  ..* .  ..   .....#* \  ....# \..  ....#* . . ....#.#.. # .... . # ....\ . .... .  .  .*..#....# ..#.  ..#  ..* * #.\. ..#. ..  #..*..*. .. ..*#
#.... *\ ...\\ .. ...\  .. .#.. ......# .#.#.  ......... \.. .#...*  .#.... .....  *.\*.* ##.*.*\.. ..#..... ..... ..*... ..# ...\\. ..##... . . .. .#
#\...##*.# **** .......*.. *.  . #..#* \...*.*.. .*\.. ... . .#. ##*. ..... .*.   . ##.#.\# #.\.#  \. .#.*#.\ .. .....   ...** . ..#*..... .... ..*. #
#\.#.#...*.#..#** ....  .* .. *#.\.  . .*. . .#...##..   *#......#\... \*..# .....#\. * ..#......*  *.... ...*  * ..# . . .....#... ..##..# #*..  .\.#
## #  ....... ..   .   .#...* .#* ...... ...  *..\.#.*......# .**. ..\..*. ...#*..*..... ....#\\#* ..#. **... #..* .\.\ . ..\..*. .\...\\..\. ... .\ #
#.*#.#*..*#.*\...... .\ . .##.... * .\#...#  #  .# ..##*.. .#.  .   ..\*.\ *...... ..#**  *..**\.. \## ....** ##*.#.. * **   #.#.#.\..* .\ ...#.*.#*.#
#... ..#.\\ #.\.#\ #*..*.. .*..\....*.. \ .\..**.**.*  . #.* .*..... ##.*#. ... \.###.......\  ..# .\.....*.\...*.. .# . .#.*.... ..*. .. *..#*..#.*.#
#.# *\...*. ..#..  .#.*#** . ...\....*...#.... .*#......\*   *...\  ........  .*.* .....#........ .. #.*.... .....*. .. .##..#...*... ..\#...*.*. ...#
#*\#.#.##*# . #*...#.\# #. # .   ... *.#. *\.. \..#.  .*.*\... ...#...  #. ..*... .#..... #. .*#.#.#**#... . ...\.#..#..... ....# .***. .\.\\#...  \ #
#.#\.*.... #*#....\. # ... ..  ....#.* *. ..##.**#...... . . .\*..# ....#... #.  ..#. ...# ....*..\. . ...... #.\.#. ......#...#.....# ... .. ...* \.#
#.... ....\  .. . . #..\*..\...#.*...*....*.\.. ..#....# *... .\.#. \\. ....\..   *..\... . .... ...#.......#.#. . .. .... . ........   .\ .#...\.  .#
#\.......*. *.. #. *. ....\.*  # .*.*... \.*.#.. . #.... *.# #*. .*. #..*..\#. .  *  ..# .   #..... .. ...*#..\.*..*..   ..*.#. .#... *.....*.....\ .#
#. #..* *#...... . .  *...#.* .*. .....  .#*#...*..# ..#\\ .*#.  .. ..# . *..#.\.#   \........*#....**#*\.\\..... \#..  .. * #**  \  .. .\...   .* .*#
##.*.....#\.\..# .#.# .. ##*##*# .. .* # .. # .. #... ...#...* # ***. ..*.*. # #.##...\ ...#.#*  ....##.  ....\** .... ..*.... . *.. \.. .#*. #. .  .#
#.   #  #........ .#\.#....... ..... \# . *# . ...\ \*.*.. *\*.... .  .#*. ....... . #...#...*.... #...*....\ \   ##..#........##*...\.#. .#.. .#..*.#
#. *. \.*.\. .*..  ... ...\..  #.\..*#. . ..* . ##.#.*.\#*#.....*.. . .###..#\.#. ...  . . .#.*#.##.. * .#..#.*....  *.. * #.. ..... ......... .##\.*#
#. .*.. .  ..**#.  .. ...\ *  ...*..    #.*\..#.#..  ..\. *.# #.##\\ \. .. ..\..*.*.*.  .. *.. .. .*.#...  . .*.*...* .   ..*   . ... ## .....#..#.\##
#...#\.. #......* ... ..#....#....# #.#...*#*....#...*... #.*.  .**...\#..#..   .# .*.. .. ...\ .* ...* ..*..\  . ..#\..  ..   ...  \*.* #.#*.. ....*#
#*. .*..* ....\.......**..#... #.. ....#*....*#*\  ......#......*  .#..##.. .\*..#...# .*#* .#...# .\. .##. ...* *#..... *.#....#.#\.\. .#... .\ ..*.#
#...#*... ... * ....#.\*... . .#.. . ...#.*  ..... .. .. ..*\. .##.....*.....*. .......#.  .  \  ..*.#.*. .\.  .* . ..*.*......#.. ..\.#..\.*.. #.##.#
#\. ..# ...  ... . .#....\#* . \. . *  ..........\.. . . ..*..*\. .* . .\.*#.....# .#.*. .. ..*\*...\....*. .* . .**.\.\* #...#.*..*..\. .*\... .... #
#\..* .. . \. .   .....***....* \.\....\  .. .#.\... .. *#  ..#...#\\..# .*.. \ . .*....#  *\\..  *....#*...\*. .. . ...... . .*.\**.  #.. .....*..\.#
##.....*..\ ....  # ... #... ..#..#* #.# . * #*.*..* .#.. .* ..\ * ..* #... ..*..*..*#.# .   #.. ... *#.*\.#. .  .*.   \#..**.  .\*. . ...   # ..\.\.#
##..#.. . \#*. #.*..\.\......*..\#.. ...* *## . .... #...... \ ..... ...\#*..*.# ... ........ . .. *.\.......\... .. ..  .#..\* ..#... .* ....#..#...#
#....... ...\ .#.* .#** ...#...\# ...*.#.#. ..... ## .# .\.#...**#. # . ..** .......*.  ....... . .....*.# ...# \.  ..*....*..##...#.##......*......*#
#............# .*.. \.. *. * ... . ..# *....# .. .. .\.*. .**#.....#..# .\.\..# .*.....#.#... . ..  .. . . .# .#..  .*   .**\. #...\....\....#.*  . .#
#.... ...#* ..\. ..#. ..*.#.\... *** #.\...\. .*.#..* ..#....*.*#...*  ......... ... #\..#.#* .* ....#.*.\.  . ##. ....*... . #....  ....\\#..#..# #.#
#..\#.*. .....##.*. ..* .. \...*. ..*....\\   \\### \.*...*......\#. **.**  ....... .......  .#. ...* \\.. * .* ..   .  ....\..\ \*\.... .. ..*. .*.##
# ..* ............  ...*. ##.#   ..........*#*.... ..   #*...\ .... .*.\...\...\.. ..  *#. * #*.\.. . ..\...#\*#.. \\\.# ...  . ...#.*#.# #.   ...#..#
##. ..*.... ..#. .\..#.#.. **... ... .\\ *.... ...# *#.. ..*..   .. ...  .. \#.... .*#. *.#. *..*...*..\ .#....  ..... .\* ..   .... #... *. .. .#.. #
#*... \....*........ # .  \..\.......*.# . ....* .#. .. .#\....\. *. . ...##*..#..##*.......\ .*#.....* * \.. *.#.........#.\* ... .*.#.\#..\.......\#
#..... *   #.. *.##...\.... \....*. * .. ...\#\.*...#..... *.. #..#.#....  #*.   .....\..  ...# .... \\.*.  .#*..   .*.* .   ... #..\.#..#.... *.\ .*#
#\. ... .. ...# ... ... ..* . *#. .#..\  * ..... *\... ..*. . .*..# .  .. .. ##.\ *. .\#*.... .\ .\ . .*. \ *\... ....\.... *#...*.#.#*#*##....... .*#
#\.\.#. ... \#*. ... .#....... ..* ..\.  .. ...* .... \ *....*.##...#.... .... .. . ..##*..#*#*\..*..##.. ..*. # #.....#.*  .#.*..** ...... .....#...#
#. .#...#. . ..##.*.**.. ..#...... .*.. ...**#....#..  .\ ..  \\#.  ....# .**.#.. # \... #*...\ ##.. . ... #.\. *#. #...#...... * #.... #. \... ....##
# ..*..\# #... ......#.....**..#.*.  \ ......#...  ..*...**.*.\...... ..  *.. ..* .\. #* *** .\*...#.#..*.*. ** . .\ .# *\..... . .. . *..*..........#
#....*.. ... \*.###...*# .    *\.*.\.\ ..... . ........*.. ..##\.  .* \.\.* ....... . # .#.#.#...# .. .* ..... ..* ...#*..* #.*...*....* \... .. . ..#
## .  **\ ...\.#......  ..\.\ \. ..\ *.#  . #..\#.*. ..*.*..#\.*.. ..#......#.#.* **. .. \. **.. \......#. . #. .. .. .\....#.. #. #*** .*. . #.*....#
#.#.#......#*....\... \  .#.#...#. ...# ..*..\.* .....##..  .. *.*......\....#.. .#  .....*.#......*. ....#.....##.*\. *......*\. #.#*.. . *.*... .  #
#. ##.\.* .#....*.  .... ....# *.* ...#.#..   ...## .#*#*........\ \*.. *.\*.....#.#..  ..#  \.. .#  ....* ..*.\. ..# ...#.\.*\ .#  ..\#*. .. .. ...\#
# . \ #  .\...#*\#   .  ..  . . .. ......*#. .. ... ...... .#....\.  .*  ..... . . *..  .*.\...*. ##..  ..#....* ..#..\....*.# ...\*.  .*#..\...  ...#
##\\. .*  *.  *..... .. .  . .. .#.**. ....*\. . \.\*#\..*... .#..**.#.*. . ..#.* .* *  ..  . .\.. .#.\.*...*..# \....#.. ** ..* #... .......*..... .#
## * .#... .*....*... ...*..#. \...#.\ .. *  .\#*. .*.# *#........#..*  .  ..*.  **\.* ..# #.**.\......#.#..*.  .. ......##.*.. . ... #*.   #..\.*.. #
#.## #. ##.. ..*#..  . \.\.. .*. .#.#... ....## ..  ## * .. .\. .*.. . .....\. .*\ . #\  ....#...#\.. *.# \.. .# ........ *#....* \....#*#. ..#..*...#
#*......\.*... \..........\.... #*..#.# #...#.#.\... #..* ..#.  ..#...#*.# .*.....*....# .# #.##  #...\...*. # .*.#.  .  . .*...*\.. #  .#  \*.** . *#
#  \.*..*..#  . .\..*.* ..*#*..* ....\.*....#*.#*\\.. *.#..\..**#..........*. \ \ #.*....#. #.. * *\..#.... ...\\* ..\. #......# . .#\*...* .\*..*\  #
#...* \.# ...  *... .#**.#*#. # .*....**.*.  #..#  \...\ *. ......*..... # *# # .. # .* . ..  .. ....... . #.\.. ***..#. #*   ..* \*. ..* ...... .. .#
#.**#.*#..#\*..**\ .... ..#.#... .#..**.*.. .#\..*....   . .\....\.\\ ...*....* .*#*.*.....\..#.\ ... ..* .. .. ... * .#\*.... ..#..  ..#..# ..###.. #
#. #.. .##...\  \. .\....  ........ *...*..\#. **. ..\.**. .*#. .*.. .. ... .  \. *. ... ...#  * .*.#*..... .\.* ...*.. *.# ..*.***....# .#.. * \....#
#*#.\.#*. .#.\...  ..* ..*..#. ... # #.*..\.. ...\# . ...* . . ..\\.... ..#..**#.*....#* .#... .*.#.. . ...*. # ##... #...*   .#.#*#* .. .  *\..# ...#
#... .#  ... ... ..#. . ..\ ..... ...##.. **.... \.\ . .. *. .#...... .  ... \*....  **#.***. ..     *...#.*..# .. .#* ... . \...**#\. ....#*... ... #
#.. ..#. ..*.#....*..\.##*.... #  ##.#.#. .*.#*. #.*.*\..#.# .\.*...\. \.. ..#.*...*...  ##* ... * *#..   #...* #.....* . ...#.#... . .. ... .. . \..#
#..*... .#.* \\.. ... ..\.*...#..  ..*\#..##*..*.###.... .**.... ... .*  ...\#*#. . # . .. . *...#.#.  ..*.\. \ .#\..#\.*.\......#. #..**#...#. #.#..#
#.....#... ..\..#.*....*. \...*#\\  ..*. .\  ....**.# .....#   .. .. ....*#... .#.* .. .. . .... .*. . #...#.. ... ....*. .  .. *##.\.*.*#.....*\#. .#
#..* .. .* .*.* *\* .#...... ..#...* ..*....  ...**..* .  . *. . # # ..##..#..  . .#..*......* ..  ...  ....**.   *..#..  .#*.#......*.*\..\..#..#..\#
# ..\.*.........##.# ...*.\#.. **....##* .. .. .. .#.. .. ...#... . ... .\#.#*.# .\ .. . ...#. ..*..#. .*.. \..#.. * *..\# .. *..#........* ... .* ..#
#.. * .##.   #.*.. *#.*#.... \ *...## \. .#*... ..* \.#...* *.. . **#\*.  .\* *..\.* .. .. .*.  .*  .*.*...##..   *  .**... .   .....#*. \. . .*#. *##
#  . .# *.. ..*. *\ . **. # .\..* . \.  . ... .*  .#.*.. ......... .. ...*#.... ... ..\.*. .*.. .*.\*..# .*#..\. ... ..#*....*.* ...  ..#....#.*#*..*#
#.\..... ....  .* .\**...##...  ..#..\..\..*.....   .. .  .*#.\.#...... .#.... .. ...... ..#..## ......*..# # *** ....*.... ... \.. . . ...*.......*.#
## .** *. .. . ...##\\..**. .   #   ....  ..  .. #..  # ...... .*##.....\...#.##.. #....##..\.\.. .*.......#**..*.# ...........  ... . ..*. .**....*.#
##.#.. ..*..  .\... *\..... ..#. ......*.#   \  #**.\*. .\  ........ # .\#\ ..    . .. ...*#.*.#\ .... .*.**. ......#.........#...*. \\.\.\*. # ... ##
### ..  .#*  #.. ........*..# ...#..... ..#.\.#. .....   .*#* ..#\*.....\...... .... ..*... .* .......*..\... ......*... .* ... *\. . .....# \**.#.. #
#\.... * ..*\..... *..*# #.* .*.. ..*. *...... ....#... .#.*..\.\. * .##. . ..\...... .*..*.....\ .... \\....... ..* .. .. #...*...* ###*\.....#. ...#
#...* *.. *.*.. ......#..#..*.... . .*  #..*......*..#.**.  ..#.... ..*..  .... .**.# ..  ...... #.#.##.*.#. .  .#......... .\ . \.*......*...# . . .#
#.. \.....  .. . ..   #.#....*.#. ..*.# .*.  .*#.#**.#. ...# .\..  .   \\.\..# ..#..##....**. ...# ....* ..\ .. *.  #.#.#\#*#.. . ..***.##..\ . .#..##
#. ...#.##. \*.\ . ..#. ##.. ... ..*....... ..\.\ .#...\.**. .*.  .. *#....\*#...#..........#..  .* #.. .*. * \. ..**\... ....#.....## *#.#.#.. .... #
#....*........ ...\*.. ... ## .*.*.......\... .*.. . #.......#.#.#. *... ..##** #*\..##\ *..   .. ...#..*.#*...\.*. .. . *  ..  *.# ##..*. ..........#
#..*.. \......\.# \..    ...#* . \.  *.. #..#.....#...*...** ...# ...*  .*..... \ .#.\##..*#... ........ .\  .*. #...#.* .#  #.. .....##...* . \. #..#
# ...\ .#..\*.\#*##.*##\.* .*.\.*.*..*..... ##. ... #.. ...**. ... . *.#.#. *.\. \ .\   #*# *...  #.. .* ... .. .#.#  .\.*#.** ... .. . ..  .. .. .*.#
## \# . \  . #  ...... . ..\.* *#.#..\**\.# ..\.*.....*... ..*.#......\...\.....# .. ...*..*.. ##....#.# .# \*  .....#  # .# #... ...*.#. .....  .  .#
#*..\*. ...... .  . . .#.\\. \  *.\##*. ...## ..  ..#...\......#.....* *.*#.... #. .*....**.#..*.. .##......... ..  .* ...*........#...  #.* .* .....#
#..*..**........#\....\.... #.*..... .*.#. *... .#.#..#. . .*\.#.*\# #.....#..*......#*...  *#...  ...#* # . .*....  . . *......#  #.*..  \   .# #.\.#
#\.*.\## \\....... #.  # ..*.\.#\*#.*.  . ..  ........ .\. # ..\...\....*  \..*. #...#...*# . #  ...\. .......  ... .*..... .  \..#*. .\ #\.... .**..#
#..  ..#...#\*#.....*.\.#..\#..\.* ..*..\ ##   \#..*.  .*..*...\. .\..\......* #..... \##*. #... ..#.*..\..*\.*.**.*..  *..##\ *..\...........*.** *.#
## .*.* .\* #\.# ...# .\. *.*.*  .. .. \... .# ...* *..**.\.##.. . .##*. .. #... ... . .*....   *.*..   *....#.... #.#*.. .*.\..**... ...*..... ... .#
#. .#*.*....\.....*\ .......... #.... ....\**. .#. \\...\. *  ....\...*.\..\ . ..#.  .. . ... #.. .\....** #....*.... \*.. *..... *..#\.*....*.#*\..##
#.#. ....*#. .......  .# .  .\**...#. ...*# *. . #.##  *. .... \....*.*..*.#..  *..\ . ... .#. . . * .\..*.. ..... *. \....#..  ...... #.* \. .. #**.#
## *. * .......#. .. . .......    ...* .. * . .#.*#..\#.*...# ... . ..*\....# .\.**..#... # #....   . .#.#.......   .....\.*.. .. * *...\. *\.. .#\###
#......\......#........*\. ..*.......# .\..*.# .. #.#.#. \. \. . . .. .... ...#.*.\ #**.*..#..\...#.#.#..  ... ..   . .. *.  ....# .  ....... . ..#*.#
## *....#...* .#.\.**.... . * ....\...*\.* ........#.  ..*# *.. \...#\.#..#... # .#.. * ..  ..#...*\*.#.......  . . *.  ..\.....#\*.......  .#.##.. .#
# .# ..*#..*\*....  . \....# ..#.....\. ..#\ ..#.......*##*\.* .*.....##.##. . ... #*...* .#....###..# \.*.....  ..**\ *\.......# \... . .. .*.#.. . #
#.*# .# .....\#..#. *..* ... .*  .....#**\  . #\..... . .. . . ..#  #..**#.*  ..#.. .  .....\........#*...... . \* #...#.* ...*. # ....* ... ...#..**#
#...*... .  #* .\ .\* *... ..... .. #..\...# .**#  #\.\.. *......#....*..*.\.....*....  #. ..*... *\.  *.*.## .#..*... .#. . .# * ..*#...*#.*#.# #.#.#
##\.#.  .  .\.* .## ...*    ..* .\ .#  .....#.... \.#  ... ....##...*\...*.   *.... .* .*   ....*.*\#.........#  ..... ..# .. \.... .. #  .. * .*....#
#*...# # * .\*..#\..* *#\#...#.. #\..  . .\#...#. .. ##.... .. ....... .  .# ... .##. .  ......#...#...... .#*. . ..  ***.. .  ... .* .. ..... . .* .#
#*# .*.....  . #...  #*.. . ... *. ..** #. .* .\*\..\. . *...*# * ..##.**... .\. \#.. .. ........#...  ..#..  #. #..\.. .*.#.*..... *. ... ...#\.#...#
#..  .....#.....*. ..*....#. ..#..\.#.. * ... \ #  .*.# .. . \. .\\.*.....\..\\.\ .  . #.*..#*. #..#\#.#....*  ....... * ..*. *\ . .* #\#. * .... #* #
# \ *.#.. ....   .. #*\.* \  ....*. . ..*.#. *#....*. # .. #.# ..**##.#..* *#....\..\.*\...\*.... .. . ..#* .. . .... . .#.. ...#...* #.\ . .*..#.#..#
#.#.  ..... ...#..*.....# . ...# .. .*#.. . **.*\... . .\..*... ..   #.* # ..  . *..#..*..\** . #..\..# *# .....\\# ..... *.\\\   .. ..## .   .*#.  .#
#.#.  .##...   ...\*..   .* . . . *#.....#.*...*.*#... \ * . **..\#.. #..#*. *\..*.#..*\ ... *. # ... ##...#. ... #* *.... .*  .. ..#.*..\..\.....\.##
#..# # .* ....  ..   ...#.. #.... .**  *#. ...  .*.  ....*..#.*#*.. \.  . . ....#.#*.  .#.*.# .*....##...*\ .*# . .......   **...#...* #...# * .. ...#
#..*.\.....* .... #...*....* .# .\.*.....##*..\ ...\\ ...  * .\. .. **.\ ......##.#*#.#\. # .*.*.###. ..\.. .\...\.....\.....\#\.*..\*\.....*.*..##**#
#.#.....* #.. .\..#. ..\.  ....#..*... .....#.#. . .. *# \. *. .. .#*#....#\ .. ....... .#.*\..#.. . .*..#. ...#. .*#*...* .. #*.. .* .**..#.....\ \ #
###..*#.* .\#....#.\..*.#. . *#. ##...\..#.. ...*. #.*.. .....*.# .. * *..  ...**.. .  ..* \\.. .. ... .* .... .# *...#.# *\.#... .#.*...*. . .. *.* #
## \# ......\#.**.#...#. ...... .. .\......*.#* .\...   . .. .## ...\... ... .... *\... .#\\...*.*. .  # ..*  .*...*..#....*..\\ *    .\........\**..#
#. ....*  . #\...*.\... ..\..  ..  ..\.#.*....*.............. ....*.\.. . ##.. ...* .. .... ..... ..  ... .. ..#....*.....# ..... ..#  . ....\.... ..#
# . .##.\....#.  \  ..  .......*.*.#* . **.**  #..... *.* ...\ . .#..\..#. .......#\..*. ..  ..###. * .##.*..... .  .... . *\. . ..* ..**.... .... .*#
#*..# .  # .  ....\.#.#.# #...*.#.  . ...** . ...*.  ....*.#\.*..*...........*.... ...#.  .* .  ..*.. .#.*\ .......#  * #. ...# * .*.** .#.. ...\# ..#
#*#...#. ...   *..*.*.....##.. .. . ...*\.# *...  ....*......##** .... #..#... .#..**..#.....#. *..*  ....#..#* ....#.  ... .. * ...\..#.. ..\\# ...*#
#*#...# . .. . ..* *...# # . ............#  \...#.  ... **#.. #..... .....*.#.  *.#*....#\. . ...#*  # ... ... .. *\.\...   . . ..\.*..*.#.*..*..#..*#
######################################################################################################################################################