#####################################################################################L################################################################
#......... #..... \. .\.. #\.* \...**. .*....#*..*.#. .#\.#. * .# ...*.* . ..... . \*..# ...... ..*..#**. #...\*....*. .  \ ... .#...\......#*..\...##
# #...\ *.. #. .#.............*..*# . .. * .....\. *  ...  .*.\.. ....*.\#* .  *..... ....*.#... .*\#...........\..*# #...#. ....... ...  ..\**##...##
##\*.#\#\ ...*\#. . \..*#*  . ....*.. .... *.#*#..*.\... .  # ..*....... .. .**..# .#* ...*. ..*   .#.*..#**. . *#\...#...## *.#.#. ...#....#.#..##*.#
# *\*..\#.....*.*.* *....... ... .... \.#..... ... *..   ##. .*. \... *...#.#. .#  ... .. . .*...#*. *..  *. \.. *. ....... ...\\.*. .*.\ ..\# * ...*#
#\# .*.\ . .#.. . . .\....\... ...*...* .#....*\..#**.*#  ##..**\.#.\.*.......**. .. .\ #.# ...*\... .... .....#.***.. .\ .. #  #.  **....#.*. . #*..#
#...# ..\..\.\##.\*... . .. #*. .......*  ##. ..*....#....\*..* .## .. *. . . *.*...#  ..  ..* .   ..\\ .# *  .#. .##.# #. . .*..  *...\.#.##**..#  .#
##.. \.#... #.* ..#.  ... .*....... . ...#...* ...\..   ..\ ..# ..* . ..* .# #*...*.   .........##... *.. .....#...#  ..# .##.. .*.  #......*.*. ...##
## .. *....***# * ##\ . .*. *  # .  ..*.. #..*\.. .. .  ....#.#....  ..... *.#.. .*\ ..* ....#..#..........#.#... * #. .#.  \.*... *#...#.....\ .....#
## \ \#.. . #.  ..*** . ## ..\.. .... ... . *..\. .#  . \*\*  .# #...#.#. \... .*... .#. ......\.#*. .#*.#....   .... .  ........#.....**..*  ... ...#
# .......\. .. ..#.#.*\.. .\..**.. . #..*.... \. #.... .* ... . *.    *.. #........#\.... . *.. ..##.#.*\*#*..#.  #..*.. \...* #. ..  . #...* . ...\.#
#.# ..  \. #.##  ..*.*... .\ ... ...#........... *.\.*. ..#*#..... .###..\....*#*...  ......*\    ..\ ...\ *\\. #.....*.. #* .\.\. ..# .#. ####.*... #
#..... \  ... \.# #.#.#.....#. .....#.. #..................\. .....*.*.....#*.#.#...* ..#  #.*......**#....#.#.......*.*##\*.# ... \.. . . ...*..#.\.#
#.#....# .. *.# .. ..**.. *.# \#...  #.#...# ..... #. .*#* . #.\.\#*.\ . #.\*.* .....\#\#*.. .... ....#.#..#\..\. . #... \..#.. .*......**......*....#
#*..*.\ ...#. #.*.#.*#\ ..\. ...  #\*.*.*\... \... .#**.  .. .......##*..*....#*.##..\...\........#...\  . .*.. ..*..#.. ... .#\\.*.**#.# ... \..  ..#
# .... #.... .*....... # .........*. *. . .#. .    .#\.#. #. * ..* .#.#.* ... \.\. **..... ..#  .*... * . #. .... ....*..*. ##..*.\..  ... .\..*\.*.\#
#. ... .. .*.*## .. ..#.....*.. \.   #. ..*\. #*##.*\ ..*..\.....#. .#.... . .....*.#..  #...*#..*  ..*.*.. . .* *...#.#....... ... *. .*.#....*#.\. #
#.....#. .*.* .....\.#  #. *.   ..  .#**.**........ . *....  \. ##.*.\...*. ....*.....# .. *.  #. ..*.. . \.. *..*...\.*.. . *.. .#.#.......*#. .. #.#
## \......#...#....#..**#.. .. \..#..    ....#... . #* .*.*  .#....\* . ....*\ # ..*#.# *\*..  ..\.... .#..........*  *.*...*. .*. . .....\*. ... ..*#
#. .\\ *.# ...\.#. . ..*..\\..#. #.\...\ *.. ..* ..*..\....  *.#.... ..*.* .#*... .. . ..##\.       ..*  .  .. .... . ...#.. .... ....\...    #  ....#
#.# *\....\#\.. * * ...\.... ...* ** ##\*...\..  .  .... .* ...\*..\.\.  ..  ......  *...   .  . ...   \.  .#.#*.. #.\*.*. . .#.. \.\*##....\.# .  .\#
#.#....# .  .. .. .\.*.. .\..#\ \ ........\*.* . *.*.*.#\*#.. ....#\*.\.......\ ..* ...# ....##.... #..*......\.***# . .... #.....#.. .*.*.#.\ .* . .#
##.#.. ..#.. . .. .*#  .**..... #*.  .\.\\...... .*. .** #....* #......  #**. .\#*.....*............  ##.. #.#.#..\ \    .. ... **.....\#.*.#...#. .*#
#...\ .....*#\..*..... *#..\.#*#.*.....*.. .......... .**  *. .\.....#.. ... #  .\.. .*. ***..##.......\...  .......\# .#..# ....*. *...  .   \.. .  #
#*\#..\...#.. .... #.. . *#...# ...#..\\.....\....#. .\# ..**... \.*......... *#  .\#. .\..* .* ...\..*. # #  ..# *...*...\....... ... ..*..*.*\#..#.#
#..  #\**# * #.. ...*\.\ .. .\...** #.....*....... .  .*... *# ..*.*..*.# *.. ..*... . #..  .... .. *. *#.* .*.  ..#.\. ...*\*... ..  . .\..#.##. ..##
#....  *#  ..  .* #. ..\*...## . ..*. \. ..*...# \ .. # #.\.\......  . .*. .    ..*\#.#\... . \.#...\...*. **..\........... ..** ..... ... . #.\ . ..#
# ##\ ... #.\.\ . .. ... ........# .  .#... \... ..*\\#......#....  ..*.*...## ...\.....*..*...  .........*.... ..... \ #.. ...  .\ .....  .#. .# ..##
#. ... ... .*. .#.........\...#.\.... * \*.  ....*  ...**..*.. . ..#..# ..#* .*....... #..#*.. ..*....*.*\. .\.....  .# # \#*\..#.... .. .\.....**#. #
#. \.....*. .*..*..*.#*.#......... . *  . \.*....#.#......#.\.. ...\#. #.... . . .*\.. . . #. *..# \*.# ***. *.. *. ..\#.#....#*. .*....**. *.  ...\ #
#*..\.... ....  * #.#*.. .*\....#. \ \......... .*..\*.... . .#. ..  *.*.# ##.. ......  .*.. .\*\# *.#.... ...#. . *.. ..# ..####....*.# .*..#.....  #
#\ *\#...#..  . .*.\ . .*.  .. ........ .  #.... #.*....#\... #..*..\#. #.  .#*#. .. ..   .. ...*.\*.* .# . .#\**...*..  \#.##.#.* ..\ *.. #..*##..#.#
# \......#  #*#* ...... *..... . .#..\.#...   .   ..\ ... .. *#\.#** ....\..#..#... #   *.*#.#..*..#.. ...#..\* ... .*. .#...*..*.#\..*.. . \*... .*.#
# ........ . #.#.*  .*.  .. ..\...*.. ...   . ...*\  ...*.. .#. .  \*...#.. . #..*\**.##.. . \.. ..\  ...#. .....#...... .  \ ..... #.\........*.\ .##
#....*....#..*.#*.. ...\....... ...... .....#....*.#. #... **. ...#.*#. ..\\ .#...*.\...*. *#..*....* ..... *....\... ...\.  \.......# .... ...#**..*#
#...###.##.... #..   .#..\**\ ...\..# ...#*..# . #..#...* ..#* .\... ............ .#. ..#... .#....#.   ..\.*..  ....#....#. \#*. .#.....# . *\.*#  .#
#...#....#...\. ..#.*.#* ....... .#.\. .. .. #...*...*.#*.*  ..#\... ## ...\...# ....#\. * *. . ... ..*...*  ...  *\.......*.\*\.*..#... ..*.  .\\...#
#.\ . *#.. ..#*.\.\...  #  \.*...#. ....*. .#..# \*......\. .#.*  . *#.\.*.. .*..*.*.#... .*.#......  .\..# .. .#.. ...   ##...#...# ... ....# . .. .#
#.*.\**#. ..*.. .#..#.\.......#....... .\ #. ..*.* *.*#*.    ..* *\.*..... ..*# ...*.*..\*\.**.. ...\ . . . ..*...#.  . *.. . # .*.. #*\.#.* .*....  #
#.##.*#.# *.\#..  *#. # . * ..\. \.*...... ......#...  .*..\....\.  * *... . .*.. *# ..#...\... .......#.\\..... ..## . ..\.#\* ......*# ...*..### * #
# .# #..* .......#\..\.*...#\.#. #...**..*.*.*.*.## .\..# *\.#. .... ..... ... *.*. ......* ..\ ..#.#  .  ..... \. \* .\.............\..#. \.\*..... #
#.... ...# .##....\..*. .#\\#. ..#...  . ..  .* . . * ..\.. ..## ..#. .**\. ...#.\.. ..# ....# *..#... #*......* *\. *#.  * ...\...*.....#..#... .*..#
#. ...* ...*#...\..... .*\.*. **..*...  ......... .* ..**.... .. *##... \ . #... ... . ..... ..#.....*.*... .  .. . ....#..##\. . #..#..*... ....*.. #
# ...#.. *\...#..* ... .. ....* **......  .. ........#.. ...*..\\#  #*... .. #  ###.** .*\*.  # ...#.\#.*##...#. **#. ........ #..#.. #.  .....*...###
##..*. .....#\*.... ..*... .....#..# .#  ...*.\#...# . ..*...... .#.\ ...*..\..... ..*#.#  \....#...\ .. \\* .. #.......  .##..*#. ..#... ..#...#...##
#.**..  *\..\\ ..   ..\....... .\... \.. \#.##*.*.# ..\  ...\##*. # .  .  .* .** \.*..# ......**. .*\.....\.. ...\ . .* ..#*...*. ..\.#...* ..*.*. . #
#...**.#... .#  ..... #. **...\...#.* # ...#... .....#..###. ....* .. \*...#.  ...............# .*... .*#**\ . .....\..*.  *#... .#*. .  #..*.. . #.*#
#  . .**.\#..*.....#.*  **.##\..*..**.. ...\ ...\.. .*\.**.#.**#..*.. . .. .**####.#.#..\\.#..# ....*#......*.. ..#  #* *.*. .. ..* #..  .*\..#..\...#
# .... ....# .. *......  .....\ \.....\  ... ..*.*#. ..  ..\ ** . .** .# .... ... .\.    . ....  .*.. .  .... ... .** .# . ...# # ..* .#  .........# #
## .. ... ..*\\......... . ..... #. ...#. .*#....#\* \\*...#..........*.  #*.#\...\##..*\.#..*....\ *.*. .#.\.... ..\............##....*.  *..\. ..#.#
# ..# *#.#.... *.......... .* .. .. ..#*..*## .#.  *#. .#. ......* ..\  *.*#.* .*.*..* #.\#*#.\... *.\.##. ..*###   ... *...  . ..  ..*#....*#.*...*.#
#...#.... .... .. .. #..*...*. ....*.#*........*........*..\ .....*..* .\  #* ***.*#. . * \#.......\..  # ..#......# . .. ..*. \.. ...#. ...*##\ .. .#
## .\#.. ....*#*..* ..*.*\.   *. ..  .#  #...*##. ..**\.  .\#*\. .*#\..\* .#.# #\.#.*.#  *...*.#. ...\ ...... *.\.\..... ...#.. .. #. *...#....... . #
# *\\#.\.#.. ...*.... . #*. .#...#\.\. .. #.#. #. .* . ..*.# \..*#.\#. #........  .#\......#\.........**..# ... .*. . ..*...# .\ .#..#..... \. ... ..#
#..#.\.... .*..#.\.. . ....*. .\. . ..\..\. ..*....  ..#....\..#.... #*# ... . .  \. ..#  . ## .\.. ...  #\.*..*\*.  .. .\*... .. . ...#.\.  .#.#...\#
#*.... \ . \*....\ . *.  . . ..#*...#.... ....#.*   .#...  .*.#\..... **. \# .*.** #..\* \.\  .#\*.#....*. ...  ....\\.*.#*.  .....#.#.. *.#..# .#...#
## ...*. .. *.. .. .\*# ....*#  . ....**. ......*...#*..#.... .....#.*...* #... *.....#.#.  .*..#...   . .  #. . .\.. .# #.#  .\*. ..*. # ... #. ....#
#.\..\ .*.# ......*...*. **.##.#. ..  *#.#*.#.#..#. .#.##... .. . \#.....*#.....\..* . ...  ....*.....#... ..\ .*..\* .#.... \....  #.. ***. **#.... #
#*.# .....\ ..\.*..#....  .#*...\...#... ####.. . ..# . .** .....##.\ * # .\....# ...*......#.. . #*. ....*#\.. ..  ..#\. . ... .#  ...  ....* .#....#
#.\\..*...*. *....\.. ...... . *#....  .#\ \.#. .*.#.. ......#..# ...  #**#..#..*. . .*.... * .\...\. ..*.. ..\..#\.*..... *  .**.*....* #... ...\ . #
#. .\. .*.#*.. \#..\#  ...*. * #\*..........#.#.#......#. .#*** ..\*.*.. #.*#... *...*....*\......#.#...\...... * ... ....... .\..\ .*\#.......* ... #
#.*#..#. . ........\..  . *.....#..*.#..#..#..*. ..   #..\.\\. ..#... #**..  #.#. . .\.  ... \\.**.\...#......\.*#\*...*......# .#. ...*..*.**.. .. *#
# *.......*.*.... .. #..\*\... .\#\ ..\... .#.*..*#.. .#.......##  # .  .#. ...#..\\.*. .....\. .. ... ...#.#..  .#..\\#..#...#...*..#*..## ..... . ##
##    ...... ... \ .  . *#... ..#*.* ......*. .#..\#\ ... ...\ .#...#.#..#.#..# . .. .*  *. . ...\## . .*... ..* .*..... ..#.. * .\. #.*#  ..\.#.#.#*#
# ....#..#. #...* .  ..#..***# ..#  .\.. #  ....*... *.\ *\  .....#...#... *.#  .*...\*. #. .... .#. ..* ** . ...#..... . ..*..*....*   *#.*.#......##
#.. ..... #.**.#.*   . . .# .#. .... . ..*\ *#.....\.#\ *#*.*# #...\  .* .......  . ......#* #..  . #.\.*..##.  ...*.. # \\..*... .  .#*.*\*\....*...#
#*....  ....##   #.. .  . ...# #.....\  ....\.#... .#.*. .. *....  .. #.**#... .#\ . ...*  \...*...... . ...\.   .  . #*..... .##\.....  ..\*. .# # .#
##* ...\*.**.*......  .... . .*  .*#.*\*..*..  #.... . ....#.# # ...*...*...*#.**#...#... . ..#. # ..#* ...*.*.. .. .#\..   \. .*.. .. #. .*.  ......#
#* #..*#..... #\ *.# ...***.#..#.# .\#.. *.*. . #. ..  ....  \.\... ..* #.. .....*.. .**. .*....  ...\........ . * .....**. ..   *\..   #.*. .*#. .. #
#....*... . *.\ ..\# *. *  ..*.. ...#.*... .*#.\. .. ##..\....*\  \ .  .#.. *..#*.*.**. ..*.  .***\....    .*. .... .**\* ... .#*# .. *.   *..#..*\.##
####\..*.....\. ##. #.#*..\*#.  *#.. .  ....#*\ .#  .* .  . .. ...## ..*..  .#...... .# ..#.# ....**. . ....\**.*..#  ....*.*...\..*..#*..#.\...* . .#
##... ..*.*. ..#..  ...*..  .*... .\#*.#* ....\ ...* *.#*#  .... .\...  .*..\....#.  *....#.\*...#*.* * .. .......... .* .#..##.. ........*.. ...... #
#.... ..*.. ..# \  # .**\#. ..**.. . ..... .*\...# .  .......#....\.**.*. . ...  # ..  #.* . .#.. ***.\... *.....\..*. #* .* #.#.  #...#.*..\#*..\\..#
#.#\... #.\. .\. #\....#. \\. ...##..#.........* # #..... #..   ..# .*..\..\ #\.\#...*.  ..*... .#.....  .....# \. ..\...*.  ##..... .. ...# ...\ *..#
#.. *. ....*...* * #. . *..**  #.*.....  ..#\ ....*.  \*\.....#.. .. .#... ....*##. *.. ..*.  ...* \.. ..**.. ..*.... .  *\...  *. *... .*..* . ...*.#
# .  . .*. . ##...##. .  #..*.. ..#...       ...*#......#...\... .....  .  . ...*... .#.#... \*  ..\#. .. ...*##. #.. ..#.##... #..# .....*....  ##..#
#\.. **.#..\..* ..  .*#. *\.* .....#.. .#* ..#*...  #....  .*..#.#... .\..  *.......*..# .#. .....#.\.\##... *.*.......*.*#. .*...\*..... #.. ...*.\##
#...*. ......# ..*....#.\..*.....** ....#. *..*. ...# .. ....*.  .* #.. .#...........*...  .## \..#. #*....*# .*#.. ..........* .# .*#.\. #.#**....# #
#....*. \ \ \*# ......  .....# . .. .....\#...# *....#  .... ..\ ......*... . . .\..*#... ......## #. ...# ....#... \ .. ..##.. \\.** \ *... . ..#. *#
#\.##....\. .##*...#\\..\... . \..*...* #...\..#.. #.* ..#.  ##.**.\..# *\.. #\ \........\. *..*.. #...#..#...\# ..*... .*.. ...* . # .. .#.. ..#.  .#
##.... ##...* ..\ ...##.*#\. *\ \ .\\...*...#.\.. .*.*. \# ..**.#. ....\\...\...#.* ..... \#..*.**\*....# ....... . ....*........ ....*.... .\... ...#
#.*.*. ....#...... .. \.*.  .\..*.#.   .#\.\#.  .   ......\..  . #..  ...*.  .*\    ..*..*...   ....\.\.. . . .#...*#.. .\*.. #.\..#\ . #. .#. .#....#
#. .*. .  *...**#..#\.#..  ...*.... . ..*#...*. .. \...#\# ... # ..# .*... .  ..#. \#  .. .....#......... .\ ....... .. . #.. ..*... .* .. ..  .\.\. #
#.###\...# .      *.  * ...\. #..#.. ..*\.\. #... .\..*# ..*# ..*.#.. *.*......*..#. *...** * **....*#.\#..   *  ... . .* # *.#. .......*.# .*   ..\.#
#* ...  ..*. .*.#*....#...*.. .**..\ .#. *# .#.    *...*. .# ... * #. ..\\   ...... .. *.  ..**. #..\.#.. . *  .**..  #... ..  ... ... .*\..*. . .  .#
#*.. .\.....*#.# ..# *.#. .#.  ...##. *.*#..  *.  ... .. .. ....*   ....*. * ... .. #..  ...#....# \......# \...#... ..  .. ..#....*.  * ...... ...\.#
#.#..#. * #. . ..  ..# \. .##  * .... .. .*   .\..#.##. **. \*.\.*..##.##\...  .**...*..*#*.  *.  *.........#.......## .#...*..**  #\# #  #..\ ....#.#
# .*..#* .... ##*...#..... .\\... #*..#.\#..... ....*.*... .\.*...# \. *...#*..\.\ *......*........#.  .....*.\.. . #*.....#**.# *\. #.. #. .*....*. #
# ....#..#...  .. *  . . ..\*#...... ....... ...  .\..*.# ..\.*..*..  *.\.\ ......*..  .#*... ...  .. #\#.**# ..\.#. ....\.. .. ..*....  ...\.. #.*. #
#\* . . .#..*. ...#...... ..*.*.#  ...**. . \.   ..*.**......##.#.\.#......#.. ..#..  #*   .. .. ..*#.  *.....\ .#.\.##  # **..#.# .#.*.#. . * #.\ . #
#...\..#. \   .. . *#\..#.  \ .#**....#....\...\.......*...  ..  #  * ... . ..... \. # ... *...#\. .. .## #..#.###.#\.*..#...  .#\.\ .. \*..*.  ...###
##...  ..*\..#. ... .\...... .\ ##..  . ... ..#.. #..#. ... .#.*.. \.....  .....*.. *..# \  ......   .**. #*. .##***.....\..*... *#  ...  *... .#*. .#
# ...*....*#.......#.*#..##. .\  . ..* .. .*..**...\..  ....#..#.#.##*.*## .. . . . \...... .*\. . .**#....*... ... #\.*.*.\.* .. . #* . *.* # ..* #.#
#**...#.##...........\ .\# ...*.\  \.... ..... #\#..#. \ .# .*..\ ..* *.#\.  #.*.... * ... .....\...........\#  ..\ #\#..   .\.. **   ..#....#..***\.#
# . ...\. *.#.\.*....#  *\\.*...#*... .#.\..#.*...* #*.#. . .... .\. ...*#. .*##** . ..  .  * .*.#*..#..*## ... . ..*..#. * # **..# * .....\#.*.. ...#
#. .* ..*##.. *.\..#*\. *.#. ....\.**  \#*.  .... ..... ..#. ....**..\....*.*.# . .#*..  .....*. .# ...#.  # .*\ ... * .##...*... ...... . . ....#.. #
## .....#.*. # # . .....*.#* *.. *......\.. .  *..##*.. ..*. ...*... . *..... . **.. .....*.  .....#... .*.. .......#.*. * .\*.....** .#. *. ..*.# ..#
#. .\. .....*...##..#    *.*.\.. .\.. ** . #...... *. *.##*.......# * ......... .....#*. ..  ....\.\...#...#  #.\ ..\..\..\  \... *.. \..*#*.*.#..  .#
#...#.....\....*.*...#.#. .... #... #.. * *... #. ...*.*.*.*.. .#. .*  . *  ...#\.. . *.*.*\....\ ..#...#  ....# ..  #. . ..   **..#* \ .. #..*  #..##
#\.*  .   **.  .. ..*.* ... *#....#..*   .....\#. .\.#** # ........\.#. .* . ...*#\ ..*  ..#.. . .#.... .  .. .. .  ..#. ...\..... *.....  ..#...*..*#
#. #.* #\ *\ .\#. ... .#.* . *.. . .. .\. *... *...*... #.*.. .... \..#...\. \.\.#.*.#*. **#......#..\ *.#.# *.** .*......\.#.\.\ ...\ .. #.#..#...###
#.\\  \ ...\..   *.##. ..*...#.... #\\**.*..* .#* .. ...*.##.#*. . .... ..  ...*.. *..#..\*. .  ..#..  ..#\.... \*.#.....#*# .. #\..* *. . .# #* ....#
#. .. . #... .. .*..... .....#.\..\  ...**..# .\\ ..#. \#  . ..#. ......*... .. *...#\# .\ .\....#.. .#* ..# .## ...  ..*#\*# .. .. ..#..\ .\. ...#. #
#\.. ...\*. ......* . #\ . .. **..\...\* . ... # #.*... .  .#...... ..* ..\..* ..#.....*. ..* . ... #.\ # *# .\.*#.*. . #.....*.*## # #.. \. \*..... #
#..** ... #..#* .\..*.....*  #. ..*\. \ .#. *.....*..  .*.# .. *......\...*.* *...**.... .\.... #..\.*..........*...  ..... #.*##*#...  *.#.....# ...#
#*.#.*..\\# ...#*. # \ \ .#..\......*#.....\. ... . ..#.. . .......\ .#..#..*#....*..  . .... .*# .#*. .\.*... ..** .#.. ........  . .....  # \\.#* .#
# .#*.  .....#...#  .#..*.... ..#.##.......\.*.\....*\.\..... .....#.#*... . ... #  ...#  .. .#\... .... ##...#. ..... \*. ..\.. *# ..*.... ....... ##
#. *#.*.... .. .. ...   ..#.  .\.*..###..#... ..*..*#..#. ....*... . *#.*. .... #..  ..... #. . .   .*..#*......*# \. .........  \* #*...... . #.**..#
#*. \..#.. ...*.* . \.. #. # ..*.*. .#*#.\..  ...*#*. #...**. .*....  ..*###*. #.. .#......* .\ .#.*#..*.*. ... * .#.. ..#..\.* ....  \.#. .*. ..*...#
#..*..  #.... #...........#...\..# ..#....# ..\.....#*......... \. ..* .....\#. # . ..#.*..#.#.* #.*..*# ..\...**# ..* # ...##..*.  #.#. *  .\* *... #
# ..*.*#.\#....\.. ... .. .... #..*.*#** . .   ..  # .#  #.. . ...*#.... .. *#.......#.......* *..# \. .* .*...*......*#.*#.  ..#..\. *. ....\.* ...##
#......#  .. ... .#..#. . ..*...\..\. .\.  ....**.. . .. ##. #....#*...... .. .#...#. . .** ..*.  .....   #. .*..  .# ...\\.  * . # #......*.  .#..\.#
##...**..# ..*..*.. \.# . ... ..  .#.*...#.... \.# .. ..#  *..  ....\.. ..*\....*...\..*#  #.*\..\.#*..... ....... . .. *.* ..... ...###*....#  .  . #
##. .*..* #...\.# ....... .\ *#. . . .#*..\\..*.. ...*..\.#.\. *... .*..  . . # *#*..\.#.\...#... ... ..*... .#*...\. #.**..*#. . #.#..#* #...\.. .\.#
#.....*\..\.......\....# ... .*    ....#....*... ..#.#...#.**#.. .#...... ....... .\..# ##.**. ** ..# ..*.. . .# .\.#**. \#..## ..\...#.\......* .   #
#. . .   .#.. .\#.... .. #... .#.\..# #.*\#    ...#. .*.#...\..*\..*...# \# *......* .#..#\#.#.\.*. *... .*. *.*.  .....* .#\.  #.\. ..#..*#..*#.* ..#
# ..#*.# ..*... *.* .*...   * .....#.. **.#.#.....#.... *.# .. ...\ ...#\..#. . .#.\\.#.#....#...#......#.. . . ..*.  #  . ..#.. . . *#. ..*  **.. ..#
# * ..#.....#\\. *. ...#*. .*. .*. . .*. .. ....  . .. # **\ ..* ...#... .. ...\ .#.\\....#...*#. .  \*...*. *..#\ \  #\..\ ..\... #\.*. #.*# * .\. .#
#..#...*#\##....#....*..#* . ..#..   * ...#.#*....#. .*.  \.....\*\. ...#...\...... ... ...*. ...#........\... **...........#.*  ##.*...#  . .*  *. .#
# .   *#\.....\\.#..*...... \..*... ..... .....*#.#..\.. #..  **............ # ..#......#.... ...*...... .*.. * ..... . #.. *..#. .  . .......*..\  .#
# .. #..* . . .*. ..# *..... **....*.....\\ .. .... *. *...*.#......# ..\.\* .*#. .#.\....#.. *\. .....# .. .#......\.... . . .... .....\.  ..... # .#
# . *.* *..\...\#........ ...#.... .... ..#.# #.  * . .#... .#.. ##. ....*#*.\. .*  **.\.. .\......* .....\...\.#.##.* .#.*.. . **. .*..*  .#. .... .#
# .*.....* ....     . ...*. #  ...\.....  .* ..... \.. .#..*.  *#   .. .*.#.*.* . #. **... .**. .*..* * #.... . \. .**..  . .#. . ..*. ..*.\......\. #
# .#....*.. \.\.*...  #... * * .. .#. ..*..#. . *.. ...  \#... #. #...#. \.#.#..*.* #*......* #*#\. .## ..\\ . #..#... *#... ..\  ...\..  . *. \.#.#.#
# . \#\ ...  *..\.#.  . #..#.\.*.#.*.. #.#.\... .... ..# ...* ..*#....*...  .\..\.*...  .*. *.\.... \. ..\*.....*#  ...#.#  .* ..*.#....# .#\.. .*..*#
#......#\# .#\\..**#.. .  .*#..\\... .\**.  ....*#.   .. . *.\. .....#..  .  ....*. .\* \# ......** .. ..# . ........ \.\. .. ## . .\  .. #..#.\..*..#
#..*.. \\\..*..\ .\.  ..  ...*.. *...  ....*.\  .....*   ... . ...**..**.# #........##.*.. ....\.........*#......  .\  .*... \ *.*...##...# #**.*\ .##
# . ..#... #.*#. ....... ... ..*.*...#.   .. ..*.\. .  ###.# #.*  .. *.... .#.  .# ..#... ... *\.#..*.#.. .#.. ...*. .#... #\.#\ .. .**..#.. *.\..\..#
#*.*...**.*  ..\. ..*\ ....#\.. ...*.... \ .##.......*..#. ... \... *.. .. #\..#.#  .......\ # ..#.# . .  .. .     ... *.. \\.\*..#.. . *#.*. ....\\.#
#... .\.# \ .. **...\ \.....  ..\#.\... \.##....#*.. .. ......*# .#.. #*#. ..*  .   \..* . . ..  * \... .#...*.#....* #**.  .. ..#  .### . . *\..*.**#
#*.*..  .. .\ \..... #*.*.# **.. \* ..#  .. . ..*.....*.*..#.# . \.....\.......*.. ..\ \ .* .#\* \.....#*.. \#..#... \.#  ..*.  .*. ..#. ..... .#*.. #
#....  . # ................#..#\ #\.\  ...#*....#.... . .\........#...*. .....# .*.......** ..*  ..  ...* *. *. . \#..#  .\.. ...* . ...\.\*#... ..\*#
#*#.#.. . . ..*#. *.#  *. ....\  .. .. ..#.# *.  \.. . .. ....\#.*... . # #... **\ .... \.. *. #   *.# .* .\#   * .#... ...\...* *  . .\ #. ..\..*...#
#\.. .#\......  .... *#...#  # #.*. . *.\ \. ... ...  *...#. ..#.. ..*#...##..  . ... . .. #.. . ..*..#  ...**..........*.. .\ #..##\.*#...... \..#..#
#*#  .#.#  #...#...* ....\ . . .. ..... .\. .#.# ..*. *.*..#...  #.#..... .. ##..*  . *.*.*........ .#..*..*. #..*..*..... *..\ ....  .\ *# ... . . *#
###....*. ...##..... ...*.#\.#.....#.#  . .#*#. #.........#...  .*#. .. ..*.. \....# . .........* ... ... \. .*\ .\....  #.*...#..#.....*  *.....*#.##
# .. #..... ..#   .*...\#\*..\....\ *... ...*. .....\.#**.... # ..# \..#*#.....\... *.## ....  ##...  *  * .#.#  .... ... ..\ .## ###..\. . #.*. .  .#
# .....\##\.*.*##........  .\\*#  ......*.# .*\ .. *.\.. * ....... ..... ......... ..\  .#...... . ** ....... .... *...  .. ...*. . ..*...#. ..*...\.#
#.*..#*R ......  #.#. .... .... ... . .. .# ..  ..#. .. .*.\.\* *#.*.........#.**...#*#.....#. ....*.#*#.*.... ...\.\* ..  .  ..**  *#  .* . .... #..#
#..#.*..... *\ . * . \....\..## #......  ..*#.. .*.#.#*.....#*#.*..\...\ \..*. \\.....  .. *.#. ....\.....\..#. ..*..#.. ..#.*.... # \   .......\#.  #
#..  . ..*.#.#  ...*.........*.... . .. *\ .  *.   *..*.\..*..#*.\..... *...\.* .#....  .........   .*. ** * \.... .*# *......\.* #.#. .. .\ #.#.#...#
#.**.*.\..  ....   ..  #.\. .*.\...\..#..... *.... * . # . ...*.*... ..  .. .. . ....* #. .#***.# ...  #\ ..#.#..   .* .*\**\ .....#. # .*....*.\*.. #
# *...#. \*.. . \..#. . ... ##.*... .*.*#. .#.\...*...*.  .\    #..\..#.. *..#*.. .*..\ . *.## ..# # ...*...##...  ...* ...*. . ..\....*#. .. ..\#..*#
#..*..  .#.. .....#* ..\##... ...   .*...*...*.\.##..#\.\#.*.#.\ . .* .# \. ... .\.#... ...*. ..... ..# .#.* *...... .*. . ......*.. * . #\..\# #....#
#...## \*.\. ...*.*#* .# *.# \.# ..# .  ......... ....\.# .##\ *.\ *.#* #. ..* \#.....\\....**#.. ....... ... .\...#.#*.*........#  #..#. .\....* ...#
#.....#.....\..  ........\..  ... *.... .   .. .#.#.....* ......*#... .. #*.##.\...... .*  ...   ##\ . * *#.##.  .. ..*....*.. \.   ... . .**....##\.#
# #... ...\..  .. #..#. .. ...*    ## .....#......\.. ......*\.\  \... .#.##.\.*.#.. *....\.#......#...   ... \. # .. **....#.#.. \#**. .... #*...*. #
#.....* \   ..*.*..*..\.....* . * #.. . .\.  # * ..* #..*... .#**.*. ..  ....*#.\ .....# *.. .*  ....\  .\. * *... .#.... .#*.. . ..#.\.\...*.\ ....*#
#.# ..... ...#.  ...# .........# .**..# ... .###. ..**.. #..#. \**.#.... .#\...##... ..*#.*..#.... .\...#... #\*.*  ..   .* .* .. .\. *. \#... # **..#
######################################################################################################################################################