######################################################################################################################################################
# . .....*#..\*. ...  #  ...\\* ........#.  .#***  \....*...\............ .#...  *##....   *... . .......*..#. #.. ...**.... #.#...\...#*...*..... ..#
#...#..*..\.# .* .. ..# *.\.*.#*.* .# ... ....*. . #  ... . .  . .....  . . . . ..#..... # ... .*..\.#. ... .   .#\ ..... .  . \#.. .# .....*. ## ...#
#...*  ..\ #.#.* \.# ..#....  ..... ..*. * ....* ... #....... .* . .. .. . .....*. *...*#..#.#...**. ... .#.#.. ..\  *#.#.... .... .*.*.  .. #.#  ...#
# ...  .\. .  .\.*... #\.  ... #.***#.#....  . .. ..# ....*... .#.\.. ..#..#. . ....#. .. #**.. ..#**..* **. .*.*..# .#.... .\.#..........#. .  . ...#
#\#....... *.*. # ...\..*.#*...#.. .... . ..... . ...* ##. .#.  *.*...#.#. . ..*.#\.\ ....  ...*..*#.... .#*.......#**....* # .#. #*.\..\ *.#..# .  .#
#... *#.. . .....  #.##. ....*.... . *.  .#.. * .#...#..\. . #... . #..  .#. ..*.. ..\ ...  ...*#...\.. *. *\...## .. .  ..#...*\ #*#. .#*....  .*#..#
#..\  ..#.  .*.#.... ...#... .  * #....*...#.#.*.....* ..##.*\.*..... .... .# ..# .. .* *...\....#\*..##. \.\. ..#.\...#...\..  * .... .... ..*.. . .#
#..*...##.*.. \. .* # ##\ .#.........*.* .. . .... ..#*.**  .*....**..  ...#.* #.#...  ..*  \   \.#. . . ..#.....\.. . .\#..*. ......  ...  . .......#
#. .. .#..*  . . # .*. ..#.#....#. ..*.. ..#...  .*.*.* *..#. ....#*#..*...* . .##.*.. .\#.#\.*.. .. .\..#*........#...... .\#. . .. ...\*.#**.*.\*  #
#... * #. ...##.. .*.*......  ... #...  *\.# ..\..#...* ...*...  \...* .# ....\#.*.\\**.. . ..... ..\... .#. .....#\..** .*.###.. . ... .\* .*.#  .*.#
#.  . .. #.* \ .\.   \\ ...... ...\...#* \\.  .. ...\.....#*. ..*.. ... #..... .#.. .* .  ..\**...      .. *.*.*. #*. ...*.. ##. .* . .#\  . .. ....*#
#*.*..... #*..* .....\*.... .*...\.*.#.  .....#*\\. #. .. .....\....  ..... .*. * . ....*. .. ....* .*...* .... # . ...\.. .....*..  ..   ... ...... #
#\... ....  ..*.... *#.  .*#.#\..... \ .#. #........\ .\.. ....... ..* .*...***......#..*#. ##..*.\... . .....#..##. \** .  .. ....... . ....#.... \ #
#..* .#* \.. .  . *. \.* #.....\*. ....# .#*. ...#.* .... ..\#\..... .#.. **....   \.#....#. *..##*.##... .\ . ....   . ...##.  ......*#....*.. .. # #
#..##.. ... *.....*..\...#*  . .#.. *  ..*.#..#.*. .....*. ... #..... *..#*##..** \*  *.#....# ...#### **.*.#  .##....  .#. .  ...... *.  #.\# * . *##
#\..*.# *#.**..*.*.. .*#.# .. ....#.. .  . #*\#*#\. #.#.* *\#..... ....#.   .......*..*.*.* ..#...#....#.#** ...  ..#. # . \..  .. #### *\..\#.**#. .#
#.......*\**.\.#....*........## #\*    #.. ...*.. *  ....*.##*..#*#***.\* #  ... .....#*.*.*  .. *. #....*\  * . ..... .. .. * *.. ... *.\...#*. . ###
#... .*..*...\*#  .... .... .. ..#*#....\..*.#...*. *.#..#*..##..\.. ..... ...#... . .#. \.*    **..\.. ....* *.\. .*..... #... \ .# #*.. ..  #  # .\#
##.#*# .# .#...... . ..#..\\.. ..\### ....#.#.#... .* .\...#*...  ##*.#*.*. ..\..#.* ....*..* .*.*.#.  #*... ..#..##............ .. ... ..#....... ..#
#.**....\ ......##..*\...... . ..... #.* .. #..\  .#........... ##\ ...\* . .. . #....\..   .*  #.. .. ..#..##... .##.*. .#**. ** #.... \ .\ .\ . .  #
#.. #.*\. ... \#...... #.#.\. . .###*\ .....  .* . ... * . *..**.  *.#. ...#*##.\#\..\.*.*. .**......#.. \.*..*..#... ..*# .*#.. *  .. ....#.* .* * *#
#*...\ .. .... ***.*#... *.*.....#*.  .....#.#*..*..#\.*..#... .*...*.#\ ......**.  .. .*..*... # . .#....##  .. ..#*.. ..### *..#.# * .. *#........ #
#*... \....*....\*..## #*...... .... #..  #.#. ....# ..\..\... .#.*\.   .\ ....\.. ..***.#.*...*........ ......*\ #.#**...  #.. ..#..#*. . .....*. .*#
#.\*.#*...*... ..... \#  #....\.. .. *    .. * #...  .#.#...\*.    .. . .\.#...#..\. . .  .  . .# .#. .#. #* #...# .#..... .  ...# ..*. .*. . . .  # #
#..*# . . ..#.. .....*.   * ....#...#** .*.....* ##...#... ..*....  \.....\. ..\...##.. . .....#..\ ...... .*..\...... . .*.....*.*..#.  .# ...*.#...#
#.. *..... .  # ..  \#.\.. . ......... ..#...*.. \\... *#.#....*\ .# ...... #..*. #.......*#... ......*.... ..*.... .\..*...... ...# # ..#. .*# .*\..#
#**#..##*  #. #..##. ****  .\ ......#  .   *.#....#* #.\. ##\.\..#.....  . .  *.. *.\....  . *..#\#.  \..\. *. \.   #..*#.#.# \##*. #.... .  ..#...\##
#  . . *\. #. ... .. . .....*.\...\....*.##... .*#..#........* ...#.*....\\.#.....* *#.......*. ..... .\..# .... #\ ...*.... .*#. .\. ...#...  ..\ . #
#  ....... .. ...#....*.. .... *....*.. # ...\.#.#.. *\ ..... ..* .  *. ......#...##.#...*.*. .\.#... .##*.###.*.. . .#...  .   .  ...\#.**.\ ..*..* #
#....   .....   \ .*.\# ..........*..\.. ..   . *..*\ \#. ........*. . ...*.*..*...  ... .. .*\.# .*. ...... .#...\.\... .\...\*. ..*.*. .  .... #..\#
##.... .  ... \#  ...*....#.#. ..**# ..\... .*## . ....... \ .#.*......* *... ..  #....*.* . .. *...\.. #... .#.*.  #..  ...* ..#  **.****#*. . .*. .#
# *...... . .*..**..#. # ..\ .\\...* ....*.*.. \#... ...#... \ . .... ..# ...*....\ # ... ...  . ...\ .* \\..# . ..... . .. .. \ *.  #.#..#. ....# ..#
#... *.#..# ##..  .  .....#... #.#..\ #. .# .  #. .*..*.  .*.#... *.**  *.# .# *....#\.*.#.#...... #..... ##* .#* ..*.\ . .*.. #  .* # .#. .\ .*..\\.#
#\....* # . \ * * #......#....# . ...... .#.*......... .*.#*.\..*..\#  .. . .....#.#..#*#.*.  \\*.\#...#.*..# .\*.*...\.#... *...*.. ..........* **  #
#..*.. * * ..#.. .#*\#.#.#.*.....** #. .. ..\... #*...*.....* \*. *..  ...#..#\ ......  *..*..*. * **......#\... ......... \   . .. # ..*.... *.*....#
#\##...\..#  *.......*...#.. ...# *#*. ..*..\...*#. ....\ ...* ..**....*....*..# .#. *. ... .#....*.#.\ \*.#..*     . . ..... .... \....    # #\ ....#
##..\.# . .. .\*.....\. .. .. . .... ..*\.  ... .#*.. .. ..#  .....#.. *  **#..  ..   .. ..*..........# #..  .........*..\ # ...**..\.**...#.   #....#
#.#...#. #.#. .....#..*...... * #.*.#. .. .\ .* .##*#.*..\.* ... .#....#......\...*# ..#*  *#..#.... .*#.\#.\.......* ..\.**....... \.#*\ .\\*.... ..#
#....  #.*  # ..\#.#.. .* ..   .. .....*. .#..*....*. *. \. .#.... .#. .*..#.\..\... *..*.##.. #**...  ..  .*... .*.#...* ......*..\ ...   *.*.\.... #
#......\.....*# .. ...  ..*...*#.....*.  \.*\....*... #. .## #* *......*...#....*.......*.....## . . * ....## . ##... #.#.# .*...\..*#.\* *.*.    .. #
#    .....# #\...*#. ...  . .... . #..\R**.. .#...#*..#.*. . .. . #.\ ...*.. #\. *........ \ .#.\..... .... .*.......*..*.....  .#. .#.*...... .#..###
#... .. \. *..##.\. ..* \*... \ \*\..\**. *....*\**... .\.*..#. .* \ ...... ..#  ....*.# .   ..*#.*..**....# #.* ..\# *##..\.. ...... #.  *#. ..# .#*#
#. ..#..* .  . .\#. .*...*. . .#......*#  #...#...*...*.. *..#.#* .## .\  ..#. \..... . . .*\  ....#..  .#.... \...* . .    .  ...........\#.*.\ ..*.#
#. *...*..*.#. .*.. ...*. . *.....  .\.* .*..  ..#  .   **#\..#*. .. *......#...#..#\..*..# . *... * . ..*..... .\#.   . .#  \\.. * .\......#.... .*.#
#....  ..*... .... ...........\ ....*#... ..... .....  .#.**......**.. ..#.*    #* ... # ... ...#...\ ..*.*.*.#.#..\.#..\...... *. . .\.... ..*... *##
# ......#.\...\  ....* #..#.#..#....* #. .. *#  . #   \ ..**.\#*\. . .. ... .*#..#..**\.........* . . ...\...*.. *.. ##..*\.*... ..\ .# .*.......   \#
#.*#.. . .... *#.... ..  #.# .* *...# * .... *...#.#...##  #...#...*.\... #.# ..*.. . \. . \...... ...#.\.\. .*..#.##....#*#  ...*... ....\ . .  ....#
#\..*##.\\.  \.. ..# ..*   .*. *#....#..*. ...*. #. ...\  ..*#*. .   .....\..#......... .   ..##... .. .*... # * .#..#  ..#\.#....\........ \ ..\....#
#...*..  #. #... .#...#.  #.. . .*...   ..*.. ##.*...\..*#.# .*#. ##.\ . ...*. #\ .. . . \....*......*#.. .....##\... .....#..  ....#* ... .  ..  ..##
#*.##.*. ##*# .. . * . ...*...# ..##....\*#*. .\. ....... .... . . ... ... .. *. . ..#*.#.#....*..*...  .* .. .. *.*....*#...**....\ . \..#  *.  .  .#
#......#.*...#.\#..\#\*  **.*..*#*..... .... .#...*....\#....* *\#  #.# ..*.#  ..* #*. *...#.. #* *....... ........*. ..* .. .. #..******..*\ .......#
#...   ..#... *..* .# .. .*.*.*. .. .**. ....*.\..\ ** . ..#*. ....#.. #. \... .. .  .## #...... . *.*..*..#.....*\ ....  ... . ..*... ...*.\# ......#
#.. ..# ....  . *.  #.  \. .# .\ .....   .. **. .##*...  .. #  ...*.... ..# #*# ......#.\..#...# **#...*##.\....\.. \..*  *.*. * * . .\ .   ..*.# #.\#
#..... ...# . .# . \#\\#  . ##*.#...** . #...  ..*...*..*#......* .* ...*... ......  .*.....*#.#...* #..# . .*....#*....\....#..... . .*...*.....\. .#
#.*.. ......\  #.**.  . ..\..*.#..# ..#*.*\**.  .. ..#*. ... # .. #.... .\.* ..#.. \#. ##*\##.#*. . . . ...\.. .. \*....  #..**\..* . .....  #\*.#..\#
#......* #..*.#. *..*. #.*.\..\..... .#.# ..# .\*\.\. .  . . ......   . .. . ......... .........#... **...   .....\..\*.# #..*.# .......*.  #*..#...*#
#. .. .#  ....#*.... .*.\ \... *.*\..#. .#.* .....* .\*.#.\.\ ..  .*##*..*...*\.. .\*........ . .##   ..\. ...#*.... ...\.  ..#...*#\. ....*...#  ####
#*.*.*.*#....*  ....\  ..* .#....  #*...#. ....*.\. .*....**#*...#.. .....*......*.  . #*  . . ....\ ..#... .*   .... *........ . . ... *. ..... *..*#
#. #.   ...#.\ ###..  .**.....**#...#.# .......* *..   #*...*..#*..#. .  *.......#..   ..*... *.. . .. \..#...*.#..*..\.  ** *#\...#. #.  .#. .* . *##
#\\\...* \.*#.......\. #..\...\. **.......##.# .. ...*#...#. ..*..  * #... ...#.... . .#.##.    * .. . ..*. *  ........... .. . ......... #...  .... #
#\*.*.. .\.#..*.#  ....#.#.#...#.....*.\*..#..*..#  .. . * ...#.. .* .#...... *. .#......# #....\..  .*...  .. ..*\... ..#**.......*.# *\... ..... \.#
#...*...... ....\.... \..# *..\ .\  ...**.  \....#.#.. *.\\* # ... #.#..*......\.  .## ....... ..**.\.... \. .\\#*.*.\.....\...# # ##.#..*..* .   ..\#
# ... ..*... ..\.. .\#. .  .. . \#.. .\... # ....\..*... .*.# .. .*#..*.#..  ..*\.#..#.*. .... \..\  ...\\.#.# ....#\.#\.#.*....*...*#  ...\\.*#.  ..#
##...#.#* .*.*.*#... *.#*.## ..\..  .*... . \.\..... #.**... .*\  #*....... . *#*...*  ... . ... \\..\ \. ..   ...... . #.#\..*\..   #.. * ... ....#.#
#...\.##...   ... *##. .*... ...*...#.*.**.. ..#.. ..#*..... .#..*...... . .##. *... .#.  ...  #.. ..##. ....... .. #.#* \....  .. * #....#\*...*. . #
#. .#..##. ..#.......#\#.# .* .. ..\\ ........#*...... .. .   #.. .  **\...* ..**.....#.\ #...\#   ..*.*.\#... ..\*.*#.#.    .##*. ...# #....  .*. ..#
#  . # *.*  . ..#.*...... #\..* . *.# .# . ..#..# \..# . ..#\ \.#. . ##. . . ...*..**..\............ .# ....*.....*. ..\#..  . *. ....* .# ....\..#. #
#...  ....*...##\. #.   ... .*...##. ..#........\#.\.... \. ..... #  *..... .#.*\  #...... ... ..  .*. .......#*..... ....# ..#*.#*. .# ......**.... #
#\\..  ...#......\.#. *. # .* *.** ..... #....*.#..\.    * . .#.#*\....  .. ..** . . ..   .*...#*.....  .\ ...\..#\ . #.. #.#.. # .*.# . ..... .. .. #
#*. .....*... ..# .. .. . # #  .*##.\.  #.... ..*\#......... ..... * ...   *#.......#.#* . .....#...*# . *.   #*\.\.. ..... ..... .. \.#* \....\#. *.#
# .#.#....\..#....... ..\...... \ ... *. ... ..#.  .*.\.\. . ##.#.*.#..# .. .....\. ... ..*....  ..*...... .* ...#. .*.* .#  #\.\... .##*..*.. ...*#\#
#\. \....#...  ..*..#. ......#\..#.*...#  #.*... # #. .... .*..#.*. . ....****  ..\..# #.\. .. . # #... # .#..*...\.#. .\. *.\....\... #. .......*#*.#
#.....#... ...*.\.*\  *\. . #.\...\.. # #*\#...#.  ...#. #.#.  . ..#*.#....... .. *...  . ...### .\# ..#.. \..*.*.... ** * \.. ... ..\.# ..... *.#. ##
#..**......*.# . .#  ** ... ..#. .\. ..  \ . .*.#  #.......#..*.  \. ......*...**#...#..* ..#.  . ..#.  .*.#.\ .  .. .#.  #........* *.#..#* \..#*...#
#.. ..# # *...  .#. #...*....\.*..... .*.....  #*. #*.\\......#..#...\..*....\...*#.. .#*...##...  .# * *.*..#..# ....*..\....*.*#............. .... #
# ...\##.....\  . . #... #. .\. *   .#.#..# ..#* ..#**.#......  ........... *..\.# \ ..  ..* .*.  # ... \ ... #.\. #.. *.# . ..*.. **..  . .......#. #
#.. ... ..*....* . **\. .*#. .#.......# ....... ... *  *.* . #..#.. #. .*#..*...\.*# .##......* .*.#..... ...*.*.... .*.\#\.. * * .*.**...# * ....#..#
#. ......\ .....  ....#..#.#.. . .. .. ........ .... . ##.\. .  ..... \.....*.    ..#  #... \. . .. *##........ .. *..#  ..#.\. . #....*.. *#\* #...*#
#.. ..\*..#.*#.#. ..#.. #. . .#........*.#  ......# .*  *.* ....*. *..#.. .* . .. . .\. .#...*.. ..  ..  .\..# .* #**. .  ....\. *....*..*..\..\...#.#
# ..**.#*   ..  ...  #\#. .#.    .. .# .*. .#...#...*... \ . *..*..  .... ..* ....#....*##  ..*..* .*..### # .....#.....* . #....#.\.* ..#.## .. .*#.#
#.*..# #\  .*#*.....  .. ..\....  . .*.\........ #. #. # . .*.#\.. ....  ...#... .  ....*#........#..* . .......#* ....\ . .*....... ... *... .....###
#*#...*.#.... *.*... ...*#.\ .. .#\  ..* ..*..  ..#...# * .. . * .*...\...... .  .##....*.#*##\ .*...*..*. #*# #.#. #......# .*...# .....*.....\.... #
# ..*.\.# .*#..... .*# ...#.   **... \*\........*.. \ #*.\ # . ... .\  ..*  ..# .*. *.. .\. ......... \.. ... #  .....\ *# \.   .... *..... .\.. . ..#
#.\#\.. \.#.* .#*..##  .#..*.   .#.#. ..... #.. . ... #...  . ..*.**#.*. . .#...\*......#..#.**..#...*.. .** *# .#.   * *. #....*.. .. . . .*...... .#
#.*.....\#..... ..*  # *.*. .  \ ... . ...*.*.*......##..... .\#......*#. .. ..# ..*.  \.. ..  *.. **  ..\..*.*.. . *\.*\.*..*#....\*.. *.. . ..  **##
#.......\#..#.. . .... \#\. .* #. ... ##..\....   ...    . .  # ..\# .**. **. ...# ...\.... ..*.... ....#..*...  ..\.... ..........\.*\..\.#..*. ... #
#... . **#.  . ..#.*.#* \#...\\..*. .#.\.#..# .# ..*.\ ..\..* **.\.\..##.*#..*.*#... ....*....*..... ..... \.. ..#.....\.*...\ *\*.*...... .*#.##.  .#
#. #. .....**......  ..#.#.*.\ \....#..* ..** ... ##*.\.. *   .... ..* \..#...*#.\..# ...#..* ##..# .#\. ... .#....*.#  *.. .*...\ **\#....#. .  #\#.#
##. ....#...#. ...#...... .*.*.*# ... ..\# .....   ..#.* *....*.*...**.. . ......\.. \...#...*. ...*.  .\.. .  \.#* ..\.#*.  .  . *.**.  .\ . .. .\\.#
#\.\###  .***#* .......# .  .##*.... ... #..#*... . ....* #  \\..\ ...* .##..#. .... . .#\...* ........*....*.. ....*.#.#.\ .....##.# \  .. .\# ...#*#
# . .#.. .\. #.#*.*.**  .\.. .. .   .  ......  .*\.....**..#. # .* . .... .\## . \..#......\*....*.. ... *..\..# ... . .... .#............*..\.\ ..  #
#...\. .....\.... # ..... \.*... ....#....*. #.#..#  #...#\.\...* ......#* . .#. ...*..#.. ..  *.. \ ...#...#.*..*.....#. .*.#....#.#..#.\#\ .*..#.. #
#. ...*#.*.\#* ...... .. .# . ............. .#*#...#...#  ..# . *#*..  .*.# ....#..#.\.. ........ ..*.#...\\.. .#*. .. # * .#..*#..  . *.  .\  .*...*L
#..* . ......#....##..#..... . .#....#.*# .. .*#...#*.#......*. .. .. .*.. .\. #..\ * .*  ...\\*... .\*...#..#.. #..*   .#* .. *.*\ ...#....*.\ # .#*#
# ..  #* *. ..#.*.*# .#...# ...#. *  ..\ . \#*...  . .# .. #.* ..  .. ..\.\...  .  . \.#... #..*....\*.   .. ..   \. .\\ . .   *.  ...#..##.#. ..#.  #
# .. .* * ... ....\.#.  * .\.. . . .....  . .**...#. #*. ..... ...#. .#....#  .*\... .**..*  ..#....#..\.....\...\#...#..... ... .. ....#....## ..#..#
#..... . * #.. ..#. ... * **\.*\\....*      #*... ....#..*. ....*........ ..\..**..*\#....#..#..*. ......*#.\\......... \*... ....#*.#.. *........*. #
#\..   .#..#..#..*..*...*...#.#... *#..# ..... .  .. \....... . .*.\. .. ...*..#.... ... #... #.. ....#... . .... ...   .#. .\.*\.#...*.  . . .......#
#.#..#.##.... ..#\.#.....#   ...#..*.. * ... . .....#..**.#\..#....#*#.. ......*\.  \.. *\.. ..  * ....#.  ..\. ..#...#.\##.*........ #.  .#  .*#.  ##
#.##   .  .. . .\# #........ .. \ . .#.. .. ....*. *. ...*..\* ..\.. .#\...  .  *...\.   .\#...*.# . .\#..*..   ....*....... #. ..  .*#*.\ . ...# ...#
#.\..#.. #*....*.##  ..#..# \..#*..  .*..*.#. ....*..**......# #*#\\... .# ..  .#....# ...#......*. .. ... .*.\ .*##.*..*. .*.#* # ####*  ...#.... ..#
# ... . .#.....  ..##*...\...#.\ ..**. #. ......\   ... ....*.... .#.... ** .\.\  . ....#*... *\...#.# .#..  ....#....#..#.  . . ...#. .*.#.. ...#...#
#. * .\ .*.... .. ... ...*...#.** \ ... .\##.# #.**.. ...* ..  \\.*#**.# #..*.. .* \..*...*  . . . \.... ........#.. .#...* .  ... ..*. ..#  # .*.. .#
#. .....\. .   ... *.*..#. #.....#. .*...... **...\.. . *..... . #. .**.  . . *#.... #*.. *. .##.*.... ...*.#....  # ...#.\ #.#  .#.#..\ #.# ......**#
#* .*..* ......*#..*.....\ .*. \ #...#...*..**.*.  .. .\.. ...*.. ..*. #.*  . ....* #.#.....**...*. .  . .*   ...*. ....#\#   #.* .. . ..#..*....*#..#
# * . ..#.. .\ . *... ..*.. * ..  ..#.**..... ..  *.. #.#...*.*.. .**. *...* .....*..*.***.. ..*. ....\\.. ...*#..*. . .#. .. .... #.. ..... .# .\#..#
#. .....# ..... .**.. .... *...\*.# *..*.  ..#*.....#... .. ..## . ......#\*.. *#...... . .... *# *..#......##.#..\..... ...\.\....#..  .#.......# *.#
# ...*.#*..#\ . \ ......\.# .....*.. ..\*\ .*...#...\. .. .. ..#.#.#..   . ....# ......* .#.  ....*\\. ##.  #*##...#.#.\ . #.\ ##* ...*.* ...*.# ... #
#*.  ........  ...* .# ...*.#.#..*.  ...#.....#..#....\\.. **  ......* #*..  .....\.* ....... ....#*.......#... .....#.#...#.*... . #..#  ..##..... .#
##. *\*...*.\.##......\ . #...*\..#.*...\...#..#.....* ..* .. *  .*.\...*.... .... ...* . *. ..... ..*#.... ..  ....*#*..... ..   \. ##. *.\.# *. .#\#
# . #  *\... ..\......#\#.#...# . .*....# .......#...\#.*. . ..\.  .* .. \ .*##...\ #.* \..... \#..\*.....\.\#* *...... ..*.*.# #..# \.#.#..#.#\...*.#
#...#.\.\  .**.. ......* . .. \  *.. ..#...* .#. \......#. . ..   ..#...*. ... .... . #.*.#... ..*\....# .     # * # . .. * . .*..*#.*.*..#.#...\ ...#
#. .. ... .\\.* .*... ...   * #  \.#. .#.. ..#..#.#.\...#.## .#* ..**..#.........  .  .*\...\ .  \...\ . .....# ........*\.* *\..*.. ..* .. *# *... .#
#......*.#..#.#..*#..*\ ....*.. *.\....#..#....*...*   *.\  . ..#.....*#........  .\..* #...#. ..*#*.#..# *. . .#.###..#  ..   #*. .. #. .. ..*... . #
##...\....  * .* ..##.... *#..*  #. .... .. # * ..  ....#.\  #..... .#. ..... .... *#... .#.  . ##*.   #. .. *.#. .... ** ...#.# .##...* #..   . .*\.#
#.\. . ........##...\..\.*. \ . .........##...*##\. **... ...\\.......... ...#*....#\* .*...*.\.#.. .*#\ . # .#\.  \*.. * ....... .  *. *......  ..#.#
#.\.\\......*.####*#... . #... ..#.*...**.... ..*..**   ...#.*..\.*.*... .*. .*#\ ..\. \\.  . .......  *... .. .  ...\ . #*. ..... .. \. *.. .. *# .##
#.\*. ..\..**.... . .\... . . #... ..*#....* .#.*#.\.#. #.\\.*. .....\..\ ....\.... . \*... ..*.. .## ..*\.*\. # ..... ....\.\.*. * .\.*..* .#.. \#..#
#*.....*# .*... ...  \ #.# #. . ..... .  ....#..#**. .. *#.  *  ..*.#. *..*... *.*  .. ................#\. \#.....*..  .....   .....*.....\*#. ......#
#. .......\...\ ....*#. .... #.   #.#   ..\...  . ..*.\ *#.*..##..... ...#... *## #. *...*.. #.* .....#.*.... ...\.....*.... .  #   .. .\..#*...*....#
# ... ..#. ...\....##.*..\..#...*#. ... .... \#.   ..\ .*....... ..\ *...#   ..*... .#. #.#.  .*..  #..*.. .. .*..   #  *....##*....#\#.#* .* ..# \ *#
#....#..   . #...#..**\. ..*....*.. ..\.   *  . .*  ....* ..\. ##..... *......##. .#..\ ..#\.#**.... \#.......... *#... \*... .# ......# ..*.#\.  .. #
#..**.#.  ...*. . ....\*\.....#\..... # ##..   ... .\ * *.   .*......*#\##.#....*.*..... .\. ...\..  * ...*... ...#* ...\.  . ..... ..**.\..  ....#*.#
#..\..... #..  # .#.**....*..*.\*..*..........*\..#  #\..*#.*\..#... \.  .*..#. #.. .  . . ...*...  ..#. ...# ........\...\...#. .* . #..\#. #.......#
#.  #...  ....#.*...  .#\...# ...*.......#*.... **... ... #...# . ..*. .*.... *. . \* \#.*...\....   .## ..#. #.#.*..*. ....#.    . ...\.#...*.\#.# .#
#.*.*......# ....#* ...  ..* .\\....# .*\.*..  .  ....* ..**. ..# .    .\... .. #.#**... \.. . \.#... .*. ....#  .*\#**# .*.\*..\.. .*. #...*.# .* #.#
#. . .#\  . ....  \## ... .......*...#.\.... .. *..... ##..........*.#...*\#*.. . ...... **.. ..# ..#*......... .... .# *....*...  .. *.#...#....... #
#.. . .. ..*.##... .  ...... ..#...\.. ...* #.... .#.. ..*. .. #....#\..*#.... ##.... .* .\..#\#  .....# ..*  .\. .   .. #*.\..... ..*. ... \. .. ...#
#..##.... ... #. .....\... .#.  ..... .\.# #.....  #.... .##*##..#.#. .#. *..#\  .  .. .##*..\** .\ **.#..*.\. .*.# *.*... ..\....**.**.**#*....*. ..#
#...... # .*.\.#  .. ...#\\.\...\. *..# ...  .... *  .#.....#.*.... .*.##..#.#.....* ..*.....# . *.....\..*. ## .... . *\...#\. #.....#..###.*... .*.#
#  ..\..#.. # **.... #\.  \.*\.\... ... .......#*.. ..... .. ..#**.\**.#. .... . ...*..* . ..*\.*. . ..*\#...* .##. #.  ... .. ##....*.#..... .\..* .#
#...*  #..... .\ #... . **....* . ........*.##... ....* .\.#.  . . .. ..*.  # ...\#* *..#*......##.. ... #... * .  . .....***... *.. \. ... .......\ #
#..\.###.#.....#..*#... .*..\..#.# ...* .\..# .\\..*.*  ..*...#.  ....#....\#*.# .#.. # .#.#..#..#......#*.\*\.*. ..\. .. .#...#**. *#  . .... .#* # #
#....#.. . ..*.#. .*...*..*# .. *  #. .... . #\. *  *.\* . ..\.\ .#*#..*.#\ ...#***..*..\ ... .... *.. * *. ..*. #*#. ........#.. . ...  ..#*# .#.# .#
# #*..\.# \..*.. \.*...*.\. .... ...#**.....#.#.....##\. .. ..## .... #\#...\. .... \..\..*# #.*  \.. .*....\ ... .  #......#. ..#..  . ... *\* #  *.#
# .* *.#*\\ . .#..\..... ..#  \  * # .. \#. ....#*.*..... .. .#. *. *...##\...\..*..#....#.  *#  ..\. *....*.#...*............*#.. .**..*... .# # \..#
#. .*.  .... . .*\ *# .**.*.#*....*# ....\. .. . .*  ... ..  .  \..#. ...  *.\.. . ...***.#  ....**  . #..#.....\... * .* ...... .. # ..*...... ..*  #
##..... # #..#..... ...#*.. . * ..#.....  \.....\..*.#.* *... *..*.  .......#...#  . ... ## . ..#..\\ .. .#  #....*#  *..... .....*...  .. ....#.. .##
#.... . **..  #.. #. . ..... .**.*  .   ...#. .*. *.. .. #*#.....#.#*..#  \.  # .#.  .* ..  #*# .*........ \ #  # \ .... ...#  #.\......\ # # .#.*#..#
#...##.\ .. . **..# .. ... .#*..\ . .*  #........ ..\..# ..*# ..*..#**..\... .**.#  .* ...*.. #.....  ...... ........ #.... ... . ......*.. ....\#...#
#...***......#*.*.*..#....#\.....*..* ..#*.\## . *#** *.\.... .#  .\ .. #  .*.*#*.#. ..... #....*..#..*..... ....... *....#*\ .. #..#*.*.## ...#..####
# .#....*\ #..*. ... .\  ....*#.. .. .#\.. #\...... ...**....**.\.*.....##....#.   .*. ..*.... ..*\ ..* . . .......#..*.\ **.*.. .*. .    *...#  ..  #
#....#. *# ... . .#..*........*...* #..#*. .. ....#\ *  .# .. ....\*..\.\.... #. *\  . .*...# . \\...*....*. . .**  ... .*.. #.....**.. ...... #..#. #
#*#.. ..  *...\ .## ....*.....*..*.. ...#\*... *. ... .....# ##.#.#\.\...#. .* . ... .*.. . *. ......#.....#.......... .\  \........#. ...\.*.. ##.*.#
##....\.*..... ..... *.. ..\.. .\ * .......*..*.  **....#*. ....  #.*. ... . ......... \. .... .... ...#.... ... \*.* *..*# ..  #*.\..##...  ... . . #
#*.**.\.#.. .... . #\\..##.# *... .#.. . . .*.*. # *\ .. ##. ##. *     ..\...#. ..##*.*# * ###......* *  . *.. .... ... ..*#... . #... \....\........#
# . ..* .\* ... ....#.. . .. . ..*.*.. * .\# .#..#.**.\..... * .* .* #.#.#. . #  . ...\.......**#... ....#*..* \ .. *....#. .....*..*...#..**.*. ..*.#
# *.*. .#.#.. ..*.* .. . .*.#  ....... . \...#\*...#..... ..\..#*##..  ... . . *#.......... \.##.. .  ......  .#...  . ... .. #.\...*.* *.#*  # #.*..#
######################################################################################################################################################