###############################################################################################################################################L######
#. .#..   ... .#. ...  #..  .#.....\ ..*..#*#..    .#..*..... # . . **.....# ..**....##... #.....#.**\...\....#... .#*. .. ..##* .*.......**.. *#.. ##
#..  *. **....*. .  .\#.\*\....##\\.*#... .\#...*....  .... #..*..# .......\..  . ...*... ..# .......\ .. .... ..#..*  #.\.#*##.##*.  ....*.\..#..#.##
# *... #.\.* ..#*  ..**.#. ...... ....... .#...##...... *.*.#*.. .\\... ..##.***.#  \..* ..... ..#...\.*......*. . . .\ .   . #. .. ...##...# ..*#. \#
# .. #.*.....\ .. \ ....... \.#..  ........##....#*...\............*..  . .....# \......\#..* . *... **#.#.\\. *..#.. * #  .. .** *.# #..  ..**....#*#
#\#....#....*. #*# ...... * ..*..*#..#*#....* . ..... ....#.#.#  .. **...*...*#.*.  ....* #. .. .*. ..*# ..  #...  .*.##.... *.\ .....*. .....#..  ..#
#. ...*.. ......   #..\. ..\ #....  *\..**...#*.# .*. \#.\ ...***..#.\\ .* .. *.  .*... .. .....*. . #. ..*.# .#.. .... ...* ... *...\#.. .*..#... . #
#.... .#*. #......\.. *#.... .. ...#\.#..\#..#. ... .*# ... ..*..\.#...#. .# *.... .*..* * .*#... .*...#.. *\...  # .\.. .*..\...\. .\...\.. .. .. ..#
# \#.*..*.....\.. ..  . .# \*.#...*.#.... . ..# \.... *..*.... #.#.*..#... # #..  ..*.#\* * .* ..* ....... .\ .\........*.. **#...... *..#......\..*.#
#\ *.#..\..*.*  ...#.* \**.###.  ...\## *\ ..... .....#*.  ..\..#*........ ..#..  ... .*. .**.......*. ... . ...* ..\....* *..## .*. *..\. .##....*.*#
#.  . ..*#. .## ...\* . *..*\\..*...*.#* ....*** \*.   .* ... #.. . #. .. ..##..\......\.##....#   .\ ...*.... ... . . . #..... *#\*#*. ..*. *...#.#.#
#.* #..........#.#..#.....*... . ... . .*.*..  .... .*...*  ...*......#...... ..... .... ....... #.# .... ...  ...*#.. ....*.. ..*.#..*...*....\.#*\ #
#.  ..... \.\    ... .. #\*..#.. .....  ...#\###* .\    . ..*....*#.. *...#\. \. ....\..\ .# #.. ...*...* * *\.. #..\  . *...\ .* ....... \\.* . .#..#
#   .....  .#.... #..\. ..# .*.. ....*#....\.. #......*  ..  .#.*.....#..# .*... .**.... ...#...... ... *. #.##......##* #.....*  #. ....\... ... \. #
#   #. .*.#\.#.\.  .#*.... ..... ..  ..# ..   .\..#...... * . **.. .....#.*..# .  \ .#.......\#.*\.*... ##..* ..#..#  ....\ .\. #....  #\.. * ... . .#
#.* .*. ... . .#.....*.*.\*. * .*#..\*.#  ..  * .  . #.# *.*.. ##**.. ..... #.. .... # . *#..#......#.\.. .#. . .*....#.#* . .#.*... .. ... ... #..#.#
#.. *.... . ..\ ....#.  . \# .*.#..*#\#.#....##  #..   *\. ..*** .. .#.\  .. .  ....#.# ..\.*....*. ##. *.....**..... ..*.  .. #...#....... .  ..**..#
# ..  *....\.. . *  .*. .##*##......*...#*#..\.*. .\.....# ... ...###.#..\.. . ... . .. ...  ..#... . ...#..*#....     #  .#.**\.... .#\# . .. *.... #
##  ...*#................*#.......*#*...* ...## *...  ##.*. ...*##. ..\ .* ..#.. ... ...#\. ...   .*..  \ ...#...... . .... # #*. *.# # \# ......... #
#.#*... .*.\..# \ ... .*\*.....\ \..... . * .  . .*....  .......\ .#.....\*.**\....... ..  .....  ..*..#.....#.........*.#.*... #* ... #.. *.  #...#.#
#. .....#\. .#..  .. #. ..#....*. #. #....  * .#...*\..... ###\...\\...#...#... .#\\\.\*\.#  .... ..#...#* .. .  #\..*......#*.#..#.#..# ....#..#*...#
##.... . .**#. ...  .. #*...**.\ \\\. .*  .*.....\#..\....*#....... *...*. .....# .. .. . ....## .* *.*#. .# .*. *.*#...*#\*. .......# . ..#..  . *#*#
#*... ..* *\.*..# \...#.....\. ..\\ .. #..*..\..*.....#.#. ..*. \ .. #...........\.#...  .....*.. . .. . .#. ..#.. .#* \.....  .....\#   ...#. .. .#*#
#*..#* ..  #*# \.\..  ... . \. ..# .##... ..#. ... ...#\ . ...* \.#...* .....*... ..#..  .. *. . *\ .*.. .##.*....*. .* # .* \... .*.\# \.... .**#.#.#
#   \ *.. \.###.\...#. . #.. ......#.. #..#. #  . .#..\. *  .*##*.#....#.#..* ..*..*#..## . .*. . .*. #..#...  ... * # .....#..#. ...  ......#\*.# ..#
##.#... . .# ..\* .... .#  . .........# #. .##.. .*. *.*..#* . ..#.**.  .\.....\... ...** .  ...#*.. \ ...\*##.... .#.. . ..... .#...*...*  . .*.# .\#
#  . .....  .*. . .. \#\ ...#*... ..* .* .*..# . ...*......#...#.#..#........ *. #. . . .*.\*#. .#\\.  #.  .#....  ..## .#. *\     *.......... ...*..#
#..* #*.... *...* ... . \..\..#.#.*..#..\ .#\..*..# .# .*.#.......##. . .. .#..*. ..   .....*.......*... *. .# #.*.\ ..# .... \. .\.*.*#  ....\......#
#..#.#\  #...* .....**. ......#*#.#... ..... ..#... ...*..  . .*   ... * . ..##....... ...** ....*.*...**..... #\. #.#.#. .  ...\...# ...## ..#..  ..#
#... .*.*#... .#........... ....*#...#.\... .. . . *....# \\....\ .**....*.#... .......\.  ..#.\..#.. .. *..  *. *. #.....  ...\.\.... . .   * **..* #
#..    .........#*  ... .*... ..*#. .#*.\.  .... .*...\##...\.*..\. .*..*#.#.. .*.# #..*. #.* \.. .## . #* \...*\  .* ...\..#\**. # ..#.*.... .# ....#
#.....*#.. *....#*..* .#.# .#.#...\...#...#... #. #. .. #...*....#.\\. \..* *.. .#.#*.#.. ...#.  ..........#.#.#..#.......... *.***. .#. #. *....*. .#
#. \...\. ...* ..****\..# .  *.\.. #. ... ..........#*.  .*.*.....\.*\*.....\.\.*...*.*   ..\...*...*#* .. ....... # ..*#. \. ..#..\.*# .#.## #.  **##
#....#..   ..#*..#..*. ....*  #..\....\# ...\. .. ***.... ...\*......... * ... #.. .... . ...*.\\.... . ..#.\ ##.\......*..... ... *.*\. .\*.#*. .\..#
#.\*..  .  .\ *.#. .*  .....  .\..   .#...*\\ ##...........#**# #..** *..*. ....#..# .. ..\.#.... \...*.*..  ..\.*. \....\**. #..  # .....# **.*..#.##
#.#....#.........*..#.*.#....#..\\..  . #.** #.*....*.  ...#*.. #.. .*..  **** \.... ..  ....*...*. * *.**.* *  \..\#.\*   .#..*...**...*.#. .#*\...##
#..\. .  . ...*...\ ...  . #. ..* \  \.. *...*#  . ...*\#..# ....# .... ... \.  ..#..#. * .#.*.... .*  \ . ..*.#\..##..# #.   #....\...#*.   .* .....#
#*.#*...#.....*.\.#.... . *#..*..#... ..\\ . ..*...*......*......#**\#..*. ...#. ....*. .#... ..#. *..#. .##.*....#*. .#.#. *.#.  \.*. .\.......... .#
#.\.. ... .#........*\.*.. .*.#\   ##. #\*. .* \.#.##....#.#.#.. .#\*.#.  ...\#..# *.*. . \*...*...#..\. .\#.. #.#. .  *..\.....##  .#....  ....*....#
#..\ \ .###...# .#....*...##..**...#*.... .... . .. \.*. ...*#.\.. . .  ..# ..  .....\.. *.#.#. *...#.*. \.*\. .#*.*  ...#. .\. \**...........*\... .#
# .#....#.*......... ...... . .#... ..\*.. ....   . *. .#..\......** .  \.#.. . #.*...*\ . .#*.  #.. ..\ ..    *.*....# ##... \#**. #.#  *.#. .#.*# ##
# .\. .. .\\......\. ... ...\*.. .*...*  ....* .....*.   . \\. ..\.*.#..   ....#..*....# ........ .*...#. ..**.#. *.. . \ .# \\#....  . ...#.......  #
# # .....\.## ..\#.#..     .*.....#.*..\*#*...*.. *\.  .##... .. .# \.  . \.*##.#\.. # .*...#.\.. #.#....    #...  #.* . .#. \..#*\#*..*..... ..... .#
#.#*..*\\. *# .. . **..#. ..... .  .*.. #* .* # *... .**\\\.* \ #  *#..  ...#. .  .*.... .*.*#....\.....#.... ... .. .#..\## *...*.  #**...*\...  ...#
#  .......##.*..#  # ....#*.     .....* ....*. ...##. ..#  \ . # \..# *     .## #. *..*...*#.. .*\#.. .....*.. ..#.. ...\.. ... ...... .\.* #..* #.  #
#.# .\** .  .*..     ..*..*    ##..*##. .  . *.\  ..  . * ...#.\...#.... . .*.....#\. ...\*#  .#..\ ..* .\.* ....... ...\..\ ..\.. . #.*...#...#.#...#
#.\.\*. . . . *.# .. .# .. ....*#.. .....#  .*. .  .*  ..... #. .  #*.#..#*.#..\*# . ... .* #.\. . .* ..#..##.. ...\..  . . .. . .  #. .#*. .. ..*.#\#
# .\.. . . ..  .*  *.#..*...#** *#......*...*  *. *...*\  .... . . #.\. ......*..  .*. .. #..#*.. .\ .*.#.\*.....*\.......##.*.** .*...#...# *\\*..###
#*. .\.*..#.......*..*..##..*  .....#.....\. . * ...  . #.......   ....#....#.##\....*.....* *.. .**  . . ..##...*....... #*\. .\*.*\  .. ....\\. .. #
#..#\..\..*... .\  .. .  .#*.....*\.*. .*.*.\.*  #...#. ..**........# ..**. .\**. ##  #... ..**\....*..#...##*..*..* .**..*. ...# .... * #.. . ... . #
## .. ...... *.#....*........#...#........ ......#..*. .\.... .* .#*..* ..*. ......*.....*  ...  ..*.#... \*.* #.  .*...  .#  * *... .*........ *...*#
#...\.\ .. #. .\..* ## .#* #*..... .* . ...*# *.*....*... ...#*\. ......*....... ##.. # ...#*#.* .*# ...*.**..#\. ....... ...*.  ...***... #... #..#.#
#*..*.\...#. . .#\..* **..###.\... # ...#.. ..... ...* # .....  #.*  .... #...*.#.*.*  *\..*.... #. ..*.*..##..  #.#  .#...##....# ...   .*...\*....##
#.\..\.. *.. . *\. .#.#.## #* ...\..\*.*.\ #.#.  ..#... . *\...#.#....   *..\ . \ ..  .#.*\..\*.\..   .*. #*\   \....*.*. \#.. .# #..\*** . **.....#.#
#....  .......  * . ..#....... *..*...#*.#... . ........  #*...###\....*.#.\........**.**.. ..#......*. ..*\ ..... ..... \.* ...\...#.. .* ..*.. \\..#
# ....*  ..*#.....   .\ ...# .* ..*.\.# .. . \##... .  .  ..*\.# #. . .\... .. #**.*.##.\. .... ...... #.....\.. ..  ...\..\. .* .#..*... \ ..... ..##
#.#..  .. ...*...*.#....#..#. # ... ..## #*#..*.... *. ...*#. *#.#\....\.. #....  ....*#.......#  .*.#. ...\. *. ...#*. .. ..*...*....   #.*.*..#*.# #
#.*.....\ #. ...#.\#*.. *...*.  .# .* .# ........ . ..**##.....   #......**.*\...#.......... ..... .* .........*.  # .  ...# *.\....... . #........# #
# . #..  ... .  . ..\# # ..**... ..\ .*..... .. * .# #. . ..# ...# .*.# \..*.##  . . . .. ***  # . ...#.#.#.  . .#. .... .* .  *...  ..\... .##...*\.#
###* .. ..##***#  ...#\.#. *... .... .. . .*..#..*....#.. ... . ..*. .........*. .. ....# *....* . ...*...#. . ... ..*.# .*.  .#. .. .... .. .. .....#
#* ....*.\.. ..\ .  * . \ \#..   #\......... .\.*...\..###\. .....*.......* \.... *.... # .....#.  #..*#...* ....... \ .. . .  .......#. #*# .*. .#.\#
#* .#. *# \.. ..\.... ...*# ..... ....* ..#  . . ..  . .#\. .*....*\* . . \\ . . .# ...*..\ \. ........ ... *.. .\  .. .*.\.. #* # .# .*......*.\ .#.#
##  \. *....**.... ..##. \.#* .*. .#*\\*... .*.#. \.  #. ...... .# .#......* \#... *......\ . ... .  ..#. . *  .. .#  ...  ...*... ..\. ... \.. #....#
#**. .\.#  ... .\.*.... ...  .... . ......*..\.. .. ..*. \.#.  .\...\.... ..  #*.*.#.\.#. #*. .#..... ..#....#..#..#*..... .* .. .#..#*..\.#\. . .*.*#
##..\....... *..#..... .. ... ..\.*\. . ...##.. \  #...#\.##.. . . #...#....*\..* .\.. ..*....*\. \*..  #.* ...#.   .....  ..#...#..   ...* .* #..**.#
#. #*.  \.. .\*.*..*..#. ##.#..*..#..#\.. .\...  .\..  . ..\..* ..#.. ..##.  ...#... .#. # .***.\..#.... .#. * . ........ ..# # #.......*#.  *.#.. ###
#.  . .*.#.... .. *  * ...* #.\.*# .\...*\.... . ...\..*.*...*#..*## #........#... . ***# ** *. ....... ... .... . #*.*\......  \... ... .# .##.... ##
#...#.#.#  ...#. #... .* \.\ .#..*..#...*#  .... *#....*.*....\  ## .. .#....\. .. *.  ..#...*..*#. **. . .*#......*# ...   ..*.####.  ...*. #..*....#
#.**.. .#...*#. . *.*..*.\ ..  ....##.#. ##.\#.#\\...... ..#. .\. *..#.. *\...#..\ * ... #.  ...#\. ... ... **. #*..* ..#...#.* ..*\...##  .... #*.* #
#.\*. . ... ...#.  . ....#.#.*.....* . ..#...*......#. *.. ..  ...*. *. #..#.. .*#.#.....##.\ *..*. #.. #.. . ..* ...\....* .# ...#.\..*...#\ #...   #
#.#..*.*....... .*.#...*.\  . \ #. . .. * .....*\.. .. *\ ***..#**. ... \.. ...*...#........ ......#.*........*.. \..#..#....#...... #.....#.  *.. . #
##*.*. \# ...... # ..#. .#..*..#.* ##* ...\.\\. #......  ... * *. #... .  \. #  ** ..*.#*.. . .#**.... \....#  ..\........# *. . . . .*#.... ...  *\*#
#.*....   .#. #...*...#.#..#.. .. ..*......  . .. . .#. ....**.\....... ....\..  ..* #..\###.. .\# *...#....*.#.\  \...#.. ....... .*  ....*.* \ .#.##
#. . *# *..\.#. .. #\**...***...*.#. .*###*. # #.. .#..# .#\...*...*#.. .# ...  \.  #** .\**. .. #..\.#..*.  ..\ #.  # * ..* ......*.. ..... . ... #.#
#.   ...\  ..* . .... ...  .. .. .#...... ...*#.. . \... #.... *.# . .. ..##..#....  . . .... ... ..#.  . ...\....#.... .... *#.***....*.  ..\ .# ..*#
#.. ..#   # .**.. .# .....#.. . .#..# .... .\*.* .. .\. ............* ..*#* ....#*... ..#.*..#..*\*.... .  .#.#.  . * *.. .... .  # .... #\*#.#.*.*\ #
#..\ ..*\ \\\. #..**...#.... ...*....* #.##..*\..# . ..* * . ..*.... #.##...... .  .* .\.#..*.   .....#.*. . ..*...*  *..#.. # .. .* . ...#......#...#
#\....\.#..  ....*.#..#..#..#  ...*. ..#.....# ..## ..\ \...#.. .....  .***. \ ...*...\... .*.... .\......\....  . *##*......*#.\.*...# #\* ....#....#
#. .  ..#.* *#  .. ..*.\.*.. .. . *... ....... # \.. .#........*.#.. .# ....#**.. *  *. #\.#*..  . ....*.# .  #..... ..   *\ ... *.. .\ .*.#..*# .. .#
# ...* *..*#\\\\#... #......#.\...... .   \...#* #*\. .*.......#.. #..  .. . ......*.... .\....*...* ....##*. ..# #.*..#...*#\.#....# ....  .#\......#
#.##.. .  \.*... *  \**..  ..*..*.. ....** ...  .*  .\.*....\..  ..*.. ....  . .........*...#..\.\#.. \.. .\*# . # ..*.*..\....... \ \    .......*.. #
#  . \#  ...........#. . .**.  * .. ... .# *.*..............*.#..\... . ......\   .##...*.*....#.    #... .  . ..*. ..\...*..*..*..\... ..## #.. *  .#
#\...  ..*#*...# .. ......*.. ..* #. #.......* #...** *.*\. .*#...   **.*.* ##..... ......... \...#. ..  .* . ...... ... ...*.# #....#.. .... *  .. .#
## .. ###.# .. . .....\..\ \ .#.\  .....   . ..#. #\##........\.... .. ...# ..#.. . .  .#...  \.#. \. .*. ....... *.*#..**..# .. . . #. ..# *..\*   .#
##.#. .**.  .\ ... ....\\#.#....*  . . .*...#. ...\.\ .#.. ..\ ....#*...\  #...\. ..\ # ..#.... .#. ... .....#.  .##..  .  \**.....*. *#.***# .* . . #
#.*#..... .*#..\. ..#..#.  \.....#.* #..... .\...*....... *#.*#.#*#.#..# .*...* .****. .#\........ .. \ ..\. .* *..*...*..#... ...#......#... ......*#
#*.....*#*.*.*.... *.#..\ \. .#..**.......  #..* . ...*...\\# ..... .\.\... ..\ . .\#.* #...* .#. \............####....*. #...#.# *#.*  ... ..... ...#
#....\ .. ... ...#*#.......\.....**  ...\#  *#.#*.* .....**#....... .... .*.*. #. .......  .### *. .*.*....**#....\.... . ...\.# ..\\....\*.\... ....#
#....*....... *..... *. . \ ...#..*. ....#. ..# * .*.**# *.  .*  . .#....#...* . .#*.*#.#.  .....# .#.   .   .  ..... .. . .. . .#. ..#****.#....#. .#
#.#..#..... *\ .. .. .\.. ........  .#. .*.. # . ....*\...\#..#*.#.** ...  ..## ....\.*.......* .*.    \*  .*.*#  *.. . ... #.*#..**.* ..#..#.. #. *.#
#* ..*\ .........* ..* .. ..#\* . .**..#.\.... ..*..# ... #.*..  ...\..#.# ... .. .. .\\#. **\.....* *..# ...#.\..#...* . ## * . \.   *#.#.*... .... #
#...\...#\....#.. .. .. *.# * . .  #*.  .*..\.  *\* \..#...\..#* *\. .*. #\.#..*. ..*  . .*##. . .#   .*... . *  . .  *.. .....#\.\.. .......**......#
## .*..... . .*.....#..*..** .\...#\.#\#.*. \\...**..*#\ \.*#.. ........ . * ..... .\... .. ...... .\. *..*#.#...#.\  *....... ... .#*...#... *##. ..#
#.  .. .# ..#..*.*...#..... ...#.... .##..*.. \.\*.#  .#.\  .. .. . . .*.*  **...... . ......* . ....*....\..... ..\.. \..## ..# .\ #.##*#. ......# \#
#..* .. . ... .#**.# . ........#... .....#..... ...*...... \.. ..*#..*.*. .#..#.. ..#...#.#*........ .... .*#.\#*.. ..#.*..*..##....**.. .   ......#.#
#\#.#\.# ...*   ..*.*.#\. ......*...\.. . *# #..........\...#. #.....*\.#.... *.#. ..#  ........##. \.... *. .**\.#* * .*.. .#.....\. .....**... ..*##
#.......\.\....#..* ..# ...\....*  .# ..  ...#....\....#.  ..*.##*   \*...\\.. .. .\* . .*....#  ....  .. .#   ...\..#...\ .. . ..\\ .\.*..#.* .*.#..#
# *... .\.* ..#..*.. . # ... .  .\.......\. .. . .... .*.....#....#...*.\.\. .. .* ....\.\. .. ..   .... ...*...* #* *.*..* * ... * *#\..\*.. ....*.\#
## .....  # ... .# \.... . ..\..# #......*......\ *.*.#*..# . ...\#. .  .#. #* ..#..\ .....   .  *.#.* ..*#\.   .*\*#... .. ....#*#.. .. ...#* #  \..#
#..\..... *. .\ *# *..*. . ..#.. \..*   .#.. #. ......... *.. .#..... ....  . #.. . .*.....*..*. #\#.\*\..#*.#** . ....*.  .* ....... ....*#.. .  ...#
#\.  *#*  * ... .. .# ... ..* \... .. *...   .* ..*. ..\...**...*.##.   \. \.. \.* . ..#. .# #..... \\ ...*.#...*... .\ ..   ...  #..*.*.. .**# .* .##
#..#.*. . ....\*.....##*. .#*##.  ...*...* \.#..#.. .* * ....#...*......\... .. ..... ... ...  ...\ . .... . .## .... ..#.*.*... ...\..*  . *. ...*  #
#*.\.. # ...#...R..\... .. . \. . . .*.*.\.\#\ * .#**...## .\ .........\ ...*. ...* . .  * ... ......#*...#...  .....\ .... .#* .. #. ..#\ *..*......#
#.*...#..*. \\. #. ...\.....\. .*.#.. \.#..#..#*. . ..\ # .#..... \...#...*.......#.# .*\. \ . . *. .\ .*.. ..\ #.....#.#....# . \ .#.# . .** #**# . #
#... . .#  ....#........... *... *.....\.....  ..  ...* ..........*  .# \ .#..\....*.*....\..##...#. .#..  .. ......#.#*...#...*.# .....    ..*.#* ..#
#.....  *..##.#....#..\ ..\..... .#...#..#  #*\  . ...#.#......  .\...#.......#...#..... .  ##\ ..... ..#\ ..#**....\.. .# ...#   *  \ ...#.. ... \. #
# .\.. .   .##..*.  ..# . ....# . \. ..#..........* .*. ..*#... . .*.. ... .*  # #.  .*....#..*#.....**.#*  *.. * . .... ..\...#...*... *...\.... ...#
#*..  . **#\.  . .......\#..  ....  ..\#* * .  ... ...#.......  .... .... . *.  #*#......... *.. \. *#....  . *..#...  # \.......... \ .\ #.  \.... .#
#.* #....#\*#. **#*.#.#*.* .. .  #. ..* . .......#\.. .#..*.*.. ...**. ...#. .*..#. . .* ... ...  ..\# . .. .#. #....##...*... ...  # .*  ...... *..##
#. **..   .  *  .  .#\.#... ..*...#...# *# \.... ...... .#.#\ *  ..  *.*....##. ..\..#.#.. .#. . *.. ..........*..#...#\*...** . .#\...#...#.\.. . #.#
#......*.*.....##.\   .**\. .*...#.##.... .....*..*.#.#.* . .. ...##.. .. *. .*..   ... #. .. ...*.....**\*\#...* \#\. ..#.  *.***\...#.......#*... .#
#\.*.   ..#..  ..#*.... ... *\.. #.\.#.. #*#   * \*.. .\  #..* . .\ .#**.. #**.  .#.\* .#. ..\ .*.#.\. .. *#.\..*.. ##.. \*#.#...*\.  *  ...* . .. *.#
#...#.*.*....  ##\.. .*..# #*. ... ..\...  .#..\#..*. .. \ #..#.#. .##.* * **.# .....#..*..*..#..*. \. ... ..*#..#. .... .*. .* .*. .\.  ...#.\. .. .#
##.\..\. #. . . ...  #.. * \.............*.*.*. #....*#....... .... *##.\.\...\.**.....\ ... .. . #*.. .. .*.*. \ .. \. .  ###...\  .. *.......##* . #
#.....  \.**... .*...\.  . ....*#..#..#.\#..#........#..#..\... #  *..##.. .#..  .  . ... ....#. . #....* .....* #\.#.......#. \ ...*# ....* .. *..###
#.#. ...# ..* \*...\ . .. *........ ..... .... .\.*#**# *\..\#...\ ... .. .##..#*...#\.. \.#..... .\#..#..*.# .* ...... ..#.*# ...*....#..#...\.\  ..#
#.*........# #. . ....*#  ...*.. ..#.  * \\ .* *..\\#. .  ..# #*.# # .. # .* #..  # .....*. \.\.#.#..\ . *.# ..#.....\. \*#.*. . *.*.. .\.*##**. #  .#
#*  ....#....# .# #\*.. ....\.*.\.. .#..... . *..** .... ... .. \.....#.. . ....*.\..\.## *.*.. **#..  .# ..#..\ *.. *.\.*...  #.*..#..# . \.. . #...#
#\.. .#...  .#. .... #....#*...#  .   #.* . .* .*......#.. \ *.#.... #\. *..............**......... * ..\#**.*...#.#... .* #......\****...#...\  ..\.#
# ....#*...\*#... ..\.. ...  .....\.. ...*....* ..*\....*. #.. .. .\....... \... #..*.\#.#.#*..#. ..* ...*..* .. *.*.. .# .\.# . .. ........*   #*.. #
#\..... ..........*. ..#*.#. \. .* *. .*  \#..*#\* *#\\.*..#........*.  ......\ ##* .... ....# . ..*.*.. ........***..#....*. .... .... ## .. .... ..#
#. .*.*# *..*\ ##..*......**....  .#..\#..# .#...# \#.... *.#.*..\# .*..  ......#\....*.. ....*. .   .#*.\   ...... .# .  .*.......... .. #.*. ..#.. #
# .*\ .... \ #*..*# .*.....*..   ..\*   ........# * ....** \. *........ ..........##.# . ..... ..#. .  ....\.#...  *.#...##  *  . *#..   *... .  .. .#
#.. **# .. ... #..##..  ...*\ .. .#.#.. *..... ......... .## ##... #.* .*.#. #. .\\..... * .#..#.   .*.#*.........# #.... #...   ............\.#  .*##
#.    #. \.... . . ##...  #.\.*. .#.#......#\.....#..#.......#..#.#........ . ..  *.\. .. ... ....# ....**.\ ...*.  .. \  ......#.*....   .* #...##* #
#... . . ..**.# ....*.. #  ##..\.....#.\\*...#.*. ....*#..\.... .#.#...... *.....#....#. .*.. #........... .#.............#.* ....  ..#.*..    ..  .##
# ...# .....    ..#.. # . ...  ..*.**..##\\ #... ...... ..\. ..  *#..# #...* *........ .. .. ...  ... .. .... .. ..#..*.   ........*#\.....  #.  .\.##
#.. .#.\  ... ...# .\ . ..\...*...#*.*.##*..* .....#....*...**...... .*... . #*. #..\.#.#*#*.#.#. \. .*.*........ . *#..**.. .*.#*.  .*... ...\* #*..#
#   *.\ ..* #...#. \###..* **. #* ..*.\.# . ..... . # #..#...*.....\. .**. #.\.#.*. .......#...*. . # .#\*..\. . *.  .#..#.\.* #. ##\  #.*.......*# \#
#..*....\......*. ..#*\*.#.  ..# ....#.*#.   ..\..  .....\.#.## ..* ......#  ....**# ... ...  . .. \..*#.....# ....\..\.# **. *....   *. . ...  .... #
# .#\.\.# *..##.......  ....#..\..#..\.#.\.......#.  .*.*.* . .* .\.....#...*.....# ..*#.  . .\...# ##..*..  .#..\#...*# ..*... ..\ ... .*..#*.#.. ..#
##...\*.#. #..##...*. ...* ..  . ... ..* .*....\.#.. \\#..#*....... .. #... .. . .  .*..# . *. ..\......*. ... **. ....... ..*.\.  ## . #**...#  . \.#
#*... ...*. .\#......#*.#... ..\.*#... ...\ .......#.#...*.. \.#...#. .   *#..#\ ..#...*.     #...# *  #.** * *.#* .#. .*.....*.. ...*. .#. ..*#* . .#
##.  .... #\....*\*.\. .  ....*..# \*... #. ....#  ...   .*#\. * .. . *..  .*#.*\..\* . .. ...... ... .#**..*\#....   #... .\.# *....  ...\.. ..#...\#
#.*.. ..**...##*................ ..#... ..\#.#..\*.. *.*. ..\... ... *. #.........  *.  .*.#.*#\.... ..*...*.\#  * ..##.....*..  .##........*.. ## .##
##* ..  . ....... . ......\ .###\. .......## ...\..... *.. * # .*... . #.#.... . \.....  ... . ..#. .*..#\. ..#.. .\. .#. ##  .#..*...*.*....\.*\  ..#
#.*.#... . .#.. .\#\...*\.*.#.. \* .# ..##. .*\........*. ..# \. ..#.. . ....... #.*# #.*. .  .*. .........\ ...#.. .#....*. ... .#. .#...*\....*....#
#.. #.\  ..* # #.\.. \.##. ..\  ..*  .*\.## .*..*# ... ...#*..\.* .*.* .. .\.#.\\....\..\.... .* .....#.... ... .#.\..*#.*.  *. ..\.*.... *  .  .* .\#
#...   ..#..*\...*#  *.*..*.........##...  ..... ....**..** . \   #.\.. .#....*. #..* #..\.\...*........*  *..**.*. . .#**..# . *. .. #... *..##.. ..#
#..\..* ..#   ..\\ .*.* .*# .*... .*...* .......#..#...*... .# #*#.\ . *# ...#.  #....*..\ \#. ........*. ....\ * *..... # *. ..\..* .*. #  *.#... . #
# \ .#......#.. .....**.#....  ....#..*..*\.#.#.*.* *...#\ ..*... *.. .\ .#*.#...... .*.. ... ..#.# ..\ ... .## .#.\ . .  .. .*  ....* #....#.\.*. ..#
#..#. .##*..\..#.#.***# ...*.. .... ..#... .#* .. .... *. ..... * .. .#..  ..# .......# .# .#\.  ....* .......... \...*##* . \.#.. ...#..\...#. #.\. #
#.. .* .*.....* .*.#.... ..*\#..# ....##. ..\.# . .\. # \. ...**..#**#* \. #* **...#. #.##.... .. .\.. .**.*. .*#...#.\ . ....\.. *...  . .\.*...*.. #
#\..#.. . \.\ ..  *# .\..#..*** .....#  ...\\.*..#...*  #..#...###.*....**. .*.#. .# ..*... ..*...#\#. #......#.. ...# . .. .. .\... .. .###.# *. ...#
##...*..  ..\.\.#\.. ...*..#.    . .#. .#..    ....    . .. .##.**\ ... #. \.*......\.. ..*.#  #..#....#.. #... .. . .# ..#.#... * .*.. . ...*\#\*.\.#
#. *\ ........\## .......... .  ...#. ..\..##....* . .. #.  .   ** .#.*.*..*.*\  .. *. #\.. .. ...#.. ...#. #. .*. . . ..#....*.. #\....* ...\#.\ ..*#
#.\.. #\.. .\.... ....... .\.\*  ..#.. .*. .... .\#..#.*. *\.#\.**.... .*#... \.\\ .* \......* ..#....\ ..*..\ ...* #\*...*.. . ...##  .     .# .. . #
##..##* ..\..  ........ ..#*#...... .  .........*. .\.\*..**.\.....*.#..*.. .\....##  .  #..##... . .*#.# *.  . *. *...#.. .#.*. ..\............* ...#
#.. .#.#. ***. ...#..*\.#.##*..##... . ... ....# . ... *.#...*.\...\##.* ...\.   .  #\..**#  #.*#....**. . . \.#..\....   ......#.**.#.* .#    .*...*#
######################################################################################################################################################