######################################################################################################################################################
#R. ...#..    #**. .........\.....* . . ...# #. ...*..\. \# ..*  *.#  *# . ..* * .\.#*#.*...*....#.\. *. .... #   . .\.. #.*. .#\. ..#. . #.. #.# ...#
#...\........*.*.. \.*..* . ..#.*#... .*.#.. .\*# .\*......# . # #..#..*# #...#... \##. #..# .. #*.. ..  ...*.. .#..\...#.#    ...# . ..#. #*.. ....*#
# *.#.. .#..##..  .* . . ........#*...  .# *.. *..   .. ...#*....\.....  #. ..#. . #.....* . .....   .....\.# .. ..\#..... . #..\ .. #. ..*...#.***#.#
#..#.. #..\.*.#.  .  .   .  .. . ..#  .#.#.. ** .  ***. ... .*#....\..#*. *.* ....#...*..........  #.... .#*..\#... * \. .*..*.. ..\#............** .#
#.\. \ \ . .**. *... \. ...*.* .*#.*. ..** *  #....*. ....  *#*.    ...*.#.#.\##. #..  .** #..*.*..  .\ ..*#...*.*.... *.\...*\.. .*##.*...#.# .#. *.#
#... \.#\ . ..... *..#*..#.. ...#. .. *...* ..  **..#* .*. .....  ... ##  .. ...*...#* . #.#\.*.... #. *.#. . ..#.*#* #*.  *..*... .   ....# #. .. ..#
# \...  .    .*##.*.#..\...#...#..#.. #  .  ...#.. \. \. . .* \ . ... .##.  .# .......#\.. .\.. .#...\ *..*.# *#  .  \#.#.. .....##. \#.  . . *# ....#
# *#... *   . .....*......*....\..*.....\. .... .. ....*. *\..#..... #..\.#..\. #  ..\... .......*  ...... .#.* ..  #...  .#   ..#...* . .  **...   .#
#.\#.\ \.** ..\.... .... ..... \....*..  #.\..*#..... # . ..# *...*. ...#....#.#.#...... .#\**........#.......*..#..... ..#.#....* .. .  ...#. .\. ..#
#\......#. .\.#  ...\\.\ .* ... ..#.#. .. ..*...\.##..\.. ....*#.*..**.*. \**.\.*..#..\#. ........*..\.....*##..#....\.  *#. . ...*.*.\  ...#. #. .#.#
#.. ..    .# ....** ...\#*.*.... . ....*. ..*.... .** **. . .. . ...*.#.. ..*.\.#\.. .*.*......  .....\.# ...# .....##.*...\*# .........#* ......*...#
# ...#..*....# *.#...* ...#.. . ....... ..##*. .. .* .\..*  ..*..*.\*\ .*....#..* ...   . ..*....*#. ... ... .....*.... ##..\. . .\#. *. *....\. *.#.#
#.. **#. ..... ..*.*..... ...#*. ...    *.*#  # *...... . * ....# #  ..    ...... . .\##. *.....#..... *   .. . .  *\   ...*.*. *\.  ...... ... #.#.*#
#.#..#.  *.\#. *... .#.* #...  *#. . .... *. . .\ .*. ....# .**.#*#* #. .#...  ........*....\.. .# ...#. ##.....*...    .  ...\.*\. .... *.....*..*..#
##.#\ ....** . #..... .. ...  ...##...#... ..  .. . .*.. **...#.##. #. .  .#.\\ .  .\\ .*..\. #. ....\...##\.. ...# *\.#. .. ....#....\ #  *.. \.#..\#
#... .. ..  .  \#. #*\..*.*. .\#. ..\ . #.\.#* *..**.*..  .*.. . ..##.*... ... *....   ...\*#.. ..  .#..#. ..*....#.*...\.  * * \\  ...\\.#. #\ .\..*#
#.  .##. ..........#..\.#...\. . ...\ ..\  ....*.#.* # *\.* \*#*.... ...  *.##.#.\.\.#  .*..  . ...#..*\.. .#  *..\#.*....#\..... . .... ##.  .... \.#
##  *#... ....... #*# .#. \.\. ..*#..... ..\.# .. .. .*  **. \ .* .#.. ..............\...*....*   ...\...#.**.. ... *\* #..#.... #.  .#.*.# . .... . #
#** .##\.. ...#....\*..* . . . \ \..**\ . \ .. . ..#.....   .\....\....    .##....###... ...#. ..*.*...#.. ...#.. #.. *\# . .*.. #*.*..##.. *.....*. #
#... ...\..  # \ # * .## # .\....\*.. ... .#..... ..#......  ....*#..#.**.*. ..  .....#. *.*#\...#... .*.. . ...  .##* *....# .. \ *..**.*#  ...... .#
#..#..*..\..... .##..\. **. .#\..*#*..*..* ... #.# ..*...... ..... . *....\     ..*...\ . *.. ##..  ..#.# .\.# ...* ..* ..*.*..\ .. . \...*. ###\...*#
# ....   *.................* . .... .### .\.**.... ..#....\.#.. . ..#.#* .*#.*..\.. *   ...#..#.\.... .###.#\.*..  .. .##.. . ..\... .....# #** **#..#
#.* ...  ...#..*. ..\*.*..#.....*.....   *#\.#.... ..#.#...... . \.#.#.#.* \ #....*#....*#... *.*... .......\.......*....#. .*#.. .#.. . ..\.*.#....*#
#... # *\#.*...\. . . *..#** ..# .. *\. .. \...*. ..## #..*...  .#.. ...  **..  .*......**.*.* .. ..#...*..*.#*  *.#..  #.*\... \.**..*.#..#*.* #...*#
#.. .. ....#... ..#*..\.....##.........#.*# ...## .....\ .*. *.\..*. *...*.... *.\..*#... *. *.#.#\  \.   \..*....#.....\#.. .\.#... ......  #\ .....#
#. ... ...*  ..#. ..# ....  ..*....# .#. * .\.## .. . .#.. .#... .. #. ..##\    *\\..# .....# ...#. ........*..*..# ..\*...... \.*.\\  ...*\#\.#.*#.\#
# ..#....#...\.. \# . ..#. \\ ... *. ...* *.#*.*.**...#...#  . .. .. .#... *\\..#  ..* \   ....*# #..  ..\ ....# ....... ...  .#.*....  *##.**.# ....#
#\. .*..*..* *.* *.#   .. ..\#....*..# ... ...*.   .\..#...*#.  ..   ..*...... ..  *.#.  #... ....*........ . ..*. . .   ....** .... * .   ..*...* ..#
#*....\.#....\. .....* ....#.. .#... . #.\.... .*.. ..#.#.. .. . ...........*.#. .......  \\...\......... ....*.* \ .*.. ..*.. ....***\ ....*. .... .#
# *.#.......#.*...  . *. . .\*#.\.\. .\  #.\\\. .. ..#*#.#* .\..\..**..##.# ..\.#\ .....##  # *..#..\## . ..*#  .*...# .*.\. ..**  .. ...  *.. .. .\.#
#.## . *....#.... .. .. ... .... .*.*.  #*#..\ ... *. .#  ....\.*.*\  ..... #. ....*..*...# *#. ##*...*.......*\....* #...  . #... #  ..\.*...*......#
#.  *. ..*.* . * .#*.#. ..  #...*.......\ ..... .... ...\..**.*..#...  #  ..#... .. ...#... . .\ .*.* ...# . . ##..\.*\#.. ..*  * #  *. #..# .*.\\. .#
#..\..#. ..\ #..# .... .*.....**#... ..*# \*. .\*..*. .**... * ... .# ... ...... *#.... .*##*. * \....\.\..***.\...  ..... . ..**#*....*... ..*...  .#
#..   .. .....\.*. . ...\.##.#\..**. .#......#\*...#....#.*.##..#. .\... * .*..   .  .. .*... ..  *.....  # .... ..  \.. .#. \ .\  #.# .  .#*.#.....\#
#\..*.*.#***..#.#...#.#.*...\ . . .. .#...#*........... .   ... *.. *.. .*..#* *.\..#..*.. ... .   .....#  *.#..... . ... #  .*#.*... .#.\ .\ *...** #
# ...* ...... \.. .*......*##.....*#..*.... *.\...#...#\*. ...**\ ##..#.. ......... .\.#. . ..#.*.....#.*..#\*.#*. \*.......#. #*#.#.. . . . ....\...#
#... #. ... .. ...##.......*...\.. .\ **.#...*.#..... *# . ....\. .#..*.. ..#. \*....* ....*..#*.# * ..\* .#\. *  .# #..\.. ....#...##. *\..   .#...*#
#. .  . .*.**\. \..#..\...... . ##.  ..#.*#. ... ###.\..*..*.*. *....# .#..\*...\. ... ..*.\. .\#....#.*.... \*#..#..*.   .. \ .##   .*#..\..*...\#..#
#  *  ... . .. *.... ..\...##\.\ \....*.#  \ .. .\.#  *..*...#.*# .....#\ *..*\ \...## ..# #*....*... *..*. # ...  # *..* \#.##..#...# # .#  * # .*..#
#*\..\*..*.... ....\. \ ..\.......  ..#.. ..*....*. \ *.....*..  . # ** .\..*..**..*.# *..  ...... . * \\...#..#  # .\* ...*. #*\.. ....... . .* .. .#
#.*  \\ ....*. #...*...  .... ... .# .. . .. .*... *.#.*.*.......* *.*....  *.. .# .. *.....#.....\..#...#.#.....#......\..     *#.# . .  \*. *# .. .#
#.  *. .  #*#.*#..#\ \ **..*.\.. ..##\ .. **.# #.# #** ....##  #..* #.. .. **#. .#*. #..\ ....\#..#* . .. *#...  \#..* .*.. *... ..*\. ...#.#*....#.##
#.\*.\.. #..  ...**..*.\\...*.#...#\.* **\.*#.\# ..*..\.#* ..#.  ..*.*.. # # .  .*. . ..\ . .#...#.#*#....\.*. ..#  #.\#. #..* ... *. \.*.*..* \#. . #
#. ..#.*#.......#..\#\.. # .*\ .  ..*# *. ..** * . .#.....\... #...\ #. *#... . ... # ... *.#. ...\ ....  #.. . .*#.....* .*.  .. *.  *.\#. \.#  *..*#
# *.  . ....#. * . .# ..*.## . *\.* .. ..  \*.*..#\... ...##.#....\.#.*......*# * ........#. .# .#.  #. #.... .... *..*.\...   . .#..... .....\. \ ..#
#.#.. .\ #.  ...#.....*........*#  ..\... ...*.*.* ...#.. #.. .    .*\...#.* *.*#.... \......  ...#\   .. .* * .*... . .. ..\#.*...#. * . .# .\#.*.. #
# ..\....*  \.#*.... .......#*#...#..#. ...##. .. #.**#...*.\ .  *...... *.. #. *..... ... . ..\.*    *..*..*\... **   ...*#.*..*  .. .. \.*.......\.#
#. #.#.\.   .# ......... .. #.*.. ...**.  . .. ... .. ..*...  .#\*...#. #*.. .  #. .. .............#.*.  *. ....#\.....   .*....**..  ..#.... ...*.. #
# .*.. \ ...*...*   **...*.#.*.##.*.* .. ..... . \\*... ..#.\...#.####\*..... #.*.....*...*\. . ... \#..##*.#.#......# . #..... *....#*..\. .. ... #.#
# .*.## . . ... ##....#..#.**.... #...... ..#*... .\.#**. ..  ...\.. . ..\#. ....*.* ...\ .#..#....*.#.*.\.#.##... ...#.. ##*...#\..*.\#...\..**.. ..#
#. #. . . .....    #*. \.....*...*#\# ..... *..*.##\. ...* ... ........ *....\.....#.#\#.*......   .. # . .#. ..**.. .. . #.......  .  ..*. . . ...*.#
#  \...#...* ..*. .#...*. ...#.. ...... #*..*..   . ...**#...*..* .  .*..... ... *.#... .##\  ...\ .# . ... ...*... .#.... .*...........*..*\.###..\.#
#... *. ##......  .* .... .\*.**...###. . ...**#..*. .. .*.* #*. *#. ..*\ . ** .*#.......**....  *.  *...  . *  .*....\*. \#.   *# ....*. .. ..#.. #.#
#.  ....... ..\.... ..* . ..... ...#.  .*.\.* .....\.. .\. \ #..\*\# .....*. .*#\ .*  #..*.#.... ...*..*#..***.*....* *.*. .....*# ...# .......##..#.#
#\.*..... . .# # \#..  ...*. ..* ....  *#.#..#. .*. .*.  #..* # ......\..\.. . . ..*.. #. *.. ... . ..*.... .#**..*...****..*....\\.\...#......... . #
#.\. *. ... # ...*..  *  .#*.*#.....* ... . #.# .*.. . ..\.. ...* *.. .. .. ..##. .\. .*.  .* .   * ..*..**...##  .  ..#*.\.. . #* *#.    . . *#. .#.#
#.... ........*#  #  .  .#..#......##.#..*...*. ... .....  *.. ..  ...*. ..\\# #.  . #.......*.*# *..* #.*   .#..  ...\....#  .. * #.*. . ..#......* #
#.  ....#\\..*...\ #.. .*..  ..#.*#.... ... .**#.* #*....  ..    ... ..#.\..* .#.# .**.*..  .\ .\.. .#.. .... . .. ....\ .*\...#.. ..  .....**.* \# .#
# .. .*.. \.... ...  . ....#.. ....\ .*.#...  #* **\*  .... #* ... *..#  ...   ...*........ .  . ...## . #.#..\..#  .##..... # .. # .........# *\..*.#
# . # ...* .*.* ..... \..\.*...**..#..    .. . ... *. . #...\#..\.....#...  ........... #.* .. .#    .*..  ..... .......#.\....\*#.. .# .\. *..\#....#
#.#..#....*.*.. .... ...#  ....*...\...... . .**#*  ...  ..*. .....# .. . .... .. .......# ...  .*..\........ ..\\ ......... ...#........  .* #.. *..#
#*. *...#..*.... ...... # \..#.#\*... **....  . .  .....#*#*.   . .... . ....*....*........#...... .. #* #....#*. **..  . ...#*. ... .#...#.# .#.... #
## #.  .  .#. #.*.*.\...*.\.  ..*.#.  ... .\# .*..*....  *.*...*..\ ..\...# \.*...#.. .. .#..  ...*. ...\.........# ..\...... *\.....*..\*..  ...#...#
#..... .\.# ...  # . .........  .\.* ..... . . ***.#.**.  ...#....... ..*.# .#. . ..... .....**.. .. ..... . ... ...   ......##..\ .. *... ...\  *. .#
# *.....  \. .*#*. ....*.*...* .... ...  .*\  *. \... \..\*..#.#.*  .......*#.* . . #.*\. . . \\ .# .... . . .*#..\.*..#. .... .....\..* .*.... ...# #
#..... .. ....   ...#\*#. .   ..\# .. *..\..... . .\*#...* ..... ... *. *# .........  . *.  ..* . .***.\.#.\. .. \.#. ..#.....\..#.. * . .*..*. ...\.#
#...\....*...#... . ...... ...#......*.. #. #.#*..... *....\ . ..*#..* .#.. .\ ... .#.#.# .**.....*...... .\.......##.*.. *.\..#....*# .... #.... .# #
#.#.#.*.#....#..#..\.. #.\  .. ...#..#. ## .. ...#... ......# ...... .  ...*.*......*...#.#. .*.*... ..#.  *. ..##* ***. *#..\....#.\#.\...      .* .#
#.#... ....*...  .. .  #\*. *.#.\.#...\.... .. .** \#.\ .....\. .#\...*#.....\*#.*...\ .\..\... .*..\.  .. .. *.\..\ *...... .##.**  .. .## ... .\**.#
#*#. ..* ..*. *.. ..*    ........\\..*\#... #.....\  .## \*.*.\...# *...*.\..*#\.*#  . ..*... . ..... .....#. #..#. .... . .....**.#.*#. # ...*. *.*.#
#........# #. ..  *#*........#.. ..*.........#\.*..* \....*.. ..\#..*... . ..........  \..\.\  .... \#\.....\ ..*#*.*. .. #...#. .....\ ...........\.#
#. .*#**.**.#.* ....#.... *.*   .... *#.. . ... . . ..# ...*.... #..#..#.. ..*.#. .... *  *. ...#... .. .. .....\......\  ..#.. . *.\ .*#*..... ....\#
#...#..*.*...**.  . *.#  *..#  . ..#.. ..*#.***\ ... ....*#.#.\......\.#.. ...... ..  .....  .... .....\\*#..#. .. ...*#\#  #   \ . ..#...\..#....*.*#
#.\# ....#..  ### .. .\. ##.#........#....* ....#*..  *....*....*.. ...#........#..\ ......#....* *..*......\* ##. . .\............... .#...*...\* ..#
#. *.......**.....#. ....*....\.** ..... .\ \......#.#...# \.....*.*** . ..\.#.... .#...##... . .* . . \.#*. \* \**....#.*..*......* ..** ...#  . ..##
#.. .#........ .#.**.#. ....# . ..... .. #.* \..#.*. . .#*.  .. ..  .*..## ......*....\..*. . *.. ..   .. .. *.\  ...  \. *.*.    \...#. .*.* ......##
#... ...\. ....#..\#... . *..#.#*.** ... ... ..#. *  .#.#.#.##..**..\\# .* .... . \.... ..*..*........... # *#.*  .. **. \.. ..#... .#....#..#..\#...#
#.#\....*. ...\...# # ...*#.*# ...  . #\...*...........*...** *..* .**... \. .*.......#.  * ##..*...*. #*. .  ...**..\*#...  .*. ..\ #. \...#\..*..  #
#\ \.# #...#.. *.*. ..**.#...\. *.*. .........###*.*. ........**\*#..    .. .. ...#..\.#..#..*.*#.  ... #......* #. .* #..#...*. .# ....#.#...#.#\ .*#
#.... #\.... #.*  ...  * ..#.. .# ...** . .. # ..*.*.* . ....... ..# .......#\.  . ....\.#. .   .\..  *\# ... ....\.  . * .\  .  ...*#\ #*.**.. .\...#
# .\. .# .. .*. ... .#\.. .#  .\.. *..\.... ..\ .  . # \.*.#\.... .* .* *...\. .. ..*..# \#.... .#. \...\.#* ## .. *.. ...# ...  . .#..#...*#..*\.#..#
#.*..#....... *..*. ... .... .. * .#.##*\ \..... ...*.  ..#. #*  ..*\# ..*.*  ###....## ........*.* * ...\...#..#.... ..\..#.... . *.##.. ..\# ...# *#
##** .#.\.#..#..*..*  . . .... *...*.*...   *#.###.....#.*\.......  ..\ .... .*.# *.  . #.# ..#.*..#*  ...... *.  .#\ #   \..\*...\..... # ... . . .*#
#......**.#..#..  . ...*....* .\.#*\####.. .... \......#...... . . ..#\*\..\*# ..# ...#\#........\.* *... #.  *#*#.#. ...*..*..#... #..*# ....\.\..*##
# #... . . . *.... #**.. . ..\ #.  ....*..#.#.\ ..\.#.#. #....... ....\... .....\.*#.##.\.#... . \   .. . .. ... .... ..* ....\.*.#\#.... .*..  .# ..#
##  . *..#.*  ... .... .........\# ..*   ..\....... ......#.. ...#. *.. .\ * .*.#....#.\ ......  ...#.  .\.*. ...#.\.. ..*.. .#...#. ...\..##*....*.##
#    ..\\ \.# ... ..#.. .. .*.#...*#.. ..*  . ....... # .. #.* ..#. ..*..##.#*..#...# .*.##  \. #..#*.. *.  ....#.*. ......#...*... .. .# \\.# #..*..#
#.. ..*...#.*..*# *..*....*..... . .**\ . *...*...  *##.*\. #.. .\.. *.**.. \#..\*. ...\.. .. \..*.# *. . ...... ..**...*#..  ..#. .* *.... .... .#..#
#.\.*. .     .#. *\##...*.\*..*.    . ..\.#...#.*\. . ......  \.** ...*  *.*\....  .# ......#.\.# ....#... . ... .\.*.  *. .\ ...*#..*.* * ..*#*... .#
#  . # \ .*. ....  *#. ....* .. #\..*\#.*..#* ... .\. #*..*...\.#.#.... . .#.. ...\ **#*.\*. .. .. #..# ..\..# .#... .#*..*.# .. *. .#....# .#.#. \. #
#**... .... .#*...#  *..\ . ..... ##. *....*....* .. #...#.*. *... *.*  .**. ##  .  ###.#  .  #..#  # .  ...#.... *. .#*\ .*# #.......... .#.\  ... ##
# . ....*. ..\. \. \   .. ..* ......... .**. \.\# \\ ....*\*. ... ....# .....  *.# *...*\ .. * .... .#*.*\.   *.... . #\#.\...#.........  \. ..* ##*.#
#\...* ....# *\**.  # ....  \.. *.....*..*\#...... ***. .. ..  ***. ....# \*  ..  ..\..*#.  *  #.*. ...*.# *.. ...*\*\ \...\ ..  #..\. \\. ... #*.*. #
# *#*...... ...\.# .*.#\ .... .#.#\...  #.. # .*........  .. ... .*.*\...# ....* ...*...\..*.. * .........# ... . .#.**.*.... .  .#..\.##*# *.*.#... #
#.#.#.... ...# ...#\... ......*.#*..\...#.*..  . *....*..  ... * ...#.* .\   ...#   *.*...... .#  . ...  ...#....*.* .\.# # #..\.  *..*.#.#. ...*..\\#
#. .....*....#.#....\.....# .. . .... ..*.....  ....#....\. .##. *........ .\*. .... .... .. .....*..#.... \.# ...#* ......#....... #*. *.##..#..#..##
# \. ..# .. #... #. ..#.\ ......*.#...*...\..\.. ... . ##.#.#....##\  . * ... *.#..... .# ..#.  .  *..... ....*.#...*.* .  #. #. ...*... #....\*...# #
#.#\..  .*..\...#..   ........  \.\#. ..###\*#. * *..* ..   ....**. #*.#.* .*...#.... .. \..\....#....*.*.*.*. *.#..... #*\. ....\\....#..... ..... *#
#...*  # . ...........*..#.#.. #. \... #..#.#.*... .  .....*.. \.#.\....... # \... .*..# .#.#.*.. \.....#..#...#. *...*.  .\#. .\..*#. ... .. #*.  .##
#. ...* *#....#.. .*. ..#.....#... ....*. ..#..#. \. \..  \..##.*.\   ... . **..# \....#* ...*..* .#.#. ...\.... \#.#.* \*#*....*. ...*.#. .*...\  ..#
#... *. .... \.\... .#.\..\.... ..* ......\..* ..... ... ##....   # ...*.\*.  .\.#. ......  .   .*.. .  *.#.  .. \..  .*#.  #.....#. .#...*.. ...*.. #
#.*#..*.... .* *..... . .#*....... ..\\\..* .** .##  .#.\#  #   ... \ ....\. .*..*..\..*#. .#.\.#....  .......*.*..*# ... .*.##...\..*..#....*.# . ..#
#.. # ..  ..*..#.*..... ..*..  .*#..*\... *...* . .....*  ...  .#  .## .#.**#....   .#.....*.  .\.... .. ... ...# #.......... ##. \.. # . ..#.*.\ .*.#
#\#.....#. ..#......*.. ...#\. #.. ..... ##..\.* * ......# .......#. \...*#**# .....#* # ....* ....# \.  . \..*.#.... .\*# ... #........  .. .#.  .* #
#.# ..#.. \*..\.\...... #.*. * .. . \  \.. \.#...### . ...... * .*\.\.\ .. *...........# ...*#.......\.#.....#... ..  ..#*......*.......**.... \#. #.#
#.\. ...* ....# ....\\ ... .....#*.. ... . .. .. .\* ......... .*.  \\.*..#.. .## ##*  .*.*# .*.*\\ . .\ ...*\*..#...*... ..*....* ..... .\... ....* #
##.... *...#.. .....\\.\..... \# * . ....... .* ..*..*.... \. . # ....#..#.#.#.#..*.\..* #..*....  . . ....* ...*###....* ... #.. . #.*.... ....* ..*#
#...\*#....##. .....# . ... ....\  ..... . #.#\... ..  ....##.. *.\. #..* #.*.\...* \*.\..#    ...  .### \.. ... .* . ...\ \ .### .*.. \.**##. .. .. #
#\....**..... #  ## *.  *.... ...##**\ *.# . .#..*.. .#  ..\#.*.. ..\.... .* ... .#. .* .....#..\..*\*. ......#. #..... .\....***. .#..*#.* .#..* *.##
#. .\.* ...........*. *. . .. . *... #....#*.....#. .**..*  ....#.**.#...... ..\... ..#..\.#.*...#*..#...   *..#.#....#*.... .##. .... ...   \#*...#.#
#.# #* .\#*  ..*# .*  ....*.*\\.* .\**.. ... ..*  . .....#.\\.\.*....*..  ........#.....  ...\.*..# \....... * .*.#\. ..#.*\. ..... ....... .# .. .###
# *.  . .. .#  .#.  .## .. .....*. #.#....*.. ... *...*. ..  .*. . ..  #.#.. ...   *....##\ *.\# . . *. ..* *.*.*.. . .. ..\.....*.*.* .\... **..#* .#
# .# *.\...** .  ..... \ ..\..  ... . .. ...*........ .*. .* # *.  . ##.. #..\.*. .*.. ..*#.. ..... ..#  *. .. .......\....*..*. .\..... #. ... .#. .#
#.#..* ...*.  .   #..\  ..#*.   . #....#.... .. .* ...* ...*#*.#....... .*. .#.##. .\ #.###.*... ...#. ..#...#.#.. *.#\.#..\.. ..*.#.# *..*.#.#**.# *#
#\#.. .\.....  ..*.* .#. .... *... .. . . ...  .\ #... ...... ..... ...##.##    .....#*...*.......*..   *. ...*. .... #.# \.*. *..* . #... # .. . #. #
#.\.#\\.. . ...  ......  ... #  #.#... *..##...# #. .## .*#*.   ... ....# .#.....#*.#*...#*.*.. ..*. . . #. .\\*. ... . ....  . ## ....##\ .  # #*\ .#
#.. ..#.....#.#.. #* \#... #  .\..#.. \...  #*...*#.#.......*.  .. .. #.... \.\*.\.. .#...  .* ..... .. .\#. ..\......*#.\.  ....*..* \. #*.\...\#...#
#... *. .# *..*....... #. ....#... * ...#....*#.*..#\ *.. ..  . # ##.\#..\.. ..  .  ..# #.....#.....   ... ***. *.**....  .#. #  \...#.... .# #. *. .#
#.. \. .* . ..*..#.*. .# .    .. ..* . *...\*   .. *# *....#.... *.  .* . ....# #.\ .##. ..  . .*...*.*..\*.#...*....#.#.  #.  # .\.\# #...\.  *. *..#
#*#\......  .\.***..... . .**\  ..*. \\..\....#.*.\ .*. #...**.. *#...*.. .\#.*.#..*#...  #.....*... .. # ....#\\#\.. .. . * .#.*.........*. ..   .*\#
# #\.. ..... .#..#..*..\ *\.*# ....\*\.. ...*...#\...\   .........\.\.#....*......# ...#. \..\ .... .... .. * #\......  .#. .#*...  .  .#. *.  ...#..#
##... \**..  ....*..\.##....  ... ..#.. \.. ... .....  .\...#. * ....*....*... .#..   .. ## .#.. .*.#.. .* .##.* *.#*.. . .*..    .*... ...*.\.......#
#\\.. . . .\....*..*. ........\.. #.#..# *.#.....\.... #....#   .*..... * .#\.#......... ........\\ ..\*.. ... ..*......*.. .#*#..\... *.*#...*  .# .#
#.....* ...#..#..\......# . #. .# ... ... . #...*.#... .*... *\** .\\#..#.....*    #.   . ...* ..  *.*...*..\.. \ ...##.   ..... . ..**..... .  .*...#
#.\**# . .#.*.... .....# . . .\ #.##... .....  #.  \....##*....#.# #. #..\. #...... .\... ..# *#\\\. *..#.. *.# #.. ...#. . #.......\..... .\.*.  .* #
##.#..*#  .*\ . #.  #. *.\. ..... ... \. ...  ## .\.*.. .\#.* .*.  .* # *.. ..*.*  *#*.............  #   . ***.*.. ..*........... \#.#.... *  .#.. .##
##.*#.#.*.#\........  .. *. .. .....  .....#..*..* . #..\. .*.*. .. ..#.* ..#.. . # ........ .. # . . ... ... #\\#...#*#.*.. ..  *.#.# *..#.#.*#..\ .#
#\ .*. .... ### .#..#. *#......##*#   ..# .**...\...#...... .#...  #... ..##....*...*. .  .# .......\  #. ... ..## . . . *..#.. \##....*..# . #.#*.. #
#.*#.*.. ....#..... *.. .. .... # ....*.. .. . .\...# # .\.... ...*. .....  .\.\.*..# ... . ... ... . .   #..*..*.\*..... *. .. ...\#.... .*.  .   ..#
## ......  .. ...*. . ...##*....\.. . # .#.. \... .* ...**\.*...#   #\..  **...*\.#... *.\....  . ..*.**..#...... .#. .. .*.\#. .... * ...* ..\..* .*#
#. ...*\.*..*...#..\. .......\ . #.\....... #\....#.*# .. ... .. .#.....*..*   .#.... *.. ..*.....\#.#...*#.... .. *.*.. .*#*..* \...#* .# ..#*. ... #
# ..#. . .* .# .#...*\#.*..\.\\#.#...*. *......  .... #* ... . .*.*.. ..*. #\ \ ..........*. ..# . .. . \...#. ..  . . .#*...#.... . .#.#\.. ..\#.*..#
#...#. ..**#.#..\.. ..**  #....\. #.#..... #.....*..*\.  ...#.*.\..*\ .. #.....*.\#...* .....# ...*\.#*#......#....\#.##.. .#.....#.*. ...  .......###
#.. ....*.... . .   #.# ..*.#.##...#\ #.* .....* ........**#..#..#.*\.  ...\\..\. ...\ ..  #..* #. .\* .\#  ..\..*. .......*. \...#*..\*...*#.\..*#  #
# .#\.*.*\.   \..*.. #..#. ..#.......#.......*..#*...  ..#*.  ....# .. ........#..#\. *...  .. ..*#... ...*.#.#.\ ....#......... .. . .. \  ... . ..##
#.......#. ... * ...  ...#*\#. .  ..#. *....***.\*....* *...  .. ..* .. .#..#....# *.... .**.  .# . \ . .#.........#.... *.*.#*#.#..#*#. . . .....\#.#
##.... .*. ...#... ....**..*.....*..*.# *.....\.*... ....*\..... *. \..\ #. ..#*.. .*#.#*.*.*... ...*  .. ...# #..*.. . #.\... .**.. ###.   .**... . #
#..* ..\.........#...#.....  . . * .. ..###. .... .. \*.  *.... . .\ .*#*..... ....#..\#.. .. *. .. ..... \   ..\......\.  #.. . ....\  ..# #...** ..#
#.. *# . .#. \.*.#.  ..... ...#\.  \*.*..*... ... \\*  ... * .*..... ..\\. ....#.  ........#  ..#.# ...#*#*... .. .....  *..##. *...*#\ #  . .#  .   #
# .. ..# * . ...*.#.  .#.#. .*... . .#. ... ##..... . .*....* *.  #  .*. *....*\.*##. ....*#. .*..## .... *.. .... .   . .*..\#.* . . ..#... . .##\**#
#...... ... .*.#. .#.\....... ........ . ...#..*.#. ..#. * ...*.  ..* .. #  *.# #. .. . .*#.. .. ..\..#...*. .. . *.*#.........*  .*.. ..* ....* ..*.#
# . .#.*.  .....  *  *\...... .. *#*# ...**#...\* ... *.... ...... . ..  ...#*#*\*... .#..\.......  #..**. .\...##...* * #..... #. ...#. #..# ......##
# .#.. #. #. ..#.*.\. * .\..#*\ ........ #...#*# .....\....##*...... ..#.\ .. . .. . #*...*#...#.#....... .*#\\...\.\. .\*. #.... ....*.. . \\..*.#..#
#\..  .. ..*\##.\ *.. ..  ......#. ..*\.......... ** #.*#  #  ... #. .* #.. #*...#*#. *.*  #* *.\ .\.*... .... . #. ... ..*# .\.... .... \. ...#.. ..#
#.## .##.  **. .#..##. .. \. .. # * #. . .**.....#.* ....#.\*.... \...*.*..\. .....\.\... .#*   . ..#*\.#.. #..##*.#. ...*..*.. .  . .*... ....... #.#
##. ..*. .. *.  ##*... *...* .\..# .*..  ...*\...*..#...#..# ..*.. ....* .   . . #.......\  ..#...   *#\ .. * .\.#    * ........* \.. .#..#.. ..  \ .#
# . ... .  .\ #...  ... .. .....##. .# ....  ...#....... .\.\........  ..**  *.  . #  .#.\ .*. ...* ..\ .*.. ..\...   #.\.#.. *.    .*... * \..#* .#.#
#*.**. . . ..#.. . . .#\ .. .. .. ...  *\..## *.*.\...\.##. .#..#. \\..*.. .\....... . ** #* .\... \#. ..#..*#.*.#..   . . ....... *#..#...**.*.. ..*#
###################################################################################################################################L##################