######################################################################################################################################################
#. *... .. .#.\ .\ ... .. \...# *...*..#\.* \....##.*\ ..   . .... \..#*#. ....\ . *  ... \..*.  . .. \... . .. . #*.\.... . ...#..*  .......... . ..#
#*. . . .#. . #..... ...#...  ....\...*. ..#. ...\. \# ## #\..*. ...\..*.. . *..##\*..*... .. *...* *.. ... .#.  ...\.  ...*.........# .. . * #..*. .#
#  .\..\.. . # #.\.\......\**...*....# . .  ......*..#*#*....... \*#..\...#*... **.. #. .*. ...*....# .*..\\ ....*..\.*.. . .... .*\...... . .... ...#
#..# *.. .. .#. ..... . .....#...***\#. .  *. \.. #...*.*....#.*..#.* ..*#**.\*\..*  ...##. *. . ...*.#.#.. \#.**. ........*..*..\...*. ... .   #....#
#.*. ...#*\.. *#.*... ..*.....#. .#*... .##\*.. ...*.   . . .. . ..##.... ...\*\..\ . .\ .....  \ *..  **. ...... . \.#.#...#..*. ........ ....#.# . #
#...*....#\**. . ....* .#.#\\   #  . ..    ..#*\##  *.....#*...*#..   .... .*. .. .# .#.. .** .....#  .... * . * ...#.....*.*...   .. #...\..*.. #..\#
#.*..*##* * .\ .#\    .*.* *..#* .. .. ...... .#...* ..*... ..\.#...#.#......  #\. # **.* ... #.. ....*#. \..** .#......  . *\...... ....*. \**#*.\..#
#..** #.# .*......**...\...  ...  *\.*. . ..#.......# *#.*..*   ..*. . ..    . .  .... #.....\#....* #..\#.\.# *#.*..... *#. \#.# ... . \...*..** .. #
#...* \.*.....#\#..   .. \.* . ...\ #* . ...#..\.  ....\.*....#... .***. . #  \ . ...#\*# \ ... *....#.##*#.  *. *#\. . ...*....... .  .*. #\..#*... #
#.#...#..\... \. .. * # \ ..*\. ..  .* #\.#........*.\.#...  ... .#  .#...*** .. .\ *.#.... .... .\.#  # ..##.\  .. *#. ...*.*. ..*.......... .. ... #
#  .. ....   \ ..*...  \ ......*.# ##.*. .*.... .  . *..\. .*. .#..#. .  ..#...##. .**..#*\.#.... .....* *..#.. \..#*.\ *.\... \ *... \...#*..\.. *..#
#.*# ........ *.# .*\ *.*.*\.\.....*....# . .*  .. *. .... ...... .....*#....\*\#. .....  # .#.  ..*.*.. ... .... .\*. # ..  \..**.*. . \ *.*..#.\\#.#
#....  #... #..#.....#. ..\.###...#. #.. . . *....*#..#** \  .  ......#.. #.*... *.. .\.\.*.* .. *.. .*.. ...# ..  . .*\#.. .*.. . .....*\ **###.#..*#
#* ....  .*..  \.. *.**\ ....#..# . . . ....*.*\ . .. .....*.#*##.\\.*   *  #.......\...#.... .# .# ...* . ..\..\... \\.#...\ *....#*#.. .. # .* *#..#
#...... ..\*.. ..#..*....#.. . .*...#*...#. . .\...\.\#... #. #*##\.\* # .. *.....\....*..\... . .. ..... .*.....# .. .# .* .... #*..#\...\..#   ..#.#
# \....  *.**  *..  . . #. *#..*...*.\.\..*.#*.   .. . **\  ...*. ..*.\........  *.#.  \..*  .. . .*. #.#\. #.. ..... ..... **#**. ..*.#.*.. . . .#. #
#.     ..\ .. *. \..\* ...##..#..# .#.. # ..#  ..... ....#....*#  . ..\*.*#......... \.*. ..  ....*....*. ..*. #.*..  *....*.*.*........#.......*#..*#
#.\# .... .* ..... . *...#.  #....*..*..* ..  ..    ..#   ...*.. ...\.....*.*.#..  *.......* .. *.#..  . .#.. .# #. *.#...#..\... \. #...*#\#.*\ .. *#
#.#.. . .\...# .\.#......# .  **.*  .........# *..  ... . .# .\\..*#......\.\... . ..#.....* #\ \ .... ##. .# .#. ..... .  ....  #...\....#.   ...#. #
# .\#.\...*.   *#  .*#*. . ...... ... #*..# .*...*...#.*....... ..##....*.*.  \ ... .\.*. ..\.  ... .*#. .....*..... ....\#*.*\. . .*..*.#..#. .*.*.##
#..*........*.. #...\ *. .#.......#... . *.....  *# *\. ..*#.*......#.\*....\. ...\..#.*. \.#...*.*.  .....  .\ * .....#..# . .#.  . ..*.#..*.  #.**##
#.. .\ ...#........  ..*\.#... ...  #*. ...\..\..#. **. . #. * ... \#\...#.*.#..#..*# .#..**. ..# *  .###.*#...# \ ...*....\..*#**#.. \....*...#.*.#.#
#...#..\.* ..# #\...#\....  ... .   ...*# ...*\.. ......#\ .......*. .#....*..\.*.\...#...... ..  \. ##\ **... # ...\..**.# .....  .\. .. .. .#.. ..*#
# .* .#. .\...* *#***..*. *.\ #* *.... *. ..  ****.\* . #### . . *  * # .*......#...*\........#.#. \.  . ....  \ #..\.......   ...... *..# .. .....\.#
#*.. ... ...  \ .  .*.**.#*.*...  .#...**.*.  .#. .*  * *...\..#..#  *....#.....  .. ... .....#. ..\* **. ..  ........#..*#..# #. ... .... .......#..#
#*.. #\.....  .....* ##.. ***..... * \.\..*....*..* #\ . . #.  *....  ...\. . .....#......*.....*..\.............*\\*.....#...#... . .*. ....... * ..#
#. \.  .#..*\ ......*..*....*#.*...#...  ..**# \....* .... * ....#**. .... ...#...\....# .# ..*#...........#\...#.... ...  # . .* *  .*.#... ...... ##
# ...#.**.#..\.. *.. #..\...##...#... .   .**.  #....\ ...#..........  .**.#.#.*.. *....    #  \#  ..#...\......*.....#...*. .##*\.\ #..#... .#. ..###
#.... ..#. .*.\.. #...\.#......*.. .\..* .... #..*.*. .  ....  .. #.....#. ... .. ....**.#  * ..##. * ..#. # ... ..\*.... .. *.\.*....\ #.*.*...*.*# #
#..  .. ...\....  #   .# .\.*.* .*#..  \#*... * . .*.#.#*..... * \#. *.. . # .#.*#  .#.... ...*......\.   ...*....**.... ..\..\ *.......*....  ... # #
#...** # ... ......* * . ...  . ..  ... **. *..*...*. #*. #\ ...  ..\.....*.\ *.... .. .#..*. .\#**..#. ...#...*\\ *.#.... \# . \*..\ .#* ..* #*..  .#
#..**.. . .... .*.. ...# .. #.#.  ... .\... .. . ..#** ........\..#* .#.. ....*#.. ... ......... .....*#.. ......*....  ..*.  .*.* . ..\..   . . #. .#
#  ...#..#*...*#  .    . ..*. *... . .*.....#... ....#*  ........... .*  ...  *. .\*\##    .#. ..# . ..#\.  ..*.#..** .#...... ...... ... ...## #..  #
#.*# .. *....#... \.....\  .. #....#\ .# ..*.*.....#. ..#. . .. .\... ..\  ..\#*....#.# .\*.....  \..  . ..\#. ...   .......  . * .......\.*.........#
#.  *..*..*.....#  .* . .* .... *..... #.#\.#.  . . *#*.*... ..**#.*#. ..... #*.*###. .. ... . . . ..#.*.... *......# * ..   ...\\....#***.....*...  #
#***\......\..   .\.#.  ..... ...#*.. .#.. .** ..# # *..#.*#* \ #.. .*..... . .#.... *.......#.*...**  ...\.\...# .\. ..#..*...\..*.*.. *   \..\  ...#
#*###..... . \. ... #.    ..*.*\..*... . ..#. *#* ..#*.* # #\..**........\...\. ..\ *.###\.#. .*.#.# \\...*... ... .. ..\. ......*..*. . ..#.. ##.\..#
# .\ *.....*..*.. *....  #..\ # ..   . .##  *.. ##.*.. ... .......**. *....#*. . .##  ...*.\..#*......#.# ...*....#.**.* \#...#.  #\\...... .# .\....#
#.** \..*.**.*.  . .. . ...... \.*.. ....#.....#\.*  . ..#. * ..#. .. .# .. *\# * ....\...#..#.. ...*.. . .\*#....  . .....#.*..#......*.#...#**.#.. #
#... .... \     *# *. #*.#.#..... ..*   #* #. .*... ....*#... .. .....  .*.#..#...\ \ *... ..#*. ..*.. .#. .. .#..\.\*#.  .*. ......##..* .*.* .#.\# #
#\#.....\. .#..  .#* .....\.. .....*... .... . *..#*\.#. .*..*#....#......\#*\... .... \.  .. * .*.#.#\.*.. .. .**. ...... .. . . ..\....  .. #..#.. #
#.. .*.*..*.. ... . * ....*.....#.*\**#. #...#\...#\## ...#....# . ....# .... .. .*...\.#.....*..\...... . ....\ ...*.... *.*..# . ##*...... . .*..#.#
#.\.\...... ..  . ...*.\#*...#.... .....**.\ \**.  #* ..\#** .# .  ......##..**...** ..\.# ....*.. #...#..*.. .\* .....\. #.*... .*. .*\.*.. . .... .#
# . .\....* .. . .*\.*.\.. . ..  .......*.. #*.*.. ..\...\.\*#..#.. ...... . ...#.*#  \\.##..*.  *. #. ....\ . #*.....#. ........ .  ..#..#* ..... ..#
#* #.. #...\\.......\.....#.* \.. .#  #\ .*# ..... # ...\*.....#...#\####... .#.#....#.* #*  *....*##*#*....*#* *. .#. .  . \#...... .# ....* .  ..*##
# **....... \...###.#** ......\.\. #. . *.*............*.*.....#. ... * *#*#. . .\*.. .**.#...#. ........... . \.  . .\#.   *.#*.*.#.......#..\..  . #
# ...*.\ \ ..*.#.. ..... ..#.. ..#..*\... . ...*..  .... **#....*.*\..  ....**#*..#.\..*..* .#\..\. ....\.. .. \#..#...*.. . *.... * ..#\ .....\#.  *#
#\  .##...\...\*.. .*\....\  \*##..... \.# \.#.##..**..\ *.. \.*#..\. * .#.. .#. *...... .....  . .**..* ... . *  .*#*...... ... .  # ...*\.#.#. ....#
###........*.. . #...**. ..\.## ........ ..#..\.*##..  *....\.#.#..**.....##.  #*#..  #*\.....  .... ... ..*. ...... ............... . ...\. ...\... #
#... ... #.\.....*. .......*.#... ..*. ....#...... ...  *. .....* .  #....*# .##***. # . .  ...\.#.*.. ..#.  .\...# *.*.#   * ***.*#... #. ...#*.*#..#
#. .......*.#*....# #.\*#....*.. **#..# . . ##...*.*..***...#. *....\ *\#  ..#..  *.. .. *.... #.##... ....\. . . ##..*...*. #..*\\...\...*#. ...*\..#
#..\...#  .#.\*. .\. . # ..... .*. .. .#...  *. .. ...#.*#.   #..*\. ... .   . .\...... .....*.\ . ... .#\..*#........ ..#.... * .*..#...... ...\....#
#\*.. ... . .. .*#..*..   ....**..*...*#.*\.# ..#..... .\ \..   .*.. \*. .#.*..\.  ...#. #... ...... ..  .#. * .*.#...... ... *\#. ..*... ...  .#..\ #
#.. .  ##. #... .* #\....*.....\..*...... .*## . * #* *# *  ......#..#.... .\..\..*..* ##.  ...#* ..# ....... *......* .*\ .  .. . ..# *  . ..#.* #.\#
#.. \... .#......  .. .#...#..#....\.* \.  #*.\....... . .. * \.#*#.#*.#.*... # ...#* .\**.#..#* *#..... .# \ .#* ...... ... *#..*..\....# .*.#.\\ \.#
#...#..*.. .**.#....\  ..##... .#. *.. **#..*. .......  ....# *........**....  ...... .**.*. .. ..*. # ..#. ..... . #..# \.....\. #.*.......#... . . #
#.** *..#...#.  .. **.*.  .\....  *. \#.  # . ..#.\#\*....* *..#...# .##.\..... .#..*..... ... .* .. \.....*...#.\*..\# \* .#..*.#*....*.......#.#\..#
#. .. . . .\. *. ..... ...#..# ...#\...##.     *.\.. .... .#. .\#...#*...*...  .. #.*.\\#   . .....## ..... ..*...\# ......#. . * .\.*..* *. .. *. #.#
# .#..#...\.\.*. .. .#....* #### ...*.#... .... *..#..............**..#.. ** . \ ......\... ......*. *..*.....\.#....#.....\ ..\..........*.. .. *.# #
#..#... ...#.... *....  #.......#. ..  .\ .\#.#... \#.#..  . *#    *  .*#.  ...  * # .....*.....*#. ...#... \.*. #............*#..##**.*  .... ..#..##
#*... #. ...#\# .\.... # .#.#.....\... ..* * ..  ....#.. .. ....#\ #... . . ....**.*   . ...*.......# .  . #....\... .*.*...#..#*\ ... .. #..#..  . .#
#  ....... ...*.#*...*  ..#.   ..*.. *.*# #..#.#\. .* ...\##. * #.*....*..*.. #*.#\*... .. . #.*..*..**#. .. #.. .\...#.\#..#*.*..*.#*.#.#..\.*. .   #
# .. .# ..... #*.\..#..  #.. .*..#.* ...*.  * ..*..   ..  #\...#.......#** * .  .#.#.....*\.\\....#......... .\.** .. .....##. . ...#\.#. ...   .*. .#
# .. #   #...*... *. .#.    *.......#  ... .\#....    #.\.*. .   .. ..  ..\..*. *.... . .\.. *. . \.. *. *.   .  *.  .\\ ..#**... \......*.. \.....\.#
##. .. .*.# ... \ .*.#..... ...\. ..#..*..*#. ..# ..#.#....* .... . *#.   .\##*\*  ..*. .  . ..   .....#\.....##.#*...... ....# .\#.. #.... .*..*#. .#
#.* . .#\*.#...# ..\ ##..#..*.*..#..#..  ..#....\..\.\ \...  . #.**\. ..*.....*.. *.... . ..... *...#. *\..  #...#.. .*.#..... .  .......\ . .\..*...#
##**  *\... .... . #.. ..* .. ...#. ##.*\ ....#.**.*. ..*\  .  .....   . *...*.#..... . *. # #...#...#*. *#...#*.....#.  #. #*.. ..\#*\...*..*#*..  *#
#.. .. .  . ..* .... . . . .\* .  ..#. *.. #.#  .#. . #\...*# # .#.\ ..#.  .#. .##.*. .#*...#..*  ... .. ..   .    ......* .#. .#.*#... ..#.. .   .. #
#.\.....*.*.\. ...*.\*.# *  .#.#. .. ...*....... ...  .# ...#*. \..... ..  #... ...\..#...* .*. . #.# ..  .*..\ *# . #* *.#. .. . .#. .* . . ..#.*# .#
#..*...  ..#.. #..#**. .... .# .......  #.\.. ..  #..*.......*#... ..##. ....* .#*..***.*...  ....    #*. .#*.  ** ...  \*.*.. \..*.....*.....* *. ..#
#..*.*... .*....#.\.  ....\\.** .. ##*..*\. *. *\  #..*. *...#.** *.... *.. .#.. ##..\ .*..#.*..\.* . ...    ... ...  .#... *.\#..#..*  .....#..... .#
##..# .... *.\..# #..... *... .*#.\  . .**.. .. #... .# .. ... ..*  . ..#.....*. .*#.... ..\.  *.. ....\..* *....\.#.#.. .... ..# ..#** ..##. .. ....#
##*.. . *. \.#.........#......# ..*  .#.#*... .... ..... *  .\.\# ..*# ...#.*.. . .. *#..\.\## ..*... ..#\...   . *. \. ......  .\*#.* ....##...#..#.#
#..\ .. ...*.\.  ##.*.*#...#....*#..\ ....#*# .#...*. .*#. #\.#....... *.....*.*...* .\ .*..##.# .*.....\.. .  ..#.*.*\\**.# .*..*#..  ..\. *. *\....#
#..# ..*.#...#..... .*\.\..... ..... ...#   ...... . \*.#** ...  .*.# ....# .##.#...\....*.* .# .. .. **   \#. ...  *....#.. \ ..  ##*...\ . #..  ...#
#.##*# .\\ . . *#*\... ...#.....  *.......## *.... . .#. ... .  ..  .#..... # ..... #*\.. ...*..  # .**...#. *..\ \ ....#* \#. \ .#*  ...... ... #..##
#.*.#.*.#..... #.............#*#*. #..#.# ......*..*..\#\.....*. *.... .. ......*. #\. . ...*..... ... .. .......**..\ #... ..#### ........ .# .\.#..#
#.*...#. *.. .*. * ..* . .. *.....\.*.# *.\.#*#......* .# *...... . .... . \..... .*....#..* .#.... .* \. #..*..# .#.*.. ..... #..*. *# #.\.\...\.*..#
#. .###...*\ ....*...#.* ..# # . .. ..*......* .....#...... . . .#\.    .  ..##.#.\.#.......  #.*...  . .... #*.#.* \*..#*.\#..#........* # *........#
##* #..   .#..  .....##*# ... ... .*.\.*.*...# * .*\ .*.\....\.. *. ..*. .#. ... .*  ...* .....##... **...*.\...#.**..#.*. .\#.. .....*.** ..... ... #
#..*..*.#\ . .  ....... ....# ## *.....#.\.#. .. .. .* .. .......#..*.....** \.*.. .... . . #.*.... . ..# .*..\ .#..... .. ##  ..* . \....*..#..#. .\#
#*..#.... ...*...* #..... ......#...\......#.#*..   .# ..* \. .. \*## ...*.## \.*  .\ ......#....#*.. . #...\ #.#...#.* .. #.*..   .. ..\..#.#*..* . #
#..**...*.*... *....#. . \#..\#.#.#\*..  ....# *.  #*......... ... .  .... ...#* .. ...*.. .. . *.  .*...# ... \.#*....#.\ . ...... . *.....#. \#. *##
#.....**.. .. #..\..#...#.. . *....\.  . .# . . #.#.#.......\*..* #.. . * .\*.. .\  ... ....*...#\.\..   .* .#.\ ... ....\ .. .#.*..#  *#*. . . .# ..#
#..  #*.. . .#  ..#.  *..#*.. .\#.. ..*.*##.....*..\...*  ..*... .*.*.#....##.#\. ##. .#....# ..... . #.. #.\ *.. .##.*.. . . ......\....*......#....#
#.*.. ....#*\ . *. * ....##..........*...*........ \........\* \ ...# ..##. .  ..* . .*.# # ## ... .* ....*... .* .\ #..**. # ...#.. .... *\.*\**.\ .#
#. ..\ ...*.#.\.. ..*.......* .  ..#.\# * ..  ..*. *.......#\..#*  .##..\.##.....   \...\. .. #*...  ..  .....#....* *#....  .. \## ... #\.\ ...  ...#
#..#. #...\#..#. ..#. ..#..#.*# ..\*. .  .*\\.....  * *\. ..  *... .. .....\...\ .. #. #.*#...* .   *........  .**......\*.*.. . ..  ##.#\.. ..#.*...#
##......... ....#  .*  .. *. .*. .*. .... .  #.\. . ..#.#..... ..* ..\\*.....#. ....*...* *....#*..*.........\.*....#\ *.  .. # \..... #.*.\.*. .* ..#
#.*..  .#... **..##........ ...\..... . .#\ ..  . . . ...*.  . *. #...\  .\.  .   #.......\  .....* \..# .*\ .#....##.#\#*...... \#........*#.*.*....#
# ...#.........#.....\....\.#. #. . .#**.  .. ..*.. .* ...\..#..#\..**.. .  ......\... .. .\\ * ...*##*...\... ..#\*.#.... ..  \  ..*# .. . .* .. .. #
#. . ..*....# \*.  . ....*. *... . .#...\... ..   .# ..\.  .. ....*# . .....*.*##\##..  .*..\. \#....# *.##...**. . ...  ..# . #\##..* .........*.. .#
##..  . . . . . #.. .  ......**.*. .# # .. . ..... ...\... .# ....*.\*. .\..#....##.*\#..*  . . .#.#.# ....*#*  ..*...*..*....*... *.\. .#....#.# .*.#
#*. *##..  #...\. . *.* ..\#...#* ... #. .  . #.... ##.# #. * .\\..## ..  ...**...#.\* *#*.*...\...#.#.. #..#.# ...### \  . \.*...*\.*. .#.**.*# .#. #
#.* .*.  .. ..** #*\...**.... .#...* \ ...#*.....*#  ....* . . .\..* \..\#..*.*  .. ..*.\.\.  . ... . * ...\*\ #.......  ..\.. .  ..... ...... *...#.#
#. . #.  ..\   ...........#... .  ...\.*...\.#.....  .\. #.*....... ..  **.*. \...###. ..#.. #.. ..#.... \. .* *.*\. * .... R ...... #.#..*.........*#
#...## ...# *. ...  *.*.\...\*.. ##..###...*.. #..*#.*#.#*. ..*.. ... . *\.. \ \.\.... .. ...#  ... *.  .#.. #... \...  ..**.#....\...#* . ...\.*.\..#
##...*.... .    .. *.#  ........*..#.... .....     .#*##. ......# #\. \#.\*. . .. ..... .#.....* \.. ....\* .*..* .... ..\...  \ *.. *# .......\....*#
#*. #.#  *.*\..*   ..# .*.....\.... ...#.\.. .#.#..... .....*. . * . .... .#..\. .*#  ...... ..#.#*   ... **.*  #. . .. .#.....\#  #  ........# ...\.#
##......*.#...#*  . ... ..\. .*..#....**.*... .#.  .#..*# .\\. ...\..#  .#. .#...*. # ..#..# ......#.. .#. . ....*.  . ....#. * .#\..... #..  .....* #
#... .. .... .... .#..*. . ..*.  #.....* ..#\..  .\# # *..##\\ \.#..#  ...#.*..# #. \\   . ....#. . ....*.#.*\ ...# .#..*.#* .*......#.. ..   .#.*\. #
#\.\. . .. .\. \.#.# ...#........ ....... ...*.*\*. ...#... # ...*   #...# ..\......*. .....#..   .*.. ..*.\\**. ..\** .#..\#\. #. .# . . * #...*.. .#
#.... ..*.*.. #\...\.*.......\..* \.......  ..#\.. ... .... ... ..  \...... . .*..*.*. ...*...  **... ...*.**##.. #. *.*.. * ...*#* * #..  ..*..*..###
#* ... .*.*.#.......*# ..*. *#\ .### ...\* ..#.\.\.......  * . \.\  .#......#.  .. \#*. *#  *..... # .#*.##*. .#. *.. ..* .*  ... #*. ...#*. * . *...#
#.. #...#*.\..#....\.###.. .**#.\.#...#.#*# ... #.*.#......*....#.*# .#*...  .## .. ..\. \#*.# #\ . . #... ##***........... .#.... .... ..\.\..#*.\ .#
# ..#. . *..*....#..#..*.. .*.## #....*#.##.#*..* * .*.  \\*.  *..... ... .. *.....\.....###...\  * .\.....* .**\ #.  #*.\\ .*  .#.#. #*\   ***.*. .*#
#... .*..# ** *...#...\ ..\...#... #.#... ... .*   .\.#... ..*.*#.*.#. ..\  .*#* *.#* ....#.. \..* .*.# *...\. ......*...  ... # * #.. ..**. ...*.\. #
#\ ** #.##. .**..\.#. . *..# .. .#.##.#...........*..#... . ....#  .*. *......#.... ..# ...* *.*#... .* .\.# *.* ........ .....**#..#. .   .#..#...*.#
#\..\.. **. ....#. . .. . ..# .... ..*#. ... .#.....#.#.. .*  .*..*.#....*.*..#.. \.#\\*.#......# . ..*#.........#..  .... .#. . .... \..... ...\ ...#
#\.... .. .\......  ##...  ....#.*.... .. .  # ... ...*.#...... .... \ .*.. ..#.  ** ... \. *.\  .*. ...\#. *.#*.\*....*.##.\ *...\.* \. .\#\*#.#....#
#..*\##\#.. \. ... .\\*.# ..# \* #...... ...*##.#..\  *........* ..##. .*...\................ .*.. ... . ..*..#*.... ....  ..... * .* ....* \ ...#...#
#..... . \   .. *#*. \ ... ....\*.... .*. ..###.* . . **\#*..*. ...#..... ..#.*...*.*.#....*. ...  . .. .. ..##.. . #.. ..# #*.\# .. #*..#\.. ***....#
#  ....*.#..... ...*. *   .. .. # *..#... *.*....... #.\..#*..*.\  .*.#.#.*.**.. ..*.. .*... . #...#.*.#.......*...*........*. .*. .. . . *#.#**.. . #
# \#..##...*#.... . ...###*..  . . .\ ..#.  * . .. *#... .... \..#*.....\. ...  .. \*. .* **....#.....\*. .\......*....#*..#..  .. **.#.#*#* .#. \. .#
#..*.......* .. .\.... ..\ ..## .   #..#\ *# .. ..  ..## *. ...*. .*.\. ........... . . ....* \...  ...... .  ....\ ... ...... *. #...\ .#* ... *..# #
#.# ..  ....*#.\# \.*. #. .........#.. ... .* ......*. .\...#..*.. #.*.    *.... ..\..\..#*. .#. #\. .. *#. . #.* \\.** *.*....... . . .#. #*..#.... #
#  ....  *. ...#*.\ ... *.\..# . .##..* ... . .. ..#.....#*.  .......\...\\*** ..\. ....* .## #.#...#   .. #..#......... .. #. . #...# \\ # .\..... .#
#.  ....# \.  ... . . .. ....... # ..#.#.\ *\*#...#\. ..# . ....#..*.. .# . *. .\*.*.. \.#... *....# .. ..**\. *..#.. . \.* .... .*...*..  .* .......#
#.*......  #.#.**....*. .**.\.. ...**##*........\... #...... .#. .\.. .\.\  ..#*\.... *.*.# .# ... . ... *.\...... ......... #.*..##.* .\. .\ ... #. #
#. ..#.. ... *#. * #.....*......#  ..... ..\. . ..\\#.#..# ..* .# #*..*...*.*  *  .#.. ..##..#... ....*\.. .. .\#. .##.\...#.....  .. *..  #... ..#..#
# #*......*# ..#  ...#...\##.*...*.. ## \.**....*. *# .  *  . #.  ..* ..*\  ..#..*. . . .....\ #*..*.\  \#......*# .\ ... *.* #*... .... .. **.* #*. #
#. . .**...*.\* . . .....*..# ...*#. \*#...*...*. .\\.#.. .... *#\.# #. # . .\.#... .. ...* **...  *.#...... *\#.\....**...... ....#*  ....  .#.#....#
#.  ........#...* ....* ..# .* .....#*...#.# *..#....#....*.  ...\...*..**. ...* # ......*\*...#*.. \#..*.*. ..... ..*.  ...# ...  *....... ..*.**  .#
#.. ...#.. ... .#...\#.*..*# .*#\..#....*#.#. .. #.* # ..* # #... . \#.*.  * .*...**.  ..... .............#..#. .. *..#*.\**  .. .#.*. . .  .. ....#.#
#...*....\.   * ..** ..*.. # #*.. . ...*.....\#.\...#. . \...*#  .. .**...*. ..#..# #... ..*. \....#.#.*.*. . .. . ... \....  ...... ... .....#......#
#  *.*\  .\. # .#\..*. .....*. *.  ... *.*# #.* #.*.*. ... ....#..\#\*..##*##. #.*... .##  ... .....# .. .\. ..\.*.....#. .. *... .\.....*# ....\\...#
##....  #*... ..# .\.... ....\ ...*..*...\ # *. *\..*. #.* ..##...\.  .....     ...\.. #......\#...#...\...#.... .#...... # . . .#.*.*....\\  .#.#...#
##\....**.....*..#.#.# ## ..\*..*. #. \ *\.*..\.....# .....#.. .\# #*. ...*...#*\ ...*.#.**.. .#...... .* .... #.#.*...*........##\...   .\...#..... #
#...##*   ... ....* . #...\.  #. . ..*#.....#.  .... *..* .#\..... ..... #....#......#. #.\....*.#....# #.....#..#.  ... . #.\.#* ......    ***...   #
#...*... . ..#..#*....#\.\.* # .. . ..#.... ... .*..\#*.. .......*. . . ... ...#..*.* .. .*...... .#.#.#....*. .#..........*..## ..* .. .... .  ... \#
#*. ... ..#..*.... *#..*.\\#*...#*.....\*#.#.......  ..... #\..\#... . *.#\ . .... ..... ..# ...## . .\.......... ....* ...\.....*.. ..* # ##.* .....#
#. #..#\.#..\.*\. *#  ..#.  .  .#. ...* .#.\.    .*# #.... *#  ..* .* . .##..... #..##..*\ ..\*.*.. *# ..#.....*#..\..  * . ...**....# \..#. .. . #..#
#..\. .#......#.#\ *#*.#...* .# * \\.#...*. ..... #.   ...#. \  .. ##.##.  *. ..   .\..*.\.. #.. .\.....*  . . #.*\# *... #.. #. .  .....#.....*. . .#
#..#....#.. . *..#.#.. \.. # *..#. ..# * *. .....*....*..  ..#..\  \ \ #  *...   #.  .\..\ ........*  ..#.... .. .* .... ...#*.. *...*  ..*..# .  .*.#
#...*....#...#.#*.#\.#...  . ....   ...   *. ..#...*. .. . .    ..\....#.. ....#.... . ...   .... *. .  ....\ .  #**..  #..\.#.....*###*. .......... #
##.*....#*. \.... *# \ .* .*.#  *.. .#*....\......\..**#\ *...#*  # . ..*.#***..* #.#.**.*.\.. .... ..*  .#*.# .*.* .... .\.  .....\...  *  ..... #..#
#..## *.....*.. .#. ***.     \... . .  ...*..\. ...**..... . \..*\...... ....#.. .. #...\. . ... .. ......#\ ..##.#*#.. .   .#.........#.....#.*#.. .#
#. # ..# .*..... ..#..  .\\.\.. .... \   # \....#.. .. .#.*#.. * . *.*.## . .... ..   .*.#. ...#  ....#.. .. ..\  ... ..*..##... ..#. .#\##. . \.. *.#
# ...#*.. #..*.. .#...#.*...  ..*.#.\....#. \#*..*#...*...#\ .  .. ... .  \..  ... .#.\.. #......\*#...*..  \.. .*\.. #...\..*.#.##...*.#   .  #.*...#
#.\ ......  ..*..........#*.##**. . *.*. ...* .* ...\.#.  ...*\# .*#.*...  ..\..   #*#... . **...*....\.. ...   ... ......... #\ ..#.... #\*... ... .#
#*#.# .  ..... *.*\.*.*...#  ....#. \.  ..#..*  .... .. . ...\#. .. *.# #.. .. . . . .*. .  ###   .## # #.*. #..#*   .* .....*...*#... *.##. .. ... .#
#......  . .......... ..\\..##..*. ..# . \.... .\#. ..  \ * .# . . ...*....\ # .....#** *.*.\*.  *#... ...... ......\..*.. ##. ....* .\ * . .. ......#
#.*# .. . #..**..*.\ ....... ..\.*. .  \... . ... #...    * *..#..\#  **.... ....#  ..\.#.\# . .  .... *...*\....\.. *.... # . . \ .....*..  *. .  ..#
# ...\...*.*.#... \. ...*#..\.# ..... .#.#.....#.#*#\.*....##.*...\..##*... ..*...\. .... ...## .. . #. ... .   .....*\.. . ..#.#.*.##\*.. . . #. #..#
# .*. ........#.#.  \ .*.....*.\...*..... ... ..* ... .# ....*#...#\...*.#.\ *. ..#.........*. . .....#.*.#.##...*..*.. ...#.  .##.. .....#..\*\.*\.\#
##.....\. *.*\ . #......#..  . #........ .  . .\. .* . *.. .#*.. . .\.#.. . ............ *#.\...  .......... . .\. #..\.**\.  . .. * *.# ..#.......  #
##*....* . .*....##...\....#..* .. *..#  ...*.#....#...# ...\ #.  \*...#.#.#... .\. . .*.* ..... ..... ......#.  *. .*#.* ..*..\#.. # #..#.#.  ......#
#.* *  .**#...*#...*.#**.\. . ..*.#\..\*.... ... ..  \.*#. ...*.*...#. ..  . . .......*..\#. ...*# . .\\#.#..*.*.  .. # *...  .#.# \\.#. .. .**..#...#
###############################################################################################L######################################################