######################################################################################################################################################
#....  .*..# . ..  .# . *.. .... . . ..#.......\ .  .. \*\\ ..... ... .....*....\..\. .... *..... .**. ......#.* .\.  ...   *..*#..... .##.*..# . ...#
#    ##......*  . . ..*... ...#. ...\#.   \\ #. **\..*\ .. ..#.# ..#..*. .... .# .\..\......#* .#. ...\ ......*......*#..#.. .*. ... .....\  #.. .#.##
#. .........  ... ...*.*. .#....#..*#\..*...#*  ...#..#     *\ . ..#.. #.. .. ...#...... \.....* .#........\* * ...#*.# .* ..#. ...**..\.... ..*.*...#
#. .#.. ... ..\ .*.. \.###.# ..  \*.* ..\.* #.*#  ...\.#. ** ...  # .   *.*.. . . #..# . ...*#...  \.....   #.#... *# .   ...\ \ .\ .. .. .. *. ...\##
##. ...#.. .* ..*....#...#...*.\#. ..#. ...\ ...#........*.  ...# ...... . .**. ..*..*......   ... .  .  ... #. #.... . ... ..  . #... ..* ..#....# .#
## . *... .\#*. .\.. . ..#.\..... *...# ..* ...... #.#.# ... .. ... *. ............#... ..... .. ### ...###... \..#..\.*... .. #...*. ... .#..* .\...#
#.. ... . *.  ..* * .#\ ... .#.**.  \ ....#. ...*#...*... \..#.  . \  . ... ....  . ....###....#...*. . #...... . ...# #    *.    .#.... *. #..#*...##
##\. *..*\.#.# . * .......*..*.*\*. .. *..*.*.....**..# .# ....\.  .... .......#\*..* ......#.. *.. ###. .\  ..... ........  .  .  .\ .......*  ..\.##
# *.......\\.  \.....**. .  \. ...#. ..\ . . .....*...... *....##.#*.. .....*... ..*....\.......  #.. . ..*..*... #. # .......\.   . #\... ..* \ # \ #
#...  #.  ..#..*. .#.*  .\.*.\.#...*.\..#..  .*...\\...** .. \ ..... .#........#... ..  \* #..\.... .*...\.  ..*   .. .. . .#.\.......... **.  * \*..#
#....  .** ......#. *.# #.# \*....# ....  .#.\..\##.*.** . .#. #.#. * ..\..*..#.*  *. . .*.  *# .......  ..# ..* . .*....##   .**..#. #..  ....#*.# .#
#...   .  .. .  * #*#....... .  \* .. \ . . .*..##...**........* .*..*. . .. *.. ..# .*### .\..\.......# .#* *.*...##...*.  \*  ..* *\ .*\.  ..... ..#
#. .....#.**  . *....* .....\. *.*....* # ##....*....*.#.. ..#*..... ..#*..... .. ..... .....*..\ .    #.. .#....#...#** .*.##***.#.\\.*... # .# #\..#
#..*...#**...* ..\.....\.#*\.. *  ...\ ..##.....  ....*...*.*#\. \ ..**...\.\  . *.*\ *#..#.*..  .. . \.*#.#.#\. #..*. *..#.....#*\*.\ .. *....... ..#
#. **#*. ..*.#. . . .. ...\.* *... ....\. ..##.\ .\. #..*. \..\.#.#..#.. *........\.* ..#..#. #. .#....*..#. ..*.\....\ * .*...\*\. *#..#..\ .# .# ..#
# . .* ....*\.\.... #..\.*.# **..*.*..\..*.* ......... #\.\.... .\ . . .  ..*\...#\.........*.*# \.*.* .. ...\##*.*. .. . ..*.   ..##........#.#*....#
#.*# #.\\.#..* ..\.#\..#*..*..* \......\.*.. \.... .#.**.. ...*...# *..   *...... *.*  ...##....*.   #. *. .\#..#.#*....   .. ........  ...#..\.*.* .#
#*#..  \.*\*..\\...*#. . ..... * . \ . # *.   .. *..*\*\\......*.............\#.#.\.. . .#..\**. #......*\  ..*.... \   . . #  # * .  *.# .. ... .  ##
#*..... . *  \*#... \*\#\ ..... ..*  .....\... *.. # .   . ..  .*...  #..\..**... ..*..... .. .*  ...\ ..#.#..... ##.#... \..  .* ..  .. *..\.* .#.. #
#.... .  . ##. .#.*** .\... . .#..\*#...* .*#** ..*.\..\ #. ..# .. .  # #*.*. #..#... ..*** #..* ......\..##\. ##..  ...#.\.... **..... *#*...... ...#
#..  .*...#......##. ...*. .. ....**... *...  #...#* .. .......  .*......**..  \ ..*..#...*.....\. .#*..#.\.*.  .. .##..#... ... \....\# ....**.\**.*#
#\..\\#*.....*....  *  ...#. ..#*. \. .. ...*. #.. ##.. ..#.#\..##.*....* ...*. .**.#..\. . . .#\. #.  ..*.# ......*.#\# ... ....*.\#*...**.*..**....#
#\ ..###...#.\..*..*. . #..#  \...*..#... ... ....** ....\#..*. .. .....  .\#. ..*.# ... ...*..# *.#...\*...#. ... .\  ..... ..*.  . .#*...# . *.....#
#. ..\.#*....# ....  .#..\*...*\.*.\\*#. *.......# .#.. .. #  ..*..   ..\  .#. ... ... ...  #*..\#..*.#\.#.......   .#....*.. .*.* . .\.\# #.*.#**.*.#
#.#..# . ...*. \... .*##.#. ..*..*...# .*. .#....  ..*.\ .. .. ... .. ...*#.* ..\ . .#\ #..# ..*  *....#....#.# * .... *. .#. . .  *.. ... ... \ ... #
#.... .\ ........\. ...  ....#. *#*...# .*\#.....*\* #..*\#....  ....#    ....*....*.* .. \.   ..* .#.. ... #..  *..*.#...## \ ..#. ... ... .#.#* ...#
#  . ...*#*.... .. ...#.*.* #.#*##..#..* .* .#\..  ....#\ *\.**.\..... #.#.. .... ... .. #..# # .#.#.....  . .... #...#.#...*..........#*.....#... ..#
#\.. *.#.. .. #... #.* **  . #...\ . *..*#...#.\.*.#..#\*.\.. .... ..*. * .*.  ... \ ..\ .#\..* .#......  \. .#..# . ..## *.... ...\.\..* ...... \#..#
#.#..\\ .. .. #.... .#\..#. . .*##.....    ...#.. . ..##...#.. .. *.#..... * . #.# #*...... *#.# ... ..\..#. \#...... .* *. ... .*... #....... #.*...#
# .  \....* . .. . . *. ..# .. .*. . ..  ...#...... .\..........*..*....*.#.... .*..  ..*# .. .. .........\#.....*.#..*.... .. \. ....##*. .. .*..#\.#
##..  ....\#..*.#.. .....\. . .\..*. . ..#..#  ...\..*# ...*#...*.... ..#*\. .\##...## \\.......**    .#*# \..... . .\ .#*.. ..*. .# .. . ...#.*.# .*#
#\..#....# .*..* .* .. # .. ..\....... ... # .**.**.#.#.*\. .#. . ..... #.\..**. ..  ...\\..#\* ... ..*.......\#  ....#.*..\# #.  . ..*.**#.***...*#.#
#* #...  . ....*. \. ..   .* *.. *. *..   .. ....#*\..#.........*#\#..... .#.# *. .#.*.... . . *.. #.......#*... .....#.\ .# .#...#...*#. .*..* #.#*.#
# #\#... .\. ..*#.#. ..#*.\... *\..# . .#...#.\....\ \.*.\.*.#...#*. .. *# ......##.#.. \*. .... #.. ..*  ... ..*... #.. .#... . *....*#.#.#\....* ..#
#..\........\. ... .. *......#. *#**..#*.....*. .\ ............... \.... # #. \\..#*.*.\ ...\. ..*...* ...# .*. ..#*... ..*.#**.*##..... ...\..* ....#
# .. .\..#...*.. #*. .# .. .# ...... . . .*\# ...   ... ..\.*\. #.*.\. . #..  . \.\.#....   ...#.....#\..\......**.#. . .... * ... .*\.#.... ..\\.. *#
#...#. .*. .*....#..*.\  .#  .*.... ..*.. *. **.#......#.*.... . .*....#........... * ... .\. .\. .\.\##.*..\.  #* ...# ..  .#...  **. ..# ....#*.#..#
##.....\ .# * . ..  #...  ..#.. .* ..*..   .#...#.. ... .* .....#\  *.##..... #\#.. ..... *.\*. .....  ..*......\*  ..*. * . *\#*.#.#\..#...... #.. .#
# ....*. .* ... .*..#   \.#. \*. *..**. .\ *..#    .....*#  ...... ....... .... .# ....  *.. \.\.\.  .##..*.*..\ . ...* ..# *......#.... . .. .. *. .#
#...#.. ..#.#. ... .. .. .. ..#.....*.  ..**..### .\.\..  ..**... .*.. ... \ .#. .## ......... \..*...\**. .. *.\.#. *..# ..* ... ... .*. .#* #.** \.#
#. #... .*.. * .\*..  ..#.#..*. . #\*. *  ..*  ..*... .....* \....#. .....  . ......#.. ##*.....#.....*....*...##.\ # ..  . ..*. *# *# ...\ ..\.*...*#
#\. . ...\*..*. ##...\\ #   *#*\.* .....  #...*.. #... ...... \.. ##..#. .\*  . ... ....  .\. #... *.....\.#  ..*..# .. ....\....*.  .*  .  .  .#*...#
#........ *#...#..*\.*.\. #...#.\#.. . ...  .. ........\.\.. \  \.*....  ..* .. .. ..# ... * *.***.\.... . ... ..#\.   . .#...#....\...#. #.. #..**. #
#..* .#....  \  *\**.  .. .* .#..#...#.*.# .*...   .. .*.....#..\ #....#.#. ...... * #*# . . ..**.......... #.. ........*..#..*. .##*  *.#...  .##..*#
#.\....\ .. ..   .....*..\...... .  .. .**.. ...\.\.#..#.*.*#.....*..... ..* ...  .... . .....#..***. .. #.##. #*. . ..#*..# .. .  .... . ...\. . #..#
#. *..#..........\....  .*.*......#.*.. . .... . ..... .#.... ..\. ... . .....\## \#   ....*.#.. #**.#..#....\.*.#. \...\. ..*...*# # ..... . .......#
#* . .\..\.  *#.#**#.#..*#..*.*.***\*.. ...#.\.........\.*... .#*.# . ...*... # . .*\..# *... .....*..\   .#  . \.\......#  .*.... * ..#  ..   .\....#
#\#.....**.* *.... .  * .*.** \...***#\.. ..... #..###. .*.#. .*... *. . \\.#.... #. ... *...# .. .....  .##\ ..##\...... . .. .* ..#.*.. ... ..  ..##
#.*...#.\.#.... *......#.. ....*.. *.\\#.. ..... * .. ...\. ... ... \.*#\ .#\#*..\. .*\..*..# ... ...# *.*...* ..... ....\.....*.. .#...*.  .*\...\ *#
#. .  **\##.... .... ...#..\.*\..#.. ..#.\. . \......*.*.*. *...  *.#..*#.....*. .\.......*  * .**.. \. ...  .#.# ... ...\.... \..##.**.\# .#*..... .#
#\# #. ...... ..  # .. . *... ..#.... #*. .....   .. .....*...*..#.... .*.........*.  .***..#...... #...*\..\  .#....*........ ..#... .#. . .. . #...#
#\.#...*.#. .# ...#.*......\   *  ..#......*..\. .\ #...**.. #..##* *.**... ..  #.. .  .#..*.*.##*. *.. . #.*...*. .**.# \.*...*.\# . *. .......#.#. #
#.. ....# \..*# ..# .....*..*.. .. ...**.   *... ..  **....#\. ## .. ..* .\.#.#...  . # #..#....*...\ *.# **## .#..\ .*...#\. .\#.*......#..\..  . .*#
###.#  #* .... .....*.  #...#..# ##  .#\.. ..*... ..\.. ....#.*. . ...  *....   ..**.#...#.*. \..##.. .  . .. . . .... ..* .\...#..  ......##** #.. .#
#..*....  ..#.   *. \ . ....\.# ..#...  \..\ .\ *......*..#.*..\    . #....\ ...*......#.. *#*.# #.. . .......  .\..#. *..#..#*\..\#....... *. \.....#
#*....#.# .*......... ..\.... . #* .. .. #. ..   ..\ ...*\.   .#. . .  ..*.#.\.  \..  ..**\..* .*..... ... . ............. ..... ...#\....* ..\*  ...#
#..\# *.  ........*# . ..*.. **...*#. ....\.. #.#..#  .\#\.*  ... .# .. ..*.*#... .*.  ...   #**. ...* .\.*..\..#......* . *.* ... #..*# .    .... .\#
#. ....... *. **.\ ...# ...*## *....*. . * ..##.# . .....\...*#*# #. \....*.\ .#* ..# .... ..*..*.... ....*.... *##..##...# ... #...\*.*.*... ... . \#
# \\. \**#*#.  ..#.#.#.#......  \.# \..\.#.. .*.*#.. #..#..... .  #.. .#..  #....#* . *.. .* #... .... .. . ..... #. \#..*.....#...... .. .. .. ..* .#
# ...*#...*.#... *..# *. ... # .#  .. #...\.*. ... .  ..#..* ...#... *. ..*. *. . \\.*. *. ..*.#*.#. *.. *...*..*. ........ .....\*...\ .. ........ .#
#. .......  *.#..... *#.*  .#.  \\. . . #. .*  ...\. .#. .... \#..#.  #.\..* .#.* *#.#*. *.#..... ##  ...\. # .# ...#*...* *.. .*.....#.. .# *.. . ..#
#...*.. . # ... ... .#.*....#  ..#. \..  ..#.*.#. ## .\..... . ... *. .#... *..#...#... . . .... .#\ ...*. .\... .#...#*#...  ........ . ..**.... ..##
# .    ...\.\*..# ...#..*. \ ...* ....  .#.#. ..**... ..\...#....*##.*..#....#.*....#... ....**.**... . ..\#.#..   #\......# *.. .#...\**..... #....*#
# #*..##. * #. ..*.  ....##*.....#*.....#........*. ..#..*. ..#...\#...\\ .. .\...# #....#..\. ... ..\*... . *#..... .#..*....*... .*..##*#.... #*...#
#..*\#..# ......#.. . .. #...#.. ...#...#.... .  ...##.. ...*   . #. \ ... ..* .  ....##\.*.. ....... .  ..#**#..# .*...... .\ * \  \#.. #. ...#.....#
#.. .... ..* #*.... \.... ..#...# .# . .....\  .#..... ..  .\*#....#...#*. .##. \. .... .. \....*#.\   ...\..#.#... .. ..........\.*\.....*. ........#
#*#..# ...   ..\... .### .#*. . \.#.\.#.. *. ...#.... *# .. ..#...........*. .  \ .#.*#... \. . *...# .#.\\ * *  \....* ...**.  ..#. ..  .*#.. #\..  #
##*.. # .    .... ..**...#.. ....\ #\.*.#....  .......  # .. .##...\**. ...*#  \ *.**.*..#.. . .*#... . *.... ... . ##  #.#.*.#. ..\\  . ..*#....* #.#
#  **# * . *...\#.... .... \ ....*......   .#..*#...*.......... #....  .*#..#  .......*..... ..\.#....\ *. .... ...#........#... #...*. .*.\\.   ..#.#
#...#. ....*...\.\..*. \..  .. ..#...#.. ....#......  *....*.. *# ... ..\#.#*\*#. . ......*.....  .*#. .. .#\***.... .. ..#. .\... . . .\.*..\ #..\..#
#.*...... # #.*\..*.*#...   *#\  .  ..#.. ..#......#..  #......\#.. .\. *...  ...##.......*\....   . .. . *. *\ #. .*.# # .*...  *... * ..*..#*..*...#
# ..**    . .*. ..\ ..*...#..\...*.*.*.... .*...\.. ...#. .... ....#*.*. .#...*. \\... . . \*..# ..\ * .*....***.....*..*.#.*#...** # .\... *. ..*#..#
##* ....\   .*. *.*..**\#.....*...*.  .#..# .# ..  \ .  ....*#.*. .#*... .*..\...#.### ..  *.\.#\.. ..*. #..*..*..# ...* \* ....   ** ..\. ....   ...#
#... #...  .. \..\.* ......  #... .......*....   #.... ..\..#*.*...# ##. ..*..# .... \#.#...**...\.#.....  ..# ..*#..... #.........\ *.\...# *. .#.**#
#.  .  #...  \..#.... ..#.........*...##*..... .......  .\... .#.\.\.*# . .  ....#.. ... ###  ... .\  ..*.\\ ..*. \.....*..  .*\. .*...# ..#.\ . . \.#
#* . ....*....*#........ . #.\.*.\. ...... .... *.....##.\... .. ... . *. \. \ ..*.. ....  ...*..  ..##...#.. .*.\. ....# .*#.\..\*. .\  *.#.#. ..\*\#
#.#.* . .....*.#..#. \*.#.   ..... . ..... ..... . *.##......**#. .\.. #....*. ......*## ...\ .......\.. # .#.. ##* ..... *.#..\... .#.\. . *. **. .*#
# ......# .#**..# \. ......*..# .......\#.. \. ..**  . ... .#. ....*..#..*.. ... .... ...#.*.# ....* . .#.....#.# #.. .* ..... .....#.\...#..*..#..  #
# ....*... *...*.#\.#...*.  #  .....  \*..*.\. . .. #  ...#......#....*.#*  ..  \###*\.... ........ #........#*. .*.#.. *.....# ..\..\#...*. .*. ....#
#** ...* .  ..\... #. .##.*..*#*# ....*. ..  ..*..\# . #* ..*..... #. .. ..\*.#\...#*#......   *\ ....#.... # .\. \.#.#.\. #.. ...*. .##.. \..#.....*#
#..\. .*. #  . ...  .#.\*##.*.*#  *.# .*\#.*# ..\. ... *#. ..... .  ........... . .*\.*.#..  * .* #.... . .# ....* \...... .. ....*#.\ .. ...#\.....\#
#.. .. . \.....** *.\ \.. ....... .##  .. .... ..\.. . ..\*.. ...... .. # .. ..* **...*.... ... *\  ..*...# ... ..\*.* *..#. .. \**...#*... .**.*..**#
#....  .....*...*. . *...##...*.*#..#.#.... ..   *.... *#  . #..... ....#. .\.*.\\. \* .. ...*...*. * .... .\.\..*... ....  . . ..# .\....\..........#
#..  .*.  ........  ..    #. \....#.\..#.#..#* ..\.....#..   .. \#   *.... * . .# ... .#..#.. .\ . \.#..#...**\... \* * .  ##..... #. . *  . .. ...**#
#.#. ... ..\\.. * #*#.* ... \\..... .  . .. .*.#*.\ #...........***.....*\..\.##.*... ..* ...# .... ........*.. *..\*#.#. ...#..# # # .... #*\ ... ..#
#.*#\##.. ##.#.* . ...\..*#.  #..  \ # . ##*#.  ..  .* #... ...##...*..*.*.#*#*\\ #\.....  .  .....#.*.#. . * ..  ....\. .* .*.. ..... *\. ..#... \.##
#.  .. ..* . .#.......*.... *. ##...#..#\.#.#\\.....#.\ # ......**......#. ...  .*.  *...*. .*.**..  .*.*.*.#..* *..*.* . .# ... .... ..\#.* *.## .#.#
#.*#*. ...#....#..*  #.. .#\......\. ###.. ....*#. ....\*#.......    \...##.* .... ..#. # . ..**.... .* ...*\.. . ....##... .. ..#.# ...*. \.. ...*. #
#*  *.* * #\*..\*......** ... ..... . ..\.#*.*... # .. *.......... ..   .#\.. #. ........*. .#** # .* \....\#....#...\*. ........*....#..   ...# .*\ #
#....\  ...#..#.  .....\....* .# .  .. *.. ... .# ......#....\. # .# ...# ... ..* ....#*.* ... .** . #..# \*.#. \.....  ......** .. .\ .. .... ...#..#
#..*..#..   .#. . .... ....# *....*.#.  . . .. .. * \*.**.*.\\ #. ..##. .#..#  \. ..***....# .#.... ....... #.#... ..# . \.... .#.\......   .. .....*#
#*.\.. .#.... #.....*......\*.... #\..#.. . #.*. \ .# * ... ......*...* \....*..*.... ...\*.###.........*....... . .*.*.\.*...#. \\......... *..#...*#
#..\.... ...#...*.#... #  .. ..#....#####.*\.. .. . ..  .* #...#** .  .\.. .#.... #. #.......# \...   ##.. #....# #...*..##.\*..*\.......*\.....*... #
# #....  .# ..**...#. ... .. .....  . *.. \.* # *. ..# ......... ...* .\..**..* ..#*#. ...\...*.# *.*....*...\*..*.........*.#.#.. . ....*..#... .. .#
#* # .\\... ..\.........*..* \..*. \ .#*  .. . ..... # .. \.\ ...*.##.#... #.. .##.*#..\\\. #.... .#.. .#  .. ..# #.   #..*.#. .*.# .*..** .#......*.#
#.\.. .\\.**#. ..*.....#...  ............ . .....#. ... ..* .... ......* ...*....... . ..*...##\#...*.. .##....  \. . .  . \* \  ...\......\*.#* .. ##
#. *. .* ..* #   .    .*.... .......#.#.*.....#.  ..*.. .#.#. .... *.\. \. ..*##.# ..#. ...\... ......# \...*  .......R.*.. . .. .##...\....\.*....  #
#......*..*.*... .*.\*. ..... . \* .#...\\ ...*. .**#...*.. ....#...#*.**. .....#..##. ..*. #...* . *  .  #.#.#. #*.\. .#.. ..*.#...# ..*....*\ ...\.#
#*.#.*..\... \...  #...*..*.... .. ..#.*. .... .\....... .\ . *. ....*..*.  ......#... . *#..*#. . ..\.#..\.## #..*.*... ..*...#*  .#..# ....*.\\...*#
#.* .....#.##*....... ....  ....\.*\*.....\* ..  . .*..#..\..*... . .... .. *. .  *. ....*...#.*#..* .###..\.... .  ... **. ..*\ ..#....* .... #.#.#.#
##. ... #.#.\...# .*\. .  ...*.*...   *#. #.* \*.......#... * .\.....*. .. .\.\. .*..*......*. .*.*#* *. .# .\..  . ...#..**.*.. . .....*  .\.***.*#.#
#..##  **...*....#.... * ..#. *...* .\ ...  *\ ..# .* . *..#.  ...   ...*....\. ..# .... . *# ..*. .* .... * ....*#..#.#........\.. \.##...\.#\ ..   #
#\#.. .\.*\*..  .# . .  .#.# \. .. *..* # *..##.\....... ....#.# .#..#...*.#. . .# * . ....... .  \* .. *\#.. .#. ...# \#. #. .*\........ .. .* .....#
##*...... ..***.#...#*.  .\. . ...#. ..#  ....** *.#.. *..  .....*.*** . . ...*.*..* ...... . #............. ..*.....# ....  **.# .*. . \.*. . \.. ..#
#.\...##  # ..... * ..* \#.....#..#\. ..... .   ..*\ .\ * *.#. ......#*. .\# # .**.. ....#......# #..*.*......* .....\*. #.# ..  ...  ... . .#. .\..*#
#.*.\..#.* ** * * .. #* .. . .... # .......#.  .#...#  \.*. .*.. . ....\.\.*#..*. ........\\. .   .*.#.\ #* *.  **.. ...#.. ... ..............#....###
#...#.  .*.. .# .#  ..... #. * *.....#.**.*  ...*...\..#*.**.. ..\.# \**..#.. .  #*#.. . .*.*...#.... .....*....* .#. ..*..... ....#*..#.... .. #..#*#
#** ......\..#.\ ...\ #.*.# .*.** .*.. ......\. .......#*..#...  *#. *.. *..\.*#.**  ....* ..# .. \ *.....*... ..#*....*#...\. .* ...# . *.. .  .. * #
# * #.\*.*.#...**.  *..\* #.#...**#....#\. ..... . . .*.** ..* ....... *.. \ . ....  . #.#.*.*.#......... ............ ....##. .. * .\#.\##....#  ...#
# ... #..# *#..*#.. ..*. . .. . .. *#..   .. *..... .........* \#..  .  ...##*...#.....#* . ......##*...  ..*  ..*....#*\*..   . .  ..###\.*..# .\ #.#
#. ## *#. ....   .\  .. ......*.......\...*#.## ...*#.#..... .##......*#.....*. *  \... .... ..\   #.*.......#..\ ....... #\..  ....***.#   .*. . *..#
#.#*..#*...*. ..*.#...... * #.......# ..\* #.*#.*.#.\*#.\...... .*# # *....* ..* ****.*...   \. .. .##...#... *.. ..\.## #*..\ #*..\ #.. . #.#..\....#
# . . .....#*  #*\.... **.... .*. .##.*....#. .*. .........   ...*.\.. ....#\*...#.. ..\#....*   . .#.#.. ..... .. #... #..#*#.# \..* \   ..   ..... #
#. \  . .\ ....* ..... #. # ....#.#*. ..# .......\*.. ...\.... ..#. *.#*....*.. .**. \.\. . ..*#. .*.##. . ##.. .*..  *#...##.   *##**............ ..#
#. . . * ........ .. .  ..*. ..*. . ..#.# ...*.*#*.#.  .. ..# **\...#.. ....**.. .# . .*#..**.# .*.**.*#.  *. .\.*\ # .......*..\..... ........ ..*. #
#.. ....* #  .#.\*  .....###. #.. *.\..\.\.......*. *...\.  ...*...*... ...#...*.*.....  **... *...##..* . ## ..... .. .*##.#* ..#.. . ...#..* \..\# #
#.... ... *\.....*\..... #.....* ..\ ...\#.. . ..\*....#.......... .*...#... \.\...* . .\........#... ......\*.#.. .. *. *.*  . * #. .  ... # .....###
#*\.\*...........***..#.*.  *...#.#. ... .....*. .......\....##.... .\. *...*. .... *##*.\*.. * #.\ . .....* .. .  ...#.*. ..........#.. .. .\..** ..#
#..\  ..*.#* . ...\.#.#   #.*.*.......\.....*#  .....*........  #.  .*..*.. .\.........\.#  *..*....... ..*\..#.*.#..# .  .....\..*.#..** .*. ..* ...#
#.*..#...#. # .* * ...  ...  ## \#.*.   # . ..*.  .#......\*#....  ...#.....  ..\ ..#..*... ..# ...* *..  \ .... ..**.*#..... .  .... \#.  .  .*.. .*#
# .*......#. ....*.  #..# *......**.#*.... ....  *.. ..### *..  # .. . . ...#.*  ..*. .. * .*...\. \**..\..... ...\. *... \ .\.. *.. .#*#.. .*#..#.. #
#.\ *...#... ...#........\  .  ..* . .*.#.*\.# .. .... .....#.*. ..  . .* ... #..*..\\#..*..** ....**. ..*...* . .. \. .....*.##.  ....*  # .. #..# .#
# ...... ..*..\ . ... * . ... ...... .. # .#..\.....\ ..**.#...#... ..  .\#..* #. .... . .....# .. **. * * *.. ...... .**.#.\.*.. *.\ *..##..*... \.\#
#..\ \ ...  # ..**.\....\ *...#....\... .. ..* *. *  . ....... ... *..... . .*. # . *... ..*\..#*\#  .#....  ...#... \#.#*.#\#.# *.\#.#...*..... . .*#
#*....*.. #....\.# ..* .*... \..  .* ..  ..... .\.. .. .#...*.*#.*.. #.. .*. .  .  ...   ...**. . ..* .. .*. ........ .*\#.#**\...\\ .*. . \**.......#
#..\. .#...#.. #* ..# #\.. ... ...# #...\\.*.....*  .* *.... .... ..*.#.\##.    .......  ............. #..#*\ #.....*..  ##*.*.\**...#* *...*.... *#.#
#*. \**..\..*.........#.. #.. .. . ...#...  ..... ...#**#.........#.......*# ....#... *  ....\.  .\.....*..\.\# . #.....  .# #.##.. .#. ..*.. .. *..##
# ........*. .\.#*. ..*..#..*\.... #.*\..*.....#. . .....#.##*\. ..... . ..  .* .........*............#  \.#\*  #.* ......#\.*..\ . ....#..#...*..#..#
#  ##.. ..# .  ....*. .#... .\. . * .#* ......* ..##.\. ...\..#\. .#.. .*............* . . ..... #. ...#*.  ....*#.* # ..  ..* .. ..***. .\*# .. ....#
#*.#.*. ....*#.* .*.\.\..*.*#.#*......#...*. .......*\.* .........  . *#.\* *. ..  ...  \*... .......  ...#.  .#**.* . #. #.....#................*.. #
#...... .*..  .*.. .......#*.*.*.  \. *...#\ ..* ...... .*..  . *  ...*..\... #.....***.......**#\.\..*..#....*.* \.  .*... .#.#... ......  . .# .*.##
# ... **#......##*.*.*..\ . #.\.#. * ...*.\...#. ..... *.#......#  *..* ... # \.#.*.... * ..# #.  .. .. ...* .. .###... ... ..*.# .  *#..##....**\\* #
#.*   *.\..*# . .\ ...*.  *. ....*\....  .\  *...  .  ......*  ##*...\.*..**..# . . .***... ..#.\.. \ .....#.\ .  . ...\..  .. .... . ..*.** . .. \\*#
#*.* ..* #. .*.. . ..#.* .* . *.# .....  ... ....\* .*.. . . ...*.\*...\.  ... ........#..* . ........ .*#.#.###.  ..#   #.... \*.. . ..*. .. ... ...#
#..  ...........**.* # ....#. \. ..#. ...* .. .\ .  . .*..\\......* ..#. . .. .#.#... ...*... .. . .....#.*..#.#....*  # ..#\.  . ..*  #.. *...\ ..\.#
#.. ...*  ..* . .....**.....\*   .#... *.#..**....... .*..#  ..  \... ... ..... . . .#. ..  \.... #........#   #  ...## *.*..\.#.\ .. # . *.\#.#.#.*.#
#..*  ..#.* ..#...  ..   .# ..* .  ... *.. .# *..... ...#*.\\ .  .....#... ..**.    *.. #.** #.#...**.\*. .*\ ....*..*.......* \  .. # .*\.. ......#.#
## \ ..\. #.*  *#.#... ..... .. *.. ..  ...#*...*#... ...#.  .....* .#  #......\.  . . \*.*\..........  .....*.*..#.*#...... . ......\#..... ..#  .\.#
#.#.\.# .. #....#.. .*.*.....\. .#*...........\.\  #.... #*... .\.#.... *.. #.#. #.  . .*..  ..* .  .... ...\.##.. .  #.*... ..#.*.#.## .. ..#...*...#
#.  *  .   .*.. .**# . .... ... *..........*.\ .*#. #....*#* .#*.  .....###* .#...  ... * ..#.. # .*..# #\...\. ..# .*.* ** #**.. . .# ..#.*....   \*#
#...**. *.## .. . **##.... ..*..#.... * # #...# *.  * . ..*.***.*. . .... . ........ ....* \..*... .*.....\...... #.\..\....#. .\. . ..# #..#*# .. ..#
#..\#....#  ..........\ #..  .... .....# ...# .*.#...# *.#..\..  .#   .... .#  #  *..#..##.. **.  . #... .. #* . . . ...# .. *..# . .**#\ .*.. ......#
#.# .... ......#.* . ...*... .  ....#..\ ... .#.   .\.*.... #  \ . #*#...#* ...*.  .... ... .....** *. ...*. \* .........#... ..  .#.... .## . .  .  #
#...#. .\. ...\*......... ... #.#..... . \ ... *. #. # ..  .....  ..#.#.... ..  .*.# #.......*..... .#. #.  **..* \..* \#\ ....\....#.*.... ... \ \..#
#.*....*..* ..#.  .*.**..*..\.. ...*\..*..*.*\ ......*..  ...# *. .#.# .*\#..#.*\. #  .....*.. #.# *   .. *..#*.. .*.*..\. *#. ...  # *##..# .# .*#.##
##  *..#..   . .... ..  ... ....*\...#\.**\..\*. .* .#*  ..*. ...*...#.  ..*.  \#..*.*. .. ..#*#..\....**#*.. ..........*..   \..#.... #*...*.......##
#\.#.....#. ..* .. .... ...# ....*.#..* . .#. . *#... . ..##.*. . .#.. .\...\ ..  *. .*#.....*.#... *.#..*....*. #.#\ *.*. . #*\*  #...#..\* ..**... #
#.*#....** * ....  ..*#.*.# **..*..**#....  ..#*.. ..**.#.# .**.. #.#.. .#  .#\ . .\  ... #.# ......... #.\## .... ....* .. .  *.. ..**.  .\*  .  . \#
###########################################################################L##########################################################################