######################################################################################################################################################
#....#... ... . .. ... #\ #.#..*  ..*........*. .*. ......\ .##...#...........*.. .....   .*. \*... ........#.*# *. .... ......* *. \\... ...#.. ....#
## ... ..  . ..#\.... . #.* #  ...\#\.  #. #.\..\..#\..#..\. .*.. . ....#.  .#.  ..#..# ...  #\#*.      .....*..\. ##... ...*..*...\. ..*.*..\.. .*.*#
# ..   ## ..#....#.* \#..#... ...#....\ ......#* ...*.. .....*   .....*..\.#...... ..#... ...\.....*.. *.#.*....#*.*.. ...*..\. ......#*\...  ...... #
# #..\ ..... .#*  .#.\ . ....#.. . .\...#.. . ....* .........*.....* .\...#. . .... ##. .... .*...........\.*. #..   ....#.\ ...#..# *# . .  .. . .  #
#..*.*. ...# .\..* \\ \.*.\*..  .\. . ....*#..*..#\ .\# *.* .\... ##.... . .*...*#....#... *\#..* *.#.*.... . .. .* ..*. ... . ....##...... .........#
#...*..\*. #...* *. ......##.*....*.*  ..#\.......\.\.. #. ...... .\*.......... ...#... #.\........   .. *.#..*.#*..*   ..#. ..#.\#\ . **... .*....# #
#..#.........##..\... .*\..#. #.  *. ........# . .*.* .*.....  ....*.    ...   ..... *... .  ... \...##.*...\ #........*#...*\*  .. .. *..#...*..#\*.#
#. *.\  .#.* ..** .*...\..\#.... .......***. \..\ .  .*.. *... .\ ..#... . \.....# *.... ..\. .. .*.#...  .\...*# ... # *. .*...** # .....*.*. #... .#
#..   ..*. . .*..#*. .*.*#.  *\.. .... .  ...*.\.....*.. ..  *.# .*.##.......##*.. .. ..#.#...#. ....*.... ..#.  ... .*.  ..#... ...#... #. . ..*# .##
#...* .\...#\..#. ....\.....** *\#*.#*.*.\.#*. .\.. . ....\##*.*..#..*.......#..###.. ......\. #.. . ..#*.*..\ .*...  .... .*.\ \ ..#. .\.. .   .. ..#
#..\. .*#..#. .#. ..\ .\. .. ....##.*.#. .  .#.#.. .. .  .*# ..**   .. \.*.*.\ \.*\.. . \.#   .. ..*.# . .*. *... ..##..#.. .#.... ....* \.. ..... ..#
#...# . .. * #\..* .....\....\.... #...# ....#* ..#....##...#\\...* ....... ....... .*.   .... .*#...#..*. .. ........#. #. ....*#.\....*.. .. .. ...#
#....  . .\.  .*... ..**....#..*\...\ \...*##..#...*#.#.## ... *.....*.. ....*..**...  *. \..# #......   . *.....**  # #...\..#**.. **. .. .#.. .....#
#..*.. ....\. . .*. ... . *..*. .*.. ... ...*..*.. .. *..** . *... ....#.# *. .. ..  # ..*... .#..#.*.\\... ... \.*#......*..# ..... .*... ...# ..\..#
#.... .. \. .. .. .#..#.\#....*.#\.... \...* # ..* *#*...#.\.  ....*...*...# \\....  . #... ##. \.. ....\*#*#..*. .\.##.... .\ ... ..* *..*#..\... .\#
# ..... . *. .... .\*\ . #\..... .*  . .. .*. *...  .... ....#... #..    . #.\.\ ..###..*##   #..##   .....*...  ...**.*\.#*.. .. *# .*..#*.*  . ..*.#
#.\\ .#.. ..#..*....... .. \. #.... \..*.\..... #..... \.\..*.. .#.**.\...# . ...\.*.# .*... . .....*.. #..# *.#.. .. .#.*.......# ...  ....#....##..#
# *..\...#.#.  . #.... ...\.. ... *.. # *.#. .. .** .*...  ..*    *# ...\.*..........*** ....* #. ....*# ** ..*.#* . ..#**  ....# ..#.*...# ...#. ...#
#  ##*...\** \. ......... #*#. ...  ...#.. ..*#.#  ..... *  ..\* ..  ..* #.  *  *... ..  *. # .\#  ** * .. .#.. ..* # .##....   . ..*.\...* .#.#. .#.#
#....\ .#..# #....\.... .  ...*. ..#.... ..  *.*#. ..*..  .#.##. #..#.... \*...* #*...... .  .# #. .#.  ....#.** ..\.. #. ..\# .  . .....\\.*##.\....#
#.. .  . .##  .#..*#. #*..\..*.**  .#* . . . ...#.*.#.  ...... \..  ...#.**.......*. .*.##* ... ...... ##.\* *..\........ ...**   * . # .  . ##. # . #
#..*..* .*..* .....  ..... ..#\.\..\. . ##. *.. #* ###...#*.  ... ..* *.#*.... .......*.#.#......*#.....\\. \  \...\...\.*\ #.#.. .......*..*....* .##
#.. .#..   *.\..\    ... #... .....#.....#.\.#.#.....\*...  \#.*. ..*...#*.\  ..... ..  .. #..\ .# #*.. #...* ...*.*...*.\   *\\...\\.... .* *..#    #
#.*\..*.. ..\ . .. .\#.#. . .#.* ...#.....#..* ...#*..#.*  .# . ...*..\ *  .....#...*... ... . .......  .*#. .*.....*#.... . . ...*  . * .#....#.*.  #
#*#*.\.....*.......*. ...* .#*..#.... # .*.\. . ...* *.. .....\..  *.#*. ...# .... ........*.. .\\.#.  # .  ...#...*.*....  #*  \  .. .... . # \.#  .#
## ..#..#.... *.\.......\*\ .\. .... \.  * .*  *.*  #.**. *..*....#*.#.. #.. * #...* .# ..*.... .....*#.. ..\ . ...*# . .#.  . ... . *  .#. .....  .*#
#* #.. #\** *.....  .#*. ............... \  ....***.#....*... .... .\#..#  .....*.... .. .\*.*.. ....... .#.. . .\#   #*..... *.#*.#.#\. #..* . *#..*#
#...#..*  . . *  *.#.*#.* ... .*......... *.#.#  \... .*.. \. ......* #*. .. ..\#..* ..*# ..*  .....\#..      ..\... ** ......*. # ....#...* . *...  #
#. ....#* *......   ... .. #. .*..\*..*  *\.#*.. \# ..\*..... \..**....*.#. *.#..... ..* ....* .. \\.*.....\.... ... *.  # .#. * *. .. \.. \.. ......#
#* #. *. .\..*..  .#*#.*.....#. #   .... .....#.*.*.*..#**...#.  .#\ ... .*... *...\..*.....#. #...\#\*.....   *.#  ..*.....* ...\.*....#.. .*\ .. \ #
#. .. #....#. * # .\ ..*. #.. \ . .* . \... .#.  *.....\  ##  ... ... ...*. ......... *    ...*\.##\.. \  ....## .#........\***. .. \#.#. .  .  .. \*#
#. ..#.#..* \......*..#....*........#. #*.#..  ..\  . .... *\..\* .* #* .\. ##\.**. .. .*.*.. . \. .* #.. ......\*....#. ... # #..\.. .# *.  \....#.*#
# ..#.\#.....  .. ..##..* \ .*#. ...\*.**...*.*.....\ #..*  ..*# \.\.\.#*.\. .\. .# #.\ .. # ..#.*.*. \ ..#....#   . ...#. ...# *...  .\.#.\..\#... .#
#\.** #.#..##*.#. .#..*.#...\. ..*\#* \.. #... .*.* * #*. * #\..*#. ..#.#  .# .#* ...\.. ..... . #...#.   .\ ..*  .. . . ...  \.# ..\. .* * . *# .* .#
#...   .#..#.. . ......*.. ...*.*.# #. #.#. .. ..\. ...# ..*. . .\....  ...... #\.....*..*...... .. ..*.. .... ......#.#....\..\ .  .  .....** .    ##
#* \..   ..... ....#..\. #*.##.. . ..\.*.*..*. ...\..\..#.*. .. **.....*\.\\.  ..  # ##*.. ........\ \*.# #**.##...\..  .#. #.*  .....# .\..\. ..\..*#
#...**\....  .* #* #   . .. .\..#.# ...* ..........\..\.  ...\*.. ****# ..#.#. .. ..#....##..  ..... .***...  .. *. . \...*. ...  ... ....##* .#.*.*##
#....#\..*\.. . ......*** *... #...*..# .... *..*\**...#.*.  .#.#..**..**#   .*\.  .....  .#*.  \**..#.#*...*...*...\#*... .\#*. .......... ... #*...#
#. ... ... \ .........#.. \....#\. ...#. ..  .*...\.#. *\. #....*..#..\......  .#...* . ..  # . ..#..#..* ..#.*......#. #.##...\....#. ..#  **.\*.. .#
#..\... .#.. ......\...#. \..*..# #.... . #   ..*.. ..#.  .  ..*..#\...*.. .. *\ .  . .....#\..#.. .. .  .\ ###. ....\\ .. .. ..*.. #.#.**..#.  *  .\#
#*....*.....*#.\...# .#** #\*.*\\.#....#...*.. * *.\  ....#** #.* * .#.... .. .. ...... *. #.\.#\   #*.#.#.......  .....\  #....*#\......\*..*. #. .##
#. ....*..\*...... ... ...#. ## .. ..*.\.#.*.. ..*#* ...*...*.. .#.. *.....#*.*.  #.. .*#. ...*. .\...*  .*.....  .\# #..*. ...*   ..#**   . ..\ #.  #
#....  . \...\..  .##..# ..* . .....*....* .. . . # ... #.......*..\*\.\**...*....*... . ..  . ..\..*#. ... ...***..  . ...\ . ..... . ...\.* .  * ..#
#...    ** ....... ..*\\\. .. ...#... .*.. ..#. ..  ..# .. **.**.*.*..# ...* *.*.# .#..#.*#...\..  ..*. *.\*. *..\.*....\..#. ...#. #\.. #. ... .*...#
#.*. . *..*. ...... #. *.....  . ...*.......# ...#..#. .  #..\.   *.. *  . #*.........\. ..   ##...*\...  ...... .*....... ..... ..\**..\..\#. ..* \ #
#\ .#..  . ........ #. . .# *.#. *..*\.. *## ...*.. ....#...\.#.*...#. . *#.........\*#.... .  .*.  * .. . ........  ....\#.\.. . .. .. .*..  ... ...#
# .#.#.\. . ..#.#.*.  ..#*#.. ...... ........#. .   ... .. .. ..  ....#..**.... *#.  .*.. .. ..... . .#.....* \#.*... *... . .# .#..# #.##.. .. .... #
#..#.. .#... . #.\.....\  ... ..#.#..*...# \.#.  * . ... .......#..\..*. .............*..#..*.##\* .... .# \.......... .....*\. ..\.#*. .....***.. ..#
#.#...*....#*...##..#....... .. ..#.*.#*..... #.#.........*...\.. . *.*#...*..*...... .* . ...*.#*.#..# . . ....#.. . .. #. #.* ##.  ... .#....  *#.\#
# .  .. ..#\#......* . . \..  ...  ....*  .    . . .. .##*   ..\#* . ......\# \.\# #\.. ..* \ . . *..... .. .......#. ...\ #.... * ...*.......#.. #.##
#*..#..\#.*.. ........#....\.*....#...# # ..*\.   ... .*. #.#\..#..... .*. #..#\....*      *...*#..\ .#..  .#  .\.# \ .#*.*  . .*.. . .... .. #** ..*#
#. * \*.  #  .#*.. *#*#.#.\*. .. .#.. .. ..#*... ...  ## ...#.*#*.* .............#.. \. ..#...*..#.#*...*......... .*  .#. ....#.....#.*. # .* .#.*..#
#   . #*#.... .#\#....*. ..\.*.. ...... #.#..*............ .. ..* *..#.#\..#.*...*. *#* ...#.... \*... #.*.\.....#.... .... .*.. ..... \..\...  ... .#
# #.........*.# \*#. .#....*.... . .\ ....#*. ..#.*.#.\#. ....##.. *.. *#.*.......#\.# .. ##.* .\.*..* . ##...\. .*..#..#  .. ..#. ..#.*..\.... *#.*.#
#...#.#..* ...\.. ##*#.* .# .# #....#...*.  ..........#  . .. ...# ..#.\#*# .  .. ..\\..#......#\.... .#.*.\..  ..*\.... .\*.*.*... **#*.\* ...*  .* #
#... ...* . \...\. *.*.  . ##  #..... *\ * . . ..**..*.. ..###......   .\.* . . ..* ...\*...  .#*. ...#.#\#..... # *..  ...##. .#.\ # ...\..###....#.#
#.*..#* .*. ##...*. .#.#. *. ... \#..  * ..#..\............*. *.......\. ..  *.#***.....#. *... .... \ .. # ** #... ..... ....#*#.\.#\* \..#*... #. .#
#..#*. *##. ..** . . .* ...\.*.. #   .. ....\.#..#.#... .\..#..#...#.#*........ ..\   ..*... .. ..#..* ......#** ..... **.#   .\ ...#.**#.*. .* .....#
#  ....*.#... .#...\....*  *........ # \\..\\.**  #...#.. . . ..  .. ....#...*.. ..\ ...*.. . .*....... ..*..# \.....\...... *....\. .* .*..* #.\ ...#
#....\ ..  ... ...* *#.. \* ..\\.#.#... ....#.#.... ....*#.*.#*....#.. . . \.\ #* .....* *...* #..#.....##. .## .\\ #......#**. ..*** .  ..*. *#..  .#
##. ..*...#.#....\....*.. #....... .......#*... .  *.  ... .* .* ...*.\#....\.  .\.  ...\*..... #..#.. #\.. #.  *..#*..  .. .. #.\. *.. .. .#.. *..  #
#*\.*...#.*... .#**.... #. ..**.##...*.# .# . *.#........# .. ..* ...#.. . . *.*#....##...#*....  ... ..*#\#.. .**.......##\.#..#. .....#....  . ....#
##.#\.\..* .#\. \* ....  *..#... #...\*...  .\*.........#..#.#. .  .#.... .....*...**.\.  .. ....... .. ...# ... .* ...\.. . ....\.... ...* # ..  ...#
#.*......  ..\.\\##. ....*. \.*.... . #..\#....#.......#**.#....#. .*#.. ... ..*.* . \#\.\......#..\.*.  . ...#..#..*\. *#... .*..  .  #..*..*...*\ ##
#.*.*.# **   ... .. .  . .*..  #..** . *....#.#...#  *.*. ..# ..#..#.... . ... ..*.... ... ...#.. .. .... .*.... ..* ..*.\..#.\..\#....*...*. .#....##
# *# .\..*#*.#*.*.* ##.*.\.*.\. *... *##  .. \.\ #...##.... *...  .. ... .#.. #\*.. . ..#.#... .   .. .#....**.... ....\#.*.  .   .*...* ...  .. ..\.#
# ...#..... ..# .... *.....  \*.#. .#.  #.#\. .#.#........ .  .#*..*.#.#... ... ..#. .. .. *..  . \... .  . *.. .#.. ..# ..\ \**.\.\... ....*# *... .#
#**..#.*# #*#..#\...  .*..#.* #...\.... .# ###... .#.\....*......#.....*.......\.#*...## . .##. .. *... ........#...#.##.*# .#. *.#.. .# .#...*.*\.###
#.\  * ...# ##.#.... # ....*#.. ... #.\...... ..*# .. ...#  ...*..*. ... ..  ....* ..# ..# .#.#*.*.*....# ..#\.... .....#....#..\...#*. # .    ....#.#
# .#.*\.  ....#.*  .... ... ....#. \ . \\....\#..  \ ...*.....*.##* \ ..*.....*#....\.....# .*#.     #.... #....*......#* *..  #...#*..#.... . . ....#
#.    ..### .. # #.. . ...\..  .. ...* \ .. *..........*.... .* ........#...#.....#... #..*... \...#*#...*.* .*....#... ##.\.. . .  .. \*  .  .*.....#
#* .  *.*.*.\.#. \. .. . .  \.\.  ** . ......*. **#.  .... . ....#. .*...*# .\#....#.\.... .....  .\# .#....*.*....##* .#.  ...#  *...*\ #.   * ..# .#
#.#. .#.. ..#. ###\.. # ...#... ..*.......*# ...\..\... .#.  ...... ...\.........#..*.#*...#\.\.\ *.*\ ..*. .........  .##..*.. ......# *\. .. .. .. #
#.. .. #.*...#.....*...#.  .# * . #......*** .#.... **. ..  ..*..*. ... .... .#..*.  ..\ ...... .. . \  ..... #**.# *. \# #.....* *.. ..... ..*\.##.##
# ..   .. ..*.\   .* #*.\...*#.\ .#. .*.. *.*.... .\\.*...  .\ ..*...#.#.. . .  #... . ...... *.....   \....#.  .  .. ..   *.. ... .      .*..#\. ..##
#*#....... . ...\*#*.#. #..# ..*..#..*.......   .... \ ..**..\* ......* #...#*. .. ...*  \....# .#.*\#..* ...*. ..# .*. ... \.\*.. ...#.....*..* * #*#
#.  **.*\.... ##** . ....*.*  ..* ...*.#*\..\#...### *....  * .*..#* .# ...  ...* \#. ....*#*.# #.  .... .*\.... ... .#\*....#.#.. .. ....#......# ..#
#. *.*.... .. ..##... #.#.* ..#.#. *   . .\.#....  .... ..# . ....#*......*.*.#...*.... .......... #\....  .\. ...\..  . .#  \* .\**.*  .#   ...\... #
#.........#..*...... * ..#...#.# ... #.\*#.*#...# *.* ** \....*.** .\.*#**.\#.*... ..\#..**  *. .\. .*\#*... .\.*.*.#...#....* . .**..... .... #..  .#
#..##.#. #* .... \.*   .. .... # ...#..*.... *#* ....##... *..#.*.# .....*.  ..# \*..  .#. *. ..#. .#. *#.#..*..*. *... . . ...*..*.#..\.#...#\ . ..*#
# ..#. .. ......\... #. .\  .. ......# ...* . #** #... .  ...##. #**. .  . .#. * .#..... ...*#.  ....... ...#.... . . .. \. ..\ ... #.. ...\#* .*.. .#
##.\**... . ... .* .**#* #..... *..*\.*.#* ..........#. .. .* .\.. . . .... #*. .*# ..#.. .# ..#. \. ..\#.* ....*.**....###. ..* *.*. ... #.. ..#..*.#
#... .#.\...*# . *.. .*. .  ......*.#.*.. ... *...... .. .. ......*.\\#. .. ... ..  ...#. \......  \....#*.#    ...*..* \ .*....... *.# .... .# . *#.#
#   \*.... # # **... .#* ..* .  #. #....\..... \ ..*.#..#..... ..*.*. #. .*#  .#..\. .\...# ## *....  ...\..... .....**.#\.....**\.. ...*......  ..\\#
# **..#......#. ...# ........... .##....  *..#*.#.*#*. ..  ..\.\*...... .....**\*... .*..  ...\.....*... ....*....... .\* .\# .*..#*\#.*. .*.*. ..#..#
#  ... \.#..#.\.\ . .# ..* ...*.  ..*#... . . .  . ..*#*.... .# ..*.#.. . #..*....** . # . .#... ...##... \#... .... .   . .  .**.\ ...#*...#. #.***.#
#. .*....*....#  #**# .. . .......\. .#*.*. #.....\..  .# *.*.... .... .\.*... .. .  \ .... ..#....#.#.. . .#....#.###*. #\ ....#..##....# *# .....  #
#*\# .*\.# \...... .. .. .  .*#...#.# . ..*.... #.# .*#... ....  ... \ .... # ... ..#....#.....#.... *. ...*..#.. #  # #.*#.. *.*#.#**...* .# .\. ..*#
##. . \.#.... .*  . .****.#......* ...\...#....... ..* .....    .# .*.#..*#.*.. ...#...#...#.#..... . #..#..\*.\# ...*..#..#.... . .\..*\...... #...*#
#.... ** ......*....\..  ..*..\#.. ..#.. \.....  .*... .#*.... .. # . #...... . # ....*......  . ... ..#.#\...#.#. ..#.#*. \\  *##.  .#.*... ##.#... #
#......* .......#.. .  ...#... ... .... .*.  *.\.. . . # ... * . #.. *.....*  ......*#......  ...\.. ... .. ....*....*  .*......... .\....#...** #*#.#
#  .\..#..# #*.. .. .. .. ..  ..*.\.*. #..#*  ##.*.... #*... . .\*..  #...\..* #.#\*..  .\###* ......*....  .*...#..  .*.... .. ..... \..... .\.#. .*#
#....... .... ...#.#...##..  . ..\..*.#.. .*... .*.#...#*.  . ...*.#.  ...*##.*.... #.. .. *.....  ......#...#.#**#..#.*... . ..#   ........ . ......#
##.#. *... #.**.. .. ...... \ .#.#..\ *. . # #.. \\ .*. *  ***.#.\.#*..**... .#*##........#. *.\ *#\## ..... #.**.. . . .#..#...\.* *....  .#... .. .#
#.. .  ... *  \... .  . * .. ..  ..* ...#  ...#........#... * ...*  ....\* .* ... . .  \# . \# * #.  .. .. .** .#.\.#.........# ..*.. .. *. .#.*.... #
#\. .*.*..  #*\\.* \.*  .#....... . \   ....  *..#*.#... .\.*.*. .....\#.# .*\.........*.. # ..... *. #.\..* .. ..   ...*..*..*.*.....\.\.*#*..#...  #
#*..*...*\...#.# .....\.. *..  ... ....... .. .*  \...\.. ..#  .# ..\.  . *. ###....*... .. .....\...*  #.* \.#.. .. ......*..  ..*.*.........  ..\..#
# ...... #.*. .\.\..... # .*.#..  .#. . ...*.#.. *.#.....#...*.. *..\...  ...... ..... . #.......*...*.. . #\ *..#.* #. ..*. *..\#.  #.*. . ... .*...#
# ...* ..... ## .....  #  . .  . . ..**..  #....*..*.*.##..#.....#..  .........*...  .. ..# *.*...#..\.*\# # .\. ..   **..*. . .# #....  .... \ #\.. #
#*.\  *.#.\# **.  .*\*....\. .. # ... . .\..... ....*.*...* .......\. **#.# .#... ..#..*. . *.. .... * .#.#*#*.##..*. .\..... .#...  \# .....#.  ..*.#
#..**.....#....\** .*..\.  . .. ...\....#*  ... .. .. .* ..#. ......... ....#.#*..... . ........  ..#. *#.#. *..**... . . #. ...  # *.... ## \.*.. \.#
#...#..#\.  ##. #.. .*..*# .\.#.#...#* . \... .... .. ...*.  \. \...#.  . .*.*........\. .....**. ..\..*.##\. ..\. ...# **..#...\*.... \#...#.#.\* ..#
#  *.  ... . ..*. .\#.#\.. ..*.###. \.#......  ...*.*.....#...... ...........#. ..#.*...#*..##........ .... \#...#. .. #\#.....\ . .. .* #.#.##.\. \.#
#. ##....... .. ##  .*.*..*\ . .. ... \. . *.......#\ .*.#*  #...*. ... . *#\... ##*.. ...... ..*.. ..# . ..# . .*. #.   .#..\...\...*..#...... ..#..#
#. ..#  #....\*.*.  ....*.\.......*# .#. . #  ..... ..*** .... ...*. .....\#..\*#....*.#*...........#\* *.. .*.  .*#...#. ..  .*\ *.#.*..* **\ # .*. #
#.*#***.....#.#..* \##... .#.*. *...#......*. \..#*. *..... **..*..# ..... #* ....  .  ....# ......#. *. ....#\.*..  # .*.. .\\.  *.#*  #..\.*\. *.*##
##...* .......... .#\  ......\.....#.*. *\.  .#.\#\..#\*... ......*..#\ ...#..*.#*## .#...*...   ..*... ..\... \\ ..##.* **R ..  #.. . .. ..\.   ....#
#..*....* * ...\...*.... .*.*#.#*   *..# ..*.#........# \*.# .# .... .\...*.  . *......\# ....#.# . ....   ... ... *.  .*. ......  #...\......#* .#..#
#*... \ * * ...  ..  ... .. .*.#..#.#  *. .  .\.* .*.#\ *  . .*. .##*. # ..\  .\ #..  **#..*#.. ...# ..#.. *.*#. \..*..\ ..*...*\. .....*. * ..*. **.#
# . ......#\\..#\....*.. ...\.# ..*.#*. .. . ......#... *.  *. ..  .#......... .. ..#\.. .. ..\*....\  .......*... \....\. ..*.  * .**....\#.#......\#
##.*.*...\.. ..*.  * ...\ *.....# #\*.*\. #....\ .. #..*... .. ...# .*....*\.. ..* .* . .#.#..*...#\.. .#. .. .... ..*. .......*....#.. ....... .  #.#
#.##....\#\.\.#.#...*...... . .*\#.#..#.# ... #..\ .. .*\....# * ........#..#.#.......*\...*....*.\.#*.#...*.... ..* ...\.**\.* \ .\.\. ....* . *##..#
#*..* .*#.* .... . .# ...    #.... #...\  #..#.**... ..#..# . ...# ...... #* ..\.**...* #... ...*##.#..# ...*... #.** ..........* ..#. ..*.. .*....*.#
#. . ...  #. ...##.*..*#.#.*.\#. ...#.\.**.#..\. \....\..\\.  ..*. ....#..  *..#...#.#  ..*.*..... . .*.... .. \.#.. .. #. .....\.* * \   ... .. ... #
#.# .*..*..\..##. .. \\.##....#. \.#*# .* . \*#. . # #......... .... .. .# ..*.# .... .... . ..*.*.\#... ..... . \  .\....#.# *.*.*..  .. #** .   .. #
#*. #.... .#.* ......*.. *..#.#...  .\.* **\. ... ....* ..*.... ... . * ..*... .  .*\ ...##*  ..*. ...#........... ..... #...  ..#. \ ...*....  .. ..#
#..##.. .#  \....*..*  ##..........*.*#\....*  *....\* ...... ... .... . . ..... #......#* ....#...*.* ......*#. #...# .\ #.*.##*.. *... ......#.....#
#....** . . *.... .  .##..*. . ...  ...#...\. .... #.#. .*# ...##\..#.. # .. .\ .**.. .. .. .\*....#.. .. *  .* ....... ... \...* .. .# *. #......*.\#
#.....#.\.. .....#.* . * .. .*. ..#. .....*...#. .. ... **#...#......*....#   .\.. .##.\.#...*. ... .*.#. * ......\...####**...#..\.......   #. ..\..#
##.*. *...*\..#..# .\ . .. \.... ..*.\...*\...... . .. ... .. .  *...* ..#. .. .. . .   . ....#... *. .*.\.... .   . *.#.# .*....# .....  .. ... ..#*#
# ..#. .. ##.\.#... .  *......#   ...#\\....  .\. #.\\.. ........*..\. ..\...  ...*#....*...*.....    . .. . . \.....\#* . ....*... .  *..#....# .. .#
#. #. #....\. .*... ...*\**..\\*.*..*..* #..#*#.*. ..#\\. *. .*..  #....# . .. ...#. .....#........ .*. #*   ........ . ...*....# \..#*..*..#.*..*  *#
# ........\. ...  #.#.*.. . .. .   ..*... ..#. ....*..*.  ......\.*#. * ....* \........ ..#.*. ....##*.\.  .#.\.\..\..#*#\ # ...\. ...*. **.. ....#..#
#..#\\.... .#.. .........***.#...#.**# #..\*   ..\*.... .#....\..*..#  .\. . **.##.\....*. ..# *.....#.## *.\#.... . .....# .....    * . \. .. #. ..\#
#.** *.. * \.. ..... .***..\**....# . ....* ..#......  .\ .* ..    \  ..#** # *... . .##  *.*..... ..# **.\.#.   ..#.... *... .\\.#  .#...#*.......**#
##..\..#.  ...... ..* .. .\... *..\.#.  ..*..#........  ..\.. *. #.\.\  ..#..##.. \...# # #*. ...... ..\. ......#*  .\*..*. . \. . \.\.*... **.. * . #
#..\* .*#..##*** ...\. .#*..  \ #*.# ....*.. ....#* # .\..   .\*...#. ....#...  #.*.#....* . .#.. ...# .*##..# ...#*#. .* ...\..#.#.*  . .* \*#.##..\#
#..... .*\......*. ....#.##.\.  .* ...###...\.**.  .#.. .**.....*..\   # * ..  ...*#*.... ... ..  ..#..... #... .\....  ...*.* . .*. .....## ...#. .##
#....... *.*.............. ....**.. * .\....  ..**.#.. . #*  . ...  . #  .** .#.* .*  . . ..* . #.. . . .. . ...#..*.*..... . .*.*. ..#\ .....  #\\. #
#*** .*.\..* #*\.    *.#....*... \* ....  #\***.#.*. #....*. ..*..*... *   ..\. ..** .#..... \ .\... #..  ..*\. *.. * *...*..* *.\\..*.. . ....#* .*\#
#*.\.   ##.. .# *.. . *.  *  *....... .. .. #...  ...*.*..#.*...#.....#... .... ##.  \ * # .....#. .  ..* .\.*..#**.  \\#... *#.\..#.. .\... ....... #
#. .*\\..  .... ...\..\#..#*. .*..#...#..#..  *..# ..#.. ..* .*.. .*.... \.\.....\.#.. ....\#...  .*..*....\..\.\.*.. .##.....*. #.. ..\. ..\ *. ##.*#
#*..*.*.  \#....#... . #...... .\.#...*.... #.#...  ..# # ....... ...#..... .  *\...*. *..\   .... # **..#. #..*..*.#.* ..#*. \...#. #*.\ .#\ #*.....#
#.....**...  ....#...\  ..  ...*.#...  .*. ##\*.. ..*....#.......  . ...#..*..*...*.\  \.*\....   *....#.. ......##.. .\..\..*..   .#. .. \*.....#...#
#*... ..*# #. . *.. #  ... ..* #.. ...  ...#. ..*\. ... ..... #..*...*.  *  ..\.... . . \..#. . . **...    .. .. .....*......\ \...#.#.. # ... ..\.#\#
#.  .... .  * #..*  .    .*. . .#.....  . ..*.*... . .*.\. ..*. .#.# ..  ....*......\... .#... . ...* .#.#. ...\....*.*.  . ...#..\....  *.* \.#.**..#
#..#.##**#* .*... ...* #. * ...*..##......\..\#* ..* \*.....  . ..#  .#\..#......\  #... .*. .*. ...# . #. ....\..\*... ..*  .. .\... .*. . *. .* ...#
#.\.. ....*. #*\.*\ ..*\. ... ..#*.#..#*\.. .  . \....#..... . ...* *...#...\..\.  . .. .*.. ... \#*.\.. .....#. \.....   *.*...# ..#.*.*. ....* *   #
# . .#.#. ..## .....  .##. .*.. ....# ..* .\ . *.. #.. ...#.... .# * #.....##* * .*...\* . ...#*...#  *##.. .  \.... #\ ...#  ... ... ... *.  . .*. \#
#...**.##. #.\. *\*#.......#*. ... ...\   #....#*#\.. . .*...\....#.*.\.\.**. .#...#.....*. \.... *##.* .   #.. .    .* **. .. ..*. ..\.*\\  ... ...*#
#.....*#.#. **. .*#. \....#*\# . #\  ... *..  #. .....  *.. . .\. . ..*#   ..... . .  ..***...#*.\.  \*.* .##.. .*. #*. *.. .. ...#. .#....* . .. ...#
#* *. .#  *. #..# . .   ** .\.... ..* . *.. \# .. \\.# \*.\**\ .# .   .  . .\...... . #.... .\...\.  ..*. # .....*...*......*. . ....#.\.*....#..* ..#
#....#\.  **...     ... .. *...\#.. .*........ .... .. .*  .... ##..##...#..\ .*#.# .\..  ... .. .#...*#.##....\.#.... .....*. ..#.....  ...##..\. ..#
#. \. .......#.. #... ** *.....# #.\  #***.*\ .#..* # ..... ........ ...... .\..*.\ .. # .#. *.*..*. #..*\ #...# *. #.\. . ... ..   \ ..*....# \.  # #
#.**. * . .**  .*.*.#** ...\.# ..*.  .**...*..#.\#.*.#...\ .*.#.  .#.*\ . #*\....  \#.\#.# # .. ..# .......\..\.. .... ..... .  *........ .*..*..    #
#*.. . *.....#.*#\..#*  #..*..\.# *#*. \. * # .*. ......#..*.#..*....  .#.\.#.\. .*.#.... . ..  .* *..*\.  ##  . .*.. ..*.....#.  \##.... .....###...#
##........*.\\\. # #.  #* . . .\\ .#.\.*# ..\.#... \# #\. \*.. *.# .......#. \** ..... \. .. .*  ....\  * #...* . .#.*. * .*. #.\..* .*.##.. .\#.....#
#......\\.* ...... . ..#.* .#.\.#.*...#  .. *.\.... . .* .....#.#\.#.*.. . * .*..... .......*.. .# ......# .*..*  *.  *.#........# ...#.#.*\ .#.#**..#
##################################################################################################################################################L###