######################################################################################################################################################
#*..\  * \...* ..#  .. ... . .....#.....\#\..*.. ..  . .*.. .. .** #*  ...... .. ....*# #..... ..** .\  .  #  ..** ...  ... ..*#.....\.....\..\ ..#..#
##.**.#\. *#  .#.\##.**...#.  ....##*..*.\... *\.#.... # .  .* ......  .*.  *..#.  ...* . .. ..#\*  . . *.....#...... ##.#\.. .*# *.*.... *\...#.... #
##*. .*.*.... #. . . . \.. ..#\\*   * . \# ....#.##. ##. *..**.*.. . . .\\.  ..\ *......# \.... . . \* .. ... ..# ...\ ..*...* .#*.* ...\*. \..*...*.#
#* .#... .... # \..#.......*..#*  *.\.# .# . *..........*#**. . **\.*. . *....... * .. . ......#*  .\\.. *. #..*. #.. .* **#. .... .....\.*# *\.#..\.#
##.*....# ##.*. ..\# *  .\...\**.# .*.#.....\. . . **.*..# *.\.. ..#........\ ###\. ...\ ....*.#\* .##..... .*.\   .###.. ..*#**.\  ... \........#  .#
# ...*#..  .#.\...# ##...\**..* .\*... . ..#. .*. .*  ..#.. ...\.#.. . . ..###.... # *.*. .#*...*#.*# ...*...*...#.. ...#.#..## .... .#..*\\ ...*... #
#*.\.. .#  ..  ......... ..#. #* .**.. .............#... ..#*  ..* . .#. ... ... .#.*.\ #..*.....*.  .....  #. . .\.    . .#*..* ... ......  ..*# .. #
#.* .....#*##...#.* *. .    ...*\..*.#.  ....  ..# .*  ...#.... .# .. .......# * \.... . *... # # .*#  .*#.#.*..* *...* *#.# *#..\....\...  \.. .\...#
## *.  #\\.\ **.# .. ..* ....#..  ...\....#....#......#*.\*.#  ....*. ..  ...... . #.#.#. \##*.\  #.*#..#.. .*.#.. ##...#.*... . .  .. .\ ... .*... *#
#*..   #.... ... .\ #.# .\....*\.. ...*.\.#.\.# ..  .#.\.#* #\#.#.....*#...\#.*...... .#.*.##..... *... *.#.*....#*\.. ........ *. .. .. ..\ . .# .# #
#...\.#......... *...* #..*.*\..*...#...........#...#*.\.# ..  .. ..#.....\## .#...... **#.\..\..#*....*##\\* #* .....**\ \... ... #. \*..#. .*.  ...#
##\... .....#*.#..*...##.*. # .\  ..#*#. ...\... .....\#. #..#.... #. \#...#*...#.\.. ....# . .... ...\.\. . ..    .#..\*#..#.*. .... ...# *..*....*.#
# \...#..* #.. .#.\ #...*.. . #. ........*..#.. ....... *\ *.. ...#.#..............#..........**. .. ...*#...# *.. \# #*. ###.*\ .\\\ .. *\#.*....*. #
###.. ..**... #.*....*. . .. * .#..* ..#...#.*..*.. # **. \......#.   ..*.... *  .... .##* *    ..*\ . . #\...... ....\..#. ..#.*#..\...... .....# . #
#. ...# .. .\ .#. .. # #. ....... #. . # . ..#....#\......*#\ ..#. **#* .#.. # *..\.. .\.#*..\... . .#. ..* .. ...#..... ...\ \#. \.. . .. ..*.\.....#
#..\*# ... # .... ...*. .\ \..#.#.  *##.# .... *.......\ . #..#. #. .... #***..  ......\ . .#..#*#*...\.. * ... .#... #..\.*# *.\........ ....*.\....#
# ..*\.....# *\.  ..#.....##*  .*..*...#...*....    . ........ .. ...... .#. .. . .......\. . \ . ...\.. ...... #  ..#\...\\.  . #...##.*\*...... ...#
#..\. .  ....#. .. #.#*.#.. ..... #...**#\ ...*.. . *.... \ ..*.###. ...*#... *...*. .....##*.#. ... ..**#  . # *..#.....  ...*\.*##..\*..#\*..\.  ..#
#* . .  ... .*...*. .#..* \ #.#.*....... .*.# .  ....#.\. ...*\ ..* ... **.*......  *. .\#....#.  ..... \.. ..*.*#*  ... .*.#...#..*.... ..   .*#.##.#
#\#  ....... ....*#......... .\.#....*#...*.. #... ..*# .. ..  ... ..# *..* . .. .#...#\..#.... .\.*\\.... .#.#.#.#*.. ... # .  #*\#..  \ .. .#*.... #
# ..... .  ...  ...** ....  . .. .*\*. #..  *#.....#. *....\ . \.. *.........* .*..*.# .\.. ..*..........  #\  .\.....#*\...##*..**.... \..*...\.  .*#
#..##.#.##..*.. .  *#.    . .#*  ..* .\# \ .. .\ * ...  ..*\** *  .#\.# .#...#...*.*\ ..# .#. .#. ####..*...*..#.. ## ............ ..#  *..*.\*\#.*#.#
# ...**. . ..#... .#. *#.....*.*. ##....**  .*#..  ...##.. .*... . .* .#* ........ ..**.*#.*.\.. ..#. .....*.. .\\. ......  ***... . .. ..*. #....\*.#
#. .... .#.# .. .. *#.#.##.  . ..#.#\. ....*.. ..  ...# ... .*  ..*.\  . .* .**.#\.\.**. \. ... ...*.... ... .. ...\  ...... .*  ..*...#. . .  * .*. #
#. .#  #.  *.. . \...# ..  .* .\..#....# . ..\*....#*.#.  .#.#.....** \... \..  \#.. . .  ..*.#... .. ... . . .*# . #\ ..*.. .. .#.. . ..#..\..#. ..*#
#..\....... ....#. .#.##. *  ......\###.. .\ #... .. \...#.... **....#.* \......*.  . . ##\..  . .......# .#..##..#.#... .. .#*# *.. .  *... #....  ##
#\..... ..\#. .\.. #. ...*.. #.*.  .##.#.. ..\...... .*#.  #..... .\ .*  #..\. .* #.  ....  ...*.#...#  .. .... .....*. . ...# . *#......* .. # .*. .#
#\.. ....* # ... #..... ..*.\.. \.#*..*......#.. . ...**. \.#.. ....*  . .#.#...\ *.. \   .. \ \ ..... ..*...  #........ #**#*.. # **.. *...  . .*..##
#.. .......***.#. ...*..... .... *.#*..  * #..*    .*#..* .\..* #.\ ....... .#...  *...#.#    #.. .. ..#*..... #.## . ...*..\ #....##.*  .#.\ .. ....#
#. # ... *.......#. #.....* *.\.. ## *.\*.#..\*.#. .* .##...*....  \.* ..*...... #..#....#. ....... .*.#.\\.\\....# ...#....#..#... ...*.*. ..  . .. #
# ...... ..*.. ..\.. *#****. \ #.*.....**. .#..*.. . .. ..# .*.. ...#.....*.. *#... ..#*.*..  *.\#. . ...*  ..*...*.# .*..#..#.##... . *..**...... . #
#.##  *...# .# ... ..#..#.*..#....*..*..#\.. \..*.  \\... .       \...#.. .......#*#.#  \#....#.  ...#..\.#....# ..#... ....  ....#....**.. ..  ** ..#
##.#*..* . ...* * . \...**...* .* \ ...*\.  ....\ \. ..... *.. *\..#\ ...#......#.. ... .*......*.  ... ....\.*#...#.* ...*\ . # .....\ .\ #...##    #
#......\.#.#*..# .#. ... ....... ... ..##.....#....# .* ..*...\ .  ... ... .#. ...........#....... . .##.*#..\*. ......\#.....  .. ....##**.. \.*..\.#
#...#.. *\ ..\......#...  ..*\*. ....*..  \.. ## ... .. .**. ..*. .  ..*.. *#.**..... ..\*. .#*..** .   ..   ..... ..*.....*..*. *.#..... .   *..#*..#
#*... . ......#*#....#. . .....* . \ .. *. .... \....##\. .#....# \ *.\ . \..  \.\ ...*\\  *.. # .# ..*.#....**. . ...\..  ......*... .\..  . #.....*#
# *..*#..*#..#.... ..* #.. \.*..*.*  ...\..\*..*.\.*#...* ..*.#.  #. ...#.* ...\..# ...#.#....* *...........#\. .*......* . .#*..** .##**.*#. .. ..#.#
# .**........*\...  ..\.##\#. ....    *.......... ... \..\. .  .\.  .#...... .. ... ...*.......*.#  ... \.# #. *........ ....* ..*....**  \ *. . *...#
#. # .#\..*... ..\..  .*. #*#**.*#...#. *......#.... \.... .....\ *..\.. .......*... .*... .*....#.   ....   .. .* .\ \...\. # .* .#\... #*\     .* .#
#*....*. * \... \..#.*** . .#.*..\..*# \..... #...*...*... .. #. .\....*. . ....**. . . . ..\. ..*..* #...**....#....#..\  .. .\.  ..*\.*.# .# .*..#.#
#....*..*** .#*  . .\. ...... \.*. .#. .. *#.**.*#*.*...#.#.*.*#.  ...\ ......#  .#.*.  .# ..# \..  .#* ##...  .#....*.\.*.*.\..\.*#.## ..#    ..... #
#....#.*\.* #.\..  *# . .# *....\ .\.*...*.....\.*..##...*# . ...\*..\ .......#*.... ** .... .\*..**.#..*.. ...*.....  \#\..\\... #.#\\*. .....# ....#
#....#...*.#\*.*.*.   ..*.. ....*. ... #...  ##.#....#..  .#.. .... .# .\\*#..* # *.*.\.*.. ..*.\...... .. #.. # . .  .\....... ....#..*. ..\* .*....#
#..*. ...*...*.. **. .. *.....\. * .* .   ..#. ..\\....... ....#..*.. .... .#.....* ....*# ... .. #* . .*. #.*.*.*  #.....#  #..##...\. ...#....*# # #
# . #.... .....*.  *......#..##.#. .. #...\.. .\. . .*....*.. .. \. . *.*. . \*..#\   .. . . .#... ..*\* ... *#.*.#... \.. **. .. ....... .*#..* ..#.#
#.#..*..#.... * \..#. ... *. .#.\..   .... #..*..\.  .*...*.  .... ..# ... .   *.#.# . ....* ...** ...\#.#.... .. *.....  .*..  .#...#.# \  .*\..#...#
# .**..\. . .*#...* .*.  .. \....#.. * .# .. ...\#.* .....  ...\.....\  .#*..\ \.\ * . .... \ .#*#..... #.* .... .*..*#....#.*..\....##...*... ..*...#
##. # *....#\*..... .#.#...\## .....   .*#. ........*..\..*\. #.  .* .....*.# .#..**.*.** ...* ...... #. #  ... .** .#..... *#*.#.# .#.. .. ....*#*  #
#.. ..#.#..*.....*.... . * ..**#*. ....**   ..#... .#...*.. ##....# *.*#.*..... .... . .##*\.. ...  . .....  *...*# #.....*.. #..**.....  ......#... #
#.*.*.* ...\. ...  ....*. ..##...\....#.\  . #..#.#..\ . ... . ... . . \....* .*.\..  ..*...... ....\... .. .  *. .# . ....*.*. ..#.* #. .#.*.# .#*..#
#   ... *.  ..# * .. ... ..*......#.*. ..#.. ..* #  * .*.#...*##.....#....\.#.*.. .##\*\... ... \..#* .  #. ...*#.*\... .. *..**.. ..... .. ... #*.# #
#  .\ .  .... \....  ...#. . .* *.# # ##* .#...... ..\#.. \.\*.\*. \#.... ..*#..\....... .. ........ #..#. .. ..... ... #.. ... *.*....  ..#. .... . #
#*..*.\....*#.\..  ....  . .*.\  ...# ##...#..  .. ..**.....*.\  ... ..  ...... ..* .\.*..#.*... . #. . . #\..#.#. ....  ....  *#. #...\. .\.. ......#
#.. .. ... *\. \# ......#. . . .#\*.. *.. \.*..#..**..*....\.# ...*.*..... .#*..  ...#....* .#.\... .... . #.  .... ..\**....\#.. .. ..#.. . *..\...##
#....***..*.. ..    # . \# .#. #.#. .. *.*  # *  ..* .*.. ..  *.* .....## . #*#.*. .. ... .. *.#...........*.#....\. . ....*.  ... \....* ........#..#
#.... ..#.#....*... .#...###*\........  .#...#**\..#**.*.... #...#\.  *.#. .. ...*. . ....\   *..#.....  *...   ...\.   *..*.... .......*.......\. . #
##.* .. .. . .....  .\*.*.....*.\ *  .#.....\****.\. . \. ..\.*...# * .# .....  . *...*.. .#.  .   ..**....\ ...\*#*. * \..*. \\# *...###..*# ..\*\..#
#... .*#*....# .*  .\.*... .#...*..#.... #...* .. ***...\ *...#.#. ......#.*.....\... ....... .. *  ..*...#.# #.#. ....... *. \.*....*\#..# .....  *.#
#...*..\.#\ .. ....#...* .#......*.*#...*.# .... .*. .# ..*.. .\........* *...#*..  . *..\.. *#*...#..*#. \.\.\ .... *.....# ##.*.. # .... .....  ...#
#......**  ..# #.#........\. .  . *\\. .#. .. ..#*#..# .. #.....*#*.... .*..#.. ...# .. ..#........  \ .#... .\.   ... **.....\###\...#*#\. . ...  . L
#*.  . #.... .   ... ..*  ..##.. .#. . .. ..  . .#.##*... #.#...#....\***...............*..... .. . .** ...*#.. .\   # *......#.#.*  ......*....#*...#
#*... \.*\.... .#.. ....#.  ..  . ...#..*.#..# .. ...\.*.\\.\ . .*#.# . *....* #. \...  #.....\...*.. ...# .#*. .....*.\ .*\...#..# #..#.\..  **#..\.#
#.#.... .  ...*#.....*#.....## # ..*... ..... ..*. ..*..#\* ........\..*.  #   .. .. #... .#*....*..*...... ......\\... ... *. .#...\.# ......  . \ *#
# . ..*..*..*#..#...*.  ...#.#.*.#..  * ....*. *. \\#.....*. . .*\....##.# ..  .# .*#.*. .. ....... ....  ......\ # .*#.. .# \#. #. .. .\#  ... . ..\#
#\ . .*. #.*....*. ...*.#*.. ....#..#. ..*.#.#.....*..## \#...*.* ...* \.#. *.#*#\*.. ..*.#... \..*.. .....#\\....\..#...*.##*#... ..\..#.. ..# *. .##
#... ..\. .#.# #....*..*    .......*.\.....##....   #.. #.. ..**  .. ...... . . ... \ ...*.*.. .\.. ... . .*#.... .# .\.....*. *..* \..# ...#...\....#
#. . # ##*...* *.# #.  # ..*\..*....#\.\   *\. *..  *.\*..*  . *.*#.\\\......* . .. .\#.#.. ..  *...\.. # .. ... \ ...........#... *.\.\.\.# .#..  *##
#  .\ \. .. *... .#..... ....*#.#.#. . ... .#* ......  *. ...  ....*...#.#...   .. ..*..##**..... *. ...\..* .*.\.#....\#. *\ #...\**#.* #.#\.#. .. .#
# .. \\...#... \#   #*#*..    .* . ...\..\.. * ......*.. .*...#.*.....\. ....#\. ##  *....\#.*\...### .*.* ..*  . \ .*..... \ .. . ...*.  .*.. \.. ..#
#*....\...\..#.. . .\\* . ..## .#..  .... .*.... .. .. .\..* \.  # .. . . *... .\......\*#.*  ....#... ..*. * . .*...  .##*..# #\.#. .# #....*#*. **.#
#...#\..\. .*. . ........ **...#  \.#..#.*.. ...*  #.*. ...#* .#..#*.. ....#........#....... ... #\.... #.#......*..\..... *... # *.. #*...# .. .. .*#
#.. #......#.. * ........#.## *#.* .......#*..\.\ #. ...\ ... ..  #..   .#.. . .# \.... .    ..#   ...*.....*  *.# ......#\*# *..#.#.*.....#.. # \...#
#..*. ......#\ . #...... ..*.....*.  .* *....\* #.....#. .. ** # .*#.#*# ...\... *.....# ..#  *.. #  *.*..  . .. ..*.\..........  *. #...... ... .* \#
#. #.#*.#\ ... #..*..#  # *#.*#..*.# ....#.  .\ .\.#*.. .\*.\...#. \ *   ..*.... .......*. #.  .#. ..*.. .\..#.\.........  ..#.. .  *...#..  ..#*# . #
#**.. .\   . #..... ..#.......#.... *.#.  ..#..... .*#... .. #.....\. .**...*.###.. .\   #. .\...*.. .*.\.\... .... ......*.**.... .. . .. * .*. *.#.#
#..   *..#.\#.*#..#..... ...## *.. #..#... . ...*.#.. ..\.....#..* #......*. ..*...*.. ..#.\ *.\..\.*... #. ... *.. .....#..*... .*.. .. ...... ... .#
#.....#....# ....... . . .#.\.. * *.. #..# .#.. . .. ...  .*........*...#.....\* ..**.....*#*.... \ ...#*..#. . *.#. # .  .... \..#**.*#..#  . ..#...#
#.. ...# ..*... ... #.\#.    .#.......* .\....*. ..*..*#\*\.\.#....*.. .**.#. ....***  *..   ..* .. *.#...\.. *\#.\ \.\.. .#. . #....#...... .\....\.#
#  .*.*.  \#*..* ...#. ...#.*. .....  ....*#.. .#.. ..#\...*..#... ..#.#.#..\*.. #.**.. #*.#.*. #..# .#*#.... .. ...*. ##..*. .. .# ...  .* ## ..... #
# *. * .#.#.  \.\.*. ..  .. ..  \ ....*..#.*\..\ . .. #... #..###..#.\.# .\.*. .# ... ....#.  ....*...* ...*...#..*..#.........**..\..*. *...\. .*. .#
#**\. .#. * #..\..**...  .#..... ..*...* . ....#.#  .#.. ..\ ..  * \.\ *... #.  ....  .*.# *. #* ..###.....#*#..#...*.#...##.  # . ..*...*..#..#.*...#
#....#.. .#. ..#.... . ... *.    ...#....... ..* . *.. .#*#*.##.#..\...\.\. *.. ..*\..\#.* *...*#.*#.*.  #\*.. ...***.#..# .  .*..#.. #.. .*.. .. **.#
##.  .*.*..  . .\.*.# #.. .  #...\.\ .*..*#**   \ #. . .* .*\ ..  .\.. #  .....# ..#    ... .#..#.*# ..... *  * . .. *#.. ... ...* *...# . ..*  .. ..#
#..# ..\... \....**. .   *# . # ...#..   *\.. *......#.\.  .\.\\. *..*..  ....*. . .# ...**..... \**........\.   # # .   . *.  .\ ..* .  * #* ..* #\.#
#.. .*  * ..*#.. . .. ......... ..*. ...##\#...# .. .  ..\.... .\*.\..*... .....#..* \... \.***.....*....#*...*.. ...   ...#..\...\* *...\....#*.....#
#.**#.#\.# . ...##     .#  ... . *... ..\...  ...   .# ..#.#. *.\ ......... ..*.\  .*..  .*.* ..    ...# .......... . \*.\ ..#.\...##. . *# ..*#. #.##
#.. ..#..##*.......... .*.... #. . ..*. ..#..\\.... ....... ...# ... ...... .*..\.*.. ...\..*..# ...*.*...#.. ..\.# * #..#*..#.  ...##..  .#...#.#.\ #
# #....# *# ***...... .  *#......#.\...  ... ..**. .*.*.#. .*#....* #.. \..# . .....   #\\..  ..  ..  ...... . .#  #  .  .... \.#.*#.* ....\\ .*..*# #
#..\# *.. . .  *# . .......# .\.***......#*** .*..#.*#.*#.. ..# ...\. .. . ....... *. .....\.#...*.#.# . * .#\#.\ #... ..\.#.* #**.. .*.....*  . ....#
#.... ....#.....  ...#.\#.*## ... . # .# #...  \*..#...... .*###.\..#... ...\.. # *#.. .  #.....#....#* *..#. ..*#*.. .#........*.  .. *#....... .* *#
# .... ..... ..... ......* .. .*. ...\#...... *... ...\#..* ...*.*.....#..*#. .#. \.\\. . ... ....  . ....# .. . .##\#.\.##*..\#..#...\ .*.\*\...... #
#...# .\. ....... .. ..... \ *..*..\#  .# . .*.*.\.... .......*. .*....\.... ..  ..**  \ #..#......... ##*..\ .*\#*. *..#  \ .#.##... \..# .. .*..#  #
#. .... ...#*.*#...   ....  .\..*... .*.#\...#.*.*.*.*..*..#....* \ .#....  #.. .#*.*......** ...##..*#..\.\  #..\.*  ....# . .... . #*..... .. ...*.#
#...* *.*......  .#* ..**...#...\ .. .* #...*.##*.  *..#...    ...#*.  ..#.. ...#.*..*#\..*. *..* .  *#.. .#. .. ..#. *.*  . . ..... .. .\...*..* .*\#
#...#..*. ...**. .\ \*.#  . .. \..#*.#.. .*.. \. **... #.. #.*. . #.*..#..#* * *  * .#* . ...  .. ..#*....\ \.*...#*...* . #.\\. ...  # ...\ ...*  ..#
#   \.. .#* ...*. .. ..\. \*..\ #......#*.\.#. ..\. . ... .....#..\.\. ....... . .  ......#..  .*.\.....# . #*   #**.....#*.\.# . .#*.*.\.\. .*. * ..#
#  **. ... .#... .......#.* ..#*.....*.....#..\...  # .*. .\\#..  *..*\...#....#..**.\.. . .#. *...#..  #.. .. .*.. . .  .#..##..# #* ....#....*#*...#
#. . #..#..... # ..#... .....  \ ...  ... .#.......*...#.. *. .* *#.\....*....\  *. .#\...*....  ....  ...*. .. ...\. \...\\##\. .....\ #.**#.#  *...#
#.# ..* . ..#...*#.\\..*...#\.... #.. ..*.   . *..... ..  . .. .. *.....*.#....\ #*. ...**. ....\ ..... *.*.  ..*..#  .#.. . ....#...  #.....* *.....#
###**..#..\. ..##...\   ..* ....   . *\..*  #.#.. *.  ......#*  #.. ...\#.....#. .\ .....*. #  .*#.*..*....  .#  ....... *.#*.#   ..\ .. .\#. \ . * .#
#\.. ..*.... .#...* ..\..#. ..*.  . .*.#. .#.. .#.. *\#. \... .\    *..\.. .#.#.#. ..\  .........#  .*...# # . *#...#. ... ..#.   * ....\... *......*#
#*.. *..\*. ....\*# ... ......... *..*#..*...*......* ..*.#*.. .....\..#..#. .\...#.*..#....*..* .**#.#..#. *..*.... ..#.*. ..  . . ....  ....*...#.##
#**  .. **.#....  #.**.. ... ..##* \\#..#. ...\#. .*#....* .. .....*  ..*.*.  ..*..#\\ .#  *.......... . .*.* # #*..#.**\. . .... ..#..   . . ... **.#
#..*..  ....#.*\..**...\ ... ..*.\. .  .\*. .\##**. .#  #*....*\##.  . .....  .  \. ....##...**...#.... ##.*#. . . ..\. ....   .. ..**.  \...**..#. .#
# . ... .*...* ...  ..** #*.#. #.#  .................# ...#. .*.#. *....#......#.*...  . ..*#.*#.....*\ ..*...#.*... *..#..*..*..*..\.#...... .......#
#**  ... \ #. . .... #***... .## .   ...*.#..  #......#.\. \\#*..\  \*.. . ............ \\\#.... . . \\.*... . . .....#..* ....#... ... #...  .*#.#. #
#\.\*..........#.......#\ ...#.**.\. #...\. .  #.   ..\ ..... .#..*.*..\.. ..# .*..   ... *.\#*#\#\\  ... .#..\ .....  ....# *  ...   #.#.\.\ ## .*#.#
#.#* ..  .......... ... ...\#.. *...*.#\.. ..\..\. ...... .. #*...#. .....*.#.*. *. .#.......*  ... \ .#*\...\#..* .. #.\.\.#*. *\.## ..#..\. ...\.*.#
#.. *....\. .. . #.#.* .....*# .**...* ..*. **...* #.*..*   . #...#..#.#*........ .. . #.#....\*  . .  .  ..* ..*....* ....* ..*.. .\#*..*....\ #... #
#.#*\*.#..**. . #... \ .** .... .....*.*. * \* . .*\... ..# ... .. #. ....   . .  ..  ..   . *   ..# \....   ...\.... ..*...... .. . .. ....  ...*.\ #
#  .... * . ...**...   # ... *..#......... \. .*..#...*.#... \ *.  *...# #..... .. #....\.  ......#*......*# .#.. #....  . ..*..#*. #..*. . *.*. \ ..#
#..\.\..*.#.  ..#..  ..#... ..#.. #*  . ..*....#..*.*.#.......... .. ..*. . * .*.#.\\ ..#.. ..#* ... .*.*.*.. *#*..#\.#.#.. ... .. ..*....#.. . .. ..#
#\.\* . ...*.\\#.## * ... ..# .. . ..... .. ...\. ..#\...\#....#*\**.... ...... ..... ..*...#... #*.\. .#.*...#  \ . * *..#..# . . #**.. . ..*... ...#
##.*\..  .* .#. ..  ..#. .#. .. .#*** ..  . .\ ..* . .#*\ *.*..  * . .... *  . . ... . ..   ......*..*..  ....#.**........*.......#.  ...*.....  .\*.#
#. .#*. ......#.. . .  #. *.*...  ..   ....** ....\  *#... .  ..\* ...  * . *.#.. *. . ..*\*.. . ..  #......*.*#..... ....  ........\. *..... ...  #.#
#**.*.....*#.#.....\.....* \. \ *.....\ ....*.# *....*.  .... .*. ..*...\.......*\..##*.#....#  ... .. . .#.   .... .\# .\#*#.. ##.*\ #... #.... ...\#
#..#.*.. .*.. *#*#.#*.**...#\....*.#  *#* . .......... #...*... ....  ...##..\ #.*... #.*.. .\....*.\.*.*... .... .*.#.\*#*. . \ ... * . . \. ... . .#
#  .............*..\.* .#.. .*.. ........#  *.*.. . ..**..#  #...*..*.##... ..  .*... ...*......# ....####.... #. *..#..#. .#... .... . . # ..*..\.\##
# *.....#....#   \..##.#..\. ...*. ........#............\..... .. . .#. #*..#.... ....*.  ..#\ .# *  . .... .......## * ..*\#.. .... .\\ . ..\..\...\#
# **.. ....##*....#*....\....## .  .. .......... .#..## . .  . \. *..\....#.... ..#....*. \..#..\#.. ..#.....# .*.... .#*.. ...#.\ ... ...  # ..#....#
#.##.....*. . #*## #.#.*..#. *.*.. .. ..\ .\... .\ .... ..\..#. .#  ..... *\. .* \....... .....*#.# #..........*.....##. \ .\.* .. * ..\ . . ...  ..##
#...*..#.*# ..* .. **..#*.**..#\.  ..# ...*..*... ## ..  .. ...... * .... ..  . \. \##.  ...# \ *..*. .. ##\ .. ....#*.*.  *..* . \*. .. *#.*.. ...\.#
#.  .* #....\. .. ...#....\*.. . \...   ....*.*#.....#.*.  ...\*#...*......\.#. .* #.*.\..\...*#.# * .. **.*..*.....*#..*.\ ..##.. .*... ...*.. . .*.#
#.#.#.. # . ... ... . . ..\.*...#*..# .... . ..##* ..... \. #........  . .....*..\ .*#. *.\. ......#...*..\... .   ...\.\......\.##.*....  . .#.. #..#
#\. .... .. . .....\**##\#. ....*#*...#   ..* .. .\... *#.\ *.....  #\.\  .#.. .....  .. . ...* . .. ... ..*...\...*  .... .. #  . ..# ..#....*.... .#
#.. ##.# **.  ..*...#. \. ..*.R.....#. #..#.\..#.*.#............  *#.... .# ..\* \.**..#. ..*..*.. ... #.\..#.....**..**... ..# .. . ..\\..*. . *...##
#....*...  *\. ..\# .*#. . .*.* ....* . .*\..#... ... \ .#...*\.\. .#..#\ ..\..*#  ....##*  ....  . .......*.* *. .#\..*..*..\...\.......#...# #... .#
##...# . \ ...  #*.... ..#.  .\..*.\\#.  . ..#.*## .\*..\ ...... *.. . * # .. #.#\......\#....*\\. .#.#..\#\ .#..  \... ... . #. .#.. .\... .*.... ..#
# . ...## .\.#....  .*.. #.*.... . .\. . .#.. ...#. ..\#...#*..#.   ....*\.*. ..\. ..# ..\ .\**.*  ..\...  ..**\ .  ...#. .....#\. . #... *.* *. \  .#
#* ...*.... ......\..# .# ..#. .##....\\.... ...**#.......#.....#\. .......\#... ...# .\...\.\.. . **.#.*...\#..*.. .\...*.#..  *.  . .....* . #*. ..#
# ..#\...*. ..*....  ..**##  ..... ....... .. #..  .   #. \.. ..... .....*..# .##.... . ..*#.*... .. ...*.*#.#... \*.*.**..  #*.#*....#*#.  ......*#.#
# ... \..**. ...  .*#*\# \#...\*.  ..#. .\....*.\ .#..# .#**...#. ..\.*.......* ....  ..... .#..  \....*.*.   ..  \ #* ... . ...* #.... #*..... ..*..#
#* ......# ...   \... #...# ##.....*# ##. ....\.*...*.. .   .*.. #.. .....*.. ..  ..... .. ..*..#..\#..... \.\#.. ...* ... ...\*.  ... ## ..*........#
#..*... .# .\.. . .**# ..*...* #. *\*.#.#.   ..* . .#\.* . #........\# .#. . .\...\ ..*\..........*..# .#. ..*   ..# .\ ..#.. *... ..* ..*\* ... .# *#
#..#\ . #...#\\..* *#. ... .*.  .....# .......# ..#..**........ .\#..... .*..* ..* ... * ...#........ .*  . #...... .* ..#.... ..  .#.#. ........ \..#
#.... \...*##** ..*.*..*.. *###.....\#..##*. *.* . # ** .#*.#..  .. \.# \.#......\.  *.. \ .   .##... .\.. *#  .##.*. . #....*... ...\.# . .#* * #.#.#
#. .# ..*. *..\**.*\.. .   .\. ....  \#....*....#*.#...*. ..*\. ......* ... . ...#...*...*#... .#..*. .. ....#..** #* ..#*\. *...*.  ......##...  .. #
#.......\.#...\.... .#\.#  . ..#.... # .* .*#.  .*.\#..**... .#.. .....* ... ..\.\.... . ..\* \. .  *..*.\.. ....... .#.....#.#.*....*  .*.. *.......#
#\.  #   ##.....  ..* *.# .. .. ##...#*...\......... #\##...*...**..*.. ..#.. ........* ..... ... #. ..#.... . #......# .\\ .#*#\.....* #..  .\... ..#
#*...\..  .   .... ... . ....# ...... *.  . * ....*# *..#.....*. .... #.\.. . ..#.. .#......*#..\...  #.*........ .*#...... # ... ..####. .#*.#..... #
##...*#.##*....*.#..  ...... *#.#.** ......#.  .. #..#\..##.....*.*..#. .##*#.***.*#. ...*..*. ..  *....*. . ..\#. .. *##........*.#. . ##  .....*#. #
#....#...\#... ..*.\.. \ #..# *........#... .. .\ .....**..#.\.*... .#...#.#.\. .. #*..#.*\ #. .*.* \. .*. .*.** ...#..... .\#*. .#...# ..*#. \.#.. \#
#...* #. ........ .. .*..##. .\. #...... .\#*.#..... \. * .*.*. #.....# \.*...  .*\  .  ..*. .    \\\..\ ..  ..  \*#.. *# #.#  #...*.#.....\....# ...#
#.\# \   ...\##.#.. . . . .##. . . . .# . \  .. .#...*...\.. . *\* #\ .#... . *..*...\......*  ...*...\##.......*....... ..*. \..\.....#..#.... .. ..#
#... ....... . .#\.\ .\. ..\ . ...*..*** . # .* .#.  .. .. ...* *.....*..*... .. ..#.\...#.*...*.....#...... .. #.\# . ....#**.  ....*  . *....# #*..#
# \# .. *..  .....\..\ *..\..  # #..#.........#...  ........* .* #...#.#...  . ... * ..##....#...*.....##..  ....*   .*. ..\ ... *....* ..\.  . .\ #.#
#..# ..  . #.#. . \. . #.........\# .. ... .*. ..*.* ... # ##....*. . *. ..*\ #\.. ..........#* .. ..# ..#..*..#  *......  .# ......#.  *.. #.\* #...#
#. ..*. .... .. *#...*.... ..#*....... ....#.*.** .... *..\.* *.#  .*.\. ..*. ..*.**.* .\.#. .. # .. . \*.....**...# #.*\**#.#. .....*.*#..#.\..# *.*#
######################################################################################################################################################