######################################################################################################################################################
#*..# .#.*. \##.... .... ..*.*...*.  .#...... * \*... ... .\.*.#......\#.# #......#*\#. .. . ...#*#\. *.*..**.. .... .. ... \ *..#...# ...*. ...** ..#
#...... *.. ...# ...\.. ..#.....#...*\..#. \ \# ...*.. \..*...*.. \... ..  ..... .*...#..*...#...#.#**\*..*.*.\.. .. # * *#..* # ..#.**.... \..*#. ..#
##...* ..#.* .*. .\*....#.  .. \.#. ..  .*..  #..* . * \#...*#*#....... .#. ..\.\.*...# * **....   .\* *  #.....#.* .  .     * .....#. #. ..  ..\....#
#\.* *....... .* ...#........... . .. ..* ..*...  .*#\.*.**.#.. .....# . ..#. .#*..#. .*....#.#\  .*#......*.......# ..*\. .. ....*..#.. .. ... .....#
#... ... \ .. .. #. * .  ##. \..#. .. .  ..#. .... .......*.* \ ...\.... .#.. ...\*.... #*#. #..#. . ..  ..*. .  .#.*..*. ...*.#. ....#..*...\ .. #\.#
#..##. .. .#  *.. ...... ... #. #....... ....#.. .. .. *. . .##.*..#\.. .*#..  . . # .*. ..* *#  . * .#..* .\.# \ .*  #. ..**.** \**  #.  . .....#..*#
#....... .*. . # .*.*.....*.*.....*..* *#.  *...**#... .*... ..*.. ...*..*. .....* .. . # .# ##...   . \.# *. ...... #...*  . . *. *..# #* ..... ##..#
#*... \*.....\#  ..#.. *.\..#..#.. . ##..\.#... . *..#.. *.. .*.... #... .# ..  . ... #**.... # ..*#*..*#*..*. .*... ...\ ...**...\... * .. ... *  . #
#. #...  .. ..  #**. .. ...\#... .. .... ...*. .  . # #..........#..\. .. . #.  . .... ..# ..... . .*.***...\..##....*.  .#..  ..*\ ..*  ..*#. \.*...#
#.*..\......*.  \.. \..*..*. ## ...  ......\.* #..  . * ..#.. . ........#   . .. *....\*# .\ . .#\.\...\..#   *\. #.  #.   *. ...#.........\ #.......#
#*\.  ....\  . \...\.. .... .*.#.......* . . ......#.  .... *.....*##...\ .\.\. * .# ** *.........  \.*.\*.# \. .*. ..... .##*.. .##........\.. *... #
#....... # .#.*.......\...#..\#.... .. #.. *. #. .. ..  **\. #.....\*...... ...\  ... #...#..........\.#  ......*..#*#.. . .#. .**\.*..* .. ....#*.#.#
#. ##...... .* \*\ \ .. . .. #..*#...  ##..  *..\* ..\.... #..* .. * *.\.  *...\.#   #..*. .**#..... . .  . .... *.*....\.......  ..*....... .##\..*.#
#. ....#..##.. #. ....\#.#.## ..\**..\.. #........*. ..#........... ..\*. ...... #...#. #....*..# .*..# .... \..\ ..\#....##... #.#. . ....## *....#.#
#...\.#**.*\.#.. ....  ..\.. *\ ....\*   * .........  *...* **. ..*.. #*... ***.\..*..*.. ..*......#.# ...#.. .........\..*..\ #   .  *..... ..*.#.. #
#.... .*##*...*. *..#. .*#\*.#\.....\. ...*... ..*#.*...#. . ...\ #\..## #. ...*.. .   .\ .  .*.#**... ..........#.....*    #.  ...#*.#  ..*. .*.... #
#.*.. ..* \. ...# . ..  . .........\**.##...* #..*.....*....*#..* #*.*..***. .. . .....*#.. # ..#  ..... . *#*...*#\#. #*.\ ......\. *  ...\ *.*..**\#
#.##  ....#..#. . ..#\. ..... ..*.. .*.*\ .*.# \.. .\\.. .#  ..\  . #..#. ..#..#. ...* *.... .. ...\... .*  .* ##... \. \ \ ...# #  ..* ...   . # *..#
#.. ...... ......*.*..#.. .*...\........*.. ..*.#.#..**.. ......\.....*. .. . ..#.....    ..*.*.....# #\\*. ...#*.... #...#\\...*.  . .#..\. #..*#...#
#\.*   .*#*...\#.... .##..*...**# ..*.... .*..#. *#.*. *...*.  ** .##... ..##**#\.... \. #.  #*.#.*..\..#  #..*.... *...  *#.. \#*#  *..*..\  #.\  \.#
#.#.# .###. .* .**.... ..\\.  ......#..#... #  .*..# .#.* \ ...... *.. .... .. .... . . ..\ .* .#.. # \\.#... .\..  ... .. .....# ... *..#* ...\\*...#
# .*...*..*. ...*... .....*. #* #.. ###.\... ... .  .#.* ##........*.**.#. .*... *.. .\. *.. .   ...\.# .....*   #... ..*##.#.. .\*#####.\.#. .* ###.#
#.. ..*\. * . .....\..... ... ... ** .. # *...*..#...*. .*  .. ..* ..... .  ...\.  .#..#... ......  .. ... .......*...\..\. ...#.......  ...... ....##
#....    . ......##.*.....# . #.#.\* \... *.... ..##..\ .........# #.. .. .*..**  .\..#*....... ... \.# .#... .   . #........ ..*....\ .. .#.  ..... #
#*.#  *....* ..*.... ... ....*.  *..\...*. # .. ##..*.\... .\. ...* .*\... .#. .*..*. .* . .\....  ..... ..\. . . ......###........*..#.....#..*..   #
#*.... ........*. ...  ....#.\.. . ..* .*.  .. *...........#* * #.  ... ....  ... ...* . \ ..# .. *... ........* \*#. ...*. *...... .##.......#...#.*#
#.... ....* .. ... \.... . .. *....  \..*..*..* .*.. . ..#..*#..    .....#...**... .*..# .*..  \. ..\ * .*#.*  ....#..\.. .*.... .*.**.#.. .  .....#.#
### #...#\... .*..*.   \** .# .. ... .  \\.. ##..*.#\#. .#*#  ..*... ... . **...# ....... \. .\. #.. *** ....\..** .#.*#..\..*  .#.*.... .... *..... #
#  \..**...\....* *. .#  \.. . ....    *#...  .#.#*..\.*  .....*#.#.\* ...#. ....#..*# .##.*. ..\#. ##*...\*#.\. ... .#..  .... ..**..... ....... .* #
#   .\ ..  #\#...*.*     \..\....#\.# *... .*#...*. \..* ..*.\#*.* .**............#\. *\...*...\*#.\#. ..... *##.. ....#..*..# .#.....\#... #. ....#.#
#.#..#..#....  .. \#. ...#\. . . ......*...# #.. .\\..*.##.......... . #\. *..... \#......*.*.#....*.#. ..*. *.*.. .#*..**#\*.. .##  #.............\.#
#\ .*.##.** .. . .....* ..#**\..\.....  ..... .  ...#*.*..** #\.......**.*.. ..#. .... #.\..*. .. ...# . .# .#...*.\#**.*.*.\  #. \. *.\.*..#.... #. #
# ............\.**\.*.......  ..*....*. ..# .*......*..#.*. #  *.. .   .*.##... . . #...  #..\   ...\\.#.# ..... **...*..#. .*...* #. . .... *... ...#
#\.*\ #... *...###...... .. . \... *.. \.#..\ *..  ..  .*.* .  \.**. . .. #.  ...*...*.##. #  ....#.  ...*.. ..#.#..*. .. .#.....   #.... .*\....#...#
#...#..#.. .  ...#.*#\  .**.# * #*....*.. ......*....#.  #.*.\* .. ..#.. ...\... ..**....* .*\ ..#..  #*..*.. .*..# ..#. .#.*  ##.....***.*. ...*.#.##
#..   ... ...\*.\. ..#. .* .## . . .#. ..\##  . *...# ... .. #*...*# ..#\#  ...#.....#... .*.  ...#   . .*.#.#.#.\...  ..\ \...... .....#*....*..   ##
# .# * #   ..#.......\...#..\ . *#.#......*... ..... .. ..\. \ ... . \. \.  ... . #...#.  .*. . .*.*. *.#.. ..# ..*.... .\ . #*..**...\ ..# # . #....#
#\*.#...\. .*#  #... .. .#* .\ *  .*....# #**.......# ..#....**.# .#. *#.* ......##. . ..# ..*...*\....\*........ .. .....#  .......  \. . \..*#... ##
# ..........* .\ ..#..\ # \... #.......... . .....*. .... ..#....**.*..#..... \.. ... . . \.... .....*.\ . .  ...*\.. .*. .#. #.. .#. \\....... .#.**#
#..#.. \..*.... .. ....*. .. #..#..#.*.* \ ..*.. . ..\.. #. ... ..#.....*.. ... ..#  .\..#\.. .* .\..\\.... .....** .... #. .....## . * ....#...#.\..#
#.. . #... *\...*.... . . ..#..* ....#.. **.#.   . *#... .#..*#  .. *\ #.  ....** \..##..\#*.... .**\  ... ....*.*..\ ..*\. .***....\#. **  .#.... ..#
#. ..... .*  *.*.... *. *#..*.**. \... * \ .... \....#. ...  *..*\... *...*.. . ..*#.\ ...*..#..#..#....#... ...... .*.* *#..........#. .*..... .....#
# *.*  .\.....*. ..*.... *...   ...*..   .#. *.*# ## ....#*.. #... ....* ..*  .#.. ......*. . ...*.. .... .##..\... *# ...*.\.*#.#.  .**. .*..#..*  .#
#..*##.#.#.  *. \.#.#.\ .*\..#.*##..#....#*..#.#.\..# .  ...  ..*\\.*.... \#.#* ..  ......*.. ....*....  ..\ .. #..#...\. ..  #**.#..* #.....\\.**#..#
#..# ..#*#..#.....*.. #.* #. # .*.*#...*......*\*.........* \*#.. .*....*........#**.\*##.......*#.**...   *..\#.#.. ..\ .#**#...* \#...\... .*.  ..##
#.  . \..#*\##*...#..*. .\. *#...# . ...#.*\....\......   **#  #.\  ..\.  .*....#... * #.#. ....*.#...\ .* . #...... \.*\... . .\*. .#..#*# \ .... .\#
##.\  \.#..*...##..# .....  . \# ..##... .\. * #.# .. * ..*#.*... . . .##...\.   *..... * *...*. ..\# *.. ..#*. ....\...*.....#.*.....#....... . .\.##
#...... *......\.. # #..* ..# .. .*...  \   .. ..#. .......   ......#\..*  ....... #....#. . .# ... ... .......# .. .. # ... ...*  .#.. ...*# #.. \\*#
#..#..#... .\.  ...... .#..*\.\..#*#. . .# ..* .#\ .\  . .  .#. .. .....#...#.. .#\  **...... ... ..# \...*\ . *...\#........  ... #  ...\. . . ...\.#
#*.. *.#..*\#. \*. . . ..#..### ...... . ....... ...  ... ..#. .. . .*. . *#.*...*# *....*..*.. ..*.. *. #. **#*....  .. .......#.   # .*....\.. .#. #
#..  .. . #*  ....*..* #\.#.*... . \ ... ....*.\....#......  **..#.*.. .*..*#\.. .*.\.. ...*.*...*..*... . *. .... .# .......  . .#* .. *\........ ..#
#\... *.*.#..**  ........#......*.\.... ..\... .. .#\ .#. .. .. .   ..#.. . .#. #.*..\..\.. ..\*#. ..**.......*... \\....   ..#.....  #...  .  #....*#
#.. ..  ..  .##...*\#*.* .* #.....*#...*... ...# #...\ #... .#*. . ... .... ....#\  .... #.#.......... ..\...#\.*## # ..* ..#.....#*.....  .#. *.. **#
#\\.* .. #... . ....*..*** . .. ....*.. \*... .... .#   ..* .....*# .. *..#.\.#.. .\#. *.. ..*.   ..\# . ..... #.  ....#\#. .*..* #*  .\ . #*....... #
#....#. #.#.*. ...\.*\.*. *..# .#.\....#... \.#.   .#*#**# \ #.....#..\  \.. ##.* ... ##.\.\*  ...  .\#. .....*..#  ..#..*#..# *......*. #...*#* .* .#
#..* .......*#.. .#. .. * * ..*.# #.*\..  . . *.. ..... . . ...\\*.  . ...*  *.\ . ..\ .\.. \.*.#  .  .\.\..##.. .......*... ...## *#. *.. . ..\...#\#
#.**.   . ...**. .\ **. #   .#...*. ..  ...# .. ....*## .##. ...*\. .....*... .....*...#.\..**\  *.*. * .* . ....#*. ... * ..  .# ..*.  .*.. ..# ....#
#. *....#..#.* .#.# .  . *..  ..#...*..  .# .# ....  .#. .\.\.\  *\ ... #  ..... .*...*... ...\#.. *...##.... ...#. **...*. ..  .\ *.#\.. . ..  *#...#
#..**..***....#\.*... .*..## . *##..# ..  .*.. ..#...  ...*#.....*.*..# ..... ...#....... ..*. *\#...... . .*..  ... #\.  ..# .. \ #..  .... ...#. .##
#*.*.#\..#*....\. .*. \ ........ ... ...#..  .# \. . .. . .\.*##.*.*\ #\* .....#.\. **.##..## ...*. .. #... ... #*... ...*..*..#.*. . .* .  . .#...#.#
#. ...#\.*  *.#. .....#*.. ............ ...#* . . .*. ...  \... ... ..*\.......*# #.* #..  \ *#. ..... . *# ... ... . .**..*..*# . .*.. ..#. .\#. ...#
#.*...... #....* ..#. .... ..\#.*..#..... . #..\..\ *. ... \#..*..... ....#*\...*... ...#    ..#*..\ \.. ...  ..........*. ....##\#.#   ..*#.##..... #
#   .  ........*......#..\..#......#..#..*  ##.. *. .# . ..*. .#.#\.# *..   .#.......\ .. . ..\...........#\. .. ... *. ......*........#*.#*..  .#  \#
#.......... .*...**. .....  .. *. ..   # ... #*. #..#.*. #...*..\...#....*#*...\# ###.*#...*#....  ** .... #.* ....#.....#.*. *\. .# .\.. \..*....  .#
#  #.\....\..*\***.. *. #. .. *.. .... ...** ...*.# #  ..\. ........  ...#  *\.\. . ....** .#. *#* \**..# #. ...#* .*...#* #.. ....\ .. .*.#. \#..\.##
#. . \.* ..#. ##...\ .. \.  #..# .........#\.*.. #.....#..# .***.. .....*#.*...*.... .*.....\ .....\.*.#.... *#\  .#...*......* #...\#\**. .\#\. . ..#
#.. ....\\  .*..   .\. \\#\.#*..... ....*.....#. . .  . .\#.* .. .. #. ..*.\*......\.   ..   #\*..*..#..**.......*\ .  #. ..*..*##..**.##....*#.. *..#
#.... ..#... #...# .*...  ........  .... .... ....#... .. . ...*....... *.#*..*  \*  . #. .#  ..*  *...* ### #. . ....*...... ... .....  ....... ...##
#..\ #......*.#.....** ...*..\# *.\# \..\ . . # .*.#*.#. ..##...   . .  ..# ... .\#.*##..*...# . ....**.....#....\..  ..*.#...# .* *  .......\.*... .#
# ......#.  \*.\... \..\ ##..\\\. ..* #.  #*.....#.# ..#......*.. . ...*. *\..\\.\ .\..........# .....  \* ..*....*.........*#.....\\#\. .. ..*.*.*.*#
#.  *. .\.\. ..#.#...#.#........*. . . ..\ \.. #.. \. .... ... ...**.......*\ #...*  . . #. .#.\.. # .#\ ....*........     ..\*. **\.\#.. * .\.. . ..#
#*...#. . ...# . ##.*.. . .#.. . *. ..*.. ..##..# ... ..\.##.*...*.\\ .. ..#... . .....# *##... *..#.....  ......*..*.  ..  .\#....*.. *..*.* *#. . .#
#. .\ . ..*#........ ....#*.. **..*....#...\ \  .\....... # ...#... ..*#..\# .. ..\#   # ...\#. .#...# * #.###...#*.#*... * .#....#..  #  ..#.#...*. #
#..  .*.... .# * .##.#...#\#.\.\.##... ..* ..... #... .#...\..  ..**#.* ...#.. .....# ..  .......* ..*\...  .\..*#*.\. .# #.#*\ #   #.  *#.##..... * #
# ...##...**...\.* *... *.#.\.....   .. ...* ... #*..  .#  ...##.....*#.. .....#.  # #.#.#**##. # .\\#\#..*. .**.....##.*\.\. .*..#...*....*...  * .\#
##..... #..#..* ..#.   ..\\.#* .  .. . ...  ... *.. #  .#...   *..#...... ..  ...#..#..*...  *#\..#.#...*# ... *.*.**.. .. ......#. #  .#.\ .**. *.\ #
#.*##.*. . . ..#.. #  #.*##.    *....*#....#*#*..\ *.....\.. *...\. . \. .* .....#..## #.*.#*\. .. .#* *...\*.. ..#...#.#.*... #**#. .....\ *... *...#
#..  ..........*....  #.\..... *.#. *... .*. *.#.*.. . *..**#  ...# . . ....#.#*#.#*\ ..#... ... ..\ \... . .. \..#...  #......* .*#..\*...#.... ##  #
#.....  .. ... ...*.... ..#...##.** ..**.....#.##. .*.....#..*\.*..#.*#*..**. #...  . . ... .\. . . * .. \....**...#........# *#. *. .#..*.\...\ . . #
# * *.....#. # .# ...#...  # #* *#.      . \.\.\..#..\  .......... ...  #*#....*..\...*.#\.#......#. .## .*.* ....#.\#..#. .  .#...  ##...   ....*#..#
#*  .*.  .#... ..*.....*.. .. * . ..\.## . ..... ... .*.* * .#.#.*. .  .#. ...****#*.....  . \#  ...\#..\... . * *#..##. #.*.#..#\#.. .. ..\.#..\\. .#
#\....#......\* \...#.\..#.... . .** #.\.##.. ....###....*...............#*.**.#.\..*.  # ...\. .* ..*. ...  \...# .#. ..* ...... . \ #. . \... * ...#
#.**.#..*..#..*\..# .....* . ............ .... .*.. ...#   #\.. .\.#.#..   ....* #....\.R..## ..# ....#*....*#. . ....#.* ...*..*#..*.....  .. ..*. .#
# #. *.## .. ....*..\..\# . ...# . ...#..#.# ...  *.*   ....# . \#. *.#.....# .# . *....  .*#.#*#. .. .\.#... .*...* .##......**.... ...#.\ ..\* .  .#
#.  ......#*  #...... . #.*. .... ... ***#* .#.......*. .*.  ....\..##...* ...*.. #.**#.#.  .#..#...#. .*.#...\. ...  .  .. .*  .*.... ##\ ..#*  \  *#
#* . .#***....* ....#....#.*.*..*.#.#.... . .......\... . .#....  .... **.# . .\.....  \#*.*.#..* *\..** .#..*\ . ... ..*.. ....##..#...  .. #. ... .#
#..... **. . * ....*.#.#... .... #...#.#. ......*..#...  * #*.*\* #. # *..* ...*.. .. ....*. #.#. ..\.* .  .*. ...   . .\ # \\...#.*.. # #. # # ...# #
#.. \......* ..*..*..... #..\.*#*..  ...  .*...**.  \.. ..#.....  ..*\# ...##...#*......##.* ..\.*\ .*.... #...*....*\.\ *.\  ..\ .*.**..#.. .. #  ..#
#..**.......*\#... ...#*.* . .......#  .# *## ...  \#. *#   * .*......*. . *.... .\..#........\.   #....  .. . *.... ......... ....*.   ... .#*..\\ *#
#..*..##.# ..*\...*. ........ .  *.#...\... .. .   #*.## *.#.#.. ....\..#*##.#....... . # \..\#..#...   . #  ... ..*..\.....**......#.*........\... .#
##..*. ....... ...*. *#*\*..* .#\ .*##.. *.# .#.# #  . \..*.. #.. .*..    ...#.. ..\....* . ...\....\ ..#..*. . ..#\..\#*#.#*. . ...#.*#.##.##   ... #
#***. .##. \.. .*.*#*. .. .   #... .#*. #. #* ..*..*..... \ *.. ...\  .*....***  ....  ..*..* .  ...#....*.##.*.\. .#*# . . *.#\.*..#.*. ..*.#..#.\ *#
#.. ..* .. ** # ..*#... .\..# ....*....* *.# .  ..*#....*.\ *. .#.......*\.# ...#  .  .. ...... .*... \ ....  .  #*.. ........# ..** \ #. ........** #
##\ ... * *\..#... ..* .  \ ..*.. *...*.\. .......... . ........... ...##  *.#........* . *\..*..*.# . \...##...#.. #.\ ...\......#..# \.\...#*..*\..#
# * #..\#. *.*##..\  .*...#* .#......\.. #..\..\.\ ..*.## #..#..*... .*. .*.... . #...... .#... *.  .* *.. .*....#.*\.*  ......*..*.  \...*. # ... . #
# .#.. .#.* \.. .\.\ #.#.#*.......*..... ..\**\*.....* ..# #.....*.*#..*   . .* #* ...  .\#..# .  .. .**...*..* .*........*....#.* ..*. ..   .#   \..#
#..*#..#.*\.\\#.. *#.  \ ... .. ##*  \. .. .. .....*....* .  #  .*\... **...##.*. #  ..**.*..#.\. .*#....*. .. ......\.#..# ##.. ##.# ...\.. ..#..## #
#\ ..* \..   .\.#.....*....**#..# . ... .* .#. . .... .... #.#...\.. *. *.*...## *.. .#.#**#\....  . \.## * ..*. \......#..*#**.. ..\....#*.*. ...\..#
#. ...#.\...#.*. . *.   *..*. ....... . *     #. .. . ...#..#...\. .** .#.\.\*...*..  ........**.# ..#  #*.#..*  .# . .. .  ..*.#.**..##...#.... . ..#
##...... ** *... ...##.# * #*  #..*....*...  .\.\....... ..**\ ......  *\.....*#  #. ...... #\.#   #...#.. ...#......*..*.*......#*...* .#...** .#. .#
##..#...#  .**...#.* .....\.. \* .**.... ..... ... . .#.  . ....  ..\.#* .  .  .....  ...... ..*... .. *#..#. .. .# ..*. ... .. .....  ..#.*. .......#
#*##.  ***.. *..# .. .#*.#.\.....\.*\.\..\.....\.*.   \ ..*..*... #*.. .#  ##\.... .* ....#*. ..\... *...#... .... ...*.# **. ..#...  ... .. *... ...#
#... *  .  #.   ......***..#* #. ...* . .*. ..#  .\...# * .......\....  . . *.. *#.   ...#.# .... #.....#.#\..*..# *#\* ...  ..#\.*. ..... ..*.\   ..#
#......# *...#. .#.\#.... ..####*.*.. #..# *#.\*.#.... .*. #. \. .. ..#.#.#...  ....*.\.# #.  .***\..* . .\...\\. ##.*.#....... ... .#    ..#..*..  .#
#*.... .... #.* #..#.. . *..# .#.\ .. ...#.#\..\......* **....* ...# .* . ... *  #..* ..... . . \ ..#\.  ##. .#  *.. .... . *....*#*.#.#.*#...*# #..\#
#..#..*..* . .  . . ...  .*..*.. ..#.#. . \.. . *.. **.. * \.\..##.. ...#.#........  *.*...#*.. .#...* \ ....*. ....# . .*  *..*.....  . .\   .. \. .#
# \..  # . # .*. ......##.\  #......#  ...#.. # #\...*...\ #.. ..  #  .# \*. .. #.. ..*.*...##... ........ . .. ..* .## .*\#\. ...*....#*. ....   ...#
#*.. #..#....... .\ *...\*.\   #* .#...#.*\...\ *.#* ##...***..........  *....*\..#. . .# . #. .....*...*  .  .   .  ..*. #*. \ #. #   .  *..... *. .#
#..*.#...*......#.##. .#.* ....\. .. . .**  *..\#.  .\..\ .#..#.......#.#.#*.. .........*.. # ..*... ..*.\..**#*.  ..\##..\ ...\**.. ..*\...* ..\..#.#
#.*....#. ....#. .#...\..#.*. .....#. #. ...  .\. ....  *#*.#.*. . *.## . .......*#*\.#.\ *... .. . . .*..  . ..* .  . ##...\ .#. .. .. #*..#.. *# *.#
#..#... .# #... .. ....\.  #...... ...# .*..\. ..... *  .. * .#.... #\.#...\. .# .##.#......*#.#....##*\## **#.#. \.* ##. ...... . . .\.\.*#. . #....#
### ***#... ..*.*.\.\.*. ....*..*   #.... .# . *.. #\... *. ..  .  ....... ..  .#  .. .\..... # .*#.. .. #.*.#......\#.### .   .*...# ..  #* ... *..##
#  . .......*..*   ...# .... .#. . ..  . ...\ ..#...... .#  ... ..#.*...*. *#... #. .* *. ....\.#.*.. . ..  .#.  .. . #.\\...\..*...\. #...   .....\.#
#. .. ...*#..#.\..#....# .. #*.##...*#.......   *.\#.....\  ....\*#. .. *.     .*..\..  .....*. . ... .#...## #.. # .. \**. ......\# ..  \*#... #...\#
# .\*. \. ..  *#. .*.... . ...... ...#.*    ##.  .  ...........\*. #.#..*.#..#.*...*...#.. . ... ...#........  ..\.# ... .*...*.\#..* #.\ **#   ..\*.#
#  .*  .. ...\..#.... .. .*.....\*....... ......#... ..#..* . .#\..#  .*#.#.*\.#......  . ... .. . ..\*.. . .*.....*...\*.#*.. .. #....\ ....    .#..#
#**..*.* .\*..*.  ..*...#  *# ... .......*.  .#...#*  ..  \##\..\### ..## ..... #.. \..#.  .\..\.\..    .   . .#..\ ... ..  ##.. \.....*.\... ..... \#
#. ..  .##.... ...... ... *#.. #..#.  ..#  *  .. #........  ...\ .. ##.#. . # \#...# .. . ... ..#.....#*.*....*..## .   ##.  .*.\  .\ #...#..\.* #...#
# . ..#..##.#...#\ ......**# .. ...#. .  .#*. #\ ... .\.  .  ..#.. #. .#*# ........ .. .#\. ..  .\.* ..#....  #...\ ... #....\*......#. ..   ...... *#
#. ...#.*  . ...\. ....# \*\*.. ...\..*.*....  ....#.\..#.*#*.*....*. **....\..\#\..#.....#........  #.*.  # . #.#*   .. ... ...*...#.#.. #........\##
#.# ... .. . ##*.\#..# .\ *#.## *  ...... ...#*.# . *   #......# . .\ ..* .#. #.#..**.*.*. *. ..  .#..   .#.. ... .#.##.# .\. . .. .#.** ...*. *..  \#
# .. .. .... ..*...*.  ....#.* .....*..*....  . . ..#\#...#.# *.  .#. .*....# .#.*. # . ....#.* ...# .*. ..# *.*..*...#.#. .... . .##...*.#..*  *. ..#
#.*..# \\  .#...... .. .....\...... \# .  .... . #.\..##. ...#....#  # \. ....#...*..\........\.... . *.\*.#.##.....*.#.. .\.*.*. .  .\.*.*#**.  #.# #
#. .....#. . ..... * *#...*...\..#\..\.\.\.....#   .   **# .\.# .. ...... ......... .# . .#.. ...## .....\.. #.#..* . .* .\....* . . ..  .#   ...\ #.#
#*.#. .   .*. .. .#.\ .. ...#.#...*#..# #. ..\...#..  \*.. ..#....*#. ...  .*  #.# ...#\ ...\  * . .. . .. .#.........#....#.. .....\ .#*.*.#.###....#
# .*. ...#...#*..... .. . .  #. ..\.#.. .. ...* #.#. ...#.*...\  ...............\ ..  . .*...*#......# . . ..\#*.\.* . . ..  .\\.. ##\# * ..*.....  .#
#...\..\*..*   .*#. ... ....... *.. ...* ..*.**# .#..*.*. .**....  ......#... ........   .\.*\#.#* ..*.  .#.. . .\.#.* ...#*........**.*.***.#.. ..  #
#... * . ...*....  ...*\**#\#..#\..\  .#...#  ## .\.*.   ...... \ .. ... ..#... ...#.\#.... .\.. *...\. . .....    .*## .*.* . #.* ##.\*..  #.#...#..#
#* .#.. #*..#..#. .*........ .#  . .##.*.**........ *...#. .\#*. ....#*...*#\\.* #.. \ *.. ...* ...*\....... .. .. ... ..###*.  .. ..*#..\ .\.*....*.#
#... .*.*.. .. .... ..  ...##.* ...*..\....*#.. .#* .. .* .. ... . ... ... .\ ##... ... ...... .#***  ... . . .... .*. . .*.......  .  \.  ...#. ...\#
#... ... #. * *..#.. ...\.\\.   ..*. . \..#.##**. ..... . ..##...*..#. ... ...*.....#.#.## .... . .. #......#..\.*#*# .**....... #..*..*\#\ . ....  .#
# .#\*..# \*   .\... .  #*.*\*  .*.. .*.... *\*....\.....#.# \.......**... .*##...*..  .  .#...#...##.  ... . ..\.#..*..#..#..*.  .....#. .*...*.#.#.#
# #. ..\...*.  *.  .. .* ....#... ...  .  # \*#.. .. \ \#. .  .... . ..\#.* *.*.....  *.... . .#.....***. *...... .   ..**...* .....\# ....#  .....#.#
#.* .*. .#.# . *.#..   .  #.. ........  ..#*.* .#. . .\.#.... ##.........# .#   *.. ..# .. . .. .\#.*.... . *.*....... .*#.   ....#.. \*.*.*# ... .*.#
#.*.\ .......\..  ....   .\ ..*.... ......# # .* ..#.#. ..*.*.. .  \........ ....*\ * .#..*..* .*#  .  \.\  \ ... ...#.... \  .  ..\ .*#.*.  *.......#
##.*... ...  ..\. *.#.#*.  ......*. .\* #*#. *......*  #   \...*..\ ##.#.  \. \. .... ..\.. ..\.*. ...   #*.*\\* ... .#...#. . * #.....#.#.**....*...#
#..*. .\....**..** .*.# * ....*.......  .*.# . *..*..#*. \*. .#...#\*##\*...##*...*.*\#...#.... ..# . . *#  .*.# .... .##*..*.#....*.#*... * .\.*... #
#.\**....  .\...# ..  #..# # *.....* ** .*. .*... . . .. ...... ...#....#.\.#.. ..... .. \.... .#.#.. ..  ... ..*..#..  *...  ...*..... . .... .*. ..#
# ..  *....*.....\ ..#...#. .... ..\*.\.# # . .*\. # .. ..#...**......#... ....*. \.  ....\..*#. .  ...## ....#.#\ *.*..* .... #.\\.........*   . *. #
# *..... .#....** .* ....  .. . ... ...\#\..   .. \......#. *..\.. . . \#.# #.#.  .. ..*** . .*.....##\.*. ......*\#.  ......... . ..*.#.  #*.. .# ..#
#... \\  .... . .#.... ##.* .#.\ . # ..  . ##....... .\\....*......\*.   ..*.. .  .\.. ...\.#..*#.*.... .*.#. .. .\ *..#.#.*#.. *.....  *\......* #..#
#  ...*....... .#...# . \#.......\..#....\...  .\ ..*..\... . .. ..**#........ *.#.*#..\. ..#.*.# .#*###...........*..\*. \....... . * ..  #.\*..  #.#
#. . ...... ..*..#...#*#.**.#.  .*#.*  .\. # .... .#.........*...**. ..\.\ ###. .*.*.. . ......#.*####.#\...\...#.. .... .#.....\...*..#. ....#   \..#
# .  ... ..* * ..\...*.#..#*. .. .#. *.. *..*.*.\.* .. . .. #.  ...\ #.##..*.#.* *\ \.. ...  ..\.... \..* ..... ....*.. ...#**.  ..  . *.....*.....\.#
# ..#.  *.#*  .*...*. ............*... .*. .. . .#..**........*..* .#*... #.# ####..#...*..*.#..\# .#....\ *. .#..*#. ...\...\ . .. . # ##... .#.#.  #
#...*... .* \\..\#.\...\. . . . .##....*  * ....\*#..#   #.\....\ ........ ..###\. ..* *.... # . #.*.....\* . ... . .#.....## #.*....\...#.*...\.....#
#...... *...*.# ..\...  .#... ... \...*#...... .*.###..#*.\. ##.*\. *.... ...#.. .*\..  ... .#*......**.#.*....#..  . . ..\..#...  *. .. .*.\... . ..#
## .\#**.. . . \...\. .\..\.. . .#   *...   .*. .\ .... .. .#*..##.*.....#  .##..\.*#.. . .##  .  # *.#\.... ##.*.....  **.** ...# \.. .  ...* .#... #
##################################################################L###################################################################################