######################################################################################################################################################
#.......  \.*....#.*  ..**. . .\....###  .*....\*.#.. ..*#. * *#. .....#* \ .# #.. .*.   .. #.#.*.....*#.##...#.\.  #\*.*##......  .## # *.. . #.....#
#\... \ ..*..\#.*#. . .. * .... .\#\.. ....*#.  # *..... .... ..... ... *.\ . ..*\...*.......*\\ ... ....#..# .. \#..   .\........  . #. . . . #.. ###
#..*.\.....***......\...##*.. *  .....#...#.....*..#.# *#.. \....   #. *. ...\#..*....#...... \#\*... ..   . #..*...  .. .#*#...#. \..\...  ...*. . *#
#*. .#..# * ..*. #......*#*  ..* #....*\.\* . .*.\.. .... .* *... ..*... .. ......#*\#\ ...#..... ..... ..... ..#.*....* #.... #....#.*... .#* .... *#
#.\....##*.  ....#.. ..#*. . .*.*..\#.....\ **#  .....**.   .*.*#..*.\.. \ .. . . .   .. ...* .##. .. * .  ... .. ..# .\....*...  .*# .\# *.*\\..#.#.#
# . ... .# #.. *..* . .. .\.. #\............* \.\.*.\......*..*.. .*.. ..*.. ..# ... .  .. .   .#\...#..* .\..\# .#. .*.  ..\#. ..  *...#.\\...*.... #
# .\.\ .. .\.*..... . ...#.........*..\...*..... \. #...##.*.#..#..#. *.. *.#.*.###. . .*..*#..# ..*...#\ .. . ..*\#... ...\ .... ... .* #......   \.#
#\*  ... ........*. .#. .#...# .#..*...##...... .... *#. \. ..#*\ # . \...* ... ..*.. ....* ...... \ ..*..#.   .. ..#* *.#.....*... .. .#..**.#.*....#
# .\......... .. \ ...\... ..... ..#....  *...\.#  ..  . ..\.. .#..\#.#* \..*. ....\.**  \..*.# . .. . ....\\..#...#*... . \.......#*. ..#.  #*..... #
#\.. \. . * \.\ ...\# #...*.. .  .  **.#. #.... .#... ..*\.*.. ....... .#***..  .. . . *. *.##..........\..**.. .#* ..  ##*#..# ..*.....\.#...  .. ..#
# ... .\ .#..# ##  . . .# .\ ... ..... .# ..# *..##.... #.......#...#.. #.#.*#.. #  *..#.*.*.*....#.. . .*..#.\\ ...\ #. .*.*.\*. ...* .#....** * .. #
#. .##......#.#  *..... *..*. .#...*\*.. ... * \*\**#.  #*. # . ##\.* ...\.*   .#. #.#. ...*\*....*#.*..  ..# .*.  ..*.#..*.*\......* .#..... ...  #.#
#.......\.. .#.. . * ..... .. ...# #. *.#  .....#*# .... ..#....**.. ....*.#...#...\.*\.#... #.**.. . ....*#..... ..##.*..**..  .#\.... \.. . . .#. .#
#. \.... .. .. #..*...\.**. ... \ .*#. #*...#..... ...*.. . #*#. . . *.... . #.... .. ... ..# .*.# ..*..*......# #.. #\....*...... *...... # ...  ..*#
#.*#....\ . . #. .# ... ............*...**... .. # . ..  ......\# .  #*. .#.. .##... ...* ... *.    *\... .. ..#. ... .** *. .. ...\*.\. . .\..#. .  #
#. ...... .*  ....*.. .....  .....*  .# \.\.*# *.... . ... ..... .\..#.. . ..... . .... .....\* .... ..#... .*...\*. ... .#\# ..* .....\....# ...  \.#
#... *.. ....*.#. ... ... ..\.*#  . .\..* ... .*.# .  .*. *.. # ...... .#.. ..#*. \. #. ..  ..    *..##.*  *\\....*... ... *..... #\.#....... .... .*#
#..*. #.. .* . * . .#\. ..    .* ..\ *\.** ....#..*.\..*.  *... # .\...##.  . .*#  #..#..#*.#* ...\..#...*.#. .#..#.. *. .\....\\.*.*...*#. #.* .....#
#*.# ##..*#.....#* #* ...*..#.  ......\....  # .*#..#.#.#.\....*........* *. ..#*  .  .**...*.. . ...\#.\*. .  ..*#.#...*#\.#...# .*...#. ..\.\.#*...#
#...... .#.  .....  *.   \..*##\   *#...#.. ...#....\ .....\* ..* .*..*..........* . .* ....*... ..* ...\ #.*... . . \..\.#\#......   ..\.*..\**..# .#
#.... *.# .#.. .....#..*..#*  .#*. .*\ .. * .....*#.**.  \.....#.#.#  *....... ..#.#**....     *.# *.**# ..  . *.\.. ..*. .........\#*.....  ..#*#..*#
#\.\\. ...  .....#*.*.....*.#*.. ..*....*. #. \#. .. .  .*.*.*... #.. *\#. . ... **.. #\..... ....#\ \* ..........# .....#*  \  .## ...#.*   \..*..#.#
# .\* ......##.. . ........ ..# .* \* # *. ... * ...* . \ .. .*.......*.\#.#.  ....#..\.*\..* ## \ #**......  ..# .# .*. ....\. .....*.* #. #*. \*.. #
# *.\* *\.*...#..  .#..... .#.#.*#........ .......  .. . . ..  #*... ....*.\. .*\..... \  .#. \. ......#. * *. ....\......*..#. ##..**... ....**.*...#
#  ##. .\#.*....\.. ..#. ......# ...\. # ... .....* ##*.*....\...  .#. ..#.  .  ..*#.... *#**#\ ....* .. .  .......* .#.*\ .\..\\. \..#.#..#\*\ ....##
#..\ .\. .   ........... .*. ..  . .\.. #....* .# ..*# ......\* *... .*.....   . .\#...*  *...  ....*..*\.*.*\.  .  .#.#...#..#..  \. \.\...**.   . .#
#**. #\\...   ... ..... ..**. .  .\... ..  *#. ..\*#  .#..* *.. .#*. . #. .. ...# \ ..\.....\\*....*..  ...  \...#***.. .... .....*...#..\..\. . ....#
# .#* .# .*.* .*\#..#.\.....  ..** *## .* * ... ...   .*\.**.. # ..\..##..* . .\. **.. ##.... . *#\...* .. .*\   .#*.*. .*.. *. .... .#.##. *.....#..#
## ..# ..\\.*....* .....\ .*.. \.\....  *...* ..*#  * . ...##\.. .... *.*.. ..  \*#. . .. . .*#. ..\ *. *..\..#.\. ... ##...*\*.\  ..*#..* ....#\.# ##
#* *...*........ **..  .... \ * . ... . .\*..#..\* ..  ... # ... .. \ # . .\  \*.. . .. .......* .*..*.*.....*.#**. ..  .   .*. ... . .#.#.. .##. .  #
#*..#....*.\ ..\. \... .   ...... #...\.\ .*... *...\ .\ *#.#*..\.##*.. .#.. #...#.. #... .. #..  *\\.##\.....## ... . #  ....\.*..... ....#* #...  .#
#.. .....#.. .\......... .... . .... .... #  \ *. ..   ....*  .#*  ...#.   .\ *...    \*... ....#.#. #*#....... . .*#\... .\.\ .#**..***.. .#*...#...#
#\#   ..*.#. .  ..#...... ........*.#. ..**.. # \...#.. #.#.. * #*\..\.*.#**\ ..**.... ..##  ..* *...\.... .#*#.# .* .....*..... .. ..  .\ .#\.. ....#
#....*..# .*.*..  .#\. ##.*.#....... ...... .... .**.#..... ... #.\*....*\.**... .#.\.#... ..\.. ... .*.#\**#*.**.*..#. .. *.. # .. .  #. *..  #.....#
###.#. * ....*.* \ . ..\.. .  \. * *.#. .# \.# . .# .. . * ..#.  #.#..**.\ \.* #... ....*. .... . ..#.......  .....##..\#.#...# .. *.\ .#.....\\.\..*#
#... ... \*..#..*..*...\#..... ....... .... *.# .#..#. .. ..   .\ . ..  * ...\#..\ *\#.....##.. *.  . *..\.*##.#... *.\#* . ..... ##...\ #.**.#...\ .#
#.. *.. \. . ...........*.. .##.. .. .# .#...*.  #* \. ...*. ..#.#..*\* .*. ... .##.*# **. ...*#. .. .. *#*\....##. *..**#\#.....\  ....\#.#.. ......#
#.#  \.....*.\ .....#..\.....###\ ..* *...#  .\ *.*.\    .\.#. \#...*....#*.\..  .##.*........ **.*..   ..  \.#. .#....  . .#..#. #.#. #.. ..#.. .*. #
#\.*..\..\.  ...*.. ..\\..\ . .\*...#.*. .... #*#\..#. ...# .    \.....* #.. \  \.*.\.*# .#.* .* .  *.*#.#. .  . .* . .\....  \.# #*##\ . .. *.\.....#
#..##.*  . #.. .. ..\..... *\ #......#.#. . ....  \. ... #... \.#\. .*   ...#*..*. *..  .... .*. ... #.#   .*#....#.  ...  .#.\**.#. . .\..* ...... .#
#.. ..#..*##.#..\\*...**...\......*.  .. #.*... *.....#.\.. ... **    .\   #.\.....*....*....#*.. *... *##.##  ...\.  *#*. \..\...# #*...    .......*#
#..#*... ...#... ...*........ ..\.. \ *. .... ..*. #.*#.#.#  . \ \.*.# *.... *#. ..#\.. ....**.#*\...  . .*##*. *   \....#.#\\*.. #..*  ...\#\  .... #
#.\ ....#\ .**.. ....*.  ##..*.....*.**.\#*..#.*...... ...#.#....**. .#\ \. \ *.........*\...*#.... *.      ....#. ##\..... *..#..#*.#\ ...#. ...#.\ #
#.#.... \.#** #..# ... *.*.*. *\..*# *  # .*. .. .. #.....#*. ..\.... ..#.# ... *.*... .......#.\. . ...*#...\#..***#\ .. . \# ...#.*... #. .**......L
# *...*.*. ..*....\.*.\. ..... ........\.....*...\ ..*\.# ..#.. ..... .**... \.*..#..#** . .... .... .*.... . .##.# \* ...... * .#*. . *#.. ..*.#*...#
#.  ..    .*.... .. ......#  #... ## . .... ...\\ .....* **...  #..\.*.*...\ . .*. ... \#.*.... ..#... .# #.... .*.#. ..\.#.#... #. . *..\.......*.. #
#\. ..\*......*  .##...##. ...# .\.\... .. *..\  .\*..  #.... * *#...#*.*.. .## \ . #..#.. .. ...# .....*#... **.#. *.......#**... .#.....#.. .*.. ..#
#. ..   ..**..#...#*\. #.#*..#..#..#....*... .  . *..*. ..*#.. \.. ........ .....** #...*.#*. .\.. *.#*...#.... .# ...* *\#   .* ..   ..\ .* ....#*.##
#.*. *.*.. \ ..\##.**.  #.\#. **.\..# ...*.  ... ..#... .\. ..\\.*..... . .*.#. #..*..*..... *...*.. ..   ##*.......# #..## .\ .#. ...*. .#.\*.  #. .#
##  .# .\... \..  .#.* .... .\..  #. . ..# ..\. *....\... * .*... *.....#....... \. . . . ..\.\*....  *.* ..#.. ...... . *.#*.*..* .  #..*......#....#
#  #.....#  *.. ... \.* ....*. ...* .*. #* . .........#...\ *.........*#\..#...# ...*\....*#.  #.# . *...\ ....#.  .   \#.*  .........*....\. ..**..*#
#.  .#..#....**\..\........ #\..#*.\.. .  .. . .. ..#.##*   \ ..* .\. ...  ........ ..\......  ..... *..\ ..#*.. * # ...##*.\..#...........*....  .\.#
#..... .**.\ .* . *# ..*.*..*.. .  .... #.  .. ....  ....*...\  *...*.\ **........#..... .....*  . . ...#. ....*#  ....## #  *.......*#*. .#..*......#
## ... .... ... . . .....#.  ..#. *.\..  .*.*...#...*. \. .***   \..# *.*  \.#*..... .  # ...#.* ....# . ....*\.**.*. ..... .. ....*...#...* .*  *#.*#
##  ..#...#** .\..#*   .... ...##..*.\.. ...*.#...... .. ...* ...\.\.#*.#.\#.* \#.*..*.*... .. #..\#\... ..  .**.# ..*. ......#*.....  #.    \..\# *.#
#   \ .... \..\* .*# \..... .. ......#.. . .*#. #.. ..#...* ## ..*..... ..\.. .#..    ..**.... .  ....#\*# ..#......*.*. # *...#.......... . .#.\\ ..#
#...#.. . .... .#..#... .....*. ...#.. \ ..*#.#...\..* #  .*. .......**\ ... \.*.#* *\....  #.......#... ... . * .......*\ ##...\ .. .   .....#. *. .#
# . .#.. # #..# .\..#. #. .# #....\*...\# .. #.* ......\..  .... ...*. .... ..* \...#.... .\...\.  \*#... * *. .#....**.......* .*.... ...*.\. ......#
#...#. .\  *. . \.. *. ..* \...........  .. ...* ...... #....#.. .*.* . #..#. . .......* *  .....**   \.. ..* ... #..*.#. . .....#.\...*\..# \...  . #
#.#.*.*..*.#...* ...  .\. *.... *. . #.\.*...#...#...\.......\** *..\*... \#.  #..... ....\* * . .#...  . . .*#* . * .\. ...........\\ \..*.* * ..#*.#
#.\...\##. ..\*#.\. ..\*..  .*.... \.#. .\.. ..... .*... .....  *#.. .#..#.\... #.#.....   ..*.\* ...* .\. ..  .#.. ...*  # ..\.. .. ..  . . #*...\#.#
#. .#\*\ ...##  ...*.. . ##... ....**.#.\.. ##.... ...#...#.*...#\ ...  .... #.*#...*#*.. .\*\.\.. .##. \..... *.. \..* # . ##. ..#.\.* #..... ...\*.#
#\ ....* .**##\. ... .... .....*...  ....  \#...... \.. .*.* *..* ..\..  ...... *....... \.\.. ..  \\#... ..  .*\*.. ......#..#.##  * .* ... . .\#* .#
###...\ ..*.. ..#*.. ... .\...*.   ...**..\..\.*..# \*.\*.... #.##*. .#*.. .#....#.... ..*.... * #.*..... *. . . #...#..\*.... .....\*...\..   .*....#
#........ # .# . .... . #..#.#.... .#.#**..#.*. *  ......* .*..# .  .. ...## * .#.\....*...*..\.....#.##.#. #\.*  .  \..  ..*.**.... \.. . **..#**. .#
#.*. ....  .........\...# \.*  ..* ##\.....   .. ... ...\.....\*  ....#.*. ...#*.\..*  \\.*........* .#.. \.. .#. ...*..*... .....*. .*... .##*...***#
#.... .#.*.........  \ #..*.#. ##..# #.. ... ..\.   ...* ...... # . ....... #\**.. .#.. . .#  ..#.. .....#....#..# \ ..*..*# ..#    .*# ..\....*#\*.##
# *.#\ ..... **.. ...#..... *.\.....*.*..  .....\..... .....*...##.....* .*.. ....# # ...... .*. .. .. .*.. . *...#.##. \ #... ..........* ...*.#. \*#
#\ ..   #.\.... ....... . . ..#**.#*.# ......*.*. *# .........#*.*. .*. ..#.#..## *... .\.*.....#*\#..#*.*.# .. .....*...   .#... ....* *#.. ...\.**.#
#..\...... .... \ .*..# #.# .#....*.*....... * .  ..  ....*.. .... ...#*..# ...*#. *. ....  . .*...... ..#......#.  . .# . ..  ...  .*.. ..\..* ..#..#
# ...... . #.*# .#.. .\#..  *.. ... ....\....... *\ \..\.*....#..#...*\#...## ***#  .... \. ..\.\..... #. .   #*.\..  .*.....#. . . .... .\ .#...*# *#
#**..  .\.. ....#.... ##*.#\.  #.. ..*. ...  ###...\*   ..# . .\ ..#. *.*.   .... *#.# *... ..... ..  ..\ . .......*.. .. # ..\.#\*...****...*. #....#
# \ ... . * ... . #.*. .. . ...*.#...* ... .........  #...\...#. **\. ...#. ...  .... ... \..\...\.. #.. ...   #.. .......... ....\.. ....* ##..*.. ##
# *...#.......#*.  *.* ....... ##.#**#     . . ....#  ..  #...  ...**.#*.. .....*###.* \  .*...... #. .**... . ....#.........#....\# *.....##.#*... .#
#. ..#. .*..  .. *\ .. ...#....# *....##.. #.\....*...*. ....*. * .*....... . #* . \#...  * #......\##...... #. \.\.*#\*  .*...##\. *##. .... #....#\#
# *\\.*. # . #... .. *   *. .. ** .. \...  ..  . ... ..... ...#....** *... #. .#..#\.##.#\..#*...*\..#*.\#.#.... *... *#.......#..... . ..  *....  ..#
#. . ...**..    .. .*\. * #.##. * .#.#........*..#. .... . .##.##\# ... # . . ... ...* ..... ......#...  ..#. .... *.* ..* \..***#.  .. # .......  ..#
#*.*.*.. \......##..* .. ...\... \**#..# .. .*  #. * ...\*... .....\.*.#.*...*. .\#..... ..  . .....*....\*#.#....    ......\..  . ...#####.. ##...\\#
# .\.. ..#. *. ...*.\ ..\.. ..... #....*\#. #* .. \\ .*.. ... ... ..\*.....*..#.\. ....*.#......   .*\.. #  .....*\. .. \... **  .. .....##..*...* .##
#...#.\ .......*.\.*.. #...#..*#  ..#. ..\......# .. *......#.. ..# .*#\....... . \...*... *.#.#..  .  \ ... ..*#............\...............\*.\*.. #
#.....\...\.\*.. .\* . . *......*\.... ... .\ ###. .........*..... *# *.*.. .* *. #...** .*....\#\#* \. \**\*..*#..*.* ..  #*. .\. ... .#\..* . \... #
#... . ... ..*. .#..\.#.**.....* #..\..#......*. ......#*.#. ...#.... ..##.....  ...\...#......*.... .# .. . .. . . *.... .**.. ... .\#.*..#\...  ...#
#.*. . ... ..... * .#. .*.. . .* *...* .*...*..... *  ..#. .... ..  . \ #..... ..#. *.\ ....... \.*#... #.\ ...\.*##*##.*.*#   *.  ....#  ....*#*.. .#
#....  .. ..   #..**.. ...... . .*##..** #....*.*. ..  .....#*#.... *. . .  ....*. .# .*.* ... .. . .#\ .  ..#...#\... # . #*\.*.   *  .. #. .*..*..*#
#*...*\. .. ..#\.**. .# #.#..# #*.**.. \  .. *. .......\*.....\.......*. ..#.*...*#  .# # *.....  ... ..**...#.\\...*...#\*. #.* .# .. *......*. #   #
# ....*... # ... . ...  \ . . .*....  ..\. ..#....##.*...  ..*   ...#  #. *  ... ..  .... .\.\. .. ..#..  .\# #*..#. #.. ...**. #...... .....\*.... .#
#.\ ....  *.#.....#.\..*.##.*.. .#.... * .... . .. ..# # .\..#*  ..... ....*...*..#......*...#..\\....*#.*..***.........*  ..# ..*. ... .#.. *###. ..#
#..*# *  .. .#....#... ....*#. .*#.\........... .... ....*.#..*.. #.... #.*....*......*#..* ...*..*.  ... .  #...##..#..*. #...*.* #.#.... .... ..\ \#
#. ..* #.....#\ \\#.*#..**#.. *..*.. **....\*. .*.\. ....... ..#..* ..... . .. . .\*###...##.#.  #*.#........#  * .....#.. . .. ...#*\.*.. *. * . ...#
#\.........#  \ #..*. * *\#\. .... *... ..*...\ ...*#.  ..   #.. ... .  .....\ ...\  \.#.*.*. *.*#  \ \.# .... . .##\.*.... .# ##\.. .*...*...*....  #
# .  .. ......* ..  ......#..\*.#.*.. ...* \. \*. *. ...*.#*\... \* #....#.....#..\# ...*#........ #.#..* * . ... .. * .. *. *#. ..\. .....*.*.......#
#\. .#  ..#... *..... *. .. . .*.. ....... .....*.  ..   *#.. . .#*....#.. .....*#... .#.. ....*.*.. .*... # .. ..... * # #*.#.#....*..\*  ..# #\....#
#.. .*..\.##*.#. .#..... .......*. \\...* *\.#. ...... ....\.\ .. . *..  ...**\. *...#.#.#.*.#.. .* .*.... \#..*..* .* . ....   ..#....##*.  * ......#
#.*. .#  . . *. * ... .. . ..*.. ..  \##... . *..*....*...*.. .#.#.....#.\.. ## *... \.* \\... ...... .*  . . . . .#...\.......#*.* .. ..  \....*. ..#
#.* ....... . .   ...# . .\*.*..  .#.*... ...# ..*.\*.*#\ ...* .. .\  ...*..#.. ...#..#...\...##.  ##. .*.#..**#. # \ ........#.. ..*......#.*.. .**.#
#.......#.#.....\...\...*#...... \.*\ .  * *#.#   * .   .... . \  #..#.. #*.\#.* .#\. ..#*#.. ... ...........*..#.* #.#\ .*... .#\ *...*..#...#.\ . ##
#....#.*.*... .... . ....#\..*..#...  #. *...*. .. .. .   ..*....#*#. ....\. ..\.  \ #......##* #.#*\#  .##. * ..*..# #...#*.\ *\.  . .#...#.. .. *..#
#.....#.... .. . .#.... .# ..# ... ..\...*....... **..# ..*#. .......\ ...**\.*....  ..\*. \.  ... \..*...#.# .....#.\  ...  \.*.. .... \*... .#. .#\#
#...  ......  ....  \.#* *.* #.#\.. ## ..#*  ... .\\ .........\....\..\\.\# *  . .\. .....#\... ........*..*.. *\... ...*.#\...  .#.# ##.. *\#. .*..*#
#..*#\.... . .. # ....#.*.#  . *. ... .##...#\.#.. *.#....\#.. #.#.# # ....... .\ ... ... **. *. ..   *#..\\\.*. *.. .*.   # .  ..  ....... .......#.#
#....  .*  . .#.#... .. . *.. . .  ...#.#.\  .. .##..* ..#. ....\##*. . ...  .  *.#..* ..\**......#*..  #.*.#. .. ..  *.  #.. .*.* .\#*. . *.. .. ##.#
#..\\*.##\.*...** ##. #.... # #. .* *.*. ..........*#.....\ *#.... .\\....  #. . .. .  ... ...#   ...#.*  .*..... .\...*\.\..*\ \.*....## . ....* ..\#
##.....**.. . .. ...# .... .\..  . *..*. .*..  . .*.**** \..*....#* .#. \*..  .. ......#....#....#*#*#.#.. ..#..#*# ..\.* \..* . *\.... .#..\* .\*..*#
#* .. .*..#....... .  ..*........ \.#.#... #... \...#...**\*..*.\#.\*.. #.* ...*..  #*... ...###.# #.**.# \........ .  #......#.\ \. .*#.#.. # .# . .#
#...#*.*\.. . \..  ..#.\.\.  .*. .*#.....#..  . *... #.  ..*#.......\. ...*. ...  .*.........#..#...*. *.\..\*  \\.. .##.*.....* ...\.*. .*# ..*.  ..#
#.*...  ..#*. ..\#\\.. .......\. **.*..  * ..   .  .  ......\ .* *#.  ..*....\.*... #....#......*. ##..*.. \.*..... ##.....*.**\..# .##.  \**#...# .*#
#.. .. ..*   .. .*.. . .*.... \# .....    .. .. *..*#.... *.. .\. ...... *.....  .. . .# . . \*. .... ...#. .*.* .......#.. .....  . .\.#... . .*\ ..#
#..*.*# .....*.#. ..*.....\..  **..*.# .. ....* .#.\.*#. . #*.. .*.. ...##...*... . .* .* #.. #*....#.##....*#.##.#.# ##.....\*.....**##.... ##..*. .#
#...... *.\.\. # ..* . \.. *. ##..  #**. ...# **#..   ...\#..*.  ..... \. .\##...\.##\.#.\.. ... . ..... * #. .#.  . ..*\*..#...  *.  #. ... . ... ..#
#..#.. #...*.....**\. ... #  . ..*.*  ..... ..##  .*.#*.........  .  .#..* .... .*. ... ....*..*   .#.  . ..** . *...#...#.*...#.. ....\...*.*.* .\. #
#.* ...#..*. .....#.#\......##.  . .. ..#...\...#.*...#.....\.  .\#.*....*. ...*..........    .....* #\#.# . .....#..##.. . #....*\.##.  ....... . #\#
# **..#.*. ..\  ...#..#.*\.*  \.*.*#...* ...###..**...  ..*.\..# . . #...  ..*. .* .##.....\.*..  ..#\. ..**.\*.... .  *..  .\#...# ..\. ...**.# ..###
##..#. .*\.# .....\#*.*..#.....#.  . ..   .##*.#.\**.*. .*.\*#.#.. *#.#.#*..# . ... .\ ...**. .. ..#\..\..\\   .\\. .# .... . ....*.*..* \\##*..  ...#
#*  ..\.. * .##... . .......\. ....\ ...#*.....#*.\....#  .###.#.\ .*.  ..*.... ..#..# #.*.. \.*...*#.*..# . #\..\#.*..#.*\*..  .*...*\  .*..*..*... #
#.*.\#. .. .#.#  .#.\.*.. ..#.....#... . *.#*.\.\.  ##...*. ... #. .\......*#.*...* . #.#  ....  .*.... ....\..*.\  .# ..# .*  *.* \. .#.............#
#.\\..\ .###  .\*#...#**\.\.# .**...#\*. ..... .#... #* *  .##.\. * ...  . . .....#... ... ...##. ...\. .. .# . #  .\.*# ........#......*...*..#  . .#
#....\.. .\.\..... *.  .. .** ... .......... .**..\..#..*......\.....*#...#  \# ...  #. ...*  \\\.......*. # .  #.. ....*#  ... * *...\#.\......#. ..#
#  . #.. . ...... \#.. . . ....#... .# .... #.\ .. ** .\.  ..#.. # \... *...*.#.\.. ..*.*#. *\. #. .* *.. \ ... .*#..*.\ ..... . . ...*.\. ....* \...#
# .##.....#*. .*.#.. ...*. ... .. .*##.\...*..#.#*.... .. .#. *\..* ..  . .....*.*.\....  *.###\.   .#*  .....#.. **#*\..# *#...\. ..#* .... .. .\#  #
# ...\  #*..*...#...*.##...# . *    ...  ......#.#*..*# #.##.*.. ***..*. ...**......*..*. # .#...\ ..*#. .*...#.\ #.. .\*...*. #...#\  * . ......*. .#
#\ \..#. *..*...\........... *\.\.#..#..\#.. .#*...... .. ...*..\    ..##. .#...#...*.*# * \ ....*......\# ..# .*.*. .#.#.......*. ...  ....#  .... .#
##............... .\...*.....*.##\..  # #*.#*.. \....#..#*...... #. \.\#.# ....\.#....#*.\*. ..   ...\.... \... . .#...#.*...#.  . #..\*. ....**....*#
#.#.*#..  ..*...# ...#. #...* ........  ..* ...  .  .. ...#.##.. ..*...\.## *.....*.#*..*.*.....*..#..   ..... . #..\**. #.. .#**  ...    ...\.*..####
#*.. #.*.......#  **.*#..*  #. ..  .# .#. .\. ..#*#..*.#.# ... ..  ...# .\ ...\. **.\*. *#. .....*.*.....\\*. ...*.  ..*....**. ..*.. ..  . .# . ....#
#* #.\.....#... . . .*... \..*... ..##.#..*..*. # ....*..*.. .. .... * ......\#....  .. ..#*  .\*..**. .*. . *.*...  .#...  .*\*... .# . ...#... . #.#
#*.. \... *....#.#..* ....#..\..#..\*.  .  ... . .  *** .. #......#* #....#.... .. . #.##..... ........*. .. .# #...  .*\#. .  . ##...*..*......*.##.#
#*........ *. .. #..#*##...  ....*#*...... *..  .\.... #..# .. .\# .. *   **#..\ ..#... . ..##*#*.**........... ..* .\..*. * .. \.....#. . # .. .\...#
#..#*\ . .\ .#** ... ....\.#. . ... ..#*.*#*.#.. . .\#   . ... .. **......  # #... .....\ .....*..*.. .#.. .* *#\...... .. *#  *....... ....\. #\. . #
#...... ..#. .# #..\........ .*.. ..\ #  #. * ..*. ..  .#*.\\....*.. . . *  ..\# ..*. ....\..\ \.*  # \ .* ... . .  ......*...  \ . ..* #.  *#.\.\.\ #
#  \ ..\.#*#\....## .# . ..  #  .*........#. .*. ... .  ..#. ......  ..... .#..  #.... .#   ###.. .. ..*.  . .*\..... ..\........#.. .. . ..... .\ *\#
#.... .# ..*. #.   .  #.....*. #. #.#.. .\\# .. .....#....#.#. .*.\*. .#.....*.#..*.#..*\.... ..*\.*. ..\. ..# ...... *. . \ ...  **.#.....#* .......#
#* ...* .......* .. ..#  ...  .......  ..# #\..\* *# *.  .*.*...  # .*\ ......*#.. .*\*....*.. *....*.\.. . ... .. .. \. .. .... .# . #..#. \ *. .. .#
#.\ *.. ...#.*## ..\*. .#* ..#. ..\.\ . .# . #..*.\# #.*.. .* .*.. #.\.. . ..*. \ ..\ ..*....\ # \*. *....... .... *. ..\#.. .. \.*.. .. .. ....*..\.#
##.. .**.* . . ..*#. . \. \.. .# #... *#.  *.* .\\...*  #.. #.......*.. .*. . *.....#. ..\#*..#. . .... ...*.. . .. ..  ... #\ .  .\\.#    .*. *.* .##
#*. .#* *...*. ..*. #...*... ..*...  . . ...  # .  *...  ...  # .. \#.. ..\\\... .#..\.... *. .#...*#*.... \*#*  . *#*** ..*......  .... .......#..\ #
#.. ... .....** . ..\. . .... ..\.\*#. .**... . ..# ......#....... ..  . ... ..... ....*.  ... \ ..#.. ..\\#.* ...*.......\.\ .#. ..... .. .........##
#.......... .*. .# #. ..\#.#    .#\ #...\ .\ ......*. . ........#..#*.. ..\**  \..#..*...#*.*.   ..* ....*.. ..* ..... # ..#.#..*. #. # . .\.. .#....#
#\...#*... .*. *.##* ..#....\.#. .\ ..  .. *.. ..... .. ..  . ## .#.. . #.....\**. . . .....  ... . ...#...##. .\  **... *.*.*.... ...... #..\ .. ..##
# ..*... .##.#  .... #.*.* .#*\ ..\  .**. .# #\..#*\.* .*\**.*......\. ..#....##.#*\##..\.#.. # . *#..\.. . \....   *#.  ...\.#\.... #. ....*.....  ##
#* ..#\.#.##*#.*...   . ..#.....# \...* *.... \. * .....\*# .. .#.* ....    .#.*\#... .#\  ..* ..\...#. . .#...... #.\ .. #. ... .....*#*.* \.* ....##
#.. ..**.  ..*\# . *. .* *  \.#...*....##.. ..#.* * .. ..........#*............*..*...**.* .##.  ..\. ...#.......*#...*. *. .\#.**\....  ##..  .*.   #
# .*.#.... .. \\*.*....*.... .#.... . .  *. .\#...#.*.. . ...\...\*  ... *  ....\.#.. ..\#.#.....\*...#.... #  .#.##. .... ..*..***.*. ......* .. .. #
#.#\..  .*.* . . # * .. ..#......#\  . .* .\.\  ..\#. . \..*.#\.* ...    .* . .. ##. . .. \. \. *.#.## .. *#..#.. ..... ..# #   . #.....#.. . . ....##
# ..# ..##*.#.\*#\*..*#.  .....#*. *. .\. .*...#. .......*..#\.  .#.. . . ...*.... .. *.**.#...*. . \..\*.#....... .*\.. .. ......#.. . ....\\..#..* #
# ... .. *..*.  #.*... .*.   .... .##*.  .*.....\# .....  .. ...\ ..**.*.\** ..#..  #..#...\.. .*.\  .#*#..*.*. * .# .*....\ ##.#*. .#.*..#..#*. *\.##
#.*#..  \... . ..  .#.. \  \.. ...* ..* ...#*#. . \...\. .#..\. .. . ..\.. .. .. .*.\#.... .*...#.*.........# .....#   ..* ..  . .*\. .....* #....#.*#
#... .. . *   #. \.#*# ...*...*. . .  .....\.\*# *. .##.   \.  * ...\  \*..*.\. .\...... * . . *.*\..*.###.  ..*.  \# .\.#.....*.# .  **. .....*#*\*.#
#..* .... #*...... .. . ...#... .R#**#. .*.. ... .  ......#. #..... .*......#\.... ...#* ..#.... .....#*... .. .#* .. . ... . .....  #.#.... ....***.#
######################################################################################################################################################