######################################################L###############################################################################################
#...#..**. .. .#.\\ #.#.  ...* # ..  .*.*..#.#\\. . #*... .#\..*....... . .  .. .#...*.*... .#*.\  .. ... ....*\..\#.*.. . .\.**#.*...#*...#**.  * *.#
#......  .#.#..# # ..#\..*.. *.#*. .*  .#...... ..... ..... *.*. . .\. ...#.#.#...*\  .# \... #...#....#.*...  #..* .. *..#....\...##....*. . *....*##
#  .......#.. #.* * .. .  .\**.\..# .\. . ..........  ...\.#* ............ . ..#.\. . ..*#. ..* . *. .\. .  . ........# .  ..#......# . \*.* .\.....##
#\.\*.\*\..#..... ..##.  .#... ..*..*...##.#.*.#..... . .*.........#.. .* \.#.*...\#...#*.... #. ... *.. ... .....*...\.*.....*. \  .#.#........ .*. #
#..# .# . . ..*\##.*.#.#.. . ..\*.....   . ... .# . .. ##... .... .\...*.. ...*##..\...*.##....*.\#*#.#.....#.#. ..... #.\..#*... .\ ...#.*.*...\... #
#..  . .*  ..*..... \ . . # ....* ..\....\*...* ....  . . #\.#.\..  #.... ....**  #\..#..* *    ...# ... . ...\  . .*.\.. ....... \.*..**..# . .. #*.#
#...... .. . * \. *.... .## ..*..\...... ...... ...#*  .*\.*.* **#..... # \....*... . . #. * \  .. .#\. ....\ . #.. .*..##..\\.. .......... .  ......#
#. ... .. .##.* ...#*...*..... *.   *#..# .*.# # ##.   ###  . .*. . . . .. ..# #.* .. .#\... . .. ....  *..#..  .\ .#....  #...*.*.\*.* .....  . #.#*#
#. ... ...*\# ....#.. \# ......... ...   ... ..\....*...** . ...#*#   ..\..  ...*.#*. #\*...  .#.\... *. *... .*.* . .**##.*#..........*..  ...... \.#
#...*.#  .   #.*...##.#.*..\...# ..\*. ..\  ..*...#*\......# ..\.#. ...  ..\  . ... ..  . \#...*...#*..*#\ .#....\.#.*..  ...*.#...#. ..*..# ..*#... #
#.* ..\ . .##\#. .#.. ...##..*.. ...  \.. .. ..#....  #... .#.*.   .. .... . ##.*.* . * ..#*.#. .. ..#....\ #   \ .... ..\.\\.  ..#.. .....*. #.. # .#
#. ..#*.#.....#.........#.   . ..#*#.##.. \#...... .. ... . .\...# .. ..#.... ......\*..\ . .....**... .\..*...  . . ...\     .*** .#. ..*.....* ##..#
#..# .....  *  ...\.....  .\. .... *.*. #.*#.  *.. .... ..\.*.**.#.# *..***#.*.. . #  *#...* \#**..\......\....*#. ..*  #.*. *. \ #* ....\ .*#....*.##
# .......... .*###*.....#.\..#  ..**#  . \....  . .* ....   ... . ....#.... ..#....\..    . . .. .*...#.. .*   ...   .... .  ...#.\#.*#.#...#....*...#
#.*.  . #..*..  *...* ..*#... .... *. .. ....#..  *........ \..\.  .#   ...*  # \ \  \..#..  ..*....*..... .* * #.. .#..* # ..\ ..#.#..* . ..#....#..#
#. . .*.....#.....  . .# ..# ...* #\*.# . .  *.....\. ..# ..\.*..\.   .. .*  .##.## ..  \ .#...   .# ..... .*...#.\\ * #. *...#.*#* \#.#......#. .\..#
#..# . .. .#..\ #....**... . *  ..\..#*.....#.. #* ..*.*\.. \*..##..# .....##. . *. *..  #* ....# #*.    .\.#. *... .#.  .  .#..  #* .\*.\..#.\#..# .#
#..... *.## # *.. ..*.....\... *.... ..........\. . ##... #.. ..... .... . \#.* . ...#\..\# .....  .......#.#*\.....*#...*#\\.*..#* ....*..#.. ... .*#
#\ ...  . .... .. *.. ##..*..........#. .*....#.#.#. ......*. .. *.*..#... ... . . .*....... ..*#\..*. ... ....#.. . .. # *.\.\#....*#..#.. . ...*...#
#   ...***    ...... *#.\.# . ...  .#..#.....# #....#.*....\.# .#......#....# ..... .....\#. *..* ....  .#.....#*.. . .#  .\...# . *.... ...   *##...#
# .....#...\.   ...\##........*...*.#.# .... *. ......#. ..**.#.*... \*#...*... .*# #\. ..#..... #.....\..*.\* \ .# .*..*\.. ## #.#.#..*.....**....\##
#...#.#.  \\....*.*.#. . . # ......#. ....#...\...#...#\......# ..\...     .....  .\...##.. *.# .*..\* .* # \...*..*... \.... ....\. #.. ...*#  ....##
#...\\.... #*.....\. ...* .. .#.....*.\.. .\. .. #..... ...  ##. ...*.# .##*##..*\#\..#.... ... .*.*.# *.# #*.* ...  .* .*..... .*..\#. # .\.  \*.*  #
#......#..... ... ......  ....\ ... . .. . .*.*.#.#....\ .*.. ...# #..#.. .*...**. ..  #*...\ . .#...\.#\.....*... . ..*# # ..*.. **.. *   .\....*...#
#.#.... ..  . . .*.#. ..  **\.*#..* .. .#..#............. .....  .**...*. *  .*.#\ . ...# # *.. # *.# .. .#.#*....#..\#*. #*..*.#\...#. ... ..#... ..#
#.  **.*.. .......*  ... #...  .*.. ..... .*.*..#\ ..*#...*\*...... # *... .**..*...\...  .*....#....#..* #.#...*#..... *. #.. *.... *...#........  .#
#....#.#.  ....  *#.... ......**....\.#\* ......#.*  ...** *... .. ...#.\. . # .# #.\#* .... ..#.\\. .*...*...#*\ .#*... #..*..... . . *\.*...**. . .#
# .*# *.** .. .... ...*# *.* ... \. #*......#\  \.*..*# \..... . . .*..#..  \*.. *..  .# .  *  . #* .*....**.\ ## ..*...*.##\...#...  #.. #*......*# #
#..#.. ...#  ..* ..  .....#...\.##. .#\. .. ..\*.... ...#..##.. ..#.  *  *.*...*..*# #. *.. #..#.#\\.. . .\.. .....  #......*.....# * .#* ... ..#.. .#
# .# ... \. .\. *.##..*.# ......... ......\.* ... . ... #. #.*.* ....\*#..  \.\. ..\. .#. ......# ...\........*##**... ..\.**. .*....**.#.#  ......*.#
#....... *.  ..*...*. .... *.\ . ..#..* .\**.. .. #....* ...#.\ ..*.*\. .* . #. ..*..#.... . #.. .\#...#*\* \.#.#.. # ....... .. . . ...  .\ #....  .#
#. .....\. # \\ #...# . .# .. .........#..# ..   #...#.# ##. *.... .\.. ***\\...\.......  .*#.....#.. .. . ... *..##. . #..\.* ... \.*#... .*  ....  #
# ....#..*# .#. . . .......*.* **.\\ *.# . .#* .. .\# .#. .*#..\..\.. ....*    .*.# ..*..#...\. .*...... *. ... ..#......... .# .*.\ #\.#*....  .. #.#
# #..* ... *#. \...# .* ...... ... \....  . ......  ...\ *.... . . ........... .\.*. .*... .* ##..  .. .. #* \#..#   . ##.. \.. ....\. .. *.......*..#
#. .\ .#. *#*#.#.** ..  ..#..*#....*......\. .*\.....#....** *. .*\ ..  ... .\.....*#..\ .... ...#* .. . *  .#.. \. . .  ..*###... . ....#*...##..#\ #
# . ..**#.#* . . .. .*. .*........*...*.......#.*.#...# . ...*. ..*.. ..**.*.#.#.*.  \.*..*#..\.# .......*.* ...#..* # .. ..   * .*... .....#.*....  #
#....*** ..\#..*# .. #\.*# #.. ..# . ..##.. .. .. .  ... .*....#.*.*...*.#.. .....#... .*..*#\** . . *.###.. .*. ....*\.... ... \ .*#* ..   \ . .....#
#...#... \ *.... *. * .....  .... ....*#..*.. . ... ..*. ................\...*. .##.. *........*  \..#.##*... ......# *\ #.. #.*\\. ... .\ ..#\##\*..#
#....#.#*\#\. .\ *.\...* \.##.*....*\.*#.* .#\... .*.  \.* .\ ... **  .#.. ..*. \ .... ......#.*... ... #  . .. ....*.#....  ...##  ......\. .. ....\#
#... \... .....\ .... . .#. ....  ..#.........#*.. . #......#.*\\#.\ ..#..*.*....#.*..*.  *. ..#.#.....#. ... .#*.. .... #.. . .. . .#.... .** ..\..\#
#.*...#..#.   . .#..#**..... ........ *.* #.\. *. ...#*.* *... #.. ....#......* .*.  #.... . ...#..*...........#.##.#. .. #..* . .#.\..**. .##.# ** \#
# .\.*... .**.. ..# * # ...  ...*...... .\...* #.*. *..\ ..#.... *#.* *#*.  \.. .#.*.#*.*.. ...#.\.   *. ... ...#.# ...#...\.. \...#...* ** #..*. ...#
#*. .*.***   \*# .#.#.  *. \\.*#  .# \**. *.....\. *  \...###.....\.....* .. ... .....*  .*\\  .*. * *..*#.##.#*....# ##.*. ..*..#..#....*..* . .#.. #
#. \.*#..\.\.. .... ....#. ...........***## ...# . . \# #.*#\ .\.. .. ##.  ...*#. #*.#....*......#.*.# ... #*#.#...#.\.#**. ..###.\....#..\.*#...# ..#
#...* . * .*#... .*# ...  *. *.. ..* .#. .*##.*#. # .....*  #* .*#\ ..  .#......#.  \.\ . *  .......\.\.#.. *\... ###. \#* .*.. #*.......#.*.*. ... *#
###..*..*..  ..# * *#*... * ..*.* .# ..##**.*... ...**  ...*... .*.*..*. . ......\  .. ... .... ... ..\#..  .......\ *..\.......*.\...\# ..*.*.. ....#
#. ..*...# * . . #. .# .\#\..#. **\.. .**\\.*.. ..*.   ..#..... .*......\.. #...#   *... # ...#... .*\*.*... ....... ........#... #.#.\ .\. .. . .\.\#
# .\*.#.   .. ..#......*. *#.*..#. #... \*.#.*.... . .#.... .   \\ .# #..*.#...  #..#.\ \\##..* # #\.  ..\#.. *.....#  .*.. . .*..#. .... .... .. ...#
# *.....  ..# .....\#. * .#.... .  .*.... . .#. ..#...... #..#.. # .*...#. .#.  #..\... .\\. #*..#.  .#. ...*.**....#..*. .\.. ... .  *#...#.*......##
#.\... #........  #  #\.....#. .. . .#  *.** ...   *#.#.. ......  #*. .\..#. .... . * . .*..... .....#.#. ..\.#... ....\.....*. #..   *..\*.*  #.# .*#
#*....\....... #* ..* \  ...\.. .... *..*. *\.... ..\ *.....#. ..... .. . .*\.#\ .\# #...... .##*#.     ..... ....#..*........  #.* ..    . ....*...##
#..\.*.\... . *#...\....#.**..  ...\ ...# ..#.  .* ...  #... .. ....\.\ \ ..\* . ... ..*.. .*#.#*.#*..# ..*...###..## ..*\...\.*.*  ... .* #... ##...#
#*.........*..#.# ...... R .... * .\*.* *. .\ ....#.. ..# ..#.. .###...\ .*.**  .. .......*.# .\.  .....#.\...*.\...  . ...#...........   \..  .# . .#
#.#...* ...... .....  . ..\..  .......# \*\... * . ... .  .\.\.*.. ..  *.*..#\..\ *..\. . . *....  #*.....*#... \ *...#. ....**...\*# **.. ..  .*. *.#
# .#. #*.**.#. .*.\*...*.\ .  \ ###... #.#..# ..#.#...\...*.*#* *\.#...**...  .. ##..\\. * .# #.## ....# .  . .# ... *#...#\.. *.* . .\...#  ..##* .*#
#.*. #.#....#. .\.* ...*....*..*...*..  *#*.... #.#.#. . .  *..#\*.##....#..\. .*\.*.... #. ...\... ..... . .. # #. .*.**......  . ..# . . . . .  ..##
#. ..*......... *..##\# . #..  ... . .**...##.* #....#\ .\..*.  ..##\##*.*..... . #*.... ..  .\.. #.   .. ...\...#. . ...* .*.... .  .*\ #....*.. . .#
# .. .. *. . .. #*..  \  .. ....#.*\#.. ...\...*##*... * \\. .. ...\......  . ..**..\#..#..\... *. ..*.. ..  .**#. . .# .#.\....\.....#.........#... #
#....*.*.#*........#\ ......*#\#.##....#. \*. #..\ *.....  \.......#   .  .\.  \...# .* .  .*... . . .  .. \#. . .....\... ........##..** ...#.  ..*.#
#.. *. .*.\.*.# .....\ # ..  .* \#....*.\.........*..*#....* *...*.... .#.....*\\.. *.. .....#.#.. . .\.#  . .... .*. .*. .* ..  *.  #.... .........##
#...*.#.. ..\#.##  .. . ..*.*\......**.  ........*   . *...#*.# .# .. \...\..... .. ...*  .. .\* *  .....\\*.  . .*\.. #*.#..#.. .#.. .#..#\...# .#..#
#...  ... \.\# ... ##\ ..  ....#* *....#.....  ..  ...*# .. .\...\   .....##.\..##.  *#..\#.......* .*..  .. * #\.#..  . *.......*.. ..\.#.*... \.. .#
#. \.**\*.\* .... ..#... # .**..# \. *. ...*.... *. ... ## # #.*. . *..  . .##.. #... \ *\........\ ........*...*..........##.... * .* . \*#.... ..*.#
#....#......*....\...... . . ..*.##. ..* \.# ..# . ..... #....#. .## .\#.##....#.*.*. ...*..  *...\..*.....##*.*.. ..#\. ..*#..*  .#..  #. . ..*#  ..#
#.. #. . . .*#*  #..*.#. .. \.... ... \.#. *.   ..\.\#...*.... ...  \. ..*\. * . ..# *..*\.......#.#.# . . #. .  .\....* . ..#...#..\..# .. ..**.....#
##* .#\ .#.....* . ...... . \.#....*#.\ ... #...*.  .* . .. ..*... .. *#... ....  . ... .........*#  .* #....  ..*\#.#.#\..#\ . .#....* ...*.*...**..#
# . *..*#.#..\.. ..   ..*.# .. *.#...#.# \...# . ..*#....#...... \.  *.\ ##.*... ##*\ .. .\ *.. #.   ..*#.#......\...#...... .....# *...*... ....#..*#
#\. .#..#..*....\ . *..  ## .. .....#. \..*. #.. . ....*.# . . .... ..*.\ **.....*..#....... .. *. .. .. .#.\.#.....* ## #.... .......  . . \#.*..*..#
# ... ..... **.*..... ..#\. .*.#..**.#...\.*...** ...##..... *...  *. ... .#. .*.. .* ..\....\.*. \*. * #...*.*.\.*. ... ... #*##.....  ..#.   ..# *##
#........* # *........#..#\.*#..*\ *.#.*# .... .  ...*.#  .......#.\.#.##..  .    .\#. . . ......#..... *......*.. .. . # #.. *.#...*.... \*...###. .#
#..*.\...\.\.# #* .*..# ..... ..*.#. #..*..# .\ *. ....#. *..#....*. .....\ . .... . ......* #. *......#*#.\.* #.*.\.....* .. . *.. * .*. ..* .#...*.#
#..#.\. #. ........ ####.. ...# \..**....... .. ... .....*... . .\# .*...... .. ....* .*.....\#\..*..*...... #.#..# .*#*#.............# .....#.*.#.*.#
##..# ... ......  *#. \ .#\ *#.... \ \..* .#...**. #  ..*... ..\*# ..... # .....#.  ..  . ... .#. . ....* ##.......*  .....#... ...\*#* . . \\. #*##.#
#...  ..# . \...*##  .. \ ..#....*  ... .#\   ** .. .. #. *.*....\...#.##. #.... #.*.  ... **#.*\ . ......   #... ..... .....\.\*. .....#...#.*.. #..#
#....\* .* .\..  ..#*..*. #.**\\*.*.#..  . ..\.....*. #.##..*. \. *...*.*.....* .......#.\# .#*. .*...#. #*#.... \..#*....#...#*.*.##  .\.*... .. \..#
#.#..#...##.... *.#*\.  ...... .\ .* .   ...\#.. ...*.. ##\.\..#* .. . ..*.#... #*.. #\.\.  * ..... .... ...*#.#.  *.. #......#.........#.\ .* . ..*##
#.... .. .##.. **#.. #.. .... ..#.#.\....* *..\.... ..*  .\.. ....#*. .*.....#.. .  *.. ... .. #. ...# .. ..**. .  \.#*. ...* .....# #..\.* .... #..##
#. .....#.....  *..#..#\.* ...#.  ... ...    ... . *.\..*.#..*. \..## ..#. ..* ....* **.#...* .*..#  \* .* .\*..*## .. **.\\....  .\.#....*. ...*.*..#
#.. .* *.....*.....*..\ ..*.*\  ... **  .*#. .*#    ....  ...*.***..*#. *.... .##.. ...#*.......*..#  .. ..\.#  ....... #. .... .**#..# ..#..  ...*..#
#. #*.#.. . . *. .#. . .. .#.* *# . #* \..*.  .. #.# . .*. *...#..\... ...#  .. .....\ .*#... #.  ... .......*... .. .#.#.  * #.*\.*... .\.*.*.....\.#
# ..   . ..#.. ...#*.#. .#. *......    .   .. .. ...  *..#...*#. .*.##. .#.  .#.. \.#. # #*...\# . .#.  #.# ..* .#..  . *\. . . . .... *.. .  . .. ..#
#*  ..*#*..*...\*#\.. ..*# .#  .#.....*#...#* .*#...#...# # .* . .....#.*...* .   .....  .  \*.. .*.**.#.... \*.## .#... .. *.. ..# . .... ...\*  **##
#...*..\. . \.......  . .....#.*. ..#...#  ..\* .#...* ..... . ....* ..*.....*.. .\**.# .  ...\ \.\..\....#..  ..#..#..*.*..#..## \.. #...#.*\#. . *.#
#. .#*..*. ....# ..#\. #.... ......*#.##.....\#.....   .. .  . .*..  *\*##\.   .#* . .... *....#.#.. #.. .#*..*..#.. .\... .....#.*. \ ... #.*. .. .##
#.\.....\ ..*......\ ...**#.. \\.  .*  .   .* .* ..\ . .* ..\. . ....* .*..\..  .. ..   . .*.\.#    ....#\. ...  #.......*    .#. .* ...*...#   # .. #
#. .*.   ... .#.\#... . .##..... .. **.\. .........#....\\.\*.....#.#.  . * **#.......#...\#  ..   ..*.. *  .*... *.#..*. ..#  ..#..\.*# ..... #. .. #
#   . .*.\..#.#.*#.*..*.*#..#\.#...\. ..# .. .#**..*..*.# . .. ...*\#.*# ..*..*....*.# * .##\... *. .\#.#..# #*.* ..*..   .#..  *...*#.*... .......  #
#. .  ..#..# .. ... \*#..#...*.*. ...\....# .  . #.......*... .   *.**.... . . ...# \#.... .. ..#....  .. * *.. ...\.....#.#. # ....\. #\#... .# ...*#
##..#.. ....  *.**##..#*............# .*.\ ...#... .#*.....*..... # *  ...  .#*.  *    #* .  ..#.#\ ...#.#\. \.  .. .#.......#  ....* ....#... ...#..#
# #.* .. ..*..........\.. \.....#....#.\.....*..* .*...... ...\...... \ . ** ..#..**..............#..* .... ...#.*... #### *....#. .. .*.\.\...#..#. #
#.# .* .. .* *..*.\. * . .#...... #\...*.. ..... ##..... .   #\\.*.# ..  ...*...*#...#\. .#. .... ..\.*     .##...\#... #..#... ..... .* .\. . . .. .#
#..\#.#.......*....*#.*..#. *\ #\..*\.#...*.....\ .. *. ... .....*..#. .....\.##. #...#..* *....*\#\.#.. . #  .#\ .*  ....\.  .*.** ..  .#...#..* **.#
# . . ...#.......*.# .\.....\ #..# . ..... .#.. # .*.. .. .*.**. ......  ....**........* #....  ....... .*..#** ..* .#. ...##..  \....#.**. ..*..#...#
#.\ \\.#.*. #....\..*..#* ... ...... *#. \ #. .....#* *#..#.**\. *#... # ...*.#.*#.#*#.\ * .. . .......\.*#  .\ *.\....#..#...#. ..  ......#. ...\ ..#
#\.# *.#.. .  * #.. . ..  . \*. *......* ....... #.. *#...  .## *..*..\..\. ....#..#......  * #* *# * . ##*. ......*..\.....*....\# *. ...# .##  . ..#
# \..#.  ... ...*.. .#\* ... ......#.*. * .#.  .. ...... ...# .#...  .\..*.#. .*\ ..*.   ..\ \. .....#.. #.\*.#*...*..**....   ..*..#*. .. . ... ..*\#
#....\... ......#..*. * ....#.. ........#*..\#. ... . \.*..... ......\. .   . ... .\*..#   .#*.#... .. .*  ...#. .. .*. ..... # . .\. .*\.#.  #...\..#
#..\*... .#*...\...\\*..# .*...*..## . . .\.... ...##.# ....* .. ..*  ..#..  #\* \....* .#...***..*.*...## . . #..#** ..*....#*\.# #....*#.*....... .#
#..#*.*#... .# ...#*.*** *   #.*.* #...\.  .#.. ..*.#.\...  . . # .***##. #*....#  . *..... .*  ... ......#.... .*.. ...#.*....... .*.....\.# ... ...#
# ...\... .\... . ............... ...... .*.. ... ....  .....\*#  ..#*#  .##.....**..#.#.\....*  ..##*.\..#.. ........ ##.\.. .**...# . ..*........###
#.... .#.#.\*... #  . ... ......*#*.  * . ... *..**. .  ..... ......* .#. ..#. * .\..#*.\ ..* \..**..##.#.\ #.\ .....##*\  \....\*. ..*\...\...##.  \#
#*  .#\..... \#.. * ....* . ..*...#..#\ .. ..\.... .\..\#. *..*..\.#..*#**....  ..\*.*....#** ....  ..*... . ...\*..#.. ..#.. ..... ..#.*.. \ \.*... #
# .  ..\..#.......#.*.*#.*   .#\. .  .\ . ........... .#...#.**. ..*\. . .#*#* * ... .#.....*.*............*.* . .# .\.\...... **#.###...\ .......** #
##*..  . *.... #. ......#\ .  . .#. .* *#*....*#*##*....*  *# *.#....#.#. ...####\#...#.....*\... # ..... #*. \#  #. ..\ *.#.....\.......\\...# ..# *#
#.. ..... *#..#..  . ........ .#.....*# . \.... .# .*  .*..##.\\  #*.#... . ...... ..#..#*\.\...\.. ..*.*# ..*.......  .. . ..\.*.\*. . .. *....\. . #
#. .... . ..*.\*. .*. ...*.# .\..... *\. ..*..#...# ..*.... #.\.. **...**..##......  . #. **#\.. *#  .**\ \.**..... ....#...*#\.*... .  .. ......\.\.#
#.#..*. . ......*## . #..*.* ....*... \.... . ......\..*.....#.\...*. .. .... #.... . #....#... ##\#...\#...# .#**\*.#.....*.... * . ... ..*..*.*. ..#
# ..#..# ..  ....\.. . . .. ...... .**. .. ..*.\#.#.*. * ..  .\ .... ...\*#\......#....#*..*. .#.\*#..* . .... ...*..... ..\..... *#.  ..#. .\.....#\#
# #\.#. *.*. *..##...... .*.  .#*\.\..#. .. .#. ..*.. .*#.. ...* \ \...#..#.*.  ..... .. ...#*.... ...*. .# *#   *.. .....#.#.*# .* #*     \ .... ...#
# ..#.**#...#.*......#..*.#..... .  ....#*\. . ..*... ..#..#...\.... * #\* .. #. .. .#.. * .#.. .  *.\#.....#.... ..*.\ ...... . .. .  .*.**.*..\ **.#
#....\. #. ......\\#  .#...#\ *.**.#....*... #.#......*#..\.*...  ##. . .*#....* .**....... ... ..*.## ..*  ##. .   .. # \..#  ....* ..*..*.....* \. #
#..\.## ..#.. . .*..*...... .\.. .. ... ...*...\\ #.#.*. .#.\###.* \.. .\...\........**..\# # *.*#.. *#* .#.. . ...*..\*.*..    .# ... .\ . .....###*#
#...  \..\   * ..*.*..\...*..#.. .\. #...\.\...  **...*.#.......* ....#. . .....*. ..# \ *#*.#..* # #.. **. ..#. ..*#... .....  .#.\.   ..\......\***#
#  ...*.....***#....\\...   .. * #......* ....*.#.. . . . ... .. .###*.*# ..... .#*.#**.. ...*.*#* . .  .#.\#.# .....* .... *. . *.  #.....*..*..*  .#
#.........*.\....... * .  .......   ... .#\.. .  ..\  .....*\. #.#....*#\..  \.. ...\. .. . .#.. .#.....*.*.. #. \#....# ..  \.....\ ...#....* .. #*.#
#  ..# ##... ... ...... ......#. **..#.*..  .\#.. . #.. .#.    ##\*\. .*  ...  *. ...........  *#.... ...#.....*. . ...* .*.. .    .  #*...*#..#...  #
#. .# . .   ..\.. . *.*.  .*..  ....*...... ..#*..... ......... ... ..#*.... ..#. *#..\........ **#.. . .. ...\. ...  .#.# .. #... ..*. .... . ..**..#
#.  ..*# *.. *#. \..*\ . #\ ....#.* \\*...#... .#..**#\. .*..#. .. ....* \.*.....\..  ... \# .*# .*...*..* .** ...  .. .  ... . * *...... ... # **...#
# # ...  ....*.......* \..\.. ....**....*...   .\......*... ....#.  #*.#. # . ..* .#\ * .....*#.#.*. . * ...*#\  ..#*. *.*.\. #.   #  ....\... ..  ..#
# #*.*...*.*.# \....*.\.* .. ....*\.. ... # .#.. * .##.. *  #.**.... .. ... .#.....# ..  ....  . .*.*..# .... *..\. ..*......#.\...# ..\.*. .#.. ....#
###.. .#. ...#..# \.\*##. .*...#.....*......\...#..  #\  #    ....* ..*.#.#.**.  ..........#... \....#  .**.   . ...#...##...\..# ..* ..\..#.**.#... #
## ...... ...#.*.  * *. . #  ... ....#...\#...........#*.. #. #....\...#... .... .**#.... * .... *....\ #**..  ...#...*.#*....*..*...... \*..#.  .\ .#
#.. * ....... .*. . ...#...#.....*\\*.............\..*.....*......#..... . .\...  ....*  .# . . \# *..*....*..\.\ * .....*** ..## *.....  .....\# ..*#
#..#....... .... ... .# #..#*..#........  .. .** *\.. .#..... ... ..  .....#....*  #..#..\...* *  *. .#.  .*.**...#.  ...*.*#.**.*.  . \  ... ... ..*#
#.\..... .. #..* ......   .......\..# \  .... .  .\ .#.#........\*...#......*. # *  * . . #### . *\.****  .. .* ....* *# \.* .*..***#* *...\. .#. *. #
#*.. ..#. .. .. .\.  ..... #.**..\... # ...** \## .\  .. ......#...\.*.\..*....#. .*....... \#...... ..\*... #*...   . ...  ....\#...\# #.. *.\..#...#
#.#.*.#...*....\ ..#**#*..\....*... \ #...#*.###.  * #.. .**..#. #*..#..#.*.#...\#\ ... * .# . .** .#..\..\... .*#  ... ...#.\*..  ........#... \. ..#
##**.#  .*..#.*.. .  .#. . #..#..... * \.  .....  .*.*...#.\ .*.#..\... .\....*\.#......*.#*.. .\* #*  .....* . ...#.......#. .* \...# ..*........*..#
##.*.*. .#..#.*..*. . .\*.*#\.... .....*..... .#*. ...  .\.. .*.\. ... \  .*.*....##.. .......*.#...*...*. #..*# ... ...... . .*#*.  #*   .*...\.#\. #
# .#...   .#....\...#  ....  . ..... .#. #. .## .... \ \# *.....#.. . ...\.\......#*..\\. #. . ...  ..* #.........  *.**  . #......#.\. #...\. . ..#.#
#* .. \*.#\#*...# .\ ...\..#...#.* .# #. ..#. .  ..#.* .. *.......*  ..#.*.*.....\... ..*...   #..    ..  .. *..*..*....#  .#...* . ..... *. .... #\.#
#*..#*.......#........*.*.*....*  ..*.# .*.. .*....*....  .. .*.\ .........#*.*\.. .  #*....#.... .....  #.. # ..#. #..#..##... *\..\ .* .. \..     .#
# .#. . . ..*.#.*.. .**#** ..... ..... ..# .\#.# .*. . ..  *..\  .#.*  ........\.*.. .*...  \** . ..   .*#.*..\.\.*...*..#* .# . .  ..*  **.*  ....\ #
#.#..   #..\...\#..*# .... *. #. .. #.....*. ..... .. . ...\..*....\.....* .. # *\.\##*# .# ...#\.\...\. . .#...*#...*. . ..#....*..#.. ..*\.. ......#
#..#* *. # .. ..#*#....* \...#.\\ ...\..\.. . *... #. #. ....#...\.......#  *   *.\\.##*#.*..... .. . \*.*.... . . . #..#.... \**.* ..\  ..*.  .... *#
#*..#.###** \*..... . ..*. ..#\*. .  .. #... ..*. ..* .. *.*.\.\. ..* ...*.# ..#......  .  \ **#..#*....* . . ..# .#...###.\.. .#.....#..# ...#  ....#
#.#\\.#..*.* \ . .*.**..\  .. # .*\. .... ... ..*.*..  .#. #  ..... .#\*\....#*..... ...... .... .* ..  *. . #....*.....\.\*.*.* \*. #.* ........ #*.#
#..* ..\..*#...\ ...* \ ...\.* \.*#..\ ..#..* *..... ....#.\*#..**. .##...#..  . .#..#. .*. .\..* .  . ....*. .*.## #.*...... \  ...*.. \   .... ..  #
# ... .. ..........*.. .*.*... .#* ..  \.##.. #  #.\. .... ....#.* \. .. ***...#.  #. ...  ...#.\.*........#.\# *.  .. .\*.. \ # * .. .\ ...\..#...#.#
# ...*#..\# .*.  . .......*... . .\#* .*  .#*##.#....* ... \ #*\#... . \  # . .***. ...#....*.\....  .\..#... . *# \... . *.\ ..   ..#\#.....*.\ *...#
# .. **..*...\ . ... #.#\ .#* .....*.#* #.\.#\..# *....#\.....# ....  . .    .. . .*..   *..*.#* #.......#.. . .*.\*  ...  ...\...**......*. #.# **..#
#..\.*#**\ .*.... ......\* .  ......#. **..\ .#*.... ..# ... *.** # .\#  ......#.#...#.\.. ...*.. *...#. ...... .. .. *#..* *.*.    \#. \. * *##*..*.#
#\..# ..*..\...# ..   ...*.*.....#... * . * ....  #..... **. ..#. #. .. .*. ....   ..#*...*#.....*  ##\*#..    .. .  #   \\#.#. *.... . .**\#....*...#
# . #.#.... ........ .*..#...#.#.\ . ...... .**  ..* \  ..... \. . \..\*\... ....##.. . .. . .   .*... ..*\##. ...*#. .#.....*.. ...*.#* ..\*#... .*.#
#....#   . ... .*...\..*..*........ .**.#\ ..#.#.*... . .* .##...  *..\*\.**#*.. *.#..*.#....*.*...# ..\ .*  . .#\***...#..... . ..... .#. .. ..* #..#
#... .... . ......\*. .... . ..*.\..*.... \\..*. #....*... .*. .# ..** ...*#...\..#*\ .......*#*#..*......  . . #....*...**\......\.\.# # . ..\..\.  #
#. .*..# * . .. #.........*...  .\...  .#. ... ..* *...* .. ...*..*\##..* . ..*..\... .*..\# ## #\ .\... .#.. .*...\....  ...#... .....# . .#. . . .*#
#.. . ..........  *..#... . ....\.*# . .. . ...\ .. .  .*..\ ...  * . \.... .#*#..\ .... .   .. \*.##....\ *.\#..*...* #...\ .. ... \. \.#. .. ...* .#
######################################################################################################################################################