######################################################################################################################################################
#... *  . . #.... .*.. ..... ...#.....   .*#..  * ...#* #. . ...*...... .  .#..* .......*#*. #... ...#. \. . .* * ......#..\.*##..#...#.  ..* **....*#
#*. ....*. ... .  .\...... .... . ## *  ..#. ..*.... .*. .....* ..  # ...* **# *#. #*.  ..* ...... .\* ##........ ....... ...........  *.. ..*  \...*#
#.*.........#..#*....\.........\...\. . ..\# . #...  ** .. # .#*.. .*  .. . ..# . # *#.   #...#..  .*...  . .#  ##. . \. .. **..# .....#..**.......*.#
#.\ ....\\..*...   ..\\......*..#..... .R*.###... #.#  # ...  ... .  \ *..*.  ..#.. *.... . \ ..... ..  .. *. *.. #*# .........#....*.  . . *.... ...#
#..  . ...#\* ...  .#\ ..#.#*..#......\ *..#.. ...  . .. ...#....*..* . .  #*.##..  #. \.* . .....\.** .*..***#.\#....#. * . ..\.. ....#... .#\. ....#
#..*. ..#...*#..   \ *. *##.....# .. ...# ..#... \.#.\  ..........#..\... **.*.#..... .... .. .. .\. . .#. .*#. ..#. ...* \.#.  .*\.**..  .#... .. \.#
#......*#*............* #.. * ..  * ..  .*..#......* ...  .#.. .#  .. ...*.\#.* .\ \ \....*.* #.  .#  . .  \.\\#.*.*. *.  .#..# #.  .. * ..## .. . ..#
#.. .........***..*..#. *.*.....*....\\. ..#.. ....* ..**#..*... .#. ..   ....#...#*#.\. .  ..#.#.......#..... . *...#..** *#. *... ..* ..#.. ...*...#
#.#.\. ... .*... ... #*.......*. . . . ...... *.  .......... .#....\*.........#..\...   .  .#. .....#.*\....*..# \....  .#. #....*..#..*. .....*.. ..#
#.# ..\#... .. ..#..*..#* *. .... #......** \ # #.....#........ .\  #. *.*..\.##...*.#.. . ###.. \  ..  ....#. *....   .*#....\*.#. ##. .  .  *...#..#
### ..#... * # . .... ##..\... #..#....#\*.\. ..*#..\ .#.....\.#..#*.# ** # . ..*....  #.## .#..  #**....* * ....# ...  .. .. #\#  ........*#\# \**..#
#.. . .*  **. .#.*  ## .*.* ....\..   .   ##...* ...#...# .  .. ...##*. .. .#.. ..** ..# .. # #*.#.. *.**\*.##.* .#*...*...# .*... *. .*.*.##.*  #. .#
#..* ..   \.\... . ..#\.. .... ..##*. ...\.#*##.#..#..... .... .......*\....* ..*. *#..\.#\....*.*\. . *.. .\*. \.#.*...*. ...*. *.*........# \ # . ##
#. *\#........##...... ......#  **\ *.*.. ..... ..**# ... #. .....#.* ....... .....# ...... ..\.**.. .. \..*.  \...*. .\*\ .. .. . .\ ...*.##..*\# .##
# ....## ..#.....\.#..#.#*.#..... . ..\ #\.  ......#\.#.#....*... \#. .. \*. ....\#*   .** .*..  ......\  ....*. ...**....*.#. . ..\ .. ###*.*\*.....#
#*#.#...  . . .. *. .*#..#*... ...  ..#   ...*.. \.# .... .....** ..*.........*..##.# .. *. .. .  .... ...#.*.\*..**. \. ... # .*... .#...#......*...#
#. ...*..*.#*. \.....#\...*.........\  .. #* . .\. ..#. *.*#...* ....**  .#  .. .#..#.\....*.. ........*... ##.. .. ...... .*.#......\ \ .... ##. ...#
#* #........ .*............ #......\.. .  ..*##..#. .*.#*.* .... . * ...*..#..\* *...*\\.\.  ..  .. .. * . ....# . ... #\#.  **.. . . ..... .#*  .* .#
#.. . .....\.*.. .....#.#..*...  . ..#. . \.*..##*....\ * .\#*##..\ *... ...\ ....... .*.*....*...#. .#....*....#   *.*#. ..... .... \...\ #..** * ..#
# .\*.....# #... # .# ..**.. \... .* .    .*....* ..#.#\#.*..\..*. ... #....  ..# *..* ...\.  .. ..*.. ..  .* .#. . ............ .*\ .\.#..\....*   .#
#..*.. .#.\.... ......  .*.. ..#....  .....*..#.....#.#. \#.#.\.*.. ....\* ...* ..... .. .*... ..\ . .#..*#.. \*.\*#..#... . .# *.....#. .#.*.. *.# *#
#... #*... ....#.#......  .* *.#  .. ........*..  ... .*..*.*.\.##.. ..\ ........*.#...#.  .... .\*\.##......#.# ....  ...\# ...\.\..*.....##. .     #
#\*........\. .. #.#..*....*... ... #\.... **. #.#.. * .. \...**. .  # .  . ..... ... ....*.*.  ..\**.\. ..\.*. ..#. .... . ..\.*.*#. ..*. \.#...*...#
#*.** ...\ ..*..  #.**...\.#...*.#  ....#**.**  \.#.   .......#**.#.*  #  **.. ..  ... #. *.#..... .  .... . .* ........ \... .....  .. ##*........\.#
##*. # .. .#...*\#.......#  #.... * *... .....\  .\ ....\** #.  ...#*..... .##. ..  *. *#.#.\... . ....#.*. .   *. ..\# ....* . * .....*....#..#.. ..#
#\. .\.  .#...\...# *.*.   \#. ....#....#. . ..\\.## . .#. *..  .  ...#**.#. . . ##..*.*#  .*...# *.#* ....# .#.\...... ... . ..#. \  ## \...*. .#..*#
# .##. .*..  .... .  ...  .....*\ *. # . #..##....*..* #... .\\.\. . ...\... . . \#.\...\. \  .*   #..#. ... ...*...#..  ..   . * ..#*. .............#
#..*..  . *.. #.. .**#.. ..# .... .*... . ... .....   \ ..*..#. .#.#.* .. .#..  #..  ..##. . **# ... .. * ... #..... . ....*.*......*. \......  *\.  #
#.#.**.........#* ..#.... .# . \. *#..**...\*. \.. ...  .*#...... ...#* ..  *...* . .......... ...#*.\\...#\*\*. *\.. .... *\.. #.#.... ...*..*.\#...#
#.. .\..*.# #.\.... . ##*...*......*......... ...*\.\. .*..\ .*......  .....#..... . . ..#...*. ... *. ........ ..\  \.. .#.. .\.#.#..#.. # .. . ...\#
# . .#.....*.*... .. .. #.*...  .\.   .........  #\#..\ .#......#.. .  # . .  ...#. ..*. .* ..*.....  ..\#\..... **.....*.###**.....#.\...  ....#.. .#
#*# *.\. ..#....*...... ...*.*...* ......#......\.  *... *\.....#... .   .#  .  .# ..\*\.#.  #*...#*..# \#... .. ........... \\.*. .  ..*. ....*.*.*.#
#** ...# . * *..... .....\.. * *....*..... \.  ..... ##* .# ...   # . *. . # *. ..... ***\.\*...*.  \#..* .#.. ...... #..* *....*.##..*. .\... *\....#
#. . ..... .  . .*......**  #.. . ..*.*... .#.......#*  ..*.......  .......\\. #..\ ... \...\  .*#.*#.*. ..#...*...\\.... ..#..**#.\ ##. .....\...*..#
#.....  **..#*...*   ..*#. ###\ ..#...##* \.*.# ..*....  ....#  .... . .. .*..\. . ..\.*. \ .. ... .**....*.#. #. ...... * ..\ ##  ...* ... ..# .....#
#....# ... .....  ..#..*...#. ... ..  #*.\.*.  ..\#..#.\*#.\##. . ..\....#..\..\*..*.. #..*..*.. ....\. .....#.*    . .. .. .*. \*.... .. .*. #. .\* #
# ...##. .....##....#.....#..... .. .*# #.. *#* ......  * ..*## .***.. # ..*.*. * .. ... .#... ..  .... .#..#.. # \#..\.   #... ..* ..# ... ... . ...#
#...... #  ..  ... \*   .. * ....   .. #...\#..** ..  ##... .* . ...*....#\#...\...*..#...... .#*\..#*.#.. . ... #.*..#*..*.. .#*.. *##.. ..*. ..#..##
#\  . .## #...#..... . ..*. . .. .*\#*..*...#. ####..  *.** .... .. \   ...*...*.... #.*. ... ..... ....... * .  . ..\.....   *. .  .#\ ........#.*. #
#.. .  .#..  ...*. ..# .. .  .##. ..\. #. ..* # .... .\\#..      .*.**. #.....# ....\ . .\........#.....*  ...\....*....*#   ..\ ...*.. #.*#. . .....#
#...*.# ## .*.. . ..\.* .. ...... #..\....\...*.... .*\ * ...# #.\..#...\....  #*\ #..#.\....#*. # #...... .....*  .... ...*. *.## . ... .#..*..*.\.\#
# ..\*  ...#. .....# .\#*...# #  *.. ..*#..   .. .. #...* *. \.*. #.. *..#. .\..... .# .\   #. . ..#... ..... . ......*. .*..#\. \.. .* . .\  . \....#
#\..  *#\ .\*...**.  ..  . . .... ...##* .. .. *...#... ..#.*#.*.**#.#. .\....# #.. .* .*#.*....... .. ...\.... .\#.*. #**.#  *.. ....*..*......  .#.#
# #. .*..*.*..#........... ... ...\.*.#. .\#.. .\...* .*..#\*. .. . .. ........ ..# * . . \.#... \*.*.#..  ..#*#.*.#.#..#........#... ... .*.#\#.\.*.#
#..... \.\.   ..\.... ..\# ......# . .*# .#.... . .#...  ..#... \...... # ... ..*** .\##.#..# *... .#.\. ..  *.   #.. .. ..... . .. ...\ #..*.... .* #
#  .....  .. .. .  \... ...*## . .*\ .  #...... ..  *.. *.#.   *.....*..*.#.#*..*..\. .. ......\... ..* *# *.. \..*.# ...*... .......... \........ .*#
# ..*...#.\ ........#.......\  *......#.#..\...##.#. .#..#... .......#.. . .\*#.*..**.\..*..## ..\.. #..*#..\..#... .#\.**.. .#\..*..  \ \ .* #...  .#
#..\.....  ..**. . ...#* ... ..  ..\*#.***.. ..*.....* \..  #\# \*... .. . .. **.. .. ...  .# ... .\..*..#.  .#.......  \....*\* \.#..# .. ...*#..* .#
#....\......#.# . ..##\.#\.# ....... . ....\ #.\. ..*\... ..#.... \.*.#.  . **\#. .........**# ..#...\......  #.....**..#.\#..\...* .\.\..#.. *.##...#
##.*... .   .. ..#.  .*\*....\##. .....#..*\...... .. \.*...##..    # ##... .   ..* .. .#...#.... ## .#. ..*. ... ... #.....#.\.\ #.. .**.. *#....\.##
#. .*# ..... .# ##.*.*###\#.. .#. . ..... .\.#..... \*..#. .\.#.*..#.. *#.# * #.........#.. ....*... .....*.\. .  *..\ ##\#. .. ..\ \. #. . **\ . ...#
#*......... # . ......  # ..*.\#.  *.##*   *.* .* .. .\\..  \.. ......... . . ..  ..  ....... \*#..*...***. ...... .#*.. . .**...#.... .#. .# . .#.**#
#*#.. ..\ *..\...# .\.\#.....*.... ...* ..#.....#. .. #* .*\*.# .*\.#...* #.# .**....#. ....#*.*. #....#. ...**.. .*.   \##.\... *.  . .#..#  .. .. .#
#..........   . *... . ..#.\. ...##*..\...  ...#   . .. ..# *....  .. \. **.#....\..#.....\.*#. ...... #*#.#\ # ...\...\...#......\\.. .#............#
##.  ....*#...#.#.##. ... **.** .  *.#.. . *...# ....* # *.....# .*....*#..*\* **.#.\.....# #.....*..#.. .##..*.. ..  . \ ..\ . *.\.*#*..\ ... .. \..#
##.... .....*.\..  ....\   #*##.......  .*.#    \.......#. . ............*\#...  #.# *. ......#.....\ .. #... . .#.\#* .. .# #   . .#.\..#..... .#.*.#
#*#.. .......\.. .. ....*..*\... \ * .*  ...  ..#.  ..**.*........ .. ....##  #.\. ....* . .....   ..  *.... .. .**#. ..*...............*\.#*.. .# . #
#.. . . .\. .. .. .  \**. \.*#... ..\..#. .#.  .     ...\.\*...#    .. # .  ... # *...* .*..#\*....#. *#. *.#.#.. ... # .#..    .#. .... *. ... ### .#
#*.  .# \.\#....**.....*.. . .\\.... \.. ..# ..# **....*. **. *  ....#....... ..  .*# *#.*\..\.\.#...#.....\*   .... . ..\*.*..**.#. ..*#..#*# . .#**#
#.   #. .* ..  .#..*. . #*......# *...\ ...**..* .#.....#.. ....#*.*.. \...  .*... .*.\... .***. . ..\ . \..*..#. .#*.#.** .... . #....#...#.#...... #
##..\. #.*\ .  .. #.. ....\.*. .#*.#..* . .*.#. ..##.... .. .... #..\ #... *... #.. .*....#.*\ . .. .. . .#...*\ .*.\#... \*.. .  . **\....  . .... .#
#.#. .###...####*#.#. ....** .*.*.#\\\  .#** ..#. .  \..... *. .*##.  .#*\. .*#...#..\.. *\..*\. ..# ....*. ....# *#*.  \ .\.. \ . .......#.   .# *# #
#..\ .#.*#...*.* ..\....#.*.  .  #\. ..*#.#. .#.*   .....\ .*...*...#  \\. ... ..#. . #\.#.........**.. *.....** \\ ....*...#..*  .##  . .......*. *.#
#. . # .**..* *#.\.. .* .*# * . .\ .# ....#.  ........#*#.*#... .....# \*  ... .*## ... .*.*.*... . . . ...* ..\. #. *......# # .. ..  .. .*#. .*... #
### . ....#....## ...\. #...*..... #.\ ....... .. #..*. #....#.. . . *.\  ..#.*.   .**..#.. .... ....\. .. \... .. .......#.  ..... .# .. .......#.  #
## *.. . ..\....#. ..... .#...#.*.. #..   *.*. #* .# *..# # .. ##* ##..#.    ..*....#.. ..#.  ..\ .   #.\.##.. ..*....* . #..#*.. # ...**.......*#...#
#  #. #.*..  .# .... . #..#... .*  ...... #... .\.......   ...#... #\..\..*..#.. ...*. ..*..... ..* #.##..\. \.... ..\.\.*.*\..#* ... .*..#\#.......*#
#.* .....* #...# .\. .*...\\... *.#.. * .*# .# .. .......\.#..*.*#..  ....#.. .\ . .*#...*###  ...# ...#...**\. ...###......  . . . .*.... \.... .#..#
#...\..#  ...#. .. ..#\*....... . .##* .#.... # ..*.# .*.*..*.\ ....*...#. ...#..#*.. . *................ ...*\...*. *...   .#. # . #\ .##..#...*..**#
#.... *  .#. ...........\ #....\ . #..*.#*.. * *\.. .#...#.. ....# .\. \....*.*....* *...\.*#*\...\ .... ...*.\..... .* ... .*........ .#... # ...*..#
#\.* .*. ...... ...   .. .. ... . .. # .****... **..#...*........ \ * .. #........#. . .. .#.#.... #........\#....#.\......#* **.....#  .#....#  .. *#
# .. .# .   . ..#.# .  ..#....#*#.  .. .#. .......* #. ..    . .*.*. . .*. . .. # ......*#  .. #.# ..\...\   # #..#.#...#.  #.....#\##.##...* .#. . *#
#* \. ..#........  ........* .*. .##. .*.#. \#..\.#*... #. .  . .\. .\.#..*.*. ....... . * ...*. #.*.... \.....#.\..  . # ..*.. .. . .. ....*..*#....#
# .*..#.#.* .*#..#\*\# . .. ...*...# *....#.#\#.##.....................###\.#. ... #. ......... .*\#..#.*\....\ ....*. .....   #..* ... *.\... ..*..##
#... .. ..  *.\#. .*   # .#*.*..  #.\...*.#...*.*. ....*...\   . ...## ..*#.*   .. *.. . . *\*#*..\ #.#.** \..#  .*#*...  ................***. .... .#
#.. ..  . .*....#. ..*.#...# ..##\.** .#. .*.....* *..# .....\.  \**#.*..... *...*.... * .  ..* .....#\.#.......#.*. \....#...\ . **  . ... #.# **.  #
#. ..#... \ *.#...*.  ..*..  . \*. * *..\....* .* ..  .# ...*.. ## .....\#. *......* .*.#........* *. .. ...#. ...*#.. ....#*....... * .#...   .  \. #
#.*#..*. #... .*.. #.....*#. ..** . \\   . . .#.#.* #  *##*\*\.. *.#.....#.*... * . .... ..  .  #*. .. . ....*...... .... .*....#.....#..\ .#. .#\..*#
# #..\.........\*    . ....** ..\.#..\..\..*...#...  ...#..   *.* *.. # #. ....#..#. ..\...#.. ........... .#.*.# #\.....\... . #....  #...#.... ... #
##.#.# \ # .. \**.. #*. ..... . *.#.  ....##.  ...  .. \..\. ..*. *.. *.*.. .. ..\ ..... .  ..\.  * .#\.*##* ...#...... . . ... ..#.....\..#* ....*# #
##.*#..*.#* *.* ..  .. ......#*.. .* .....\ \.#...#.\..  *..  ... ..\ #*..# *.. ...* .\.  ... ..*...*.*.\.. .......\#. .# ....*..#....#.. ......\*. .#
#.. .# ..... ..... .. .##.\.. ...*.# ......#  .*  ..... . #..#.##* .. ..## *  ..*.#.##.* .. .  .. .*\..\.*..... .*#.....  ....#.# .... ..  \.. .#.#..#
#. #..**... ** ..#.#... #..\.**.** .. ...# . \.**....  .*...*#..#. ....#* .\.. ..*. \. .*..#. *.....\. *......* *#...# ...*  . ...\*.....\.. .#..\ ###
#*  . . ..  . # ... #.  * ..#.. \...*.#.\....#..#*....*. ...*.* \.. ..\\*....#..#....#.. .*. ........*... .....* ........... .# ...*. . # .\.*...#*..#
#**...#..*.*. *\............ . \#...*   .. #......\#..**. ..*.. .\ *. ...##..#..*. .#  *# .\..*..*.  *. ##..#.\\.. #. #...*..  . * .#.  #. . ##.* \..#
#...*.\#.   #.. \.*....#\..*.*# # . .  ... .*...#.*. . *.\..*#....#..#.\... ..*\ .... #....#  ... ...* .#.. \*\*   . *#..# ....*..#.. ....# \.... #.\#
##.#.# .#..\#.... ## .....#..  .....*. .   .  . .........##...........#..#  \.. ..\*.....*  ....#..... . # .#\.#..\ ..*.*..*.#. . ........#. #...\.. #
##*.\...#.....#.*\   .\  ......*.. ... ..\*...**#.#.... * ......#*... .. ...*#.*.....#..  .. . .*..... *.\.\....#\..#....# ##. ... #*..*..*...\ *\..##
###.**.. ..  ..... * #. .***. #..*...*#   . ...*.   \.#*.  .*....#.#... ... ..  # ....\.. ..\ . .*..*#.*.##**... . .\ . * . \. ...#. .*# *....*  # ..#
## ....#.....  .. \# . .*# .. .##\.  ......###..**.. \#..#... *#...* *#...*#...#.. ...\.  ..*....#. .. ** .. .. . ...... ...#......... . #.. .*.\...##
#.#.#..##.. . .. .. ... ......  * *.. ..#.. .#*. .#.....#*. #\ . . **... ....#.....  ...\... #........**. \*\# .. .\#.. \.....#*.\..............\ ...#
#... ...**...... ..*# .. ##*#. ....## ..*\.##\.... . #......*.. .....#....**.... ...* .. .....\....#..\ **.....#*  .  ...#*. .  . . .....* ......\...#
#....... #....... * ...*.  #.. \ . .*... ...#..  .*.. ...\.. *.. \..#.#.. ... ...\...*...... .#....#..  ..........  ...#... .#...*. .. \*.. \*.. ...*#
#.. \.#.... ....*. ..# .\. \*.#.... ..*......... \  #...# #. .  .. ..***...*.*.. ...  .... .\.* ...\.#..*.. #.. . .\#.*..*.....#. **...\.... . ..*#..#
#. *\...*##.#  ... .... .\*.*...**\*\.. # *.#..... *....  . ..  . ..*.# ... ..###..*..... .#. \**..*. #..*...*##.  *....*. ....*..*. #. # #. .....#. #
#... .. * ..\ .*#*  *#.* . \....#.\.#\. . .#*#*.. ..     ...#*.  .. ..#*..#... ..*. ...#.. .#.. . *....**...#*.  #...# .#. #\#* *...*.\**.   .. # ...L
#*#..\........#.#...  ...#......*.*.....  .#...# .... *.. ..\\ *......\  . \.# \ . *.. .#....#.*...\.#.  .. .. . #. ..#. .  #..*.# .*.* .#......#....#
#\.. ........\.#..#.. . ........*...   . \.**.\.**...#... # *..*..\.... \ ...#.\ ## .# .. \..#....*...# . .\..##.\*#.*.#.#\....\** \#... .\ ..# .**..#
#....\.*. .* .....\. .**.. ...#. *...*#...#.*\ ..   . ..* .* ......#. .....* .\#.*.. #. .  ##\...#..* ... ...# ......    ......*.#.#*.   .\.**..\ ..##
# .....*..*#\..*#.  #.. # . ..  #**..# ..* #.#.*   ..  ..**.\.. .*.* .*....** . *\ *... .. #... . .### *..  \......\\#...*...#*....*.#.**.\#. ..* ** #
# **.#.....*....*#..... *......*. . .*...  ....... *.*#*\#.\.\..\ .. .. .#. ..#.#.........# ....*...  ...*....# .. .\.. .*...* **.... ...#.\....\\...#
#   ..* ..*.*... .*. .. ..*...*..... .## ..\...**.......\ .*.....#*.* .#...#.* .*#..#.*.#  .*. .. ... .\..     ... *#...*...*....*..\ ..... . .*..#*.#
#*..* *..# ..  .\.*..*\.* . .#.*#*\.\  .. #.*... .* #. . **.....*...***.  .#..\.*.#...*...*.. ...**##... \.*..#.\.   ......\   *. . .#. *.*. .......*#
#. ..*#*. ..#  .# . .#..*\#.*.   .*..... ... *. #. **...* ....#* .*. . .... .##....** . ##......*#..   .#. \  ...\#.  #\....*#..#.\...... ..\.....** #
#\.#. *....\**\..*.*.. # ..\# .. *  ....# ... . .#. .#..* *.*.... .*##..#.# #.#... . *.##...\... . . \.. # ....#.. *......  .#..*.# ##........#.... .#
#.. .... .....#.# .#*... .*...*..  . . . *# ..*.\\#.**\.#. .. .#...# .*..*\..*.# ....#.....\*.. \#.##....\.  .... .. ...\..#. .#. .#.. \.\......\.. *#
#. #\........... ....*... .. . # .............*.\*...#.... .\.....##....# \...*#..**#. .... ... .. #.#.##.\....*#... *..## ...#.*.......#*.....  #..*#
#.#* . *.*.. .#.........* ..*..#.#*. . .... ...#.... \*.. ....... ....\\ #.  ##.*. ...#\  ..... .  .#.. .   # .. *.......* .#..\.#.#...*.#*..*.#.. ..#
#. *.*.....*.. .** ..\*#.* .#*\ . ..  ....  #. *  * *.\*..... ....  ...* .#** .. ..... ..\ .*  #..#.#*..#.#.#. .#.....#.....*. ...  ...#*. .. #.. *#*#
#*\*#*.#\ \#. .#**. ..... * #.* ....... *\#...*.\*.\*..\ #.. #.#.* . . . .  ...* . .*..#.\\ #......\##*.*. *. ## . ..... .*.......# .*.*..   #.**...##
#...  ..#* .#. *.#...*..# ......  .*..... .*.*\#.....#...*...*......*\.*.\. #.. ...#.*. ...*.\  .....  ..\..#.....#  ..*.\ .\\ ...\...#.\.#. .... .. #
# . ...\*......  ..*....\ .#.\..#* \..*..... \\... ..#....\ #\.\ *#.\ ...##.. ...# *.. .\\... * .#...\*....... #.*## . ##..#....*. . .* #. * #.#.....#
#\. ....*.#*. ..*.#* . ...**....*#.\..* ....#.\..#. ###*.....*..* .#.... ...#..\ .#*#... #...  .\.\#*.**  ... ..*..... . .. # ....# . .#.*....*.*.*..#
#..  *.....\..*..* *..# .. # #. .#.*...#...   \*.#.#\.  ...  #. . ... *... .*.#.* ****.. .#. *.#..*.... ..#.\ ....#.*.. ** *. *......* .*#.*... ..  \#
# .  .... \. .#*.  \*....*.*###\. \#  .*.......# .......*....#.# #..#.\  ....     ..*.  *.*#.*...\..*. * \... ...*  ..*......*....*\.#.*\.. .... .. .#
#  .*...*. .  \..*.. #*.*.#.#....\ .  . .....# .... *...... ..# .....#*.#...#*...**....\  .. ##*. \#.....  .. .# ....*# #\ \ ##... . . *..  ## ......#
#.. #.. *...*. . ......*. . .*. ... . . #*\..*  ...\.#..............  ..#\..#   ..#.. * .#\ ....**#.. . *.#...\......\.......... . \*    . #.\ ......#
#  .##.*\#*  .#  # .. ..\ .#..*  ... .#..*. ... .#.  ..\. . .#*## . ... .\.   #.\.#.. *. . ...*.... * .  #. ..\ . .  .# ...\..\ ..\#..  # #...#.\ .#.#
#.#..*#.. ...  .. . .. ..*..#. . .#..#.......*   ...\..# .*. . .\* ....*#...*. * .  .. *  #* . \## #....*#....#.*.... *.*#.. .... .\# .. .**... ..\..#
#..  .....#. . . .....  . .*... ... ..#.*... .... #..*.....#.  *..... ..#. ..# .......\.  ...#...#*.. # ....*.  *.. .# .*. #.*# # *.. .*. ..  \ \.\ ##
#..\. \*.#........ .* #...*.\.*. ...*... .\ \.  *.... \..#.. \..*......*... .\*. . ..#... .. .. ..... .#.\\......*..  .....* ..# .....*  *..  #   .. #
# #.*..... *........ .  .*.\..\.. . .*..  .*. *.   # ....#.\*. ..*.***....   .#..#..\..*.#...#....    *.. .. . #. . ...\  . .*.....* ....##*.....  *##
#. *..  \. ##.#*#... . ...##.  .. ..#  *  #.#.#.**#... . .#....   \#.... * ... .... * ......*..*..#....#..\..*......... ...\.. \ . .. ..\#....*#.  *.#
#.*\\#... ...\.#..*  \ ..... *.#**.*.. ....*....**..#.....#.... ***..#... .##...*. .. .. ...... .# .#...# .*#.....#   .*.* \. \... . **#*..* . .#. . #
#... ...#..**.*\\...*. #. .#.\ #.*  \*#.\*........ ..*.\....\#...*\.. ..#.. .. *.* .....*. *\....* \.. . ..... ..* ... .... #...*.....*...#.#*.. .. .#
#...*.*..........**#..#** ......** ...#.*.# .#  .*.*.#\....... *#.*#.. \... ..\# .*.... #..#.* #..* **##. #.. ....\..#.# . .. .. #*..*. ...#. ..#. ..#
#.#.  .#. .. . .\. .*.#.#.#......*. .# #... *...*......# .*.............. .#...... * . .  #.*.# .#.....\..* \.*\......*. . ....*..\#..  \##. *# . ...#
#..**. # .#..*..*.#*#.  \\ #... .  .*.* .  #.*...#... #.*.. .**...#.\..\*.....*.. *. .*.........#. *. .#........#.   ..*...  .# ..#.*.. .#. *#..#...##
#..#..*#\. . .**..... *..*.*.....** \.. .. #....#.. .\ .\**#...#.......***\# #...\*....\  #  ..*.\  # .**  .. ..*..#. . .\. #.# ..\#.  . *\... ..#. .#
#.......*#*.#... ......\.##.... ..*#.*## \.   ... ...    ......\.\ \. . .. *..*#*#*.. * *.. *.#....* ...#.  .. . ....#.** *. ..*..# ##... **......#.*#
#\*. . .#.. #..\....*.... .#.......*......#.. #\. ..**.*#. \\..\. ..*  #\\.... # ..  \ .*.*.*.... *....\...\.  #. ..*..#.*.\.*\. .... ..*..... ..*.*##
#.. ...#..\*..  .# ...*.. #.* . .\.#.#.....# .... ............*#. .. *.  ..* \. *#.  .. *. ... .   . ..**##..  ...\ .*.#*....  ...  #..# *.... \** ..#
#.  ...#.*##\\.*..*....*... ...#\....**\..#..*... .*.#..#.*. .  .  . .*..*. ....# .\.. \*...\. ..*.... . #.. . .....*  ..*...\ ... \*#..#... ..\. ...#
#.*... ##.. .. *... *. .  *. .   ..\ #.*.*.#.....# #*\...#...#.. .....*..  . .......  . ..*. ... *..*\. *# **.*# ... ##. *...\ . .#. *.*#... # . .*..#
#.  *.*** ...*. ...* . .**.. #.. . . *....##....*....#..#.. ...\.#....\#.   .#.# .  . .## ......\. .*...... ..#*.\* #\\.  ... ......#.... ...*..*\.#\#
#.. \.....*. . .    ..\.#.**.**...*\.*..*#  #\\........ ..\ .....*.*..\ *.*......#.. **. #. .#....*...##..\# #  \.........\.. . . . .*\.  *.. #.#...*#
#  ............ *##.... .#...*.**...#.*..  ..*. .... .. #.* .*.\..... .. ....\.  \... .## ..*... ..... .. ..#.*.  #.*\.\.\......#.*...#.*. .... ..*..#
#\....**..#.**....*..  ..\.##..... .*..#. . *#.......\#   .\. ..... .. .*..\#. .#  ##.... .#...... ..\.....#. ......#..... \#..#.#.*....... .#.*. .  #
#*...\.#\#.#* .#  ...#. #.*. .. . #...  #.....  ..#...*. ..# ..### .... ..#...#.....##.. .#. .......#. ..*.#...*.......\.*#..... ....#..#... ...#\\..#
#.*. \.. .*... *\  ...#.\ \#..#.#\*.... #. ... *......\* .#  *......\..*#..* ..*#.# ...#.#.. .. .#\#.### #... .# ....  .  .\..* . ...*..*. .\ #.*....#
#\.. *.#*#*  ..\......#. ..\#. ..... . \.\... *. ..   .\.#.#\....*..*.*. ..\ .....# ...#.* .#.#*\...**.* .#.#*. .##\ #\..\ ...#.#....#....#.*........#
#.#..#. .#..... ..\ ...**\  .. ..\ ...*. ...*. .. . . *.*# . ... . .. . ....*.......    .  ...  .#*.....#.\\.  #.#.\..*.   *#.  .* *. ....\. \  .  ..#
#... .*... .\..\....**. #..#...#*....#.... ... #. *.. . .. ....*. ......*.\* #... * \#  ##...*......   . .* . .....#.* # ...\... .  .*..#.....*..  ..#
#..#. ...\*...##. ..* ..*. ...*. #.#\..*...*\. ..\....**.*.*.* ........#....#...   . *.*\ .#...*..*........# ..* ..*.. #.#.*.. ..*.   ...*# \. .*\..\#
#......  *. ...\*  .#...#  ... * . #. .# ...#....*.. ..#.  . ... . ... \#\#.......  .. \..\..*  .*.# .# .#... #  .* #*......* ... .# **#.... ..*... .#
# .....\.... ... . .. .**.. ...*#.*.  .. ...#.. #\##....#.*....*....\...#.. ..\.#.....  .#..#. .... ...##. .. * #*#...* #\.....#.... .#.\..\.#..*\.#*#
#...\#* *\.. .#. ##   \.....*.. . \..# ..\ . \# **......*#.  \..  .. .....\.. .  **. ..*. \  .  *#*.. .# *. .#..... .* ... .. \ ... \.\#............ #
#...   #..\.. ...#..# .*..... ..#...\...\.*..\ *.. .. .   .##  ......*..... .. ..\\....#. .   ... ....\.*.*.*..* ..... *...##\..  .  \# . ...*##  **.#
######################################################################################################################################################