######################################################################################################################################################
#. #. .......\....  ...#.. .. .. \.. ...**#* ..***#.. ..#... .*... ...#. * .. .. * \ .....*...##*......... *. ..#**..* #. ..*.. .. . .......#*..#..*.#
#.... ... .*. ...*#..*.....#.. .... ...\*... .\.... .\..#.# #*.  .# .\..#.. .. .#. .*..#*.*..* ..*....*... * ...*\.. .*.. ..\#...* ..    ..\* ##.*...#
#........#..*.* ..  .*\...*. .#.....*\.#..#..#..**.\.#..\**... ..... ...\* #\ ...*.... ..*...\.#....  ##..* .**.* #  .  ...# ..\*. .  . . \\.... ..* #
#.....#  \.\...# * * .#.*## .. . ..  .... ..#*. .. .#.* . .. ... #. .#.*... .* *...** ..  # ***.#.   .... # ... \.**....  .....#*.#..  .....#.. .. . #
#....  . ..##..   #...   ..#...\ ..*... \.*.  . # ##.  ....* * *.. ... . ..##. ...*.**...\#....* \.. *... . .\..#..  *.*. ........ ...*..... ..... #.#
#..\*.#..... .*..*....#*.# ...............\\. .  .*.*.# ...##.. #  \......*.#..#.#.## .*  *......\....\. \...*\. \*    ... ..#..*. .. ..*.....*.  ...#
##. ..#\. ....  . . .....  .  ..... .. . ....# ........*.#..\.*.....# ..\* #*.... *. ...#.#..   ...# .......\.. ..* . ##......*\..  *. .# ..#.*.... .#
#... .\... .**.**.. .. ... ..... ##.**. .. .*. .*.. ..#.....* ..*. ..*\... \\# ..\...**....*#*. *...\ \.. \ ...*#.  \ ... ....#..... .*##..*. .. ###.#
##.*.#.#*.\....\\.*.# ...*.  ...*.\* ....  .#*.. \. #.#**. \.  ......#*...#.....* .. #...*..\\.\.#  . ..*....#..##.##. .. *\  ..*. *.... .  .* *# # .#
##..#. .* ... .##.....#.* .  *   . #..*..##.. ...  .*.   ........ ...\.\ ...   \...#.. #..... #\ ..*. *.\...* .# *. ...... ..  .#. * .  . ..\* ......#
#...... *....#* *.#  *.  .*.#*.....*#* . .\.... \... ..# ...#.... **  . ..*\ ...*#*..** ...#... .*.  ...*....*.....*.#...#.* \..* ..\.. ......#.. *.##
# #... .\\ .. ....*...\...  ... ..*.#  ...#.... . ..*... .....*.*..\#\....# ..#.. \#..##.#...*..#*... .   # ..# #...... *.. . *.. ...##. ... *..\#..##
##....\....  .* .#. # ..... ..*.## #* . .\....\..\. #.# ...#. *#... ....#.... ..... #* ... #*##.#..# #.* . .*.. ... .. ........  # ..*..#. #.\. ... .#
#..**#*. .......\\.*... *. ..#. ...# .* *.....\#.*# * ..\.. ..#..\ .*.\* # #.....*.***  .* *..\*.*.\.# ..........#.*\... . .. ..... .# *. .. # .##.#.#
# *..* .. *... . # . *. ... ....\.\......*.......*#.* *. * .. *.* \............*# .. #\.. .   *..\ .....## ... #. ......*#.    ..*..  .#..* .*.#.. * #
#  ..... . . #..##..#.\.#.........  . ...*.. ....... .*.#... # ..*#.  ...*##..#..*##*.... *##.*#.. . #.#  ..  \.#. .*.*#.\..#..*#.. *#.#\*\.#\ *...*.#
#....#......*  .. ...* .. .*. #. .#*... . .#..#...... .....   .\.\. *.#*.. . *. . ....*...* .*. .*.\\.*. *. ...*#... ....\ *..* . ......#..* *# ... .#
#\ #.*.* .... .*\ .# ..  .. . ..# ..\ . .... *..*.. .#.. .... . ...#\.#.....*. .#.*\.. ...#..*.*#*  .\. *  \\.# .\..*#. .   .  #\.#\.  .... ... .. ..#
#..  ..\# . ......\.\   #..*.*#......#. ...*.*#.. .. .* . #. .. \..  ..*   ..*\.#.....# ... ..##. ##.... . . *.*.#*..#\ \ *\*\. .*. ...#. ...... .*..#
#.*.*\. *..*..#........## * ...#..# *#....#....\.. \. #.....*.... ...*.\.#. ... .... . .#.  *...\......*..#.*#*  ##.#..\. . . . .*..# # ...#... ...\ #
#.#...*\.. .  . .  ..........  .  *  .. ...\..\.*.....*.... ...#*. #.......... *   .....  # ... . .. .... \....*.. \\ .  \..##..#.*##.. .. .#.... ...#
#. ....* *\*....*...\.#.*.* \..*.#. ...\..#..* ..*#.... ...\#*  .*. . ##.*. *  *. .\ ....#..**.......\#.* . .*. ..*..... . ..  ..#*  .**.#  . \*. .# #
#..*. #....##\. #*..* .*\*.... \.......#.. **..*##.#...*......  . ... ..  ...  *.........# # ... \#. ...#\..#.. *...*#. ... ... *... .##.*.#  . ... *#
# #..**...* . ... # ##* .... . .*. .\.. . . ## .. .*. ...*. . \*..* . ...*. *\.#. ..#.. .\. #.. *\.....** ..*.*#. .*... ...*..*. . *. # # **# \....  #
#....#.....* .. .....\.*.#............#. . #.. ...#..*#..#* ... . \#* ....* . * \..\   .#.... ..*#...*#..# ..**.\ * .... #. .. . ... \ ...  *.#. .#  #
#...*. . ..... .... .. .... ..... ..* .\.  .#\*..........#.... **... .* .*.. .#. ..*#. . #.....*  *...*... .... *..\ #.. ..#.. ..# ..*. .... ... .#..#
#..#..# **.. ..#\*\...* .\..#. ...#...*. . #*#.\# #.... #. .*....*.  **..#...\.. *.. * .#\ ....*. **  ...#..*... ...*. .## . ...#... .  *. ..... ...##
#.... . ... .. .*\*..  # .*.*..*.\..........#..\. .....*\ .*...*.#. *.* * **.**\...*....  ...**.#.# .*. *. ... ... .\# . ....**..#..*. .*.#.. ..*#..##
##.. # .. ...\**  . *\.*.*** .\    .* * ..  \##..\. ... . .##  . .. #.. ..#. #\#*# # * ....##.#*.\....#.## #.*.#. * .. *..\ .. .  *.* .  \ ##. ..#. .#
#. .#..* *..#\. #.#...#....  ..#...\...  .# *. ..  .** .....* ..\##. #..*.\........ * #    ....  ....*.  #. .*..\. \...... ..\.\ ...##..*\..*....#...#
###... .## .. ..\*....\  ...*....\ .#**.. .\....#\*.#....... .*..#*. *...  *..*   . ..##.#.... \ # *...#...* .. *...#*....\......#...#.*... .....\ #.#
#...* #. #...#. .. #*. .\.. .## *.\..\**....##......   ...*#..*..#.  ......\.....#*.\\....... \.... ..#..\. \.* .#. ..*.\..*..#.* \* ..***.. ..   #..#
#.#   .\  \\  .. *...# .. .**..   .. .#. #.  .*\##.....# # .... .##.#.. . \*#.#..*. ##.#.  .#.* .. ... ......  # ..#*\* . ..*.. #.\## \. .. *.\  *.*.#
#\ ...#  .*....*\....  .#....... **#........*..\... .  ..#.*..\* .# *.** .. # . .#..**......# .#.... .... #.#\  .\ ...#... .. ..**.. .*....# **..#* .#
#..#.*...*.##. * .#. ..#..# *. *.*#. .  ...*## *...  **. ..#....  *... .#  ..*\* .  ... .. .#.\ #\.. ......... .#\.. \.*.*...*. .* ..#.   .........#\#
#.## ..*\*..... * #.* ..***.#..*  ..  . \...#.. .......\... .\ ..*.#.# \   * .#.*.... .#. . .* ##*....*. \. ..*.. . .. ..*..*. ## #. .* .....#\.... .#
#.. .  #..*. ..**.. .... \  *.#.*. .*.#. ...  .  .##.. .##.##. ..\.....#. \*.... ..\ #.*...#..#. \*. ..*... * .##.*\.  ..# .* ..*.*.#..#.# . ** # * .#
#.#.#..*..\.* #.. #.\..\...*.#.\. ... #\... . . .. .* .\ .....#.*.*...\.\....*\... . .*...\.**\..*.##.*..#*#....\... \ *....  \# *.\. *. . ......\\ ##
#..#.#*.......# .. *. .*.#.#* #..##....*..*#\#.#.. . #..*#*\ .....*. . .**..#.....*..\...\##..#..#.#..#. *#*.** .... .  #*. .....*...*. ..#..#.* .#  #
#..\.*\.#*...*#. .* * ..*#   ##.# #**.*.. . \ .*\....  ##*.#.\. .\ ..##... .##. .... .. ..........* . ...*.\.... \...* .. ....*#. **#. . .*. \*.*#.\.#
##.   .\... ...... *........ *.......* .\.#. *...*..#.\.......#   *...*#.*.. #...* ..\... . *  ..  .  .*. #*. ..# .*.. ...# . .. ...*...*.#..*...* ..#
#...# ..*. .* ... ...#.......... .. . **. ..**....*. ..*........#.#.... .#....... .. # #.\.*.....*.#.      #..... ..*.....   *.* *#.. . .#.  \...#...#
#\\..**.. ...*  ...  .\ #.... * .....*  ..#..#.  .\... .#..\*.# ..... ..\ *..*. ... ..#.. .*#....  * .. .......*....##.*.....*....* .\..\#*..* .. *..#
#.. #..#*...##.\#...\#....  ## .... ...#.#. ... . *.. *.... ...# * *** ..*# *.*. . .**  *.. ..*##...\.... .. ....#..#..\**#...* ..\*..*#*.  ..#..... #
#\ \   .*...  .\.  .#... .#*.. .....  ...#.#\ .#.#.#..\ *  .#*.. .\\..  .\ .   ... . ......  .#.. .#..\......\#...... ..\* .... \   . . ..*.##.#. .. #
#.#\..*..*.# .#  .\.  \ *..** . . ##*..*..\.*#.  .# .  .. . *.*.. .* *.#.\  .\. \...#. .. #.. . * *...# .... ....*#.. *. \\*.. .*....* .# .  #. ...*.#
# ...*#..... . #. .... ...\ . **.*#\.  * . .\ . #..\   *...*....#*..# ..\....#..... .. #* .. ......\. #...# \#. \.. . \... ..*.*.  . . \ *. .. . .. .#
# . *... . #.\.*.. .. ..##*.... *\ #..  . .*\.......** #...**.#*\.. *.#*. *. ... *.* ..*...\.....*# . . ..#  *\.  \.. . #  ..#..# #. ....*...\..\..\.#
#   **.\*... .***. #.... * . .\.*#.\.. .*.  ... ...\...... *.. . #.*... .. *#..*\..##.. . .. **.# .......  .. \.\. .\.#*.*.\#..*...#. ..* ...*... .#.#
#   #.. *..... **#.. # #..\ *..*. *#.... .#.#..* .# \\ .**. ... ....*. .#. *..  ....#....* .  .\...*... *.. ... .   . .  * . .... . .#..*.#.*......#.#
#*.\.. ..\......\....\ \. . ...*..#***.. ..  .*\.\ ..  ..*#.. . .\*** . ##.*.. .\ *.. .*..#*...... .#... ..\..\.* \ ..*..#.. ..... .\ .*..*#\..*...  #
#*....*\# ..\.*. .....\...#*. ...\#..#..#..\....# ...... ... ..#... .*.*\ .##.*. ...#.  .*##.   ...*....... .#.*#* .#...\.*#*.*#. ..*.\....*. . \..#*#
#.. .....\..# ..\. \*.\\ ... ..  # ...#..... # .. .#. .*#. *. * ##....#\ . ..#...* ..  \..*.. \...  *.... ...*..*.....# . ..*\....# ..#*..#. ... .. .#
#..*..*.....#.*.*.*..#....#..#..*.. .*....*.*.   .# ..*...#.*.   . \... ..\..*.  .*.#.*.#.*...\...  \.****...... ......*.* . ...#.. *##.  \#*.#... ..#
#.. #*... ........ ..... ....#.  *.. ...* #... *.......*.....#\ ....\. *..* ....  \....... * .   #.*.. ..#*... .#*#.  .....  .#*.#. #.*#..#..*#.  ...#
##.##....*.# #... *.*...  ..##*....#\ #. . ... . ....... ....#**.\*.\\#..... *.  .#* ...  .....#*.... ..... \.. ..#*..#.\*  ...\. .. . #.#....**.... #
# .\ ..   #.........*.** . *.  * .. .....#\...  ........ \ \..##.  *#.. ...#\.#...    .....**. . .*....*...*. ......\*.##\. ##...**.... .##. .. ...\.#
#..*. ..\...*..*\.\ .....#.*#.... \. ......  ....*\..#..* *#.\.. ......#.* ..*#  . \ .\.... .... .. ....... \..........* ...   .# \...**....*... . ..#
#...#.   *..# . .... ..\.#  *...... . ..\..  *#.. .#.\ .##.*#.**.. ... .#.\ . #..... #... . . . *.*.... .. **. ... *.* .#...*  ...\....  \ ..  . ...##
#.... ...... . #..... ..*.... .#....#..#.* #.#.......*.  .*.#*.#...*. \ .. .. *. ##. * . ... ..#.##\* \ #...... .#*.*. ... .**.*. ##\.**....* #** . .#
#. .....# .#  ... \. ..#.  .*#...*..*.#..*.*. *. .\.  ..   **# *...*#....\....\#... ..\.... *..#*..#. .. .. .. #. *.  ..**.*...*.*\. ......* ..     ##
# ...*..... *.. ...**  ..*....*. .\#. .... . ...*..#..*.#* ...\.  . .... ..... . # # .   .. ...  .#* #.......... .......#*#.. ... .... \#.. #\.*. *. #
#. * *.#.. **.*..  ..**##. .*#....... \ #*# ...*  * ... . .\.*.*##.#...*.# ..*......\ ..* #.# ..#.\..# ..*#.. .......#*..*.\........* .. .... ..*.. .#
#*.  #..\.....# .# ##*.*. .\ . .*.\* .... #..*.... #. ..\... ...*.... #......*.......\#.\*........*.\. .\   *.. .. .#. #..*..#...#....*   .. #....\..#
##.. \  . #.*#  \..*.. ..# .. . ...*.*. .##.. * ..#. ..* . .. ..#. #. . *#..... ..  # \..........\...***.... * . #. *....#..#... *.... *.\. .. .#....#
# \. .. ..#*. *#..# . .#* ...\*.... ......#\. ....*..... . #.*..*.. *  .# ...... .. ...  *  #*.*.# ...#..\  . ....\..#. ##\#\...*..*... ..#..*....\\.#
#\..........* #.. .. . .*...#\.....\.  .. . \*.*.... ..#..#...* #. **. ..*... ..#.. .... #......# *.* . .\...\.... #.#. ...... .... . .**#.. ..*...  #
#... *..*.. ..\ .. .# . #*... ...\..  * ...# ... .....*. ...#.# #  .* # .*..##..*.#.\.. ..\.......  .............#.*.*. ..... .#..\ .*. . .*.*###\ .##
##.*.... ....# ..# .\\ .. ...\. . .. .. . .#.# \ .* \..#...#.# ...... \....#.....  .... ..#..  ....  . . # .#...#.... .. ..*..# *#\# .*. .#\..... #..#
#*...  .. #...... ...#... .\...#..\.# .*. ..\..* .# ..#.*#.....\ ..*... . .  \*. \....*...# . *.* ..##... ... #.*#.. .*......\# * . .. . ..\..*\ #* *#
# \#*\.#.\......*.*...*.. *.....**. .. ...\..#  #... ##*. #.. ###*\ \.*.** *......... ..*...\.......*\ .*#..... .. .*... ..*..\ .\.\.. #.#.. .\.\ ..##
# .. ... .......* ....  .........*.. ... ....#..#..# #..*. . *...\#.... .. .*. **.\. \..... ...#...*......#    #.......*.  . ....*\\. .....  ....* ..#
#. *. #*.....*. #..# ...# #\...#*#. .... .*.*  .\** \.... .. *....* .  .\.. .. .**..#...\ .* .*..**.#. .. #...... ..#.. *\...\....##..... .*. ..*#.\.#
#.* .....#.....*.#.     . *...*.* ..#..*. \*.... ...*.#.\ ....* # ...*....  ............ .. ..#*...\. \.........#..*.##*.. . ...##.#.. *.. . .. . . .#
##..*. \.\* ..** *.. ....*.... \..#. ..#..\. ..*. .\*\...#.**  ....\...\*.....\    . . .. .......* ...*.  ...#...   *  ....\.....***. #. .   ..*#**..#
# #.*.*.#.#. . ..# *...... . . ...#*..#.   *.*   .*..*. . . .#.. .*  . ..   \.*......*......#.*#\. . . .. *....#.#.....*. . ......\....\.#. ........*#
##.. ..*...... . ... ...#.*  .. .. ...\ ...   . ...# ... . .**.*... .  .\#.. ..#..\ .. .*..\   ...*...\...*##...* ...#..   *.*\#.  ..* .*..*\ .*...\.#
#.. .\.. *#. .....#. #. . \ #........   ...\...\.  *\.. ...#......\..* .....\..  .... . *.#.  .\ .......... .  ..#.\#.... ... .\..\..* ..\...* * .#..#
#\\*.....   ..#...... .#..**\##. .#.#....#..#..#.  ... .#... ......#*.. *..   .. \  .....* ..... #.. .*..##..#  .#..  *. . #.#..*....*   .......  #\.#
#. *.#   ....*.*.....*.  *.. ** .*......#. #*#.#....*.*... . . .. ...*...  ...  . \. . .#.* *. #*........  *##.#. .\.......**.#...\ .....  . ***.#...#
#  .. ..#*\.# * .\*  #.  *. #.# .\. ... *..*\..#.  . .#... .*.... ..  ..#...\ #.# ... ..*... *... #.....*..  #. ... # .*.#* ... .*\..#.*.*...#.#\\...#
##.#... ..**. ... #. ..**..*...\. ...#..*.. ..#. .* .....*.....*.\* ...\#..\..*. .*. ..*#...#...#\  ..\#...**....... ...* ..**...*..*..  *.*.#.\.#..##
#.... .. \... ... ..*\... ....#*..... ...#..*. *.. . ..*#.*.  ..*........# \....# .# *......*#.  .*. .. ..*..**. *#.#....*.###*.... . #. .\...*. .. ##
#.\.. .....# ....* .*    *# .........*.\ ..........  . .\.\.  . .. .#. .#....\\\ .....\*..  .*. .  .# ....* \..  #.#.......  .......# . .# # ..#....*#
#\ .. .#\ .....\# .*    .. **... ..\....#....#... ........\.#... . . . *.....#. ...##..*.\\.\  .....*.**. *.. . \.*#.#.# .\ # ....#.#.. **..#... ....#
#..#....\....*. #..\.#.*.*.\....#*# .#\.#  .. ..*.. .. .\\... ....\..# *..*..*. .. *.# \*#...#.. ..\..\....\.#.... #...*. .   . **.... \.*.. .  . ...#
#. .  *...#\ ..#..\..\ ... ......#\ .\.. .\... .....#\.*... .#....  *. .*\...\\.##...* . *...\..\.\ #..#.#...*. *.*....#*  ##..\*. ...##. ..\*#.. \* #
#.*#..#.... .....\.  #.. . #..#   .*# ...... .#.#.... .*... .#.. *... *..#..#..\..............*. **.#...* ...#..\..\\.  .#\. .*... . ..#... .\......##
# ..*#.. .... #..#  *.#.\ .#.. ...\\ . .\.. ....\ #...#.**#... .*. \  *.............. .*.*... #..#... .. #.# ..... #.\. ..*.......*  *. .... ..    #.#
##.\.. .*.*. .... .\  .....#.   .* ..*. *.*  . . ##.* .   ... # .\... ....*.\ .........#.#  .*. *.#.#.   # \.. \ ... .. ...\**.#*\..#.#....... .... ##
#  . \.# ........#**.. *...*.. ..  .**..... \....  ## .....\.. * . .  \... . .........# ....... * . ..*. ...*..\#*#\.. ...\#.. \*.  *..*##. .\....\. #
#*..... *.*.*.... *. ....\. ...*.# .. . *  ..... .\*.\#....#..  .*...*.*.#.   .........\..\..*..*...# .\.....#***..*..\#... .....#.....*.*. \.* #*#.*#
#..\.. . ..... #*##..... .... ....*... *..*.. .  .......#.#. *....  ..... *. .##.....*.\ #..##..\..... .. .... *.\.. .#.. .... ..\. *..  ...\.*. .# .#
#....#**..# *... .....*  .*.........# *#*. .. .. ...*#  .*#.. ..  .#.. .. ##...\\.... \## # #*.#..*..*\. ........\  .......\..*.. .. . .. ....*.#... #
##...*#.   \\ .. *.*........ *   ..#...##\...*##. .#. .#.**..*...\#... . ..   ....**.* .  * #*....* ..   .#\... .  . ... #*.. #...  ....\. ..* * *.  #
# ..*.#......#..* ...#..# . .##.#. .  .\*....\#.*..  .\. ... .......#.\..... ... #......#.*..\ *#. ..**. . .. ...\*##..#..*.....  ....\....... .# .. #
#.**\\... .. ...*... # .#.*.. .* *.. *.\.*#...#..#.#.#..#...#  .#* *# .  \ ...  ..#... ...#  ..#.. .  .. *\#.# ...  . *. ..##*. ...* *..* .*#.#. *.*.#
#  .  .... **.   ..# .#.* ....... .# \...\.\#..*. .. .... ....  *...  ...... ## .\. .\# . . \.*......  .###*.*.*. .*\.#...  #.\.#...  . .... ***.#*..#
#... .**..*..#. #  .. ..  ..#...*..*..*\.....#* *.* \#\#  ... ....*. ..... ....#.#. *.*......*#.** ..  R.#.............. * .* .# \.. ........ .** *\.#
#*..  ..*...  *.*\\.*..#.\.. ....*.......#.#...*... . . \..... . .#.#.. .. . #.\ ..#.*.*.\.# . ... ..#.. .#*#*. .*.... .....* \.#.*.....*.#... *\   .#
#*\ . # .....  . .\.....*.*...  \ #*   ..  *.##.# \.... ..#\...\ .##.*.... .\ .**#..... . #.*. #.# ..##........\...# #\.# .... .#.#.*..... ...\##...*#
#....*....   .....#. ... #.. *  # \.#. ....** ..# #*. # .#.*..\.. .. .......#... . .#.*. ...# . ...... \* #.\... .  .#.*..  *. ...#\* .......#..\. .*#
#. ..*..  .*#.** *.#.*..*..*#\..*..#. ..#.\ *  . . .*.. \..  .*...* ..#.........# \..*#\..#   ..... ........\.*..#... .. *..... #. .*#..*** . ..*... #
#.* .. # #.......# #...*. . # ..*.  ## ..\..#* \...#*#*.. .... .  .. \  ... .# ..*....... #.  # .......\...#..\. . .#.\*. ...\. * . ....... .#... .. #
#*. #\..#  *.. . ..*...  \. .  .....*#\.#.#..#.*\*. .*......*. .... *.. ...  ....*...\*... *.* ... .. \. .#\*.* # #.#\..*# # *. ....*.*...* ..*..#..##
#* ...##\. .....*. *..#. .*.*..*....*\....#..#. # ..#....  .. ... #* .. #...\..#** \. #..## .#*.* ....*.#....  . ##. \.**... ..\. ..... ..* ..#*.....#
#.. * #...##\...........#*.*... . ..#..........#****..  #\.*.. .  .. ..##\.. #.\..\.....#..# . ...\.*. .\.. ... ...#..... .  .....#* ...*.. \. .... .#
# ......*\.#... ....*#..**..#\...*  ....*.#..\ ....\. ..\...  \# . *.. .. #....* ...#.*. ###.*....*..\#####....   ..*...#...#....\.. . **..  *..#  \\#
#.  .# ..* ..#.. ...#.#.... ... . ........ ..*.....  *. * .###*# . .  ......\## *.#..*.*. .**...#.# . ... *.\. ...#*..\.. . #*.. .... ... .....#....\#
#..... .. .*..#..\\. . ..\... . .  .#.... ...\*..  * .*.. ....##  .. #.# .....#..#... ... \....#.**.. . ..## ..#** .* ..*...* # ##... #**...# . .. ..#
#..* ##.*.. . *. ..#### .....#.. .#... *#  ..#.. ..  ..\.....*.* . .*. .\ .   ..*...* .*. \.**....... ..# .*#.#.##.. .** . ..##.    .....*.. *#.#.*.##
#**.   .#...  ..#  ....  .# *#..  . .  .*. .. . *.......\... ..#.  ...  ...#  # *...#.\ .  #.# ... .... . \. .#.*\# .*.....  . #.#..*.*...#.#*\.#. ..#
#.#.. **#.*... .  .\..\...  .......***... #*  . .#*.#........* .. .  # ..\.. . *...*... * .. .#.#....*# .#..#.\..#... .. .. **.#.... .. \... .. ...#.#
#...  #..... ..#  .#.. ....\.. * . \. *  . .  ... .. # . .*#*. . ..#........ # *.* .# . #*.  . ......*. .\\*.... .#. ....    . #.*\..*... .# *... ...#
# . . ..*.\. .##....*.. ..\.. ...\\* *.  *\.....*  \..##. .\. ..#. #. .....\ .. .#..*.......#  ... \##*  .#.# .....\ * * .... ...** #.#** . **... .# #
#...   *.... * \...#.*..\\.  *... #..*#.........\ ..*  ......*  #.# .....#.. ...... **......\.  .. ... .*.. .# *. .*......*..\..\.##. .....\  .\..#..#
#....#.*.#.... .. \......  ..# ..##\##......*.  . #...# #  .\*. #....*. #..#*\ .#.#*... # #.#. ..  * ......# . # \..*### .....#.\#.  *...#....\..  *\#
#*..#..*... #...#.....*.  #*#......    \ ..#* .#.. #.*#.#\\.*.. \  \.*#...#\... .#.*..  .*.. . .....\. #....*..* ..... \ ...*.. #*\..*.*   .#   .#...#
#.#.#.\*#.*....\ *.*. ....  \\......\**.  \ #.* #\....#*  . .#.. .....*##. .#.## ..   . . ..#.*...**.. # \.. .\... .. ..*  * #\ \.# ..\*..*.\\.##.*..#
#.#....*.. ...\ .#..#*. *....# ..#.*.. ....**#\*.... #..  .# ...    .# ... ........ .*..#.* .... ... *. ... .\......  .* . *\.#.# . \# ... .. * \ ...#
L   .* *. ...* ....... ...# .#    #... .  ###.*......# *\ ..#.# *.... .**  ....  ....* .*..#.. . ...... ...*#*...#.* ... **#* ... .#..*... ... ... #.#
# ...#*..*.## .  #....  #..... #..*. .##.#...*....#.**.*.*.    . #. #. .*. * #.. .*....*\.*........... .*....\ ......... .... *.\##.#*\...  ## .. **.#
#  #...... ... ...*.#*.##. . .. \*... *.. ..*..*.. ....#*.. . . ..#.... ..#.##*.. **...#*..# .. ..\..*.# .\.#......\...# ...##.....  . ..#  ... .....#
#...#...#.... #  #..... .... .*.. . ..#.*....#.. #*#.. #  #.... #*.#.. ... .....    ..\# .#   . .. .# ..#.#..\#.#\.*.#.#*. ...  *  *.. .* .... *\.***#
# ... *.*..\. .**..#.*.. \. . .  . .# .*......*..*. .*. .. ... ... \  .\*..*..**. .*.\ . #  . . \..###....*.. ..... . ...*   \.# \.   \.#... ....\..*#
#. #... #. .*..*....#\*  ... .##.. .. ... ... .. *.*.*.. *#. .#. . ..#\.. .*... #.... . #..\ . . .....*.. .#..  \\.# *.*. #.\.  ...*..*...\.  # *....#
##.#. ..#. #.. .... .* . #. . .# . .. ..*..... #..#. ... ..  . . . ..  ....#  ...*.*..\#..*#....*..#..... .#.*\...... \ .... \.....*.....\. . . *..**#
#*..*..#..#..**. \.#*...\.*  .. ..#..#*..#*.*.\*...*..#*** \ #... . .*. #.# ..*..*..\*# ..*  . *...\.  .....\ .# #* .**#.... ... ...\ . ..... *......#
#.  .\ \#..* ....# *. .. #. *..#.*. .  ..... .  ...#. .#.*...... #....#.\  #. .**.  .... .... .*... ..#.*..*..... ...#......*.\   . .#.#. ##**#..\*.##
#....\** \..#*.....# . *... .. .#.. .....  .. .*# \..  ..*  .* *.....   #.#.....\\.#. .. ..  .*..#.*  .\#.##  #..*.......\.*..#.. ..# ....**...... ..#
#..#... . . \......#... .  .... \#... #*...... .. .  .\*..#....*... .*. #.# . .##.*..  ..#.. ......#\. \ .\...\  .#...#. #..\...........#..##........#
#..... .. * . . ..   # .....#. .  .\#**...  .##.. . .*\.#\..*.\....#\*..# . .*.\..*. *....\. #.*.........#... ......\..*#..\  \.**# *.  #. ..#...##  #
#.#* .\ #....  *... ..  . ....  #.\.#. .. .#. \\....\ # ....#.\#... \# . .. .# .*. .*...... ....\ ..#.*...   ..... ....     .* ..\...*.......*...#\\.#
#.. . . #... * .... ...  .\..#   * ...*.... .... .##  .\\ ..........\.#\*. .. ..*.. ...**.\# ..* #.#*.....\....# # .. .*#\.#  .. ..**....... ... #.**#
# ....  .\#. *#..#..#... ..#.#..... ..... .#...#...#. . ....\. **.. .*\ \ *#.#....*...\ *  #..... ...*..#  .. .#* #*. ..*.*# ....#.# **.*..*.***. .#.#
#.*#.\ #. ..\.  ....\.**. . #*..........##.\.* .\..#........ ...*#.#..# .# .... ..    ..*... .........  ..*#. .. ... ..\ \#.. . \......#. \... #.. * #
# . *.*.# .*##... ..#. \.*#.# .... . .**.... .. .  ##..* .*..\.\.*.......* ..\ #....* ...........*..#. ...*.... .  . *\ #.*. .\.** ..... #.##.  ... .#
#..*.#...   * .*.. .....#....  ...  ..\*..\#.\.. . .*...\. *.* \...#. \...\*. . *. .*#*.#......  . * . ...... . *......\.*.. *. ...\#..** ..   .\... #
# ...... *...#*. *..#.*.*..\ ..  *... .#. . \. * .\.*   ...# \....\.. #*    .. .*#... .*.  .. .......* ...... ....*. ..*.* ......#.. .  . .... .....##
#.#**..#. .. #...#  ... .. ..\. *.#\*...  # . *.........#.. *...#. *    .*..  .. .. *. ...... \. *... .##. ......#...\.... *. ..\...*..***..* ......*#
###.........#\......  ..\.  .*...*... .. .#** \.*.##.#.# .. .\.*...#.#...  . ..#. .* * ..* #....*.#. ..* ....\. .... .#.\#.*..* . *#. ..*.. .........#
#...  ... ...*..# .#.*..#.\....    .\.\.*\.*#*.......\....  #**.# \#.#..*# ....##. ...    ... # ..* * *# . .\...... .. **...*.*.. .. **  . **..#..\#*#
#. *.. # *..*.....# ...#.  ...# #....* .. ..\.  .# ..    ...*.. ... .. ... *.......#..#.. . .... # ##......* .##... ... #..  .  ..\* .. .* ...*. ....#
##...*.. .. . .*\.. \... ......#.\*. . \.... .*..* . . . #.#....#  *.. .\.\.....  .\.\.....  ...*.#. *. \....# .##.*.... .# #*..#. \. .#... #. .....##
#..\..\..#..#. . .#*.#  .. ..*...\.. ..# #\ #..* ... * *.. **##...# ..  ...*.*.#......*  ............... \...*....*.. ...##.#.*... ..*.*.... .*#.....#
# #. \....*.#. #..  ......# ..#.. ....#..\#... ....... . .*.  ......*#*.....# ..... . .#. . .# .. ... #  *.*. ..* .#  .* .**.. *\. .#.*.....#..#*#...#
#..#\......... .  # . #\  .. ...#.. *\#. #.\....# \   . ...** . ......#\*.#.. \#..**....   .#..\ ..*.#*.* . *.*...  .....*.... .* .......... ...* .*.#
# ...#..   ...\.\*.. . ...###.. *.....  .. ..... . .. .... **......#. .#*...*.... .. ..#. . ..... ..\\.....# .#  .#.*\ .*.#  .. . *..... ...\#*\#.. \#
######################################################################################################################################################