######################################################################################################################################################
# .. ..* .....\...  .... ... *.*.*..*  \..   .. ... ....... .\*..*.*.#.\. ...**#. ....#..  ... .#.. .    #.. .. .\...#\.....#*\....\**   * \. #.. #..#
#\*.....#.*. ...  *...  ........\\ ..#.#.. .. .#.. #..#*..\  . .* *... . .*.. \*. ..*. ..#. #.  ..*#....#...# ..*.*\.....*...  \\ ..*....  .\. ..#.\ #
#...#.. .#.\.. .. . #  *.  .\\..##  ....#..*..# .. #.*...#. #..*.... \.\# ..#\.....#. . *  ... **....*...#.\ . ** .. \*.*\...*\..\..#*#.*...... ..  .#
#.. ..#.   #.....*  ## ... . .. .#.....#\ ....#*#... .\  .. ...#* ....#*......#. ..............#*. .* *.......*. ...........#\..* ..  ....##..\...*.##
#\*#... #..##  ...#. .......\ ..\.*...*.#......... ..\..* ..  ..    #.#...  ..**. .#*..\.#\..*#* .**..#.\..*. ..*. .. ....\.\# ##* . ...*.. #.. ..  .#
#.\ #*.*#....#.*.* ... *...*.. #.     ... *#..*. #. ....##..\##. .....*...*.. .. #..  .#.#..\# ...*...*.# ..##....\*.*..#.  ...\.\ .* #.#.. . *...  .#
# **...\.. ...# ......*.*..##.# ..  .#... .#..* # ## .......*...\..*# *...*.##. ... . . #.#.  #* #*.*... ..*.... ...  .*.*.\....*.* .  . #.....   ..\#
#.... \..*..#.##.  . .**... *..*... .... .... .*** .\ ...#..*.......\.*...* . . ..  .# ...\ .#.* ..*.* .. ....#* \......# .... \.#..... .\... \. # \*#
#\.....\.. * .*... .# ....#.#*.*... ..* ..  .*.... ....*. .  . ..  \ ..#..*##..... ......  *# #* #...*....  *... . . . # . ........*  # .*\*. .... .##
#...*......*. .# ...... . ##\*#*  #*##.. *...   . .*. #* ......##\.... .#...\.\.. ...*.*..\... #..  ....#. .#.. * ..*...*.. * *. .. .*...  .....*.**.#
#... .\ . .......*. ...* .....\..*#* ...#..  #\.. *# ........ ........... *.## # .....* ....*...## ...** ...#...*... .#. .#*   ..... *...\*. ......**#
#....#. .  .#* . .. .* ..#...*...... *#.. * #...... ....  .. . \.. ..*\...*....#.......  . *..*  .*... ..#... ...*.   *#*. ...  . * .\...\...#. .....#
#.. .. #.* \... .*.....## . ..#...\.........#.####  ...#..#\. . ..\.#...#.. ....#\....... .  .\ .....*... *. ..*.#\.... . #.#  ...#.. .##.**\*\....#.#
##*.#.\ .\\#*. .**........**. ....*..#...#.# ....*.\ ..**.#... ..\ ... .# .#.....# .......* .#\ .. #.  ...#.\* \.....# ..  *..........*.#\  ..#.#. ..#
#...*** .  ..*.*\.#..\.# . .\. ...  ....\ \ *. .* #.*.. ....#. ..\. . ##.  ..#.*.... .\  ...\ .  # ... .*. *.*#..*##...#. ..#..\  .\  .. \*........ *#
#... *.\*.\ .* \ . .#....# .. ....  . .. \..... . ..#.... .#\.##. ..#.....\... . *...  #..#..*... *.*# ..  .#* * #\  #... #..#..#* . **\##.#..*......#
#*.   ..#....*...  ..\......#... .*.  .....\.......\..... \  ...  ..#..*..\...*  #..*.*#.....\ * .......##.*. .## .*.. . . . . #. . .\**.# .. ... ##\#
#.*..\.\..\. .......*\ .   *..** .#..#* \\.##..\...  ....#\....  ..*..*.#..........*.\....#.\.....*.#. .  * .  .  ....*\#.#... ...*......#..   ....*.#
#. .*..* .* #. #.* .#* ...*#.*\#..\. . .. *...#\  ...... ##.. .. .*..#\ ... ...... ...#**. ..*\\*.#.*.....* . . .* #...   *.\ *#.#  ..\\ ..*. \* ...##
##* .#*.#. #..#.##. .#..  ....\.....   #... #....*..#.  .. .\..*.# .. *. ...#.  . ..*...#.*. *#.  .**#   ... ...*. ... *.# .*...  . ##* . ........   #
#  #*\ .* .. .#.#.#*...... ..*  ..#*.........#....... ...*.... \*. . .\....... ....  ....#. #.##.#*....  #.  ....*.*##*\ #.#.\.##......#...... . . ..#
#.#..\..#. .....   .......*..  **.\.. .*..  #\....#..  .*..#. ..* .\.... .#.\...* . ## *..#..#* .##.*.*. # *.. \.#.*. .#*. *. ..**...... .\....#*\.# #
#... ..#...#  . ..*\....  .#.. \ *.. ....#..\  .......# ..\.* *\ ...*. #\*..\.... ...#*.* **. .##...\ ...*.\. .** . * ..  ..**.# .*.. ##..\...**.....#
#. #....... .. .*..# . .*\..*#*\**.\........* . .# ..... .*. *.*.. .... .. ..#......# * ...#.*\*** #*...# .....*.... ...* .*  .*..*  .. . #.#. . . #.#
# ..... ... ..* ...*. . #  . .  . .*..*.... .# ..\.*..  ....# .\# .   . #....#.#* .....*.*.*.\#*...*..# *.    .... ...\.# ..#.#..... .#  ...  ....#..#
#.. . ....*.. . .#  ..*............. #*.\.......* ... ..#. ..........\*...\.*....... . .  ...#*. .#.  .\#..\.......*.*..  .\ ..  ##  ..**..#.\.\.....#
#.*.* .. .....# .....  . .## *...#..#..* .\ ..# ...\..##.\...\.\....#.*#....##..*..#..... .**..\..  . .\# . \# .. \.... .. .......*\..  #. .##. ..# *#
#..##\.. .# \  \*  ##. .. ....## . ....*..\.* . * .....*\##. *. . .... ..#.  .\.  #  ..*. ........#\..\ .. *\.*.*..*. ...  . . ## \###..*. ..#\.. ...#
#.\....#. #.*.. .#..#...#*... ..   ..\ . #. .\#..##..*..  .* . #.....\...*.... .**\# .  .....\.. .*#. .. *.. ..*. *.*...  **..#.  ...\....# . ..*....#
#..**......\ #..#...\.. ...* #*# ...*.* .**\.  #........  \.. .  .....#..**....*#\. ...  ........# \. ....  ...*.\. ..\\...#.. *..#   ... . *  ..* #.#
# .*.#..*.#.# ..*.. #. .. ....*..*. .... .. . ..\. \..#*.*..##. .. ..* ##...  \..# ....##** .#........#*  .#  ......#. \...\...  .  . .#..  ...  ...*#
#..\##......* \......\.....##....**\.\#* . ..  *.# .*....# .***#..*..**. ...*.#\. .#*........\*..**.#  .*.*..  *#..**. .#*.\ #.#\ .... ..... . ...* .#
# ...*..\*   ..#.#*. \..#.... \  ..... ....*.# #* .*.... .. #.... . **..*#..*#.**...... ... ....#. .....\..*  *#... .. ...*.   .#..\.* .\. .#  .. ...#
#..#\. .#.... .*..*. ...  . .....#.. .....*.\.*...#.  . .. .#........*...# ..\ . \...*..*. . .*.\.............*#.* *..# *. #*   ..*.*#* .# . \.#* #..#
#.#.# .... .....*##  \..* ..#.... \.... .. * ..\*.... .....*..**# *#...* *  .. . .....#..\*. .....  .#...*.#.##.*..  .* \*.. #. . ....* **..*.. *. ..#
#..    ......#\.#  \**.. #..#.  .  .*. *#....\#.* ..* \ .#.\\..#*..... .* .*. ...*.*. ...* .\.#.#.# .. ....\....\**.......... #... ##\....# . ...  ..#
#......*...# .#.  ... ......  *..*......*.* #. ...#..\..# # \.. . ..#..#.\.*    ...#..\..  #.. ..**....\.. #.  \.#...*... .......#*..*.#.\#*..#. ... #
#*. ..#.. \.  \ ..*.*..**.\..*.*.*. .. ....  . ...............#......  .....*...  *. ....  . *... ......  ....*.##\ .\ #..... \ * ..**.*  *. ..*.**. #
#. *. **....*..# #... . # \....  .  .. .*.\..#.  .#. .#\ .#. .. ...   #\.....\  *.....\.*..*...#...#....#.## *.*.\...#.. .*..*#.\.*. .   ......* . ..#
#.*... #. .. ......*\ ...#  # ...... .....#. .*...*.....*..... . .#... *..#*.....  . \ ...\ .* ..  . # .. .. ..*....#...... #   #. ..\#......\.##.  .#
#* .. ......\#  *.*.  * #....... ... . ..    .# ..\###.*...*. #.#\.*. ##..*...#*#. *... *# . .....*..#.*.. .*\#..*..* \...   ..*...... \.  .\....... #
#*##  *...*# . *..##...#.. .. ....\... ...\.\. . .. \# #.R* ..... ..*.\ ..#.#\#...##. ...*..\...*##  ..........*\ ..# #.*. ...*#    #...#... . .* .*.#
#...#. ....\..#.. .....*. ..   . .. #.**..*..*.#* ........ *...  *.###.#..*#.# # . ....  .  **.....  .**..**.\.#.*... #. *....... **...\  .#.*...  ..#
# *#...* .   ........#. # . #  .. . .. ......* .* *..*#..#....#.*......# \##.  #.#.*...\. .....#..... . \# .\**...#\....*.. ....#\ ..  ....\ ** ....\#
# .. .\.* ...  #..... ....*..##\.*.  .... *.*.*.....\*..*.*.\\.\... *..\\ ...  \... ..\.*. # *  .. ... *..*\.... ..... \..*\ ..#.* \\ ...**....  .   #
#... **...#. ... ..\# #..\* * ...*. \.\ ... ...#\.\....... .*.  *. ...#...... .# .. *. #..*** . ....*...*..# *#  ....\ . .. \..\# . \. .#. ...*.....*#
# ..#..#.. \...........*  #...#\.#.#.. .\\...* .   #.# .. .*. \......\....  ...#*#...*......... *\.. ....\ *#...*..#...*.# *.  \... .... ** #*..\....#
#. *. **\##  .. ........ ..*..* ....*\....#. *#. ...* #.*..##..#...  ..#..   .\...... . ....* .... ..#..\ #.......  .# . #\  ...  ... .#....  \.#...*#
#....     . ...  ** .. ..##*#. . . ... \..  ** .... \ .  ...* .... *.# .# .. .... .....\..*\#\  . ...... * .  .*.. *  . \.*.  ..##.. #. . .*... .. .*#
#.....  ## .#....*.... * . ..... .*. ....#....* ..\\. .....\. . #....* **.. .*.. .\#.....*.....\.. .** # . .*....\*. .#..*#....#.. . ..... .\. .#. ..#
#.. # #..... . ..... ##.....*. .....#.. \  .\* \.. \\.**\*  *.......#.\**... ....... ..... ...\..#. *...#.*#... ... #*... ... . ....# * .*...#.*.*...#
#...#..\...*.......#.. ..... . . .. ...\....\#.\..*..# .  .. ..# .  ...*.*. .#* *.*. ..#\\..#.*.#.**..... \ . .#\........*...\.##...  . ## .. .*....##
#\. *.  ....#.\.\.*.#......  .  # ...  ...#..*. .... ...* \....... ##. #* . ... .# ... .. ..*.#..  *#.*..*.#**..# *.#. . #\...#.# ..* #. ...\ #\.*. .#
#.##.\.*... ..... .. ..*... #\ .# *..    . . .. ## ..\ *.#.. .##. ..  ...*...... .\* ..  ..*...#..#.. .........#. *.......... ..  \..# .... #...\. ..#
#*.....*.\#. *  ... #*#*.*. . .\.. #**#.#. \   \\.#.#.\*#... #.*#...  . .... *. ...#... ...*..#   *\ \\.\.. ..**.*.#\\ ...#*..\..##..\.#\..  ....# ..#
#...\...#.    .....#...*... .... ............ . ...\#*\*#.\. *\ ...\.. .* \.*.\...*#.. .# ...\.....##. ..*.#....#.. . .......**.#..*#. ..** . .  ....#
#.. . . .# #..#...#  ..#......#.#.....#  * # *.....#......*. \.... **\ .. . .. .....*.#..# ...#\. . .*##*. *.*. #...*#\##.  .#\....**  ....... *. \.*#
#.....  .*\.* #.*\\...# . . .. *#..... .. .....\.*.  * * .*... .#...*...\.. .#.........*...*..*#.##..#\. .# ... .. ..... .*#..*#\\. #..\*. #.. ..# .\#
#.*.#..#\  .*...  * \.... #*..## . .. #. .....  ... .*.....#.#..# .#...\... ###* *# . *... \..#..#. ..# ..\ ......\ #. \.  . \..# \.*# .#.. \.*. .. .#
# ..#... ...#.*. . .*.\#..*.*#..**..*. ..*..*..  \#.. * .. .* .....#...... ... .* ....*. ....*.. . .#..*.*...#. .... . #...*...#...... #*...\*#...#..#
#.\.. *.\# ..\.#...  ...*... ...#. ...\....*.......  ..    #...#.  .## #..*.#..  . ...#.  . ..*#  .  .. ..   .  *#*\* ..*#...#\.. ..  #\ .*....#. .  #
#.*##..*.\  *........#...............*. ..... ..*.*. \..*.\#.\.  . .. ..* . **.. .#..#.***.... ....\*. .. \..*..* .. *# .\. #.#.\....\. #.#.. .*.. ..#
#...*..   #.#..*.....*.....#.*... . ... ....* .##..##  ......      ##.  . *#... . *.*. #.\\#*#.*.## \*.\\ *..#... .#.. .*. .#.*.\##.....*** .\ ....*.#
# ...  ...\..... . ... .  ... *.*.. \  *\...**. .* ...... # *.*# *.  ... *...##..#\*.* .  . ...#.##...\*..... ..\...###..#....#. .*.*.#. *... .....\.#
# .....\. . .#.... . .*# ##.. . *..#....*..## . ......##..#..* ....* .#..\#.#. ...#.. . ....  .\ . ...........*...\#..#.*#.\#.......#  ..# ... . .* .#
#.  #. \..*... . ##*.. . **....... ... ..\* *....*. ... ... *......#*...#..*# ..... # \.#..#.# *.  ..#*. *..#...\........#.. ... ....\*. *.\..\ .\.*\#
#**....*. ......* ..  #. .\.. .#.#.    ....*.. .. .\..\....\\.\ *...*..... ##.\ .. . .*....#.#..........#.*..... ... .\.... *##.#.....*.#...#*.#*.. .#
#*\**\#.*#... . ..*##**....#. ..#.. ## .... #. #.#.*.. **...  \. . .#..* .\\ #. . ........  .  .. ......# #\. .... ....#.#  .*.... #*.. \ .#.  .. \*.#
# .# ........ .#. *.*.#.....*.*....#..\...\.# .#..* ..*...*#.* . .*.\#  .#. ...\...# #.#.. \ .\\..  . \. ..\ . #* . ..*.. *.*#...\#..*........*  #*#.#
#.  #.\. .. . ....* ...#. \ . .#\* \...  *......*... *#\....... .*#..# .\.\   # ...#... ..***.# ......\ .* \ .. .#  *..*. . .. * .***......\.. ... ..#
#*...\.#.#..\.. *..\.    #..#.*......*..*.#.  #....**.*........ ...\...# ...#.\.  **... *..* . ..##.. #\  . .....   ......*..............#.*.* ......#
#..... \...*.*...*#..#* .#...  \# * \.#.# .... * ...*.# .\\.. **..   .*..\..  ..*...\......*#.. *..*.#*.. ..#. \.#  ..#*..\.  ##*  ... ..\.....  #.. #
#  #.#.... .. ...#..\..\*  ..   *...\..\..#  ...*..*.#. \ .........  * ..\..#..*. ...*..*...*.....#* * ..*.....*.* ...... ## . ... #   .. .# . .. ...#
#.##\ . .\ .  ... *.. *#..#  \..\.. ..#.. .. ...#.*..*.. .#.. .. ...*. \.. ....#..*  * *.#..  .... # \#. .*. \....  .*#... . #* #.....#.*# . * *#... #
#... .\# *..*.#... *\..\.....  \...  .#\.*\# . ...*. *. . ...  * #\\# .#..*#... ... . .# ....\\.#....#.. .... #...**  .  .#......*... *.. .. ..... . #
#...#..\#...  ... ....* .. .. *...  . .........# #.. #.*.# . . .# *.#. .  **.\ . ** .....#. .. . .. ..*  .. # \#...  .\ \.... .. ..*\..*..#...*..*...#
#..\.. *......*#.. .. .#..#\\....#..#. .*. .    * ....  #.....#... ... #..*..... .... \..\ .. ..*.\...... **.  . ....*. \*. ....*#... ...\.*...*..*. #
#.. ....*......#.. ..*\#.  .*. *.... ....**\# .. .... .......#. ...\\.  .. ..# ...... *   .\*\** ..*.*...#*..#....  *...\*..*   .##.\..\##.#\\*#...#*#
## . **...... .#* ..  .....*.#.* ..#..*.. .*.... * ...# ..#.#.......\..*..*. .*... .. ......*.. . . .#...\.. . .  .....* *\\.\#\....... . ...  .#...##
#....* . .#...#...  .  .\#.   . . \..#...#.\*#.....   *..# .# . .*..*###....*... .#.**\. ..... *... * ... *...#\.**.. .##..  .\.#.##.. * ..#.*.*\\...#
# .\. .*# #....#\...\..  ..**...#...*....... .. ... ...#* *#.. .. #....\ .. .\... ... ....\ .#*.# #.* ...\#.#*#\# .##.\*# .... #  .\. ... .....\.###.#
# ... #.#.. \\*.#.. . .\ .#... #*...\... ......# . .#  ##  . *......#*...#. .#. #..... \ #. .. .##.   #..... ...* #..#.# #*.#*..# . ..*.# .#.*......##
##...# ..**.  ....* * ......#*....##. ..# *... \*  ..* .#  .#\ #.* . ..# #. ...#*..#..# .\...*. .## **\ .  \ ** #*..#..*.. . .... *.##.**...#\.\. \.##
# # #. . ...#... . ...#. . .*.. .#\ .  ...* \. . *.. ..* #.\..*\. ........ .... ....*#.##*#..... .*.............  ....##.\.#   . ....  . .  .#... .\.#
#.*...#... ........  . # .\..\......... .*\.  ......*.....\#*........*. # ..#* ...*..###.....#..#..#  .\.*...* .#. #.*  ..... ..* ... ....   .*   . .#
# #  **.##.... . ##..*. .*. .* .. .\#... ..#...\.... ......#...\ #. #...*.. \.#... .......... *. .*.....*.. .... .  #* \*.. *.......*. .* \#..*.#  ..#
#. . ...#...  *.\.#.. #.#\... ...* .#...... . .*#....*\.  #  ..#...#..\....*.  ..* ....*.  .   ..\...**.*    ..* ### . ........*. \.# .... .\.. *\...#
#* *#. . .#.\ .*...##.....# #.... # ......#.*. \. ...\*..\...# ..*. ..  ..  . . #*. #. #. .. .\*...  ....** . . ... .. ...\..*.\\. ..#.  .# .**.  .. #
# .....#* .. .*  \..#.#.. . .  ....##.#* .*....#\.#.. *...\.*.  .#. #... .\*. ...*.. *.#.#..#  .#..#.*. ...............#..  \*.\. . . ..#. *\.#. #\ \#
#.. .\...*#..#.*#**###... .*#*....#...#  .*.\ .  *.. ..*...**#....*.  .. .....*....*  ..# .. . ..# ..\.#. .. \# ...#... .# .#  . #*\* #..*##*.. .....#
#........# .  ..#..... **.*...** ....#.. ...#*.. .##.....*\*\ *. ..#.... ..\**.....#.* ..*#. *..# . ** ..\..... ..  . .*.........* .\**.#.... #...#  #
#... ....* ...* #..* ..\.#..\..#..**#\....#*.....*... ... .#..... .## .......* . *....\....... .#.*. #.#..#.#.. .#**\.. #.*. . .. .. ... *...# ....#.#
#....#........*... ...... *....#.#*..... *.. ..##*...... ..*# .. # .\.*....\* \*. \. ... .. ...#.. ... .. ##..***\ .*...###.\. #.#.. ....\..  *.\.* *#
#.... ...  . ......... *..\.. . *. .\* ##...... *#*... # . ....* ....  \..... ...##..#...#.# ...\.. ..  *.....#.#. .# .. ... .... .*\ *#... * ....#..#
# ..*.*.*..#. ..\...*# ....*\.. .......\....#.... .#\.....*  \\.*.. . .#....... .\. .. .\. #*.#.. \...\# ..#*...*.  *#\.\*. . *.. *.. *.\. .. #\  ..##
##  *..#.*.\.. .##...**....**#. .\.* .\.. *..#....  .#....  *...  . ..  ...**.# .... ..*..\... ..#....*.. ....\.*...#..*...#... . .*# \.*. ...*#.... #
#..  ..*.... ##....... . .... .#...\.  . .. #. #......#....#.......  .#.......#.. # .#. . ..##. ......\.#*.**..#.. . .**.... \*# ..  ..# . .... . .###
#.*. .......#..*. *.#.. * **. ..  \ .... *# *...#.#* \..*  .* .*.* \*\..\* . ...\ ..*.  .#.... ..*. .... .  \\... . .. .*... ....*. # * \.\.#.  .# .##
#. . .* ##....... .#. *...*.*..#. *# .\...  .\ .  .. .\.... .***. ... ... *. ......\. .* . *..** .*... .. .\.* ....*#...*..*\.\.#..*..\..  ...*...\.\#
#.... *. ..##.\..*#.  .... . .#..\ #..##* .. ....*....#. .....#..\... *...# .   .# .#...*.*...#..*...#.\..  ...#*...\.**.#..*..*.## . ....* . ... ...#
##.... ...**. *....#.##. #.#... *..#.   . ....... \\...*.. ..*\ . ....*\\ \#\.. ...#..........#.##.. #.*. .......# ###\. .*...#.*..#..*. ...#...  \\ #
#.  .*.. ..  ...**. ...*#. *.*\.  #.*. **.#..\.#.*#... ##.# \... \  *. .*.#.\.. .......*...\.#..  ...\.\. \....... ...# ......\....*.#..  . ...... \.#
#.. #  ...\..*.....\.# ...#.#  ***#  *#..#... .**...**..#.  .\.  .*.*. . # ...  #* ..  *.**#*.#...** #...  .\*\. #.... ....... .*.*.* ##..#**.# # ...#
# *.#.\...#.#. ..#*.....*.*... ..*.....*.. \# ......#....  ..*  *. ..  #*. ..* # *.. .* ....   \..#.#...#*..#...## ... . .......##. .\  *.....#.** ..#
#... #*# ...... ... . #......** .  ...\*# #.  .*  . .........\....# . #*#.*....*.\.#.*\.  # #.... .... .. .. .* ..#\#..  *...  *..*. ..* ..***\.. .*\#
#..#..... .. .........  .\....* ..#. .. ....*.. .\.. #.... ....*#....*..#..... ......... .#. \..  ....#...*..#..\\.\..#..*# ..\ #..*.........* .... .#
#...#*#*#\\...#.. .\  *  ... .  .... .....*.*... ..* .*...*.... ...# .* #............#\. ..*.. ***..#.#.\#* **#... .#....#....#  *.#...*#..**...... .#
# .#* .\*.....#.#\ .\\.# ... .. .. * .....\ ...... .*.\*..... #**.. *##.  #. .#...##  .. ..*...\ ..# ..*...* .#.* .#..... .....*.#  .* .#.. ...  .  ##
#\.... ..*\ *. ......#..##.#....*. ...#... . .#..#.*..#. ...*. .\#*.*.#.... ...  \ ........  .. * .\. #...........#.. . *......# #*....* \**..   . . #
#..*#...... .....##\......#..#. ..**.*.**..   ..*....\...*.\. # .* . ... . .. #..\* .*..*#\#*#*  \ .# ..#.\*##....*.. ..  ...  ... . #. .#*.#**. ...\#
#\.. ...#. ..  ..* ..#..#.\.\.............*. ...\.*#.*.. ...* #.. ........*  . *...  .... . .... *# .  ...*\.. .#........  * ...#. . #.#...*..*.. ...#
#\ * #\\*  *.. .#. .*. \.... .  \. ...#...\.*.... *.#.....\..***... .. . ......#...  .....*   ..*...*#.. .. .*.*...#... *..  .........#.*. .# ..... .#
#......#....*..**.\*.#.\..*##.....  .*...#....#.#.#..#.#  ...#.* .\.\.. #. *#..# .#.. ..* .#. ....***...* #. ..\.\*... .#........*..\...... # .*...*.#
### *.. \ .#.#.. .\\.  \ *....#. ....... ...\# ..*. .#. ....#  .... ....... .. *....#...... . . ... . #...#...\#....# .  . \..#.#.*. . .. .#\.*#.#.*##
#..\... ..*. .. * . .. ..#.#   ##*.. *#\*.*.... ..* .*  *..* ..## #.#. ..*.*...\...... ...## #..  ..#.  .# .##.. #..*..# ...... .  #.# ......#*... . #
#  *\#..#....#.#\.\...\ #...........*...#..  .. . # ..* . ...  .  ..#\\. ... ...#*#.. ...*# #..  .*......*..\.*.. \.  #....*. * .#. ..\\ ...# .. .. \#
#.#. ..#.\*#.* .   ..  ....\.*..#   #*..#. ..  .#*. . .#...#..#*..*#. . *#*....\.#.. .....*..\. #.. .#..*.... ...#......*\.. . . #*. . . .  .*....*..#
#\ .*. *#....... .\ \.. . *.......#.*.... *\....#..*. . .# ..##...\.*\.\  .. ...#. .# .......*.*... ..* # ..*... # ...* ... #...... .#*.***.*.##. . .#
#. ..#.. .....\. .*....#... ..*... .*#...** \*...   *..\\*. ..\..*..... ###...  .\ .#..*.* .*... # ....*.#.*#... #*  ...... .   .\ ..... ....  .. .. #
#.#...#\*  ........#..* .#*#. .*.. ....*.# #* *.#.#...* ..#. ..... #...... ..# ..*.**.. ..\.#.#..... # ....#  #...... . ...*#.. ..*........#\.....*# #
#. #\#**..# .**#..... \#. * .## ...\. .#.*. #.... ...##. ...  .  .. . *.**#. .**#...**.***   **...##.... .#*##..*. .. #.#... . .#..*. ...* \..\..#. .#
# .....  .#..... ....   ....\.. .\...#........#.*.*..*....... . .#*. *..*#..\#..# *# .# ..... ..*  .. *...#.... .   \.#.* ..#*. . *.... . ... .. .*#.#
# .. #\.#.#.#*..* *.... ...\*.* .. .....\** ..  \.. *#. ..#... . *.  ....*#. ....###. .#...* . #. ..#..*.*.... .....#.#....*... *..*.  #..#... .#....#
#..\\. . .\ \    **..#.#..#*...*.......... .#.. ..*   .*... .*#.. *....#*  # .#*.  .\. ##.  \......*... . *. #.*#*. #.##.#..#  ... .#....# ....\.#.*.#
# ..... . #...#..........  ..*.. ....#* .... .  * . . ..# * .# .. \.........#. . # . ...*...... .. ....... **..#*\ . .* .. ... * ....... #.*.......  #
#*..............*  ....## *  #. ..#\. #....*    ...\.. . ... *.#\#*..#\. #. .#.\\. ....*  .  . *.  . .*\..\\.\*....*... \..#. ...##...\.\......*.... #
# .# .. ..  . . *..   #*  .  ...*..#..... *...*.. .#  .....*. ........*... *.#. \ .* .  .. ..\ ....\#....  .*........  ........ ..*......# .....  .. #
#..... \ ..*... . #....* **. .#.. .##.##. .*.... *#........\.*.. .#.##..... . ...*..*.. #..*...*.*.** .. \* . # .*. #  \\....*.* ....\........#*. ...#
#..# \#* .....#.... .....# ..........\*.\*.#. .**....... . .  \ .......\ ** ..*... .#  .......  *. #.....*..\ . .*#*#.....*..#. *#..#....*.#.\ # . .*#
#\ .   # ....\.#* #. .     .*..*...* .  .* .#. #...#. ....*.. ..\#.\## ....*#. . .## .*\... *... . .....#.*..#.\...... *...*. .#. . .* .# .\  \*\..# #
# .....# \.*..*\...#.. ..#.  .   ..... ..#. ..#\....*.\..  .. #..#.*.#.. ...*#....  \* .#*#.\........\ ...* .. . *. ..    .*.*.*.  * #.... .# ....*..#
#.  .\. .##..*.  ..#..*## . ..#.. .. .*..\.. ... .* ..\... *..#*.*... \..#...   #..... * .#**......**\ . ..#........ ...* .\.*#*..** ....... #..   . #
#... .  ** .#... *....*..#*. . .. *....*..*....  #*.....#. .......... \.#.# #.# .. .*..\#..... . \#.... .. .#. . .  ...*..*\   *...\..*..... #..\.**.#
#...\\  . *. ..#* ##..#  *...*... #..  .\ ....... .**##. *.\.* . .........\  . **... .#.* .....\... ......#.##......# .  \.#. .. *..\ .*  ....... ...#
##.. ...... ....*.\ *....*...*.. *#...# ...\.. . ..* # .##......*.#..\.#. #.**#.. ... ...  . \..* .....  ...*  .\*.  ....* . ..#.. #..*. ...# ..#.*\.#
#.*\# ..*.... ..*...*..\....***..*.   . ... .... .## . .. .... . . ..#**\ #.#**...\..#...\ * .#. ..*  ...#. #.....*.... ..##... .....#.. \ *\\..... \#
#.. .....*.\... *.*\..\#...   ...* . ..  .. .\. ..** ... \* *..\ . *. ... .....\........#... \\   \** .# *# . ...\.*\..*.#. . .. ..* .. *#..*.*.\.*.*#
#.#  ... *.**.  . ..    *......\ . .*. #..**....#.\\ ....  .....## **#. .#.#.*....*. ......#.* . . ... \.*#   ..*\*. #... *..#.....  ..#  ...*\..*#..#
#.# .**.... \ .*..##.. \.... ..# . .... . . # \\. ....   .#. ..#... .. . .#........*#\...*.*.#*  \. .* .. ....... . #........ ..##. .#.  * .. ** ....#
# .  *. . .* .... ###.. ...#..... . *....*...\.   #  ....... . #....*.##. .##\*......#\. ... .....\**..... .  ..*.# . \. .... .#.\....#.. ...... .. .#
#\..\....\. ... . *## \........*..\*.\.  \..#..... ..\*...*..#..\..*\#.** ..*.. ###.**....* #. ...\.... *. *##*## *.*..#.*.#. .#.\.   .....# #...# *.#
#* . .. ..*... .# .*.* ... . .........*..#. .....*.* ........  .*\# ..#\*... ....  . **\.\..... \.# .. . \.  . .*..*...   ..##.#.##..# .#....\..#....#
#...*.  ....*.*.#*.*...  .... \  ... ... #.*.  .*..... #  \* ....\..... ... .#. ... ...#\...*. . ..  .......* .*...... . ....**.*..... ........  ...##
#.\....  .. ..##..\ \*...* .  .. * .#...# #.  #*....  .*.#.# *...*. ...\ . ..\. ..... ..  .. .\*..  ... \ ... .....  *#.#.**.. .... #... #.\...*.\. .#
#.  .. \  . #... .*. *#*.* .. ..*.# ... .*...# #*   ...*. ...*.*.*.. *......*..#. #...*......#.* . # .  ..  *. .....*.*. #...#...*..... #. . *....*#.#
# \..#..  ... \# ..##.*  ....  ... \ ##*#.  ..\ ..#.\. ...#*. . ..*# *......* ..#..... \..# #  # \. #*  *##. ## #  .#....#\  ..*....... ......  .....#
#*. .*  \...# \. ##*\.. .....\.  .\...#.  \. .. .. .....\ * .*.#.*. \. ...*.*** \# ..#*....... \#.## .*..* \..*.\..  ##*.#\.... #*....*.*#..... .....#
# * . .*.... . ..###...\* ..\  . \. ....*..#.. * ...... .#*.. . .*.....  ..#.  .#** .***.*  # ......\ #..  ...  ##.#.. ** *...  . # .. .# .\..#.#*.*##
#####################################################L################################################################################################