######################################################################################################################################################
#.* ....... ..*. ... ... **. .... ..** ..\.. *  \#...\..... .*   #.#....##......#.*......#. .#*...#*#.\.*. .\\\..  .. ... .... ##..*....#.. .*..  ##.#
# . .*.*..# *. .\ \#....... ..... * *#.*.#.\. *. #. .*...* ... ...**.\...*..#** *.....* ..*. ..* ....... ... .... \.#  * #  .. .\... ..... .\#.*...**#
#* .#...*...#.... #.\* .*..\.. .*.# *#\*.. . #*. ...\.  .*.##....  * .**..\##... *.*. ..#.....  ... ..\.. ..*..*..#* . ..*.  .*.... #\#.*##. ..#.*.. #
#..\  *.**.. ....  .#..#   ... **. *\#   ..\...... ....\# .....  .. ....#.  *#.##.#*. ......  *. #.#. ...## *\.\.......... ..*...#*....*.# ..#. ....*#
#. .*..*  . . ... . ..\...# # .*......*\..*.\..*#....  ..* .. ..#.  ...*  ..#..#.....# \ . #. #*##*...  .... ..#........#.....*..#... ... .#. ..\ .. #
#......##\#.. ... ..\. .#.\ ... .#........... ..#..... ....#.#.#  .* ....... *##.*..**. #. ...#.. .#.... . *#. # .#. .....*...\ .*..#....*.*........ #
#  \...#.....#   .. ...\....*. # . *......*..#.\....#.#.*. . ..  .#\.. ..  *.... ...*.......* .  .. .  ...... .\.*#.  ....*.#.  * . \#....#..   ..\*.#
#... #.*#*.... . .......  .#*#. ..*....*.\..... .. . .# .#... .. *\. * ..*..\# . #.*......#....  .. *..**# .#*.# .... #. ..... #*  ...#.#. ..  .... *#
#.#..*#  .\.....*\ \...*........ #...... ......\..#.  .... .....#.*. .. ...#\.*. \ .. .......  ....*.....**##* .\#...*  .....\.*. ..#..#*.. ... *. .*#
# . .\\*... ..*\. ..*.# \...# ...*.*. .*\ *.*.. \..*.. # ..\.. ..#...*..  .. ..*. .* .#*\..... ..# .#. **.. .... .....\ .*.. .\... #......*# . #..* ##
#. . .* *.. . .**.*........*..\.....\.** ..  \ ..*\.# #...\.#.... #  .#**\*....\#.... *.# ... # \ .*.....\.*  \  .**. .#.#*.. ........ . ... ...*....#
##. ..*.... .#..*. . *...  \.*. ..... .. #...\\....#....*#.\.#.......\...... .  . ....\#.. .#... * \. \.#.**...\ .# *. .  .#.  .....\...\*........**.#
#. ## .\.. \ . .  .# ..#.   \.....#..\.* . ....*...*\...*. ..\. *.......\#\#......*. # ...*.  .. . .... ... *.......#. #*.\.. # . #*.. #...*...*#.\..#
#\# .*  .#\ *.   *.  .. *\...\.. *.. .*. ..  ...\ ..* ... **.#*#....*  .....  *.  . # .\#.*.\..*   .#. #.#.**.. ........#.*. * .*...*#*.....* .*.# .*#
# .# #...\...#\.*...* .#  .......#..  .   . ...#*..... .# ... .*. #. .#... .*#..  .*.  ....#* \*.. **.\\........  . \#.*.# .. ......\..#. ...*......##
#..... #.# .#.... .\##.\*... . .* .# .. * .. .#.. .. *....   .#..\  ...##. .#. .......*. #...#. ...  ........#..*...#*.*  .*#.##..#..#.*..  .....# ..#
#\.\.*.\...* ..#.\.. ...# ..*  ..   .. .#.  ..#..#*..#* ....*\*\  ...... .#.*.**..*.\.. . #. . #...   #...#.\...#. \ . .*   ..\ #.*. \#. #...*.* .##.#
# ..... *..... . . # ...* ...##...\ \.*  #..*.#  ..#\.  . ......*.. .*#\#.#.\. ... ..# .. #. ..*.   .......#.   *...\\.. ....*...*. * .#*..#.\..\ .#.#
#..\... *  .*.*. ..... .*.*... *  ... ..** .\.....  ..#..*. .....*\#..*.... ......#...*.#....  \. *. ##\.\..#. ..* ..  .#. ..*.\# .*#*#\# #....\. ..*#
#. .... . *.\..*.\ .*\ #** * .  . .*##... *..\#.*..# *\.\*.....# . . \* ..*........##  *.*.. .*..*.... .*.#.. #\ ...*.......\ *....# #.. *...*.  \...#
#...  * .    #*. **.# .\..#.#. *. . ...  . **.*.\*.....  ..#..*..##..*. ...*..*##.... ..  .\. ....##...*##.. .#\\ .... *.#..#...# .. *.#\*.... .. ..##
# .... ...# *.*.. ..**...*#..\. . ..  ..#.....*..*.\ ... * .   .#.#  . ...*\ . .#.. .*... ... *..*  .*.. #.\...* *.  ......*.. . ##... . * #.*.....\*#
#... ..*\. \. \. .....*.**.*..#.#..     *..\\. ....*# .#.... #  .....#...##....** ............ *.. . ....#*   ... #.# . ... **..#.\*.#\... ......*..*#
#.#..*#.. \ *. .#...  \.....\#    \..  ....#... . .#  ... ..# .  ...  .. ..\..  #.. #...#......*.\.*. #.....*..#. #..* ........ #...#...* .*..\.*.#..#
# .....*.\ ....#..##.... # ....... *. #.#..*......... *.# .....# .#*.*..*....... . \.##.. ..*...........*....   . #\ ..**\*..... .\\...   \.#.\.#...\#
#\.\..# ....*\.. #.  ## ***...\...  .....\*. #..\.......#.#*.##. ..   .\....#......#.*#..*.\..\.#...\ ...  \.. . .* .\.*.#.#* ...\.\ .  . \.*#.......#
#..*..\* *..\...*# .... ..*..... *......#......# \*....#.\. ....  ...  \..#... #.... ...#. . .#......... ...#............#. ##....*# *#.* ... .... # #
#. *..\.  *..#. #.  ....\***#.* #....*\..... *.. ..........#.#  *.*.\.........* .#.....*. .#*....\.. ...***. #.#. .....\..#.  *.\  *.   . \ # # \. ..#
#. .#. ...\.\##...# .... ..##.. .  . . .. .#. ..\##*......##.. .... *##* ....#.#  .\  . *....*. .*...*.\#*... . .. #.#...* *.#.\* #. .*.#\. #.#..*.. #
##...# #. ...#. .#.*.. .#.....*.#*#..*# .....\\ *#.. *.# . #.. *..*. . *.#. .*. .#.#*...#*. .*.. ..\*...\###...\.. #. ..... **  .# . #.. ...*...#. *.#
# .... *.. *....*..*... *..*.*  ... .\ \.... ...# ...*\....#.....\...#. * ...#...#...\.  .\#..##..... .. .#. .#*\ . ... ....#.*...... .. . .*..\ \# .#
#*.*. #  .....#*........  ...... ..*......#. .\.#.. *...# . #....... ...#.*. *. . ##.#. . .. **.  *.. .*.\ .... *# ..  .#...\...* .##*#.*..*..*.....*#
#...*. . ..#.. ..#.* .. * ..#.*. ...#..* .... .#.. *..... ....*#. ##  ....#. ... *......... .. . #..##  #.#.#.*#. . ..#. **..  ... *. . . .. #.*.....#
#.\.*# .*\  .#... * .#  .. .. # . ..** ...* .. ....* **. *#. \......... \*..* \....#....\*..  ...#.....\##. . ...*  .# . .#... *  .. \  ...#.. .... ##
#...**. \  #*. .*.. ..  .#*#... ..#... ..*\..##....#...\*.\....*... ...#  ...#. *..\\ .#*.. ...*..# ....#..##...... ##.*....# ..#. ..\.   ..  . .*.*\#
#*..\. ..#.#. .#.#....#... ..\... \...  *.*.. .*..*...... .*..  ##### .#  \ ..*...\*..... ..##. ........ ...#.....\#...*.  #.............. \*\.......#
#..##...***..# *\.*. .*...\. . . . . ... .*..  \.... ..*.\.. .*. ..#...*.. .....\... .*\ . #.  \\#.........#.*.. # ...##.#\*...* *...##.# \...#  ....#
#.* ... .  *........# .. ..... ..*. .  . .#..#.. . #.*.  #.#  .. ... . . #...##*.... *.#...*.## .#..*....#*.## ..... *.#.#*... .\##.*. .*  .*   ...#\#
##..   . .#... .\ ..*. ***\  *\ \.###...  ...\ .\.. ##.\*.#...*..* **. ....... .*#. ...  . *. ..*#.#**....#.....*..#. #*. #..**. ..\ .* .. .. .\#.. *#
#\  .. .. \ # ...#*.. .#.*.   #*.. .. #.#. ** *.. ......* #.\.#*.. \.*#**#.#.#*....  *.* ...\. ... .. ..\#... . ..#\.... \..*...*..*..  .. . . ...  .#
#... # . ... ..#.  ..*.  ... .**...#..##*.#*... #.. .*  # .. * .... ...\**. . ..*\...#* . # .......\*. .**# .. .  . ..\....##.*\\..##** ..##..\.# ...#
#*.  # ...#*. ..*...#....**........\ . . ....**. ....\. .#  . #  *.. .\...# #.\.....##..*.\ .  #.......  ##......* * . ..*....# .......*.* ..#.... ..#
# # *\...... .. .... .\....**..  .*..# .#..\ #. \##  .*#.  .\*. .##.#.. ..* #....##. ...\  ... *\*...#. . .... ... #. *.\**##. #*. #\  .\.\ ... .. ..#
#\...*..##... *.## .....  .**..*.#.#*.*.. . # .....# ##**. .# .*\......* .#. .#........ \ ..  ..... .\....#..  *#** *.\.... ..# .#..... ...\*......* #
#. . .# ....**. *  #*..*  .#.  ...*.* .. .#\*...#..#* #..  ...# # ..#. ..  .*.**# ## .. .#. .. .#... .*.#.* ..###. .  *. ..* \.*.... ....\.# *. .  ..#
#...\.*..... .*.. . ..\\*..  #*. ..  *... \*.....\.... \ . .#......# .. ......#  .* ...... ...#..  #...#.....# ##.....#......#*.\ .. ......*.  ....#.#
#.... \#.\.  .\\ ..*. ..*#*\ . *... .# #**.**..*#... .....* . #..... ..* .#.....*..* ....\ . ....# .# *\\ .*......  .... .*...  .  . ..#. ..* ..#.\..#
#.....#....... . . .. ..*...#...  ...*#\........#*...# ..#.*. \*.#\*.  \#....*..  ..#*.*...* ..... #. \..#* ...#*.... .\.*.# \#*.... .....#. .\..*.. #
##\. .#.. . .... . .**# * ...* .... # #.... .....#.*..*...\...... .*#.  ..........  .....  . ..*.. . .*.\.  .... ......... .#..\..*.. *....*..# #  ..#
##.*#. .. .  * ...  .#....*......... ..*.##   . .# . . ..\.. . . .....# . .  ...*.  #.   .... .#.* . \. .** *. ...  ..#.\ ....*.....*#..\..#...#*....#
#. ..* *..*.*#.\..  .  .\* ..***#.# #.*  *\#.#. *..*..#..#.#\..  .\* ..#..*..*..\  #.\\*    #.   #...# ... ....\ .* .#\.\*\.*...... #..*.* ... .#.*# #
#*\...* #.. ....  ...**.* #*....*..* #. .\#*. ..*.....*..\ .#.*  #... .. ..  ..# ..*#...*... .#  .#.# ...#.\.#. . #.*.. ##\. #**# \   ...*..\ ..\. . #
#\##. .. .\* . \....#\*.  \ \ # *# #**....# \.... .... ..*...#   .\   *... \..*..*#..... . *..#..**..#....*.#..  #.... #. .##... *#.# . *........ ..\#
#  ** ..*....#.# .#......* . ..# *.*..  .# ......  *# *  ...#...## .#..*#..*#\ .*  .....*#. .\..\## . . ...#.#***..# ...#.#.    ..*.. *.*. *#.  *. ..#
#.##. .*#\#..*..*.  *  .  ... #*. ...*........*.\* *..#. .........\.\#.. .*..#.......*..\...\.#...#.**#... .....*\.#..... .....#........#....   .#*#*#
#.#**......\.*..*. ....##* .. *.. #*# ..* .\.\.  .***\  ..... . \..*. . . ## \#.\.... ...#.... . #..#..... ...#.\.  \.#.. ... ...*..... \.#. .\ . . ##
#  .. ..**... ..\#  .. \#...... .....#.##..#\****...# *... . .\ ...\...*.*.*.. .. *.. .. .*. .#*#* . ... .\.  ..#..*.# .#* .*\.*.  ... . ...    .....#
# #...#....  \.  ....*# #.  #..#.. .*  ..*#*...*.. ..\ ..*.. .##*.. ....   *..*... ........\  . .....#.. .\ ....*#...*..  .* .  ...  #  * *#..**.. . #
# \.. * .. .. *# ..#.#..#.#*...\....##. ...*\..#.... .  . #.. #\.*  *.... # ... ..\....#.. ... .* ..\#  ***. *...*. .. .. ..#...##.#*.....#\..  #....#
#.......*. *. ..... .. . \. ... ..  *\.*... *... \.# ..*#*.. ...   .##....\. .......\*\\ . ..#* ...*\\#. .... ......# . ...  ....\.\# . . . ...*#.#\.#
# ..#... .....# ..*..**... .. ...... ..  *..#...\...  .  . .*. ....  **#.\..... \. .*.*. ..#   ......\ ... *. ..*. .. ..* . #*.#.... \# .\..*\#..** .#
#.*.. .\ #. . *#.*.\.. . . ..  .....\....#.#.....#. # .\*...#.*. .  #.#. .#. *..... .. .*  .... .*.   .. . ......*\....# # ..#.# ...  . #.  \# .*#.#*#
#...*.*. .... #**#.\ ....#*...*.\. * *....# .##.*..*. ...#\. . # .#.  .*.\.  .. ......\#..*...\......\. \.**.* * ..**.....*.. #....\. . *.* #..#.....#
#.  . ##.. #..##.  ..... .....  ...*#*.# . .#..*##*....#..#. ##. ....\.*.#. . .. . .*  *...#..\\..# .....#.##.. .\....# # #.. ..\..#..\. * .   ...  *#
#..\........ ..#  ......*..#. \ ..\#....... .. ... .**.*.... \... *.#.. * ...* #*#\. .. .* \.....  *.#*.\... .... # ....  \\ ...#.*.*. . \......... .#
# .*#...* #...\\...*#. * #.*.##.#.....* ..  ...*....\.##...*  *...*... * ..* ..\..* #*.   #.**....# \.   *.* *... *. ..\#.....\\  ..   \#.  *. \\# \.#
#\.#.# ... #..\.. .##.\.  .*....*..* .*..#.. #.\\* ......#.**#..  \.\... ... . . .#.........#.#* .\...   #.....##..*#.*.*.#.  #.#. ..#\. .*.# .#.\.*.#
#.\.*# # * ....\*.\..## *  ... \  .#.........\...* \  .#. #. ....*.  ....*.#... .*# .*##...* \# ... .# \. .#*# #.*.......* .\.\ *.. *# ......*. ..\.##
#... . ..*. ..**......\. *   .*... .*.  .....# . .# .\#*..*. ....#  ..#. #. #.. ..   . # \.*.* \.  .# #.#. ...\....\*\. . #*#** .. . .\. .*.*.. #....#
##.\...# *#..#  \\...\.##... ...#*. ..*. ....#* *..*.*...#.#.... .. . #..  .. . *....#...\\. ... .\.  ...#.  .  .#.... .*....*.. .. .# .... .#**#.#. #
#**........ *. #.*...*.. ........ .....# .#..#   ..\...#*#..* *#  ..#.. ..*.... .... ....* .. ..  #. ....*..*......  ..\.. .*..... * ###..#.. .***.#.#
##..*.... . #.  ....*.......*# .. \.... .. ..#*....#  ..*...#..*. * .. *#..... . ...*.#\..  .. \**............**.#\. .#..*#*..#.. .... .* # .#.......#
#...# .. .... *..*....#.*.\.*... . ..\..*..#..#.#.. ...*.\* . .*. .*  ....... . ..*. .#......\ #*\\ #.#... \.*.. ... \ \.\ * .#..#.##  ...   ....# # #
#  #*. .  *..# ..#*\*....#. .  *.. ......\.# .*..#*  # ....* .* \...  ...#.#..  #*. ...#..\ ......*..# .... .....* . \. * .. **.*..\# * #..\ ....... #
#..**... #*#..  ......**.. .#.#..... .# ##....#..##. ......*  .*.\...#. ...  .\..*#.\# #\.. ....*..# .. . . .* .....**  .   *.# ..  .*..*. .. \. \ #.#
#. ...*.  *..*#*..*\ \........ \. . ..**.*..  .* . . *\.... ... .#..#....*..#...  #.*#.... .*#.*.  ..*..#  ....\#*...**.*...  # ........*.....  . .. #
#.*.\\. .  .\....... .#... .#.. . \# \.\.\ *.. *. .#...  . ... .*#.*..*#..*# ..#.\ ... ..# ...*. \..#.\ ..**.....*...*.. .\.... ... . ..*#. \.#..*...#
#...**   \..*.....#.\ .\...#. #***#*.. ##..*.#.## #. ..# .  ..# .**. . .*..#...#..\#.# .....*.**\  \.... #.####.*. ..  # #..*.  ##.... .... .  .*... #
#\. \\.#. .#\... ... .......*...#.*.# . ...... *.##..\\ . .\ .*  \.#. ... *......*.* \..\  .#.. .\...#.* #.*...... ....**.#*.## *.#... #......... . .#
# #*...\ . ## .. .. ..#*# ....*.. .*.. *.. .##.. ** \......  *..**..#.#  ..#.*.# .* .... . .#.. ... . ... . .. .. .. .\\ .. ....\...   .*  .  .......#
#.#*.. .  ...*..*. ...... ... #....#... . ....\.*#* . ...# .**##.  .#.*#. .... ... .\ * .. .\#...\ .*#.....*.  ......\*. *.#..*. ...# #. ... ..#...\.#
# \.*\. ..\  ..\..  .\.\...\ . . \.#.\#.\.***.*#..**. *...#. .\.. *....#*.... .\*  . #  ..#\###.#..*...* ....\*.*. ........ *#....* . ..#..   . \#...#
#**.  ##.. .....#.*. .*...#.*.  .*.#. #. ..*#..........#....#**#....*\..#.*. #*. ..  #.  ...#.. #..#  ..\ \# .*..*\ \ *.#  .* .\...... ..  .#.. ... .#
# .  .  ..**. \.. ....#.* .......\#. * .\..  ..\.  ....*.**.  ........*..  \#\.# .\... \#*...*\.#.. #\**#..*.# .*.*..........#....*.#\  ## #* #. ....#
# .#. .*.#.*.... \.#\# .\.....#..#. *. . ... # .. # ..*  .... .. *.  .*\.*..*..... .. .......\*....  \..*.. .\..... ... . .. . .*# .#..... .#.*.... .#
#.*...#* \#..\.. ......#.....*.  ##..#.\* \.\....# ..# ...\.. .......#* .#\.\ ........*. ..  # *  ...   .\..#\..#  .\. * . . .. ......\ *..\.**\....*#
#.. .\..#*.....*\*..**#....#.*...  ..#...\.\\***.*.. .#\*.\\.. .    #..... ...... .* #..#... .*... .. .. ... *..... ..\.. ....### ...*..*.*... ....*.#
#...# .*.#.# \#.......... .  ..#. . .#....#.. *. \  . #**.#.. .....**.** .... #.*.....#\.*....#\....# ..* .... ..**..*.*..... #..#  *....\... *#.. ..#
# .*#.  . .* .... ..  ...... #... \..\*.. .###.....*.#.*.. ....*\  ......\** ...  .... .* . ***.# #.....#\#..#\... .# #.#..*.. .*...\\\.*.#  ... .**\#
#\ ......\.\#*.\*....\*...*#   .. *....#  . #*#*.. ... .*  .*. \. . .*............. ..# #*\.. .\..... .* ###......*.*..##.*\.. .*\*. .  . .#. *\..# ##
#..  .*..  . ... .**..*....   .*.....#\...... . .. ... #..  .......#. .#\\.*..*.. .... ... \. *.....#... *#.*. .*.*..#. .. *.*.....#... \. .  .#.....#
#...*.*....#.*..    \#......#*...#. ......... .......... ....* \  . #. ..## .*  .##.*##... \\..  ..  .#.*... .*.. .* #....*. ...... . . . ..*#\ .*\. #
#* ...  \...#  .. .#..  ....  . ....# .## ..**.#....* .... ...#\*..#.* * ##.*.. ... . # ... . . ##.......#. *..  .. .  ##\*.. .. ...\#......*#*.#....#
#.*.  .##...... ...\ ...##.* .*.. . ..#.***...#\  . ...#. ..............  .#..##.*.... #*..* .... ..... . .\..\.. .\##* . ...\ \....*... ....#. # ...#
# .*. ... .. .#. .   ......#\..\....***.. .* ...  \#\.#* .....*.   .* ..*.# ....#.. ...* #. \ \ . *#.#  .#\.*. *.#.......#.#...##*........#..  . ....L
# .. \...* .    ..*\.*# # *.##.# .  ...  ... . ..... .* .*..*.... *. ..\.. . ..*#..*#....*..#... . ... *.\ .## ...#. #...*.*.......#* ...  ..   .   *#
#.... . ... .*.. .. ..  .... #.*.# ..#...*\.*..\ .##.. *. ..#...  .#  ...*.. .....#.\... ....#....\#.  *.  *. .. ...#... . ......# #... .. \* * .. .##
# *..*....\...#..*#..**\ ... ..*. \ ....... .*.....# ..#*..*..*#\....# * .* # ....* .. . .*........*.... .* ..*  .. \.. .. ........ .\.*...*..#. ... #
#. ...#.*...*.  *... . .\\\.. ......*#..*#.# #. *.*.......#. .........  .... . .. . \ .  * *.## # . # *.#  .. ...#. ..#..** .#.#..#. .*.  .#.#.......#
#.*#*. . .#.. .......   .*...*... ..* .*....##..* ... #.  # .#....#..# ........  .....* *.\#.....*  .... ..* . . ... #  ...\..#.... *.  .....#.. ... #
# . .  .## .*... . .* .#  ..# \#.. # \...#...*........ .#\ *. *. ..#    . . *.* *  *.  ....#### ... ... . \......*... ...\##.# ...#.#. ...... ..#....#
#\..# .*.. ..*..#.  #.## *......*. . \#. \.. #....   ... .....*.*. *..#....**  .*... #.....*  .*. .. . .##.#**. ..\.. ..* ...... #.\ .. *.#.\#  .#. \#
#. *.*.#.##*..*..*.#..#\.*....  ##.*... ...#.*..*.... ......# #..#*...*.\..*..\ .. . .. ..#.*.. . ......*..  #.. #*.   .\ ...*.\. #....  ..*. .* ...\#
#...#*..\#   . .#. # .#  ....# ..\ ...#.#* ....\  ..# . ...*. .. \\   ...#\ .....##. .. .. ... . ...#*.....*..\ ....*.. .\.*.. .*#...*#. ....#...*..##
#...... #*.*. . \ .....*. ..\. .......  ..........#.\...#..... .*..*.   .\. .  .. .#. ......#.#.\#\ ..**#...\.#... .#..*.#...*.. ...# .... . ........#
# .\.  \.#.... ...# ..**..... ..  ..\*.. . *.........#.#..... .....#... *.. #.#.*.. *#*...*\#.....** #..# ...... .. . *. ..*#.\...... ..##. .*...#..##
#. \ .*.\.#....* .... #....#.#.#. \....\. ..\.. .* \...  * . #.. . . *#  . \.....*.. .....\..*.\ . *..\**#*.#. *..\. #*\..... .#........*\. ...* ....#
# . \. .. ## ...#*.#. ... .\. ....# \..*.... * . . .* .\....\.   . . .* *..# .. \.\..\.... ..##*. .. *\*.# \ .*.... ..\...  .. ...*.. .\.  \. .\.# ..#
#.#.#..*# ...#\...  ....  ....*....*..*# .. .#... . #*  ......#. .#. ....  .*.*#.. .# .. \...*.\*#**.\*# *..*...#..  ... .*.# ........  #... # . #.#*#
#..... * *\.. ... ..*\.  ........* .. ... .. *   .\.. *...*\*..\.#.#.\ ..   ...*.\# .* # .# * #  .. . *#.** ..###...## ...\..... # .. .. ... ... . ..#
#  .*.* *.  .... ###. ##\......*........#.\\# \\*.. ...#.#...... #.*   .. ....... .\\....*..*  #*.. ....#**.*.**.*....*.\.#. .\.#...*#. .#\  ... .. *#
#. .*. .#  \..\... ..*   ..#* .\.#..#....* ***.# ....*.*...# \ * ... ** ....\.###.#. .*.*.........*#.. ...\. .......*...#*... . ..#.#.  *# ..#....\ .#
# .*. .#.*..  .#.*# . \.#.*....\*... ....*. .. . .. ...  \..#..**##. #*.\ #. * ..#.#.  .*..# ...*  .*..  . ..#\. ... ....#\...*.##. .*.#.. *.*.\.*.* #
##.. ...*#... . ...... ...\...* .. .. # \....  ...##.#...*\...\ .*..   ..*. \*.**..*.......\.*..\\. .#.#*.#...*...*\\.#   .   .#.....\***#.\. .... . #
#*... ...\ #\..... .......\..\**.* .\.. . .....#*. #.... .#..... .......#.*  .# *....#\*..#* .#.....  \......... *. \.......*...* ..\# * *..  ....# .#
#.\\.\#...***  .. *. ..\\.*..*...* #..*.\.*..# .# *.....#. .. .. . .. . . .*...\..#. #  .##...#. ..  .* .. .. . #.......#\....... ... ...#... \ .*...#
#\....... #...\   ......... ...#. .   * *.......*.....*..\.#... ...#.#. #\*..\**......#*.\.#..#.*....#** . *. ......*. .# .*.........*....  ...**..* #
#. *.#.....\ *\..*#...*..#..#... ..*....#...# \...** . ..#...*#.\.*..* ...\.. ..#.*..*.#. #..* .   . . ...#.........*.....*.# .....* .. ...#.*..\.\###
#. ......   #\.#... .#.*........ #. ..*....\..#*........# ......\.. .  #. \..#...  #.....*\. .\ . . ...*..*...*. .#  . .\.* *\#.*..  .. . ... *.. .. #
#....#.  ..* ## .......*...... .....#\ . ...  ....#...*  \...*\. .# .*\. .*.#. #*.....*.\.#. .  .....*#.*.........*.* \.... ..... ..*. # .*.......***#
#.. ... *.......... \....*. . ........\. .  .  ... .# \.\*....#.. .#*.*...*#*..*...\\ *.* *..* ...\#.... .\  .# ......... ..\.  ....  ... ...... .* .#
# ....*.#..\...*..# ##.#.## *.. *.. . #.. *#..  .. *.. .. .......... #...... ...     .... . .....*...#. ..\ . # #...*.*..*..*..#. ...#..\ .\..  ..\..#
#.* *.. .**.  .  *..* \ ...#..\\... *..#*....  ... .......#\...##.. ..* ..#.\ .\.##..   *...#. \ *..#*\**  ..... .#..  .#...*.. .#*\ ..\. #...## #...#
# ...#** ... .\.*....... ..   .# .  ......**.\*  .* ..  .#. .###*..## .*..  #..#\#. ..# .... .\.R.... #  ....#\.#*...#. .*.#   .......#. .#...# .. * #
#......\\.*.\* .**\.* .. #...*.  . ....*  ...#.*.. #.  *.. ...*.*..*.... ..\....# *.   .. . .... # . .\. #*... .*......#. .   * .\... *# #.* *...  . #
#...*...#.. ..*.#...\.*.  # #.\.. ....#.......#...*. *.#....*.. .# . . \. *  # .. ...... #.  ** .. .**....  . *..   . ...# .......#..#......#.  # ...#
#....*.... \....**. .##..#..#\  *. .\.... #...*...*.*\..\* \##*.. ... \#. ..\###....#.. . .\#.....\\ . ... #*...\. *...*.*..... .##.*......#\..... \##
##. .. .#.. * . *..  .*....**.*\..*\.. #..  .... .** # ...*..*. ..  #...#... #.. . ....\ \  \.. .. #..#*... * . #*...  ..... ...#* .*  ... . .. ##.#.#
#...\  . ..**..#.. #. * . . \*.**. \.* .. .. .*....\...* # ..\.. \ .. .. \* .#...* .*.##..\ #.. ..* #..# .#*#..* .. .#.. .. .. ## .*..*....#.*.\.#..##
#..*.. ...*.. .* .\.  # .. *.... ...*.#... *...  .*\*  .#*..# *.\#..*.*#.*# # *..  ....#..#.# *..\. \. *# . ..\ .  # .*# .. #...\.... .....#.#. *. . #
#*.\..... ..*.#............ \.........\...#. .#* .#.......\.#......\##...#.#*...... ...  ....*\....#... *.##......*....#. #*..\*..*.. .*\.#.#.*...* \#
# ..... ......*... .* .\..   ..\ ...**\.#\#   . # .....\*...*.##...#....#..# . .. ..#\ . ..*.... .  ..#*....#.** .*. .....*.* ....  ...#...... .#  #\#
# #.*. .  .  .##*.#\.. .  ..#.. . ......#.*..... ...#*#...*.*.*\. .*. .*** * .*..\   ...#..#*\*.#.* .#   . ..   # ...#.* . ....*....#.*#.. .....#.* .#
#. ...#.. .\...\......\ *.**.\.....#. .....*.#... .\.. ...... ...#.\... *  ...#.*..* ...# .  ....##....#..#  \\.*.#\  * *. . ... ... . #...*. \.\..###
#... ... ... ...#...**....... .#\..* ..*...\# .#.. ...*..*..*.##.... *.  ..... .....*.. .#...   #* ... .. *...... . .\.......... . *\. * ##..* .*.#..#
#.......\*..\* ..#........ ###**...** ..*......\..#... ...*. ........ *.......#**.\.#..##........ ..  ....\. . ...#.#\.\. ..  ..  . .... .\# .**.. . #
#. ....*.... \..*.*.##. #...... . \* ..#  .*... *....  #.. .  # *.\.......\\... *...** \\*. .##.....#.  #. * ...# *#.  . .....*.. .#.#. *.# ## ....#.#
#.. . \.. .#* .\..##....  ...*.. ... .... ..#...\\ *... ..**.#.... *# ..#.. ..\# *....*.........* ....* *\ * .\*\*#* #   ... .#\\ . #.*. .# \#.. #...#
#. . .. .#.*.* ...\...*......... .*. # .*...*.#....#.. .......... ......## .. . ..#. .\\.\* ..*......  ... ...# .#* # ..#    . \. .#.... .. *.  ..## #
#.* ...\*\..**#. .# #*. ...  *.* ...\.....   *..# .. ..*#. ...\. . .. ...#*  .\*...#...  .#...*.....  #. \* # \\.. .*.*\.* .... .* # ..... .. .  ....#
#. . .**.. ..# #... .... .....  .#....##* ... ..... . ..... .#. \*.* ..# ..#.#...##. .*..*.*........  .**.*...*  #...\  .*..... .*....#..#. ...*.\. *#
#.#. ..*...\.#.  .*   .#....#. # #...  * #  ..\.#.#.. ##.... .* ..\#..*... .. ....* ..\...* .#* .\.#.... .*...#.**#.......#* #..#* *.. ...  .. . *. *#
#... #.#*#..##* ..\.. #........*. .*\#.*..... .\..*......# .... ...* # ...*........\ .*.# ....#*..\ .#...#..#...**. #... *.....#..   *...*\#  . #\...#
# ..#. *** ...   * .*#.... . *.. #.. #\.#.*.. .# \..\#*\ .* .  ..*.. .*. #\  \\. #.#.#* ..*.*# ..*....** ***.\#.*. *..... #*..\....... ..#...........#
#.* .##. .. \#*..#....* ..*.....#... ..#.#.... ...**.. \.#.*# .*.#*. *..... #.....*.#.. **. . .......*..*.... .#..\.... .#.*..\#....   . ..*...  *..##
# ... .\...*\.#.#..#**...# ..*  .....\..\... .  ..#\..#  \ ... .... .# ......#*..    .\.. ....#..\...\...\ \..... .....##*. ..... ..#...#. .... #\...#
#. .........#..#.. ..*#.\.. ###   . ....#.# .*. .....\.\..##.   \ . . . .#.........*.. ..... *.#...\*. #. ..*..... #. ..... #....  .. *.. *.  .... ..#
#.... \.   ..*.. ** ##.*...##  .. . ...   ...# *. ... \. .. #. ....* .......#... \ #....... .. .*.*.  .#..* ..... .  .. . ......  \.... .........\ ..#
######################################################################################################################################################