######################################################################################################################################################
#\ .\...   ##.#*. .*.......#..... .#.#* .#..#.** ...*.*...\............# ....... ....#..  ... . . .#.....#.  #.**##*..\ ..  .....\* *. .....# *..#.#.#
#.#.*...#... ....*..#   ** .....# ...#..\.#. ..... ... #....... #*. .#  . #..#.*...** ..* .\ ... \.*.*..\.... ..  . #...\ *. ...* .. ..****\#**.# .*.#
# *....  .#.. .# . .# ...#....\***... ......*.  ....*.#... .*#... * * .....*. *...*\  ..#... .\*...**.....##.#...**. .. . #...#......*..\ . . ..#... #
#*. .  .#.\.. \.#..#.. ....... ..*#\.** . ... ...  .. .. .... ## *..  .#..  *. *. ......... .   . ....#... #..\. ...*..*.#.. ...#. .  #.\.\...*..  #*#
#.#.\..#    # *..*  #.. .... ..*.*....**##..## *.....\ ..\.............#.*... .   .*..#..#.... .*. ... .... .*...#.. # \ #....*  ...#... #..*\ ... ..#
#. #.* .. ##.. ...\.  . .. ##.. ...\.. . . #. #.... #..* .. . ..*.. .\........\.\. \.* #....  *.\..  ...\.# ...*......\.#.*..  ....*. .*  . #. .#..*##
# .*.\#. * .*. .#\.... .*..#.*. ..##. . ...  .  . . .*. \.#*. ... ..#...## *..#...#....## ...*. .*.#. ..  . ..* .\.*...#. ..  .. ...\.  ... . *.. .. #
#.**....#...... ...##....*..\ ..  #. ##...  .. .*....#.... ..  .* \.* ......#.. #.*.. .......\ .. ...  .#  .. *##.. ..*... ..#\.. .\**. #..#....... *#
#.#\# .\...*...**   . .  #.#.*#. ...........*.*.\##....... ...#*..*..... ..#. # .*.*......*.*...* ....#..#*. ..#.*.  .**#. .....# #. . * .\#.#.....*##
# # .. *. ..* . .*..#*... ..#  \.\  .. .  ......*... .*. ... . ##* .........# .*#  * ** #......#. .*  . ....\  .#*... .. #....#.*..#... ###\ ..   ...#
#\..*..\. ... ..#..#... # \\..\*... .  #... .. ....... #.#*#\#. .* ... ..\..*#.    *. .. ..*. .  .....##\. ..* **. ....*........ *\...#......\..# . ##
# . .**  ... #.* *  ..*.   ...*\. ...#.#.# .* ###..... ..#.... *\\*.. .\..... ......#  . . ..#.... *...# *.   ... .  .... ..##....*... .*.... . #...##
#*... \....  .. . #.   **...\#. #.#. #.   .... *.....*# .. ...#.....\..*\ ...*.\...  .. *..\.. . .. . . .# ....\#... .  # ..# ...*.  . **....\....   #
#. *. *.* ..  #**  .... ..  #.*.  ....#.*.#. ...#. # ..#... . ...... \..........  ... ....#.. ........\#..  .#..#***..*.....  #... ... ...*  *\..*...#
#. #... #*.*.#.. *. .#....\..# .#.#. . #. .. *.\.\ ..   *..#* . .\..# .*..\.* ..  .#. #*.\.\\#. .*. .###. \.#*....  .\**...\ \*#...* * #. .#  # #.*.##
#....... ...\.*.....# #..\. #\##..*#  #*..#. \. . \\.....#...*#...#*.  ... ..\..... ..  #.....\# ...#\..*# *.#................## .##**.*.  *..** ....#
#.........\.# \........\*.. #.# .#...*...\. . *.##.. . ... .....#\ ...    .......*. #......\#... #.......*...#..###**.\...*. ..\. .  # ....# ....* .*#
# *...* .. #.#. #..  ..  .# **.#** .# ....*...  .*.*...*. \.. \. .... \##......  ..*. ** .. .*\  #.. *. ..#**.. ... .\.....*  .. *#..\...#...... ##.\#
#..\*...*.#...**# #\# .....\ ....\#\... .*... .\ .\... ..# *.\.# #..... *..\.#.*.....  .#.*.  #..........#\...**#* .. ...\. .\...# .  ..... . ...  #.#
#. ..#.* .....#.. .. ... . .......*.....\.##.*.*. . \..#. ......\ .....*. .#..   ..... .. ...\..#.....#.*.*.* ..# ....  ...... ..*.*......\. * .  ..*#
#......  *.....#\ ...#..\.  \. .\.*.. ..... .. #.*.......\##...#. .....*..# .. ..##** .*....##*..\ *# .*.  .*#..... ... #..#\ .#*#. * * . *....\. * .#
#.#..# #. .\..*. **#..#.*. .. .. ....# .  ...........*...\.*  *.\  .#... \#.#\#.....#.... *...  ..# .. **\ \*.#.**.... ... ....\\# ...#. .# ..# .  .\#
#.... .. .*\ .... . ....... .... ..*###* ..\.\....*\..... *.. *...\#..#.\#  ..\\*.* .*. .. ... * .\...#..... ...*.....## .*.. ...*..*.... ..*\.*#...##
# ...*   #. ... * .#...*... ........\.. .  \* #.. .. ##.#...#..#*#  .###.. ....#. ........\R........ .\##.#..*...*....#*\... ... ...*.* .#\..* * ..  #
#.. ..*.. .. #.*.*.#...*..  .# ..\.#...##..... ... .\\\** ... .*.. #. .. .#...#..\.... .   .. **......    * *  . ... *..# .#*..  ..#.*.# .*\ #.\.....#
#  ##..*.. ##.#.\    ...  . ...#..\  *\.....#... #.  .. #. ..... ..* #. ...#... #..  ...  #.*  *. \. ......#*. .***\..#...* ..... ##..# . .. #.  ...##
#....*.*.#.# \..* . ...#.  **.#*........*.*...........\ .... .... \.......#..#..#  #*....# ..#.  .#.*. *.......#.\ . .... \.#. ... .   ..... ###.*.#.#
#..*..# .* \.......  . .*.## .#*... . ... .. . .**..###..##. ... . #..*#*.# ..# .*   ..  .\....* *.... ... . *.*..#.. .*.....  .*. . **.*...#*    .\.#
#.... # ..  ....#.**. .*#..#.*...#........ .# .\.... . ....**......\.#*#\#*..#..* ..*..\*.*.... ....*......*..#.. \ \*.. .\ *  * ..*. .  ..*.*#\  ...#
# . .... *. \........\... .#  . ...\. \......*. .*.. .#.* #  .*. . ...*. . \..*# .....#..  ..   ... .*...**\..*...*#...#...* .....#....#.. ........ .#
#. ..... ......*\*..*\\\ .... *.........* ..\..*.*.. ..* . #*#.\.....*.\... .... .# ...\.. .. *.#.*..... *.....   . ..#...\ . \.\.. ...#.#..*#.. . *.#
#* ... \ #... .. .##.... . ..\. ..#.#......*\.*.. ... .... * .. . .. .#. .*.*. .# .#..*  ... *..\\  # # .#*. ..*. #. . . **..*. .. .........###*.. . #
# .. .. .##. ##   ... \.#.*.*.... .  .* *#\..*. #...   .#..#\. ...#....\. #.#*. ...    #...# ..#..  .#. ......#.# .#..  ... . . ... #.*...#....#.....#
##..  ...  **#.*...... .* .. ..#...#* . . .* *.  .\ *# \.# .. ..*#.##.*\#####......... .#..\#  #**....\...#..\. ... . .#. ........*. *...\#.#\*. .. .#
##...#.. * . .  .. *.*.. .*.*#..\ .#.. ..*. .##*.....* *.#.#... .*   .\...   **...#.*.#..#.#....*.... ....*#....*.... . **#.. .. .\.*..#..*..#...#.. #
#  ...\#*.* ........\#*... #.... ...\.. *  ...# .. \............#  .*...# .....#..  *   . #.....# #....  .#.*....   ..#* ....* #.#....#......# ...  .#
#.## ..*#.......... . . . \..*...* ...#. \*..*....*......#.. ..#*.\......#.\\...*.. .... ...... .  ... ...* .#.......# ..\...#.. .. *. *.\.# .. .#.* #
#. ....\.....# ... .#*...*. ....*..#..*.....#...  .\  ..# *.. ......#...  *...*. #.... #. .. .*#...*#... .#..*...#.....#.. ...*. *#* ....\*#.. .  ...#
#..###...*.*#.. #*...  #.* .\*.*.#..\..*.# . ... ..... . . .....  ...*.  **.\ .*.*.. .# . . *.## #.\#..#.  *   . . .\.... #.##.#...*   .\... #. .*..##
#.##..#. ....\.... ..*..  ....##..#. .**. *.. .. .. . ...*# *..... ...#.* \ . .#\*....*# ....*.*...  *.# ..  #.. .*. *.. *....**.  .\\ ......*#. ... #
##..# . \. ....... .*#.. .*.......*#\\... #..*\*...*...*. . . #...*\...#....# ..## ....  .*.**.* .#..\ ..*.... #...........\......#\. ...*..  #...#..#
#..*..#* *.. ##. . .. ...#. .......\.  ..#. * \ #..\... #.#..**.*. ..#* *.....*.* ..... .......#... ..  *. . ....\ .#...   ......*.  \.*.. ....... ..#
###*.. \..#... ..... ....#*. *.... .\...*..* .. #.#*# ..#\.\. . .  #*.*.# . #.\#..... ..... .#\*..\.\*... ..#......* .#. .#... ......* ..*.....# . ..#
#\....* ..# .. .....*...\.#.#.*..*..*.\.. .#. . .\..  .*...*.. .....#..\...\ * .... ..  ......* ....# #.#..##.\ ..*...#.#.   ........ .***..\*.*..*#*#
# .*..  ...* # .* .......  **##.##...... #. .*. . ...\# .. .. # .\* ...#   ** .*....#...*...*###   .# . # #... #....# *#. ...#.*. #...\\... .. .\... #
#.*# ... .*# .\ \...#\..#\.. .*#\.. #.\*..#\. ... ..\...#.#.. . *. #.#... . .....#..*.#.. .*. *.# *\.. .... ...\ .\..* #*.# ..#.*.....*....... ... . #
#..#  #..*..*... ..*......\. .#..#... .*. ... .....##. ... .......#.. ..\*#*.  .#.* .#.#... . .\.  .....*..* #.* #.  .\*\.. ... ...*. ###.*..*.*.\ *.#
#...#*.... .\#.....  ...#.......# .....  . ..**   . *  # .  *  ..\...\*...**...\#. * \# #\ *...... ..\....# .*...*..#\.. . \.. ...  #.\ ..*. ......*.#
# . .*. .#.\  *.. ...#.\...#...*###*..#.#..... . .....#**. ...  ...... ....   ....*...#..... ...*. *. .... *\ #.. .  . \....#.*............*..\ #.#..#
#..**.. *.*\    ... .*.. ....\. *. .*\ .... . .\.. \....  #*\ # *. .. ..* .\.*. .  ....*#..** .\... ..  #. . .  #.. .   *. ... .... ........#.  ... .#
#\.\ .*... ..... ........... .. ........ .\*...#.\.##..........#.*..* ....... . . .* . ....... # ...*#......  .. .... #. .*. ..  ... ... .........#..#
#.. .#.. **  .*.# \ #.*...\.... ...*\.*\* *.#*... ..  .\ . #*..*.#.#.. *.*.. .#...... #*.#..... .#. ..### .. ...#.\.. .. ...#....# ...#\** .... .. ..#
#..\ ...*\..#\.. . .....\...#..... \ #...*..*......*..#*# ** *#* ... #.#..##.* *..   . ...#.......\.....\ #... #. ..\..#\\\.... ... #....*. .##.* \  #
#...#..*   .\.*. . .#*. ....... \.*. #.*..... #.#.......\.. **.*###. .##  . . .. .... ..  .*#\. . ..*...... .#.* ... \ .\#..........  #..... #** .. ##
# .# ..#...# ...*..#.**.  .  .*\   ......*.# .....# .##.....  \. ..... ##.*.. ..... ..#  \.##...... .\ ..*.. .  ..  ..\ ...#.*. ...  . . ..*#........#
#.# .. ..#.. \#\  *...\\.#...... .**... *..*#.. .. ...\.# . . \.....\*.. ...\#.. ....   ... .* \...*.....#....\ . . *#.* ...#\  ...*#..#.\...#.. ..#.#
#...#.  *..*    *  .\ ..... # ..#.   ..*  *... #.*. **\.. ..... \\. .....#.\. *..* ... *  .#.. ..*# ...*... ..#. .....\....*. \#.\#.   ...*.#..# *...#
# #.  #.  .. ..#*.....*  ....... .. . #......\* .. .\.# .. # ..#....*..... . .**#.# *.#.#  # #.... \ .....#...##..\.\###**. .*.##  \ #... ***# ..* * #
#.. *.#. ... #.. .\*.... *#*. ...... *\. ... . .. . .. ..#* ..\#..    ...# ...   ..\.\. . ##.. ..#.#.\ ..  .. \.  .....#. #...*... .....* .  ..*..   #
#..  ..# ....* #......*.# ..#..*.. . ...\...  ...*....\.**.*.. .*\ .... . #.. \ .#.#. ...# *#*..\\..  .#.   \.. . ..\ ...........\..* .\... #.\..*...#
#\ #........# ...... . .....*...  ........**.   .#*.. ..#...*\ #.. *  ..  ....#. ....#..#.. .  ......*. .\#...#.#... ... *..\  .*..\.... .*.\# *   ..#
#..#.....  . *  \.   .\. ...#\.  * . .#.\...# ..# .  .\ ..#  \.... . .....*  .. .\#. ..  .*..**...\*..#...#.... . ...... ..  *...#.. *.* .#. ..  .*.##
# .. #.  ..*....*...... . .. . .#...... ...... *.... ..* . **.. ......##.. *.*...#. .*. .# .*.. . #......  .*  ....#*\. .** .  . ......* ..\*#   ... #
#. .\.\.* *.  # *.#. ### ..* ........*..\#\ .* ..# .*..## \..... ..... ..*.\...... .\*#.# ... #..  .. .... *. # .... . .#.  *.   .. ..*. .**#  ...#. #
#...# . * # ..\#...*.     .....#\##. . .#.\\ .* ..\.** .**....... .  #...*#. \.#\ * .*.. #.\ *.. .**.*. #.  ... *## * * * .*.##.  *......*.#. .*.. ..#
#....... . . \..#. ..# .....*........ .#\ *..# **...*\##.\ ...\....\ #.#....#..**\....#\...... .#..\. ...*.*. *. ...  ...\.... *..  ..#*.. .*\\#. . .#
#.\.\... ...  .#  #....  .\ .. .... .. .. #. \..... *  . .....*..... #....\...#....#  \. .....*....\\*. #.... ###.#.....**.. .... ...*.## ......# *..#
#\.... *.*. .\**.....#. .....  ...# ...*..*###*. ...*.  #. ..*.... ..#.#......\..... ..... .....\.* . *#  *  ..\    #.*...# \.\**# ..  .. .... \.. ..#
#. .....# ** .. #... .. #..*.......\ .*. .......... ....#. ....\ ........*..*..#\  *..#.*. . ..#*.........*. ... **.*\ .# *.. \.# .##........ ..###..#
#.* .. *.... **.. .. .\*. .... #... *. .#*...\ *... ....... **...\   ...*...*. ....#. ....#..\\.\  ** .  ..  *#**. .**.........#........... ..  .....#
#..  ...*#..#.....  *....* #\.#.... ..*.#*.\....##... .  ...\.*.... .... .#..#...........  .*# .  \. .#.. #.\ . # .\#*.... ..... **\.. *. .#\*. * *..#
#. .#..\ .*.... # ....*#. ...**... .\..... *.. ..* . * .......  . * ..#. . ...*.#. . \..#\##\*.*\.......*....  . ..#  *.*  . .*...*.. *..* ***  ..*..#
#   ...\  .\# .. ... ... # ..* * ..... .**..#....  \... .. .#.. .............#.#.*..\.# \*.  * .......#\... .......... . .**. .. . .... *. ... .#.*.*#
# . *.  *.\**. .. ......\*#........ **..... #. ...........**. . . # * .\.  ..\.. *...#*.\ ..#.\ #...*..##..#*   *#..\.....#*#.. *... ..#.  ... #.#...#
##.\**#.   .#..#. . ....#... .. .*  .......\..... .... . .** .#*\..###. . ##. .#.*...##.# .# *.. ..*........ .#.... .. .\..... *.... ..... *#..... ..#
#.. .. .* .#.....  *.*.#...\. *.\ .. ....**.  ..*\.... ..#..   \. . .*... .....*\.#\...\.*. . .**...... #.  .#.#....... \.. . .#.....  . #.#..*#.#...#
#  *.. .\ .....#...*.. ..\***.. .\\..\.## *.*..\ .....*# ## .\**..#.*...#*.# ..  .  .**.#* .# ...  ...#.#.... ...*. *....#..*  .  .. .  ..#*... *.#*.#
##.*#*..#...... #\. .. * ......*#...*.. ...*#. #.....*#.  ... *..  .*.... \.... . .#*..##..*.#.#...\.#...##. .**  .*.*. * . .. . *..#.***. \ *.... ..#
#.#.#.*. # ..#**.##*....#.*.*##. ..  ..*. . ..*.#.\**.    # #\. #*.**. .. .**#..#.. . ..\  ... \ ..*. . . ....**...*... ..  .#. *...*.#. .#.*.#...#..#
##.\..\. *. .#..#..... ..\...*........ ... ..#*.*#.......##.# .. .... \..*#\........ .... *# *.. *.. . .. .. .#  .###... . . .\..... #..\ ..\..... *.#
#...\...#.\  #\.  ....#..#* ..\*..  .   .  .. ** . ...#* \.\..  ....* #. .* .#*###..*.. ..##.. # .##.#.\*...* *\ #*#....*....... .\\ ....#.....*.....#
#.... .#..*\.#..#... .........#* . ... ..  #.*#..*..# ... \.. \... . \*.# \#....* #. .\..  .#......#..#.*... .....##*. ..\..\.. * ### . #.....  ...*.#
#. ..#.\.*..*#*..#. #.. ...* #. ..* #  #....   .*.....**..*.. #. * ... *..* ... .# .*.\...*... .\# *..*.....#.    ...  \#....\.. .#. .#**.\* .#. ..*.#
# .*..\*.*.\..    .*...*.... * ..#. .#\ *...  .  .. *.. #. \... # *.##.... .#..**\..*.*. ..#*...*# ..#..... .    ....#...*.#...#.*.#.\.....#.*. # ####
##.  #\ *. .  ....# *   **..#**....    . ..*..#. .#...#.. .\..#*..#.##.....  \*...... ......\#.#.#.\.........  *. .. ..*.  ...  *....#.##.#.......#  #
#* ... *.. #... .. \..........# #.....*. .. ...\..#...# ##..*..#.#.  ..  #....#..\...* .#\..  .. .. . ..  .#.#.. . ..\#.\ .#\.#......\ ...##.*#... .*#
#.#...* . . **  *..*......*#.  # *#.. ... .... . ..\. . .#*.... .* .......\.#...** #.** #.  *   .#..#.#.. .....\..# #..*. \. .. #....*#....#...*.\...#
#..# ....#.. .. *.. ...*.\..*#.. ....# ....\.*....\*...# .**##\ ..*.#.. ..*.   ...  \# #.   . .\.*........*.*...... *.\\*.#.. *#.... . *# .  ... . *.#
# #..  # #* * .. .#*.* ..*#\.. #.. .*....\ * *..  ..  .*\**.\#..#.. .# . ... . .#..#. \#.#*......... #.. # .\ .\ ....#...\.#...#. .#. .. .*..\...   .#
#*.\ .* # .*.*..*... *\. ..#.\##. ..* \\\.  ..  #........ ...#.......#..#*..#.\ .  ..#.# . ... ...*.. \.... *   \.. *......\ ##.#....*  ....*..*... *#
L .....\ .. **  ..........#..#  ......#.#* .  .. ...#..*.*# .... ..#.#...*...##.  ...#...#*#... **# *# . .\*#... .#.#..#.\..## . ... ...  \. # ...#.##
#\......*..#.. . ...*....* *... ... ....# \. *.***..#..*  .#*........\ .... \#..*\.#  *.#.\. . ... \#..#. *..* ..#..**. #..... * ..*#.. * *.....*# .*#
## .#...... ...*..\.*......... .. ...*.... .#.*. ...*..#\ . . . \# *  .. *\ .  .#......# ..#. \*#...# .. .\##\    *... ... #.##* .. ....\ ........**.#
#.*#.#.*.**#...#..* . . ... . .. .\#..*\ .*#.\*\\#*. .  .....#....# . .\. ####...\.#  #. \ ..\ .\# .....#... *#..\ ..\*.. .. #\ . ...# .#.*.*... \..*#
#.*.. .....  *........#.. .*.  *#. . .# ..* .. \.......*....... #*.....#.*.* *...* .*......*.. #.. \. .....#. . . * ..\ ....  .*... . ...\*.*........#
# \  *....#.\...*. . # .**#.. .*.....*........ #*.... .*....... ..*.* ...*...*** .\.  .  \\ .....\*......*..... .  ..... #*...#*. .*.#  *.\#.... . ..#
# *. .*#\...#.. . *.\..#...    #**.\.#...# #\ ...*...\*. \..**... .#.#.... *.\  ...#. .*#.\ ...**.   ..  \#..... ..*...\..#....##... ...*.... .\\*..##
##.#.#.. ....  .*#....\.\# ....#....... ..  *#. . .##.. *.*#.. *...  ..***..* ..#**#.. ...\ *. *.. *..*  . ... \...... \.# ...# .*.*. #\. #... \.....#
# ..\.#....\.. ...*.* . *...#... *.. ..    ..*.#..* #..*.*. .#...... ..*..... .#.#..\... *.*.. .#.*.*... ......*.\ *... #...  .... ... . *.#*##* * ..#
## ....##.\....\.##.#.#...* .......... *\..  .. ..#... # ......\*. .. # #\#.  .. *. ..*.. .......\ \.  *#.\ #.\.. .\..... #..\.* #\...*.. #...... ..\#
#  #.\ ... *.*#...*..*.#. .. ... ..*.#.\. *.\....# ....\#. ... \.....\ *.#....\..\ .....\\###.#..   .#.#*. ... ......#. .*.#*....* . .#\......  .. .*#
#..#*.  .*. .#...*...\.. #. .*\.. * .\.. #\*#.#......  ...**. ..* ..#.\\.\ \ . .*# ...*...* ...\..*\\\. .*.#...**  ...*. .. .*...*...  #\.#.* .**.*. #
#... ..#..* ..#**.. . # . \\.. \. *.*.    .....\.\ ...*\.. .. ....#.. ....#*... *.....*#.    \.. \*... . ... .. .. ... .  ...# .*. .*....#.. \ .# ## #
#. . . ...# ..  #.. \...#\.* ...*##. . * *.#.*.  \.....\ * ..   .... ...*.#...*  ..#\.*.. #. . #\*#... ....#\ *.*..#.**..... .   ........*.....*.#...#
#.. ....#.#..#*. ..... .  .. *.....\ ***.*. #..*...*#........*. .. . .#....... ........ .  ....... .. .#..* **....#*\..\..\.\... .#*#\#.*.. .........#
#..# ..\ \ . ..*..*..  . .. *#..#. .*. ... . . .... .. .\.# .**. #...*......#. .##...* . #.* . ..... *.. ..#... .... .*.\# . \.  ............#\.#. \##
#.# .. *..# *#*.....**...##*\*##* ..#. .. .  .\ ......*..*\.... *\#.. **.\.#*..* .\...# ....#.*#.#.. #..  .#.* .\#... ..\... #.*\* \.. \.....# . #..\#
#.\...  . .....*.... . # ..*....#*.....*.*..*.....#.# .  ..* *..\.*..\...*.\*\......\**\*  .*....  .*. .   **...#..\\.*. *. ..##..*. .. .# **........#
#.... . ...*...#....* .* .###. . ...# ..\\..* .*.#. ...*#..\..#.*#\.* .. ..*#........... \*\*\....  ...#.....*.*... ....  * .. .\ # . . ..*.# .. ..* #
#..  ##*. . *\*\.... .#* \..# .* #. \..*.... .. ...\....\*** \. *.#.# . .....** ... .. ....... #...*  #....*.. ..# .. .  . .#... #....*#* .#*. . .#..#
#*\...#  ..*.#\#*..#. ..\ \ . ....*.. ..\....#..*...*\ *. ...*  *..#..# #...\\..#.. .*###... ... \.# . ..*. ...*......... ..#...# . *..#  .# .... #*.#
#....... #   . . .. ....  .... \.   .#** *..*\####  .#. ..#...*...*..... .**..*.. ..*..\.* ## .....*.....\.\.# .#....... ..**#.. .\ ... ..*.*.*..*.. #
#.#. .#  ...*..   ....* #. *. .\*.  ..# .. . *..  *..* .. ....  . \.*. .*  ....*  #.\..... ..# ....#. .... * #..\# . ....\.. . .........*.......#\ *.#
#.. .* .....\..* .*.*.* .#  .# . ..*.\. .... ... ....*..#.#.....* . .*..**.....*\ ...#\ ....#* #. ..   ..   ..*#....*.. \ *. .#\..#.#    ...#..\...\ #
#*#*#\# .#.###. .#***. .\#. \ .#.  ##. ... .*.  *.........*. ...*...#.. ..#. #.### .\\....***\*...  ...*.. ..*\\*.. .*\#**.... ... .  .#.# *.. ..... #
#*#.....\......  ......# ... ..*... #....#. # # *.. *.. ...#....#...\*. ** \ ....*..  # * ....*.##* .. ..**.... *.*.. .\. *..*..#.. .  #...*\#...* \.#
#. ..#....*..\#.. ..#*  * ... ..  .#.\\#.#.#.*.# . ....... . .**.**. .   #   .  .#.  ..  * *#.*#\#.... # #. #..\ ..*...\ \.  .. \...#  ....#....#...##
# ....*. ..\... .. . \\ ...#*.#.\  .*  \ ...... ...*\...\ .* .*. . . .. ..\..#.. .... .   \ . #..  ...#.\. ..*\..*  .#......#....##.* . ....#. #.* #.#
# ..   .... \ *.\.. . #.#. # . *......\*..   ...\ ............#.. .##..* #.....#. ..\. .... . *.#* .. \.\. ...#\.... .. ..... .\ \....# . #. \ . . \.#
##* **.#\# .*#. ..*#...*#....#....**.. .. . ...#*.. .*...... *\ . .*. #.\\. ....* . #*\...# *# . #.*#\. #.\.\.. . .#. ..*. #..*..#.#..##.  ..\*. #. .#
#. . .*.*#*.# .#**..*#*..\\.  #...\.\.\.*.....#\\...... ....  # .....*.....#*..... * . . ...#.* .. ...#.. ..  #.... ...* .\ . ..*....... . #*....\#  #
#\.....\ .\..*..#...\. # .  ..*...... \....    ..#...# #\#..\. .#*. #*.  . . .. .... #...#.**  ....#...#..... ..*.......#.#\. \.. ...  .\*.# *.... #.#
# #.....*. .\#\.  .... ........... ... .#.**.* .........#. .....\.... \#  ..............* . .*...#*\......  .#...* .......#.... .#.... ..#.\.. #  .  #
#.*.... ..... .........*. .. * .  *..\\.\. ...... **  . ...*... . ...*.#. ....#..*  *#*.. *...\ \*..*..#.# ..#....# *.. .. . .* .#.*....... * ..**.* #
#.#.* ...\# . \. .*.. \....#. .  **.#\.. ...#* .#..  .*## \ ..#.**  \.  ... .. ..#.   #........ . *#*. .... ..#.#.... . *.. ... #. .. #.  . .. ..**..#
## #... ......  # .*\.. ..#\..... .#.. .. .\  * \.. ..  ...  .#..## *..... . ...**.*.#...*..\.. ..*.   .\.*......... ...##..\... .*#*.*.\.. .#... .\*#
#....#   #. \. .*.*...*. ..*......#..\*  *.* . . . \.*.*  . \.*# .#  ...*.*.#......\....**.# #.#...* ... .\..# #. .... .*. *..... *. . \.*   ...*. *.#
# .\.#....... .......*.. . ...*.*.*.\ . .. .. .#..#..##\.**\ ...##..*.. . \.*. **#.#.. .*.#..... .....\*...*..... . .#.**.#\ ....* .#. #....#. *#.*# #
# ..\....*..\\...##*#..\ ...#**.# ..* ...#. ..* .....# .  # .#*\.#\. ..*.*\........ .#..\ ....\##...*.. ... #..#.\.# . \..*..#.\. #....* ..*\..#.\ ..#
#..... ...#.  .. *.. .\*.#...*. .....*......#... .# .#.....*. *#.  .\.#. .*.. .  .  ..##. ..#. #.*.\# ..# .#\\..\.* *...#. . ....   #. .\ .. ...#.** #
#.*..\#.  . \..### .. . #*. .*#.\#  .....\.. ..... \ . .*.. . . .##.#.   ..#...#. . \*....** ...#. . #.# *..#..* .. ..  .\*\#.. .... .  ..**. *   ...#
#  ...*... ..\.\ .*\..\.. .#...#.....* .. * *.\ ..*.. \..\.\# .. .. *......  *. .....*  #.#\. #..\#. .##.. .* ..*\*..#... #......#*..*....*.  .....*.#
##*......\\ **...*.**.*.# #... . *#\..#..*.##. ...  #*.*.# ....#. .*.. ..*# *.#.. ..\.# ... .   .... *##..*\....#. \ .*.*#... .* ...#.... .... ....* #
# ..*.#...  # .....# .## .#*. .  .  *.. * ... ....#..... .. ...... ##..*.. .#.#.... .**.#.. ..*#. .\..*. . ....  ...\..  .\ #..#.* ....  ..\..*......#
#..*..#..\ .. ....* .#...  .#...#*.*#  *........*.#  \  ##....  .......#  ....\#. .  ... *.  ... .\.. ...\..* .  \.. .#.##........\..# .. . ..\ *. ..#
#...*. *..*#\#..\.# .. .**.. . . .....   ..*... *#.* ..*. ... **.#.......... .*\  ... ..*. .. .. .. ..  \\ .... .\#....*#  *....*. . #..* .....  \...#
#*.#.#..\ .... . ....#. ..*....*.\.#. .. *...\ . *. #. .....\#.#..... ..*** . *... .... \. #.. ..*...* . ..   .........  .... ..... *..** \...*\.*. .#
#. ..#\\..#. *...**#.. .  .##..##...## .\. .*   * . . .\..*#. ....*.*\  ....#..*.....#.#.. ...**  #..#.* ..*. .\ .##.* ..#.##..... ...........# ...**#
#.... #*..\#.* .#.......\\*#... ...##... ... .*\#. ..#..#..*.*\. .* . *.*#..\.#.#.   ... ..*..\.. ... ..\#*#.\.##.. .... . # .\.. . . ...   . .. ....#
#*.. ..#....  #....#.  ....  .**#..  #. ..*.. . .. #.. . \... #..  * ...*  # . . *..  ...#. * ......  .#.. \... .... . .....##.*# . .  ... . .... . .#
#**\....... .* ... .#....#..*..# .#..*. .......* \.....#..#...\.. ...   ...\\ .....\#...#..  . * . .* ..     ..##*..#*\.. ...#.*#. .........*. . .. \#
#. * . .\*.#..  ...*..  .\.\........#.*.....   .. ..# . .#*... .#\..* .*   # . . #. . **\ .. \.. . #*  ....*...* ....#.# *   ...... ....#.#. #..#....#
# ..*  ...#.* *..*#\*................ *#....#\..\...\.*.\\\#..*** .....*..*.*\. ..  *  .  . ...... .#*# .. ......\.** .*..\ \ . *.....#.. ...*.*.* * #
# **. * #.... .*. * #* #\* .*. .\*  .# .*# .\#...\. #.  ....*......*.  ...*. #..*. . #.........*...* ...  . .\* ......* . ....* #\*.   .*..*...\.. \ #
# \..... #*. \.#..#..*. ..\*. .....#.# ..*. .. \# . ..*..*..#.... *.*... ...#... .\.#.   *.\.\.... . .  .#.# ..* ...\..\*\....* ..**..#...#....  .   #
#.. . *\### ..#..#..#..  .*.. ..# ....#......#..#.#\ .*# ..*.. \ #.*#..*. .\.. #..***.#*. # .\..#. . ... . ... ..#.. \  .\\. *...... .#....# ..**\...#
#*\ .*.. \.... .. ....*#.. ..\*.\\... .*........*#..*.##......\..#..###..# . . ....#. \.*##.. ***. .* \\.\ # .. . .. . .**.*...* ... .......* .*.  .##
#.... .#.. . . .#..# # \.#.*#*.\. .......*..\........ ..\.*##.# ...... .... .\.#... .. .\*.... .\.#...... ..\..*..**   .*#.. .. .....# ..* ...*##.. *#
######################################################################################################################################################