######################################################################################################################################################
# ..#.* ....  . # ..#.....*. #..... ..  ...*.*. \* #.\... # \. ..... #..  ...#..*. ..#... ....*.... ...*.#... .  .**..#.##.# \. ##.. . #   .# .*.* .##
#*#.. .#...# . # ..*.# *#....\\\... .... * .*#..*. *.. ..*.\*. \# .....# .... #..*.... ...* **   *..  *.*.. #...\.\  \...#..... ...#....*...*..... ..#
# ...#.. #.#.  *\..* ......# . .*.....# ...* .#... .. ..#..#. *.. . ...# .**.*. ... .*. .. .... ......*.*. ...  .#..\. ..*#*..\....*...#  \*.. \#*.* #
#. ... .* . * ...  #. .\\.. ..\#.. ...#...*...# ..*\*# ...\ *. ..*.*.   .....* ..  #.*  #*.#...**. .\..........  \.#.... *.....#** .# ..  ..... .##. #
#...\* * ..##  ....*.*...#.## ..\.#.*#.\###.# ....##..#..  .*** ......#.  .....*...\ ...... \.#.*..# .*#.#*...... #.*..*.\ . ..#.. .....*..\....##.# #
#..*.*... .##.. \.. . .....#. #\ *.#.......#.\..  .\...\....*.....##....* .  # .. .*.\#*\*...  . . *.**..#.. \ ..... ....*#... .... # .*..#.. . *.#*.#
#   #......\......*.. ..#.\.. .##*.. ... #.**...#...\ .\.. ...*......... .. . ...\..#..#.*.. . .. .# * # ..*.   *...  \. ..#* .\.#..... #..  #  ..#..#
# \..# ... ..#......\..*.......*...........*...#. .. ..\......*#... \ ....  . ..# #.. ....\ . ...*  \ #.. .## *...*  .  ..#*.* * \.......**..\. ..# .#
#.... ..*..  .*. .\..\...\.*##.**.  \.##......#..# #.    ...  ... .. ...... ##.  ....#.*..  # ..#.\#.....#..   .\.... ..  ...#......  .***. .. ... ..#
#\..#.... **\..\.#.. .  #.#.#....##*#*.*. .\.* ..\.\....##..  .. .\*#*...*#..*\.... *.... ..*.. ....* ... * ..*  . .\.#..# .. ....#*.#.. .\..#...#.#.#
## .* . . #.\\.  .**.\.#  **.....*### ...*....... . .  #.\#.\... .\#*.##..\. .#.. .\*#..# .#..##** ***  ......*#.  #* ...\ . ... ..  ...*.\#.*..# \..#
#.. .....  # \ ..*......  ...  .  #. *....#*...*.. #. ...*.  \..\..... #..*\*....*...... \..*#*... ....##.. ..*....   .#.\  . ... .*......# .  .. #.\#
#.#. *.... .. \.**... ..*.*.. ...#.*. ...*......# ...*......#....*.*.\#.*.*.*..#. ..# ....\.....  . *..#.# .#*...#..#. . .. .*. ...*. ..... ........ #
#.*\.*.\......*...* ...*#**. .*..#.## #..** .\ \...#.##.#..... #.##\  *\#. #* .#.. ..*..#..  .* ......#.\. . ..#..*#\..  *....   \ .*.*.*.*#.# . ...*#
# *. *.# ....\..\*... ....#..#.*# #.  .#. .....* ...*#..*..*...*...# ... ..#\... ..#*  . .#.#.*#..#..\ . .. .#...  #.* \.. .\... *...\##.#.\ *. #.#\\#
#.*....#*  ..... ... .... ..\ *. ...\.\##.........##.#\..#.. ...*.. .# ....... *.\..\ ..\  \ ..  \.#. .. ..*.#..*.#. #*. * .*...*.****.*.#. *.*...*.*#
#.#.*. # ... ...\ . .....*.. #. ...#.# .  *#. \..#.*.#*.....#*\........*.* .. ..#.##.*. . ... .  .....* .**\.##. .**.*  ..  . *..*.....\*. .\ . . ...#
#.. \... . ........*..\#*.#...*.... .. .*. . ..\\. .  ...... .##..#..*  ..... #   \.**.... *.\...* .. ...*.. . ... ..** ..  ..  *#**.\...#..#. .#....#
#.......  .# \.... ......*.#.\. .#..##.... ..... ...*.*.  . ..*....*. *. *.. .*.\*..\..*.\\.\..  #.......\....* ....\..  #...*. ...*  ..#*...\.\.....#
#*\..* ....#*.....##   .. . . .. .#.   \.*... *. \.*  .*     .. # #...*. .#.*\... .*.  .*..# #... .. ** ....#. \#...... . .*. ......... .\.# .# *.# .#
#.....# .\ ..\. ..*.##.*# . .\ ...  .##..\ .  #.....#. \...# ..#. #.... .*#.*. ......\...#.  ...* #\. .....*... ...* .... .....#  ... . ....*.. .... #
#.. *..**\#...##\*.... \ .  .  ...\ ...*.....*. ...\.##\ ..*...*.#....... ... *\ .....# . .. ..    . .#. ..   ...\ #.*#...# . ...  ....#\\. . *#.# \.#
#*..*   .#..*.*....\ . ..*...\#\.. ...##.*.... #...... #*... .**.###. *.....* .**#.*.\. #. *... # ... ..\.*..\ \..#. .# .....*.# #... . #..*\.  . ..\#
#..  .* . .. .... ...# #.. .... .\\..... ..... . ....#..*. . ....  \.. *.... ..\**. ..* ...... .\..#.\#. \..\*..........\ .....#......# #..... . #* .#
# . ... .#. ##.\...#..#*. ...  .. ...\..... ..\ ...\. .  .#..  #* \.. *.... ..#  ..*.....#...#..*..*. **#.. *..\.*.....  *... . ......... ..  . ..  .#
#......*.*##.*......#...#.* #... ..#. ..#\.\.  *. #..#.#... #. .. *....  .*...#...*..*. #.....#... ..  \  * # * # #. ..... .*.... #. . .\...... ..*..#
#.*....*#.##.*.\.    . ....#.\*.. . .  .#...*.. .*.... ....#. *.. ..*...#.\... .  .. .\..*.#......... ..*.##....\......\#...\*....#.. .#..\* *.. ...##
#\.# .#..#.#*..  ......... ..# ..\* *#.* ..... *.*.#.....*.#....\.*......*..\*..\ #...#...#.....\ .  . *..#* *....\.......   .*# .......# . .. # \ ..#
#.* .# \\**. .....  . . ..#.#...#..... *.  *#... **..\....\ \. .*.*. .#\..# # .\#*. .#.*. #.....#*. .#...#\. ....\\..... \..  . .\#  ..\ \**\#.. ..#.#
#.. .....*  * . #.. .. .*#* #*.#*. ...\...* *.. . *... . .. .# .. .....*....\.#.. \*.. .#.. .*  ....#....*...#.  .. .. *.......... ..* .\ ... .\*..*.#
#.. .   ... . ..#....*...... ...#.*.#......*...  ........*...\..#.... ..  ..\.#. .. # .#.*\....#\...... .... .#*........*\ .#.. .#.....\...###...#.**#
# ..#...  ..........\.#......#....  .**.. \....... *....* ..* ####. ..*.\ ..  \ #.\.*..\..\*  .*. #..... **  . # ..................##. . .#... . #. .#
# ## *.....*\.\....* .. ..\*... #*..*. .. .#.#...\ ... *##.  .#..# *.... . * \.... .*#  # ......*..  ...* *.#..  ..*\....\ \. ...#  ... ..*..\  ....##
#\#. ...#*....#*.**..#.*... *.*.*** .. .. # ... . #..*.*#.* .\..  ........  .. ..#*. **..** ..#.* ....*   .....*.....  *.#.\..\. ..#.#*.  \ .#.#....##
# .#  . #.*. ... ....# \*  *#**#.....* ..# .. #..... ..*.....\  ......* . ....    \..#..*. *. .    **.##..... .. .*..\..#... . *\.... .. .....#*.....#
#..*\.#. .*\#.. #......... .#.. ..\*.....#  * * #..##**\*... .. ..**... ......\....**..*... ...#* . \.  .. .\....*..# #...\. .**.. . . .. .   .# .*  #
#*.....* .  .*. . *.# #   .... * ........ .#.\... .# .  ......*....#*# .# ...\.\. \.**.*..**.. ...* .* . #*.* ..#  .#... . ......##. \. \# ..*. ..#. #
#..#..*\ .. *.... .. .\ .#. #. #..#.\# * ....#.#....... .*.\  ...... ........ .. .. . *#  .. . #.#.#.. .\ ...#... ## \.\.  ..\.....*\...*. .#.*#.. ..#
#... .*. ......#..#.. ..#..#... .*   ...\........\*.... *... .*.    #......## ..\.* *.#...* ..*.#.. . #.*. #..*.#......#..  .#*.#.*#. .. ..#. ..* \ .#
#.........*...#\.. .. .. ... .\#. *.\.....*.. .. .*\...*..... ...\ ..#\ ...*...  .. ##\ .....#.. . * ..# *.*.## .....# .. .. ..   .. .. .#.#\. . #.. #
#..*.# ...\....  ...#. ..** ........ ..#. .*.**. . * ...*....*... \ ..#. *..  ..... .. #**#..# *.. .. *...*.. .. .#.. ..*...*...\... .#...**... ....##
#  ...*  ..* .#.\.. ..*. . ..*.#.. ..#.....* ....*#*.. ...........\.#. \.....*...**##..##..#.*.#\\ . . .. .*... ....  \ #*....  # ##. . ......#. .**.#
#*..   .  ## ..#\* .* ..... *.#. ..  .*.*........ #*   #*\..#.\#\.. *...\.*.. .*..#*. ..... *.......* \\........*\.*#..*. . #  .....* .. \#..#. ....\#
# .\#. . . ..##.*##.. ....  . .#  ..#... \*..... ....*...#.... .  .# ......#...  ..... .*.# .\... .... . .#...##.\.  .....# ......#.# ...\#. .#.. ..##
#..\# *# .. .*.**. .  \ ... . ...  ...\#.#......# \# ....*.*.  ..#....#..#.#....#..... *.*.  ....*.. ..* ....#.\#.* #.  ..#  .# #.# .....*..*. ...\ .#
#. ... *......... . . \  .. \..\.*........ **..\... *.*.#**.*\.#.....*.*\..#.  \..# ..* #.#.*. \..#.   #.\...#.*\..#*#.*.*.#  **...   * . .*. ..*. . #
#*.*...\.*..\... . *.. .*.\.#.#. ***.*.. .#...   ... .#*. *..* ...\ #*.\*.*  . ..#*. .*.*# .  .\. .#. \.. ...*..*. . .#.*..\ .#...* #**\..\.\ \.....*#
# ..*... .#\ #  . ....\ .. ..\..*.\#....* #.#..* . .**.#.....#*. ..##*#.*#.#.....#.#... .#.  .. .##.*. *. *#*.. ..# .  *. *. \*.. ## ......   .#..#.*#
###.*...  .#.#.... ...*..**. #..# .... .# . ........*    .\#.   ....\#..*#..... . #*.....**... ... ...#\*\ .#.*.#.. . .\.  #\. ..#...  ..  . . ..... #
#.#. *\#\...#.  . ..#.. ..## . ##.\...#. .#......#.*.*...**.  .**....#...*.. . *.#*. \#*. *#.. .. . .*... ##...* .* .*.#. #*.## . ..# .#.........\.*.#
##. ...*.\. ..\\ \\.....    . ... \#..  ..##........*.\ ..* ......*.. ........ #.#.. ...... *...  .\. \##...# .* *\*...\.*.. .*. . . ... .# .#*# . . #
# ..**..... .. .** ...#.  ..  ...#..*** ...*..#.*..*.#  ..* ..## #.*#\\ *...\.. ..\...#.#...  #.\.\\*..#.. . #....\.*.\  *...*#....#.#.. .#..*\  ..#.#
#.   ..* ##...... ..# ...##\. . *\*.. \. ....*...  #.# ..  .\*....  * #..* *...*  ....... .#... \*# .\. . \....*\.\.# .*.#... \#\*.. ....*.*#.....#  #
# #........#..*.#..  ......#. \...#.... ...#..\# \. * .*\...  .# *...  .#. .. .. ##....\#....... .  .. .... *..\..#*...*#..*.\..*....\.**.*.. .* ...*#
#.. .\ ..  ...  ...\.*..##.   ...*. # .\*.#.\.**. ... .*.... .*..#* .\....*. ... . ##. .\# . ............ . .* ....#*.  *\##..*.. .#..\  .....##\. ..#
#.. ..#. ..  **.. ... #*.* . *. ... .\.#...#\. . ... . . * .#.#..  *#.  ....\. .. .***.\ ... *.\*.... ... . .**...    * . ..# *.#.  .. . *#... ... .\#
#.... .*#...# \..#*#.#. ** .......\.....\.* #.#.. ..#  #. #... *  ..# #..#... ...**..... ... * .* ..\... .*..# ..#..... . ... . ..#.......*...#..#...#
# .*..#.*#*.  \....*... *..........#...\.*. #.*..*... ..\..*.\*...  . \.. #......   ..*.  .  . ....* .\.\ # .\\..\....##........\..... *...*#....#...#
#.....\\#.\\*  .. *. .#*....#....... *  . .  ... \.\.*#.#.. .#..* . \ ..\ #**. ..\. . .. #\......*..#.....*........**..... \.... ....\\ *... .... * ##
# ..... . . ....   ......\..  ... . .#.. . ..\\.#.*#.*..  #.**.....  ..\. #*..#\ ..# #......# .....*......*....#.... ...  * ...*# .  *.. .*....#...  #
##.....   . ...#... ...* #...*...#.#.  .* ..#...*** .\*.......*.*.**.... .#.#*..   ... .. *. ..# *#.. .##.  .* ....\## \*.* ...#.\ . .... \.*..#.\*#.#
#  .. *.. *.# \.... ......#. #... *#.... ... . .. #.\  ..  ...#..... ...* #....*...##.....*..*.......# .*\.* .\*... .  ...*..... \\ ..*\#....#\  \. .#
# .# .. .   #.\ *...#..*.. #*..  .....\#.#*.#... ..*......# ..*  .#.. ....*..#*.\..\*.#*#\...#\.*#..##......... ..\ .. .* *.*##..*. #* #........ ..###
#**..*..*    ..#\. * . **...\......#. *.#\....\.#.#*.... ... .    #.. # .\** .* .. .. *... #****....\.\ #.#  ..\...\..**.. ....*.. .. ...\. .*   .*..#
##..\* .*.# \.*... #... #..... ..#.....#.\.**... .*....\..*.##.\.#.*...#*.\.. *#...*  .* ...*..*\.  \.*..#. #...#. .**. .. . *.....# #..* ....* .. ..#
# ...##*.*.#\.**..#.#.**.*.*. *. ..*#....\.... .#*.. . ...\.......*.. #... #. ..#*....   .* .  ..*... ...*#.*.....*....#.# ...\... ......#... ... .. #
#*.... .\#.....#.. *.#......... .. *.*..   ....\..\##..... ....# .....*.\. ...... ......\..... \.. # ..* .. #. .. *.*. * ....*..#.##...*..\. .*.#.#\.#
#. #.. #... ..  \\*..*..... . . ........\... ..*  .. *. ...........* *.. .* . ....#\.*.*. ..**.*. .. ....\#.......* ##\..... ... ..\.    .. *.  . \*.#
#.  .*.*....#\*#....*.. ..\ #......  ...*...... ..*#* ...*...... .... *  .#.\#*....#.*......  ....## *#*..  #. \ . \.. *#  ..#.. . #   ... .... .*...#
#.. .\..***.\..\.. .*.* ...# . . .#.... ...  #*.#   .*  ..   .\*#. ..... # . \.. #*.*#..... ** .#..... . ....  #... ..\..*.* ..*.\. .\ ..# #*  . ..#\#
## # ..* ..\#... #..*#.*...#..#......# . .# # \.....# #......#.. .. **.. ..# .....\..\*......*  #.. #**.*.. .##....... .... . ...\. .* .#.#.#.#.#..*.#
#... *.*..#*#..... .#*...*. .    #.\ .  \*.. \....  *..#..**. .R.... **..**#..... * \#. .. .#  \...#.*\.\# . .*  .*.\.*..... #.*. #. *..........  * .#
#*.....*.....*.. ... .*#......\..# . ..*#  #.\# .   . .\....# \\ ..#.*.....#*. ..* ..  . ...*...*...*##.#.\ #..*...... #.*. ##.*  \ ..#... ..\#. .*###
#....*\. ..\# . *.#  ..  .*..*.**. #\....\#....*....# . \..\...*....  .*.... .\#  ...#**\*...** ..\**...# .*. .... .*.. ..# ..*..  ..*.. ... \*  . ..#
# ....\...\. ###.*.....* *.   ..... *........ .....\. \..*.#.#. ...\. #\***. \ ....* \#....#....*..*##\...#.......\.. .. ..#....\....\\... .*...\#*#*#
#.. ... \. ..#\  .\... ... . ......**....#..*.\*\.\...*..\#*# ...#....#..   * #. ...#* # ..*#...\....  *#......... ..\*#... *...  .  . .#.*. **.. ..##
#. ..\..\... ..........\#.. ...\.#  . .*..... \#\... .....**# ..#.\.. . #\  *. ... ...#\..*..  \.  .......#.\#.....*...\...  . #. . . *.....#. \.#...#
##.*...    ... .*#.\   \*.....#\... #...    .\ ...*... \.\ ....  ....  *.# ....#.#... ##...#. \..# .**....   ... #..*.*#. .#.   ......# .. .#*  ...\.#
#*.....\ *.*..* # #....# * #.*... ..... ....... .... ..#.....*.* ..*...  . .  ...#....#.*\.*.. ...*.# .#.# ........#*# ...... .. ..#..#.#....#..*. ..#
# .....* .**.\*#. .\....*.#.\.... ...#*  *.   ...* . #..  \#.... . #. \..##*... *..  . ...#.... . .#...\ \.. ...... ..\.. . \  .\ #..#\.*.# ... .#  .#
# *..........  .*.....*# .....*..\...*.* ........ .***...  .. ***....# #. .# .* ... . .\#*# ..#...#.....\..... ... .   *.\.... .*.# .\ .#\..  .#.....#
##..#.\*. ... ..  #\......... .......*..\ .**\... \.*...  .. .   *.. ##*.\ \..   * . \\*. .\. .......\... *##.#.#.\ #*\\..\\* . \ . \#.*. # .\ #  ...#
#....*. .  .. ..#...##.#.....#*.*. #. ... .. .*.. ... ...... #...#*..*#. #...*.. ..\##*. \.. . **... .........\...#...*.. ... *###. .#\.. ..##..\ ...#
#... * *. .*.#. \.....#..#.  * # *....*.... ... .\..#. # *#..\  ...#.*.#.... ##..*..*..... .. .... .\.#*. .#*.. #.. #\  \ . .*........ .\...*.. .#. .#
#.\ .  .. . ...  .  ...** ... ..#.......#*\.. .. #*... *\. ..# ... ... .. ...#......* *.#. .# .* * . #....* . ...#  \.#.**.  .*..#..  \.\.. .#\...* *#
#*......* *#......# .*...*..\..*#... .* .. #.... ....##... #..*.. . \.*  ..#**##.\.  *#.... .. ....#..  ..#*. ..#. .. * .  .\... ..\.* #... .* ..#.*##
#..* #\..##.#    ..... ..... .. ..*  *...* . * . \.. ... .* #...# .## *...#... . ... # ..#. .. .*.#..*  ...#.. ...#.....#...*..  * .**.....**.#  ....#
#... #  ...* ..*... . #. .#. ........  ...# ..#....... . .. ... ...  ..\. # *#*...#. ..  ....**# . *.* . .  #...... .. . .....*#. ... . .*..*. *... .#
#..*#..#.* . .*...*....*.. \..*\.#*.#.*.....#*\.. ...**#\.... #. # .*  ........*......#...*....#*. \##  .\*....#.*..* ...  #\.#..\.#. ..#  *.. #.*.#.#
#..\..\.  # .#....\ ..#.. . #..*. ....  . ...... \.\. ..\..\..*# . *.. ...... #..#.* ....#* ..*..\*##*.. .\....\*... ...... .......... #.#....#.#....#
#...... #\.#\*  . . .\.. #.....\...#....... \ .......* .*.*. # .#\.#. .#\. \ .\ .#.....* .. ..... .. . .## .    *.* ....## * .   #. .\  .*.*. .#.  *.#
#....*.. ...##.*.*. .  ..*.. . ...***.#.....*..  .*. ........\ . .*..\..  #...*#..#\\  . . .# ...  .... *..*. ... ..*\......#....#... .... #.*.  ##.*#
# ..*.#..\* . .*. ..... ..##*..*.. *...##*#. *. *. .*..#... . ..*#....... #.. #......#\.\.*.*... \. \.#.....*.. ..*.. ... .*\## # . ...\*.* .##...\\.#
#..  *. ......\* ....*##. #.. ..# .. ...* # *# .. .. .. ..#**. ...* *. .* .*.. . ...* . .* ...... .....*.*.#......#..*##. \ ...#.###\. .. . ...* ....#
#.......*..* .#. #.  .... \..... .. #..... .  . *#  #....*..#.  .       . #*.#.*.#.##. .#.*. ..\ .*...*...... .... ..   ....#* ..**.**#.#....#..# \ .#
#...\#....*... ..#*.###....* #.....\..  .... **.##.........# .*....# . . * . # .. . #..#\.\.**. \ . . . ... ..*\ \\..\...#. *\#*....  ..\\.#....*.. .#
#.\\.....*..# .#..*.*\ * ...*.  *...* ...*........ ..... *.#..*.. .*. .***..\#.....## . .  ## *.## \ #. .....*...#*#.##.. #..#\*.. .. .\   * .*..  .##
#..  ..\ \ *. ..# ..\ \ .\...#\#. ... ...* #.*.#* ...#..  . ..#*....   . .#*.*......#... .*.**..*\\.... #.. .#.#*.#* *..\..##\ .......... #....\..*  #
#..... .  ..  *.  ... \#... ..**#..\ .*.\*.#*....*.. ..  ..\ #....... . ..\.. .....##..#..... .#. ..#\... ..\**. . #* .\..... ... .#.# *. .#... #....#
#*\  .#.. ... .. \......#.\.\ ..\... #...##.......   # .#*. .... #.# ... #.#  \.#..** .. ..#. .  .. .....\....\ ...#.#.*.\#*.#... .. **.*...\.  ....*#
#.#\ .*\....... ...#... .  \..##*..# . . ... .. ..#* .#* ..\ \.  ##.  . #. ..*....\#*.#...#*... .*\ ..##..*.. .. ..*...#..*..*# .\..  * \\ .\#*#.. #.#
#. . * ......#............\...* ..# # . ..*\.#... .#..*  ....#\ .. .*...  #...#.. * ...*.. ....... #.  #\. *....##......#*# #\.. ....  ..\#....## .  #
#.#  .\. #\  .* . . .. # .*... .#\.........\.\#..#. # #*.* #. ..***\. .    ....* *..*. #*.#.  .*  . .. . ..*....* .**....*...* *. .*\ ..\....\.. .*..#
#\*..*  .....#...... ..\.*....\  .... ...***.# . . ...\.......###....  \. ..#. \..  .  .. .. ## .*....*.. .... .  . .*..  .\#*  .**.* # ......#\.....#
##..*...... ......\\   *#.*.##...\. ...# ##..\.*# # ..#....#.* . #. ....#  * ..#\. .......*...*..   #. \..*....\\#....\ ........... .. ...*.. ...**..#
###.** .## . .. .#.#  ..#. # .....  .*.**##....# . * ..#...#.. #.#.....\...   #.  #.*\.#. *.. ..#..*##.*.\. ..........# .*  .#..*......... ... .  ...#
#.# ...... . .. ..*. ..##*# ...##*.# #. .. .# ...#.#*.  .. #...  ....*.. .... .*\.  **.. .#.*.*  .*#  .. .*. . .....  .. .....\  ##\ ..*..#..*..... .#
#. ...\*.#...  #\ .....###.#\.*#...#*\\. .........*##. ...* * ...*.... * ..# .. .* ..#. .......\  .#*## ## #. #*#. #.. ..... # ...   ..*  ....#*.#. ##
#.#.......#..... ...... ....\.*#....\.# \ .. .\\**..#*....#  ...  #........#. ....... . #...\...... #.. .....\..........#...*#  \. **  . .. ....\#.. #
#.#.. ... #**...   .\ #....#....##....#.... .*.\.... ......*...*....*..........##.*  .. .#..*.##.\..#..*\. #........  \ ...........  \#. ....#..#.\.*#
#.... ..*  .#\\ ... ......\. \...\..#.** \. ..\....#.\ .....**\.\ .. ... ...*.* ...  .# ..... . ........  ...*.. . \*.#*... .\ #....#.. * *.. .......#
#.  ..... #. .. # .. ..... ..#*#*\.....*.#..... .... \\\#..*... . #.* . ...\...#*....  .  . *.. #..\.*..*.#. . #.... .  ##\.\.*.  ..\.. #.. .*.#..*. #
#... ....* ..#.. *..*.\.. ...  ..\\.......##..*.*.\.. .  *. # #...  .#... *.\**....... .. ..* .  .... ...# .**.#.\...* #. .  # ...**...*....*.*  #\..#
#*..*#.. ..\.... .#..# *\. .*.# # .* ..  #..#..\.....*#. #. .......   .\. .#.\*....\\..... . ... .  #\ *. #.  *.. .#. ......*.......  * ....#* ......#
#**  *#.. * ..#\  .*.\..*..\.# . .. #*# ....\. *\.\.. *. . ..# .*#. . .. ...... \  ..*.\...*.. ##.* .. .#**  #...*.....#.##... ...*   .#.\.**   . ..*#
#. ..#.*\.*. *#...*. * .. ....*..##...  *...\.... ... ..\.# ##\*. ...  .* #... \#.#.. ..* ..##.\   .* ...\ ..... .. .##\ .. # #. .  .. ..**.    .*...#
##\.. .#*#....... *.. .\..*... #..... . *.#.*\.#..#.*#. .... ...... .** .. ##*#........  ....#. .#*......#.  *.   .##.* *.# #.. .. ..   .. ....  .##*#
#.. #.# . ... *.. ....# .....# \    #.**# .. .#\#.  . *.....*. .*.\.\. .*.\ .. *\... .. . ... *. .#... ..\ ... *....*..*.* ......... *. . .\.#*.. .*.#
#. . .... #*# .. . #*... *.*....... * .#*.. .. ## ...*#...*..*.*. .......... ..**#..... ##....\. *.......**... .... ##.#...\*.##. .. \. # \\##*#. .#.#
# ... #.#* . ...\..\ #..\*....#.* ...  ....#** .\..***.. .... ...*\. # \... * ..# ..##.*.....*..\..  .......#.*...## #....\. \..*#\*...*. ..# . ###..#
#**..\. .  .#.  #\ # .#....** ..... .*..*#.#..#.#..#*....\.*..... ...*.. ***.# .. ...#*...* .  \#.......#* # \.\...*.*...  *.**.  ...  .*..*..\*..*..#
#.# ## ** . .. *...*#.*. # .  .#.... ..* #*#.*.\..* \...#\  . ......*. #.*.#...  ......*.#....#..*...* .  ..* .#... . **. ... .#  ......  . ..\#.* #.#
#...\..*..**..... .....#\..##\..* #..  ..##. ..*#. . **#... ..*.*.\ . . ...... .#.*#.*.#... ** ..\\ .. ...*# ...\. ....... ........*..... ... ..... .#
# ....##..... .\.# ..*. # ..#\ ..*..\*. ...\   ... .\\.\ .*\* .  ........ ... .* ....#.. *.#  .\........ ...**.*..* ...  ... .....\.*... ....*  .*.# #
#. ... .......# # *.. .#*....** ...** ...#. **.....***#.  ..\.#...#...**    #... \#.. ..#**.\.  .. *....*..*#.* #.... . . ........# .#. ... .. #. .#.#
#..  * * .##\# . *.......*. \\\...\#*#.*....\ *\#.# ...**..*  .........*....#\\..  *...*.#...#*  # ..*... .\..\...*... ...\.*. ... \ #*....##.... #..#
#. # . ... #   ..#. *# .*#... .##.*\\ ###.\**#....   # . .*. ... .# *. #..\  * ... .# . .\*.#......\*  . ..*#.. ... \. .#...# ..* .*.  .*...#.. .  #.#
##*. *.. ... .*.. #\* ..... .#..\   ...*\...#. #.  ..*. *.  ......\...#.##* .. ... .  .. ... .#.. .# ... .....  .....*.\    .. .......#\........#  . #
#. .*. ..\#. . *.#.... * .. .# *.*  ..*.\  .....\  . .....#.   ..\ *..\\. #.#*.##. #.#..*...  *.* ......#*..*.**...... ........* ........#.....##.*..#
#..**....\.. .... #  ..**.\....# #.. . . .. .#.. \..#.. ..........#.**...... ...\.. .....*..#...*..  #*#. ......\ ......#* ....#**# . .* ...#*  ..*. #
#.#..*#... .... . .. ..*..#.\. ..\ ...*. .\.   ..*..  ...* ..*... ...**.#..*.*#.. .*. #...  \\.  ....* .. .. .......# .... .  .\.#. * ..... .. .* *.*#
#.\*# ..#  #..... .\*. . #*#...\**.* *. .......*  *.*. . ..# .*. ........... *..*. .*..\.*.#..**...*..... ...#....\\...*.......#..*..*#..*\..... ...*#
#.\..*.........#.*.....**.. ...#..* *.. *.*..*#....\.  * .  ...#\...*.  .*...... . #.. ....  .*..*.\ #. .#..*  ..*... ##*.. ....#...... ##...#\....#.#
#  ... ... *.. #..  \*. *.\.... ... . ... .\... ..  ...#.# .*...#* .#\.. #.#. ...... ..  #. .*...   .\... ..*.\*...*.. . #*.. .  \ ..#.......# #.#.#.#
#.. .....###.....#\#  .# \..... ...#.. ....**.......... .#**.....   .#... .*....*. .. ...*..* #. ... #\......# ...*.*  .. #** .*\...*. * .. #.#*#....#
#.\.**.  . *.. \ \. *.......*.#...*.# ...#. . *  *.#.\.#.*.#....*  .*...*#...# \......\.#.#.. # .... ...#\#..  #... .. ........*\.\..... ...**...#..##
#*...#* . ..#.#. ...*.....\*. \*.. .*.\. .*. .... .*..... ...##....  .#. ..... ...\ *..*..#....#.#.*  .. .# .#.#. ... \ *..*  ... ..#. # . *... .#.* #
#.. . *. \.... . ..#*..# . .#**.*\. ..      *\....*...*.... . ...*#.. .\#... .##.# .*#.  ..#***.\#.. .. .#. *. .\* ..*.......*...***# # #..  *. . #..#
#..... ...*##.#.\.....\*.........*.  ....#..#*...#..#..#.....*....*.. .*#.##..*. * \*#*..\**....\\* ..#....#... .*#.*# ..#. ....\..*.*..... ....\.\*.#
#..... ..#..**  .. ...*..# . ..... .. * #   ..#*. \#*..... \.*.*..\ .# \*....*....* .*   #\*.\.... .#. *.#.# .*. # #* .# ..\.. .*.#. .* #........ ...#
#...*......... # ..#**.#. \...*...\.#. ..*#... #... *#*#... #..\.## ...  . ......*.    . ..#...#  \.. ..\*  ...*... #..*# * #*..  *\\  \.# #  ..*#. \#
#.###. .*.. .* ..\ .\.#..\\# ....... ...\*.\  .. .......  ...#......#\..\.. *\.#  .*..##**....\.*...#** #...   ......*.....\... .. ...#..*.# .. **...#
#. .....#*\  \.# \*....\ .. .*.....   *.*. . ....* ... \ .....# ...*.. ****.*... ....* ...... *..   . ..... #...\ #.... .#.#.. *..\  ..*..# .... \#\.#
#** .. .     *... .* .. ...... . .##..* #\ ...... .*# *\ .\.....#...**.....*#.# ..#.# . \   ..*\..\..  ..  . ..# \.*. ......  .. #. .......*. #. # #*#
#.   .*.. ........ ....*   #.#... ##.*..#.... .*...\..#\... ...*..#....#..... ..  * ..*....\ ...  .*.*   ...  *.  .....  .. ... *..    .... . . .  ..#
#. ..*.  .#..* .\*... .* .*. * .#   #*\.* ...#*...#*.......*.....# .**..*.  .#  .......# ....#...*\ \#. .......#... ...#..# #...**...*.......\##.. ..#
#....... .........#... ..*.\*.. ....  ....  . .. ...*#*...\. ...\ #*#.. ..*.*...\. .*  ..... \... .##*....\.#.#.*....#......... .*.\.  #** ..  ..*.**#
# .. .. ..#.*.....*.# .....#. ...#....#...... . .. ###*.\..* #.#.#.##....#...... ..*... *.. ..#*.......# .. . *...*#*#..#. ...\#....  #. ##.*. .#...##
######################################################################################################L###############################################