#################L####################################################################################################################################
#.#..#. . .\* . .. .##.*.*.. .#...#..#.*  # ### **#. ..* .. #.. .\. #.*... * . .  ..*#.. .. .. .* ..\ ...* #\..*... .#..* ..........*#......*.*.***. #
#... #*#.## ..*.\ .... ..#....*.*..*......#..#..\... ......\. .#*..*.. # . ...#.#....  .*....  ..  .. ....#**..*.*... #.......*.. ..  ..\*   . ....*\#
####.... # .....*.*...  ... .... #.. . .. .......... ...... ##\...\..  ......  .* \.....*....#...#.*. .*..\...***.. ..#....*..*.....\##* .  . ###.  .#
#... .*..\...#..#.......\## ... ..**#.  ...#.  *. .*. .#*#.....# #. ..*.\.. #..  .  ..*#.. .*#.....*#  *. # ..\...* #.*.......  ..#*.##. *.\.........#
# \...... .     .....# *.....  ...#.  ** #*....... *.*. .....# #..#..... ........*.. .*...#. . *. .....#...#.. *  .. ... ##.... .. .## *..  *....  ..#
# ... * .# * ..*\.*..# . \#. # .##. .. .  ..    .*\.# ... .#. .*.\..\ ....... .\.*. * #* .....*      ...*........*####\... .......*#. .. *..\.....*\.#
#  ...  #. ..\# \ ... ...#.. ..#..#..* ..**.... ..# ... . ...\.. ###....*... .......* #....\#\. #\.... *. *\. .#* .....*..#\. *#\ . .  *. *.... ..\. #
#...\# .. #...\.. ..# * * ..#.#.#.#... . ......\.*.*\# \ ..... ...#\##**.*\**\ .*. ...* .#. ..  ##.*# *...# ......\.\..##. #.# #.. ..#... ...... . #\#
##**\. \..\.. \ ....*#. \. ..#... .. .# \\#.#...... ...#.... .. .  ..#\..#*...\.... #...#...*... ..\\.\\*  *.....  .. ....*.. \* ..*. . .. \.*.#..  .#
#... ..  * . #*#.. .\.  #.. ...# ...   #....# .#..  .**. .\.... .#. ... * . ..*...#  ....\...\.*...... ..\\..\\ . #*. ***.\..*.....  .. ... .**......#
##.\...*.*..*.... .#.. ..* ........*.#.\ . #..  .. .........**... .#... ..#.  .\. ... ...\ ....  .....* \#.....*..  .....#......\..***...# *  .. ...*#
##.* *.... .#..*.\#. ...# . .*.  ....#.*#..*......  ..*..... ...*... .*.#... .  # .*\  .  . .*. . *  ..##..\ ....# ..**\.#.. ........ ....#. . ..# . #
#. ....\.*.**..... ... .*#*.   # . **#. .*.. ....##..#. .\    \.#... ...* . .   ##* *\..#.  ..#\.#..#.  . .. #\ .... #.**...\*.*.. **. .. ...#.......#
# * . . .#...##.#*##* . .#  * ..... ...  .. ....# *  .*..\... .#....... .*#.  .*...*. \. .#..*\. ... ..\....#*. ......\\.. .*#. . .*.*.....*#*..*... #
#.\..  *.*.....*.    .#*. ....#...#*#  ...\.* .  .. ....\ ..#.. *....# *.\.\*\*#\ ..## ##.R... ....  ..#  ..* ...* *\...*#............ #.\...#  ..\..#
#.*  *..#\\.   .#  . * .* .. .\... \.* *# . \..#..  .. ..... .. ..#......\ .. ......*#.# ..#.* ....  *  .  # *.. \. .\ ..* ....**.#.*#..#*.#........##
#*.. ..   . # ......   **\#\\.. .*.*.#..#......# \  *#.... ...# ..*  ..*.*...  .#. .....  . ..........* . .. #.# ..\ *.#.... .*....#  ..... **. .. ..#
#.\#..*. .* ##..*...*.... . .\#\\#.. ..**........ ..*..#.. ...#......\...* .##\  #..*.*.... ..# ...\*.# .....# ..#.  ....*  .* #...*#............\.\.#
# \#...   ..\...*.....#...*#. .#* *. . .... #....  *####........* ..*#*\*....*.##.. ...  .\\. .#*.   .\.#.\  ..*.........* .*....#.. .. ..  ...#...  #
#*# ..... .#.\....#.*. ..#.*... ........# ....\  ...... #. ..# ..\# ... .*  # **.. ..\.**.......\ *. ..#..*# ....#*.###*... .......*\  . #\*. .... .\#
#.#. ##*....#* .....#.*.*.* ......  *.......\.. *.*#..... .. \ . .*.. .*..... * # ..#. . *.\*.. ....... .... .. *.*..*..  .#. .......# \..\\*.....  .#
#.......*\.#*#. ..*. .** . ..\. . ....#..#.. \... .. #  *#*.* . ....... . ...* .........#.#.# ...... \ .*.*\\.. ..#.. ..\#*.\.*.....*. .# # * *.*....#
#.\ \.. ..*..#. \*.*.**.*.#...#.*....#..  # ..*#*..*........# \ *... .\.#..*.. .*.....***......\\ * .  .\.#*. ... .. .. . *....  .... *.# #.....*... #
#.. .. \.  ...\*.\\..*...#. *...* .. #.....\.*. *\.# *.\ *. *..#.\..\* *...* ## ..* ....#***.# .. .*.*. ....#..\  #...#*\.#\.#..#.**. .*....*##. ....#
#\..\* ......#......\*...*.##...\#....  . *....#... # . ##*.# *  ..# *.**#......... ..#.#** ...\...... .#.... .#. \ .....*#.  #.....#*.  \  .\ #.*...#
#..#  ....*....#.. .*.# ..........#... .*  #. .\  . . .*#.#...... . ..   . *\ # ..*..... ..#... .. . .#\...*...* .*#...#..   #. .*..#   ..   .*.. \..#
#*.# .*.#..\*.....#.. ..\#. ..* \.\..#* ........ .. ....* #...\.. *..\.. .........#...#...*.*.*#...#. #... ...#...#....#  ...#.. .... *... .# #.. .. #
#....\*.#.\.*..#\*  ...  .*... *.  #.#*...  .#. ....# .# .#.* ....  . \.... .. \.. *....... ...* ..# .. ....  * #...  *......*#........\. *..... ... #
#. * . .   ... ....#.#..\..*\.#. . ##. ....*\*.... .#**#\  #..\##... \#.*. ..#. * ...\.. *. #.# ..\ .. \.*.*. .*.*...#..#.... . ... ...*. #*.\..*. .*#
#*.....#..#.. \... #  .#...*#..\. ..\#..... **# # .. .. ....  ...*... .....# .  .. .*. ...  ..\*.. .  .....*.# .....\ * #..##.#*....#..##.\*..#... ..#
# #. \..*..  * ....  .*..*. #..*...  ..#.  .....  ...*.. ..*..  .\ # .......#.*  .....*. ..\.. ..#. .. *.\....\.\.. ...**\#. ...  .... ......  .# ...#
#......#.#.....###  ...  #.#... .\#  \ #\* #.  #.* ..# . ... . *.####\  .. ... .. ..   ...*....*.... #. **.* .# * .*.*.. *#.. ....**... .  *.. . .*.\#
#..  ..*#\.. .##. ** .. . . #  .... #. *.#..#......\*... .  ..\. . # #.......#.## .* ...\*.#. \ ..* .. ...   .. \.  .**. .#*.. .#\  \.  ..\ *\. **...#
#\.\. * # ..*.... . .###.#.#.\.\\ * . ..\#..*. #.* ..\.#  ..#..... ....\ .... .# .. .. .\  \..#  ..#*\.*.. ....*#.... ..*..\.#. ...# ...#.\..........#
# . .. ..* .. .**#..* **....*..\*.* *\....... . .....#. \. * .#*** . ... .. ...#  * .... .*.*\.*....* ..#. .. ..*##.# \  #.#. .#.\*\...#.....\ .*.*#.#
#  #.. ....*..\ *#... .# *..#..\ #***.#..*. ...*..*...*# .*.. .\. .#... ... . ..#  #*. .......  *# .* .. \   \.#.. .*  ..##\.\#.. *. . . ...  ... ..\#
#*#...#  *\..#.*.... ..*.*#  #.\\.. .*...... .#. .  .#... . ..*.*. ..# * .*\  # *..#.  .. \...* ....*...#...\.. ....*...... . . ....*.....*...*....\.#
# ....\.*..#. ..*.. **. #..# .*...*\.** *.\....#*#.  .*..* ..*   \.... ....**...# # *.#... .. .. *...  .....\ .\#.#.. .*##. #*... ......\#\...##..##.#
#.. *#.*....  ....#*...  ...... ..\*.  . .#.. \*....# ..\.*  .    .  *. . \*\.*... .#.  .#....#.*.... .\......... ..#* *  .. ... \. **.* .#...\ #...\#
#..... ....#   ..#.#...#.....   ...* #.#..... \.*..#\..*...#.#. .# #.\#.\ .   . ...#.#.\. . ..*... . .......##.. . .#...\*. ..#\  .*..*......  . #.. #
#. .# ... *  ...*.  ## *#.#. *.** .......*.*## .**......*.. .# *.. # . ... ..*.\.. .# #..#..* **\\#.*.##.#. .*#*#.\. *\*.#*.*\.\ .*.\  . .#.*.#* . . #
#*...*.. .*\. .*...\..*.  ...*.\.... ...***.*#\#.. ..\ ..# #..##.*.\..*...\#. ..#... *# ......... ...   ##.... ..  ..**.#.\...  ..*#.......  ***\*...#
##.. ...#.\#.#...#\..... #...\ .* ..*.\..... .#.*. .....\\.. *.\. . .*........###...# .. .** ..#..   .*#*\\ #.\.# ..*....\..   . ..... . .** #  ..*\.#
#.\.\.\#*.#.\. . *.. ##.  .. #. *. ...#.. . .*.. #.*\ .*..*    *.......#.*.....#. ...#..#  \ #**  *....#....*.. *.\....* # ...#..\  ...#.*** *\.#.. .#
# .*# .\...# ..\ \... .\. ... **..#\..#. .... #.# .#..#* ...*.#.. ..  ..#.# .#. ...\.# .*\.*#\.....#.#.. .. ##*.\\....*.\..#....*  ....#  ..#..#.#..##
#..* ##.\.*.#..... ... ...* ...\. *....\# # ..#.. .. . .\\.. . .#...... .. .*#.  ..#.#....#. \* ..#.. #. ..* # ....\.* .....  ....#...*##..#   *. .*.#
#..\.*...\ .**.\ *...# . .\.. ......   ..\\\\*.*......\.#.\#.**. ....#..\  ...#*.*.  \.#...#......  \ #  .\\..*.....#...\...*....#..#.... .#\.. .*. .#
#....*.*#.#*.#.*.#  . .......#\ .*. .\. # .*.\ # . .\.. .* * .  * \.... *\. .*.#... .. .......#.. .. .# . ..#*.  .. ... *. ....  **.. .......\*..#. *#
#.\. .##*....#* \...... ..  .. ... *. \*. ...#.*.#...#*.*#\. .*.#.. *..\.....#... ...*\.*... ... ..#. #........ *\  ..*..* ....... *. .* .\. .. ...* #
#***.#  #..#...*...\*#**.#.. *...###.. .. .*#...*\*.  #....#* *.. . .\ ..    #... #... .*. *...\. .  . \#\* #..#.**. \*.. ....* #.\ ..\.#...*. #. ..*#
# .#...*\..\... . .## .....##*.....  ....#..  .* .* \....\...**..##.. .. #*.*#.. .....  #..#.*#.*. . .... # . *.\*##...* *.\ #..#..#..*.#...  .....  #
#. .#*. ...#.....\###.#.* .....#... .. ..#. .... *. #.. ....#....\#\ ...*.....   *#.# * ....*.*\.*..... *....#  .   #.\. .......\.# *..* ..*#.\.#*.\ #
#*..*....##..\\...  * * ...  *#...#... ...\ **##*#. .. #.##*# . . ...****#.......\. *....#*#\..\.... #.#..\.\.....  ... .. \.........*#..\....\.... .#
#. .. #..*****#\# ... #. .#   ... .....*.....*...# . .....#...##  .** . .*.#*.* #**#.*.#**......\.# .#*.. #*...\........* ...*..\\......*..# ##*.. ..#
#... *.*#.  . ..#...\.*.\.... ..*......#..\.* ..* *.\  . * ..*#  * .. .*...... *.....*.#**...* .*. ..*...*......# ##.*#... ....... \\. *.\ ..# . ..\.#
#...\..\ .\  .. #  .*.  ** . ...  *.  *. . #. *.. ...   ..\\..**#  .\ .....\........***. .. ..*...#.. .#  . ...\.\.*...*.*.\ #. #\.*.* .*##..##.# . *#
## .. ...\#... \.*.  . ##.... .## .*.## \..#. ...\...#..*#**.*.#...\ ..# ...  #.#.*..\..*.*#...*#...  . .. ..# . . .. #.#.....   ... ..\\... **#...#.#
#. #  #*\   *  . #..... *... .*  . .#\.#....#.... \#*..*.*.*.#.. *..*... * ...\.. ..\. ..*... #..  ...*. ... ..\... .....**.*... .....*\ .....*.\##.##
## .....# . ......#\ .*.* .#. ...* .*. *... #. ..#  .. #............... ..#.......*. . .. ...#..#.......#..... *...  ...*. .* . .  * #.. ...*. .\..*.#
# . *..* #..*..\## .**\..*\.**# ...\ .\...*...* .*\..  ... .*. .*..\.. . .# #   ..**\# * ...*   .  . ..\ . .\. *# *. .    . .*..*....\.. #.#*##..* \.#
#.#. .....#.*\.. .#..........*...  ... .  ....##*. .*... .##\\#...\#....*.# *.** \ **.......  *..#..  \..*... ..   *... .#* .*\ ....*...#.......#... #
#  ..#...... ..  ..#.#.  ..... . .....#\ ... .....\ .*.  .#......  ....*....*  *..#. ...* .*#..\*. ....*.. .. ..#......* \\. ..*\..#.. ..**  .#\.  #.#
#*..  .# ..\*..... ...** .#.#.. # ##.\ . \*..*#* . .....#\.\\ \............\. *. ..\ * .** ##....#*..\. ..*\.#..*#*\    .#..\..**.. *...#..*\..#. .. #
#  *.. ... \.... *.#..*#*  . \  \  #.*... #. .##. *... #... ..... . .. #.  .\..**...\......#   ##. \..*........  ##. #. *.** .#...... *.*...#.\.\... #
# *..**#.#.* .\..\\.. .. ...  ... . ....*\ .... .....#.#\.#\.\ ....#.. .#.\... ...\#* ... .#. ..........*.\ . .. . #. . \*  *..\*#.... .....\..  *.###
#*.*#  . .... \ .. .. ... ...#* ..#.#. ...**\ .....\.. .. #. *##..#*.\..#. \  . .. *......* ..*#.*..#. \#... *... .. ...\*# . ....*##*..............*#
#.. #.*\. * ..\#. ....*...*. .#. . . .#   . ....#.*..#*........#.... .......#.. ......*.#. *.# .* ... ....#..*. \.\.* .#.. ##. .##... .. .. .*....*..#
#* .# ..... .. #..#... .*.. \...*.* ..\\#.... . .*...# *..... .... .........#..\#*. .*.#\.  ...*. .# * .* . * .# *. ***. ##*.*\  ....\\..#..\  #...*.#
#  ....##..#..*#....# .. ...*...#.*....\..* ... **....\. .....#\ *. .#*.... ..**.# ......#\.. *.\.\.*.. ..* ....#. ..\ . .# .*\ ....*.....\. ..... \.#
#...... *..*..#*.*.\. ..\ ..*#....\..  .. .. ..*.*** .# .. *...*# .. *. ...##. .. .  # ...... .*.  .. *.\. ...#....*...*.. #.......\ ..*. # ..*.# * ##
#*#..... #..\ ...\ . .*.*..    #\**\. . .. .*.. . .... * ...#.  ...*... ..#...* *... * #. *.\...#... ...*........#.. ..#*..... \*.\..*# .. *\\...... #
# ....\...\*#..##..  .  ...\#. ..*. \ .  ..  \..*\. \ *#  .\. .....\.. \...... ...\. ..*...\*.  .#....... .**.. *.. ..##..  ..* .....*  *\.\....\\.. #
#***... #.**.. ..*.. *.. ..#... #.. #.  * *.*#..*. .... ..\#.*.#...*.#\.*.#..#.. ..* \ ....... ..#...*.#. ... . .*\...\... ..# .*... ...*  .. ...\#.##
#.....*... . ..** .  . ....*# .*.. ..*\....#. ........#. ..#..*\ *..#.#*.   ....#.* ... #.*.*. .# ...*.*.  .. ... .*\#*.*##   . \..*............. * .#
#. #....*. .* ..##.*.\....*.. .  #.....*  .. ..# \.##.... .  #..# ..## .. .*# #\.....**. * .  .\.. ..#. ...   #*.\.\* ..  ....#.....\. #.# *..*..#*# #
# ....#.*.    ......# .....\.#.. .# .\* *\ ...*  .*..**.* #  .*... * #*....\. ..\...#..*..  *.*  ...\#*#...  .. ..# .....#.#. * ..   . *....\#*.** ..#
#* #. .. .... #\*.  ....# *.. # *....\*\.... ..\ \. #..... . \..\ #... ..#\..*\..**     ..*\.. . *.#\.*  ..  .#  .....*..\.#.*....\.. #...#..#.......#
#.... *.. *...* .*.*# ....  * \... . .# ..# #.# .#\..*#. .*.  **..#....*..#.\. .\*\*..  ... ..* ....**#...**.*\*#..... *.*...  .#*.....\.#*. # .# . .#
#....  .#*...* ..** .#.......#.. .#*..*.. .*#.  ....#. .\.* ***.\ *#*....  .\... #.... ..*..*.. .......#... ... ... .\\*..\. ...* .*.......*.#..#.\..#
# ..###....*..*... # .#.#...*.. ...#.*..\.#.*#...*.. .#.... \.....# . .. \ ...\...  . ...... .. .... .\..# #....#..*... ...\#  ....# ..  .#. #\..*...#
# ...*.*. #..#  .. .... . .#  \..... *......*...   . *..... . # . \#.**. \*..\.*.\.. ... ##.. . . ..  #...*... *..**.#.\#..#**\.##.   . .......\... .#
#.. ..#..\. ...\ *....\.. ***. #*....**#..*..*..#........*. ....*\ #... .. .#\..\..  ....*. *\#.\\*#\...  ...#...#.#....\ *. \.. .   ........* ...#.##
#.#. .. ...*\ ..#....*\#. #*...*.. #...*.* .#.*..\.\.....#. ..\#.. #...*.. ..... ..*.  \. ..##\.. . #  .. .# . .##....*.. .. * *.....\.. .  .##.* .* #
#..... ..*....#......  #.... .#*.\. ...\... ... .  .. .. .. .\......  . .* .  \ *.. .  \.... ..# .** ....#*   .\.*.#..  ..#\ .... .   .. *.. . .# ...#
#......#.\*...#.\. *.  ... ..**... ..... \# .. .... .*...*# \... .\##.\......*....#..\#...**.. .#  ..  #.* . ..*.  *.* ..#.... \*.#\.# #. * .......*##
#.#.# \ ...*##. .#......#... *.#.....*...# #*. #*... ..*..#\*  ....\ . #\  *.#.. . .#. ..*\... ... .. .... # \#.*   *. ..   * .#*\ .. .#\.#.#. * ..* #
#*..*..**.. . **.*\.# .. *...# .**#...* *\...  ... *.\..##..  #.. *#..#.. ..\ *..*.. ...\..**..** .   .\... # \.*..*#. .... ...... ..#.... ...#.. *. #
#*.* . . .# .\#...** ..# .*. \.. ..*...\ ...# ...#.*\.\ ...  ....*.*..*.... .#. #....#.#.#\  .... ....# .*.....*.....*.........  .## ...  ..*...*.  .#
#*\\#.#*#**  ..#....#..#.*  *.\... *.. .*\.#.*.*.#. \....*.  .. #.*\\*\*.*#*.... ###.  ....#\   #. . ....... ...#.*#..* . .#. . ...\** ... .....*. \.#
#......#...#*..\\...#. . * \*.#**..*#.*..*...\#... #...\... ..... .... . ...#....*..#.* \.\. #.....* . #. *.* .\ .* * . .\...# ..#....  .. .#\.#.##..#
#*...*..#*.\......\....# ....* * *... ..#...\..*...\*#....* ..*...*.. *.# ## #**... * .\. *  .#..*...\..    ..  \*...\......##  .#.#.*.*.*.....*.... #
#.* *  \...#..  .#......\ ..#.. .* .....*......\.*.. # .*. . ..#\......\.*#.* #.*..##  .....*#. .**...\. * ..*..\...**..*** #..  ...#*.#..**. ...\*. #
#..*.   # .#...... .. .  #.#...  ..*.  ...*....\.#.. ...*..*.. ..... . *... \\##..\.\# #.... .\ .......* ..*....*##..**. .#....... ..  ....** . * ...#
#*...**...*.*#..\ ... .*. #. .. .*..*   .. *..#..#. .* \#.\.... ..  ..#...**.. .*. \#....\.. \..#........*.# ..\...*. .#. ... .... ..\ .\ .* .. .....#
# .#...  .  ..... .. .. #..#..# .. . #.. . .*.  ...*... ....\\....  .*......#.  .....*# # #. . ....*##..#..\...* ...... .*\. .*.# .#...*. .* \.  . #.#
#. . #.. .*..#.. .*......... *.........\... . #... \.#...*. # ...  .#..  ...*.\.. * .#....#..#.....   ..\...*. .  *  *.\ ...# #\. .#...#.* .*.. *#\*##
#.  . ...*#... .# . . .#. .... ..##.# ...#..*..# \... #\.. ..*..#. ... .*....*.  #\.*.*#.. .#.....\.... .  *\  .. *...# #....*.**.... *  .*\..##.#.**#
##..... .* *... * ..##*.#.*#... ...\ ***#.#...  ....#.......... ..*  #..*... #...#  #.# .* \  *..##*. *.*... \ ..\ .. \* . # ....... \  ..*. .\\#.#\\#
#. # .\# .*. . .#.. .....\....  ....*... *...\ ....  .**...*..... ..*...#..  .  . ........*.#.....  . ..#.. ...\...\.. . #......*...# *. .#\.#*.*.*. #
#.... ###.#*... ..**........ . ..#** \... .*..   .*# .*   \  ....*......#.*.*.*.#*\ .# ....* ...\# .......\. .#. *. **.\.. .\... ..\. #..  .   . *...#
#*... . *.##.. .**.#  ..#..*.* . . ... * #....**.*. ##...**..#**. \#......*#.  ... .  \.\..\......*.\.*. ..**  . ..*# ...**.\. ..*  \.*...  #.... . ##
###*\.*. *...\. .\.#. ..*\ #..\  #..\.# . * .\*#\... ... \.*.. # .#.\..... . . .  ... \#\##.......# .#*.# *..##*#*.*  *.# .. ..........\ ...... ..* .#
#....#  ....  ..#....\#.*.*.\. ...*...#...... #.. .#... ..\.*...... ##\...*. .\ ... ...  ..# .*.# ......* ...\.#.. . #....\.#...\.*..... . .\   *#...#
##\.  #..** ... .\** .# .#..*. ..##*...*..* #..#..   .. \............ *.#.\. .......\.#.* ...# .\..#......\...\#*. .*## *  ..## *.##. ...* *....#.*..#
#*..  .....#**..#.*. .....*.... ..*\... ..\ .# .. ....\* . ...*##*... .. ..... *.... *#...*# ...#.... ....  *  .. ..*#..#. *.* \ ....  # .*.*. . . ..#
#...*.. .\. #\..#... ...\...# . \  *...#. ... .*.#...*  #  ...##. ...* **.....#.... *.   *.  . .......#*.#..\.*....  . ...  *\ *.  \. .**... .#*...#.#
#.....\#..* ..*#*. .  .*.# .\***...#......*..  ...#*. .# .... \..\ ..\ .\#...#......\... .. *.. .*#.... ..*.. .....#..# .#   . *\..#*  .# .\#*..... ##
## *... ....*.#....\. ...  \...  ..\.#  ..# \ \...\.#.....*..# * . #* .*. .\*#..........*\.#... *. .. *.* #.*.\ ....... .\...*#.# .\...\##.......#.\.#
#..# ..... .# . ..  *. . . ..##.. ...\....... .# ...*..  ... *# \    .\ .*... . ....... ...    *...##. ..\ . .. *#  ..##\. ..##.*..#. .\.. ....#.*.#*#
#.*..#... ..\*...#.... . . .**. .**.. #. ...*. *.. .#.###. \.. ... *.#.#. *. *..* ..  ...#  ..#.*..   *.     . .. #. ...... .. .*. ... #..*.#.\.*...*#
#..*.. . ..*....... #.  #......\ .  *...\ *\#..#**....\.#...\.. #. ..  *# .##.*.. \..#\*..* ## #  .. ...* . .\#. .\*#. ..\...  #......  .. ..# # .#..#
#..*....*..* .........* .. .....  ...*. ...\.*#..*. \ .#*.\. ..\#.*.*\.. .... . ... \. ...#. .* .....\..# ... .*. ..\.... .\  .  ... ** ....## .*..\.#
#..... .*...*\.. ...#\.*........... .*.##*....*.. .  .# .........*.. \#....  ....*...*.#..#*\.*..#*#\.. ** .#. ..#..... \. ... *.  . \. .#..... ...#*#
# .\#.#.*.. ** #*....#. . .* *.*..*...  .....*...#..\......  .... . .....*. #. .... ..#.........#..*.* .*..* ...*...\  ..*.\*..#. .. . ..*..* . #....#
#.*..\\.......##*.... .#.. . . #.*...*\. .. .. ..\. *  .\\   . ........... .#.. . .... .... ....* ......#*.#***.\ ..#.. .#. #.  \............   .. ..#
##.. .#.* # .. ....# #.#..# #. ....##............. ....*#..\........ *.\. .\...... *....##...*#.......*.  . .\ .  #.* .  .. ..#*.....\.\ *....*  .#. #
#.#. *.  *#... #\*.*...*#.... .*\ #..#\. \#.\...*.#\.*\..*.# ..\.###....#.....##.... .#..*  ..  *.....  .*.* . ..\.#...*.. .* .*. \. .. ..*.*\......*#
#.     .\ *.\. #  . .....*#......  . ..... .\  *.#... .. .#....#...# ..\   ..#\. ##.#...  .**.....*... # .#.#..***.# ....# ... .. . ..#... #.#....  .#
#.# .. .. ..\........ .....\. .*..#..*....#.*##\. ..*...  * *.. . * #**\ *. ....#.. .*.##.. *#* .\.\..... #*....  *.. .*..... *.. * ... .*#   .**..# #
#\ *.... . . * #*... ..#...* ... #** * *.. ......*.... ...#....#\. .....## ## ..\.......  * ...*..* # . .*.#..\. \...... *..#...#.   **... .**.. .. .#
#.*..#..\. *..\.....  #..... .* .. .*... ..\.. #.**. .\.*..*#*#.#. *  .# .  ** .......*..#.*.. ... .*#..*...\ *..#.  .#. *#.#\. .......*#*.. . .....##
#.\.\.#*.## . . .... .*\  ... . \##.... ..\\## ...*... ..#. \. ..#......*\#..#.*...  \..... ..  ## .. .*\.*....* . ## .*\....*. #.. .#....\#.........#
#**.. #....*..**. .* ... #..#** #.#*..*  . .*. .....#... . . ..* .. .#.. . .**.**# .... .## .\.. \#.\ . ... ......*\...* . ...*#*  *.*. ..... *... ..#
#   . #... ..*\.*. .#... ...*...#\... #.... .... ..... ..#\ ..**... ..*..# #... .\*.*.# \\...*  . .. .*.....*\*... #.  .\. \ ..\\. \# ... . .\*....  #
#...*. #...... . ...\. . .  .  #.\ .# ..*#............*.# #  .\ .## ....\. .. ...*  ##..... #..## .#...... .*.....*...*........* *..\.... # ..*.... *#
#.\... .... .  .....*.\ ...*.#     *\\. .#..* ..*.. . .*.*..*... ..##*.**.*.#...#.  .  #..#. .. .\*.. ....   .#....  ....... .... ..\*#...#... ..#. \#
#.*....# #*#..*.....     .#..\\*. .....  ..#..\#.. #.   #..*.\.. ..... ........ .......  ....... #..**#..# .#.*\* *.. ...*  .........\. .#.*. ..... .#
#.. . **# *. .. ..*.....  #  ...*...  .. .#... .### ... .* .#* .#*.. ....\...**.. ....*.. *\.\ .##*...#. ... . .*..  *\... .. ..#..  .\ ...*...#.....#
#. #.*#. .*##.... \...\. *.#.... ..#..\*............  *  \.*. ...**  ....* *... .*.\.....  *. ...*..*.... \*# .. ** #. ....#.#. .......# \.  .. .. ..#
#*\\\..* .\.  .*....  ....  .#. ..\.........*.*.#..# ..  .# ...#........  ..\.... ....*....#.....  ..#** ...\. ..  ..\...* .\.....\.*#.. ..*# *....* #
##\.  . \#.. .\.*#..*.*.\....  ...#.\  #. . *#...*. .\.. *#....... .. #\ ...#..... ...*. .#  .. ...... . .*...\ . ...* \....*. *.#**. . \*...  .*  *\#
# . .#.   ..*.**# ** #.. .\#.#*\..#** ..* *. ..* ....\. \ ##.*.##. ....*# .#..... .\.*. ..  #\  \. .\#.*.*.**.\.# . . ..#.\*... *.... .##.\#..*.*..  #
#.*#..... .\.*.   ...... .*.\.\ ......*..    *...#...#. ***...\  .*.*....\. .# .......##.\.\ *** #..\ ........*#.......#....  #.*........#. ...\.....#
#..#  . ..*\... .#*.\.... #.\.*  .#*..* *.... ..*...\#..\..#. .#.. .. ..*...*..#.#\..*# *.# ...# . . ...\.. .  .* . .... #.......* ... \*..# #*...#. #
#...#.# .*#.. .....#.....  \ .*##*.. #**..\. ..  . #  ... .......\.........##..*.  .. ..**....*..#\.....*#\.#. .**..*\..... . .*.. *....... *..*.*...#
#.. .   .\.*.# * .*...#....  ..*  . .#.. *... ..... .*...  ..*\..  ..\#.\.. \.......\. ..*\. . *.#\......# .#.# .*...\ #... ....#.\#*.  .... .\#. ...#
#  #.*...   \..#..** .. ..\* ....  ..*.. ... .. .............#*...#.  .#......\..*. ..\..#...#..# ..*.......\.\  .  # # \...*..#\.\.. .\#.. .#.....*.#
#.. ..\. *#....\ ..*  .#\. .....\..   ......#..**..\ .. ...*# ....*...#.. ..#\.\ ......#.. *....#*\ .#..*.#.....  ....... .*. *#.* ...   ........... #
#.#\.... ..... \.*.#  .*...  ......*##. ....\.  *. ..#.  #.#.* .....*.. .  #. *. .. ....*\.# .*#.... .... . ..*.#... ...#. . .  * . .. .\* .*\......*#
#\* ..#.*... . # *...\. #........\......* ... . #....... . ...*...*#..... .#.*\.. ......  . * ....**. *.. . *. .*....\\ ... .\\*..#*.#..#......  .*.*#
##   . ...*\. ...  *#.\*.. \.*..*#*.##. ...**.*...*. .. .#.##..*..# **#.\.*... ...*.*.*  #..   \.. .*# # .  .* ..#...\\........  .... \# .\ ...  ....#
#....#. ..###  *... ... .\*..... #...\.#.\... .....# . *\  . ..........## # #...\ ..#. \.*.......  ...#....#..\ ...... .*.*# * .... # \.*  .*..*##\..#
#.  . #..*.......\....#... \.#*#..#..#.\ .. .****....**.... ..# \.*......#.. . ... ....*# .....*.#.#..#* .#..*.\...  \. ..**..*.......\*... . .#..*. #
#...\ ...#*.#. ..... .**...*... ....*#... # ....#..\#....###. .. ... .... ##....\# *....# #...*....\ .. ............  .*# .* .#.\.#...**\...**...#...#
## .#.*.*.. ..  .........*.... .... ......*..\.. .*.. \*.  ## . *. # . * ..  ..#.##*  .\.. ..\*..*.#*\*. ..  .. .#..#..........#.. ........*..*...*#.#
#.. ... ...#.\ ....#. #.  ..... ..... .#.# .# \ ...\.......# ... ..*.##.....## ..# .\. ##....# .#... . ..# #..... . .*...# ..*... . **...\ .. .**. .*#
#.....* .. #.. .. ...... ...*.  .*.. ... .#.   .. .#... .. *...#...*#*# *...*..\*# .# .. .*#. ....  *.\* ......*........ .....#.\.\...## ..... .##...#
##*  \ ...  *. ..#..# .*..#.  .\.** .\... ..*\...\*. \.. #.#\*#. *....#.. . . **\ . .. .....*..  *.#.. * .. * \. # .*.#......#...*.. .. #*....*.. #.\#
######################################################################################################################################################