######################################################################################################################################################
##...#\..* ... .. #... * *  .... ... .... #.. .*.#. .*.# .#*..\..... .. ##..\..* ..  .\*..*..   .\#..\.# .***...* *.# .*.... ..#*\\#..**.. .#.\\* #*.#
##..#..*.# .\..#.*.. .. .*....##..#.# . . \#.....#. ...*...  #.#. *\.. ...*....\ .\*.. ..  .# *.....   . ##. *....#.........  *#. . ........*  \ * #.#
#....*#..\# .*#\*......* .. .*..#..\ . .\..#\.#. ...  .*  \#  .\.*. .*#*.. #. ...*....\ ....*.....*  ....#..#* \......\.#*. ... \. ...   ..*. *#  #. #
#  .#..... .#. ...**...*....*.. .#. .... ..*..# .##...* *..... * ..#.*# *  . .#..#......*.*..*.\ *..    . *\\....#.*\.*..\.\# *.R . #.*\. **.\.*.#...#
#  .  ...\... #..**. ...\ ..# \.. *..\.  ** ......#* . #*........ ....  .*\.  .\...*.##..   #*\#\.. \....\..   . ...\..  #.. .....*.\.* .. #. ...# . #
#....**\. ..\##..#.. .........*.....*# ..#..... ...***#.. .*\.# ..  .\\...*..... .**.. *..  ... .*\..*. .*.\.... #. *.*.##* \\.   .. .. . . \*#.  \. #
# * # ......#..#..* ..   ...\.. ..*## . .*.\...\ .** .  .  ...... *#.\#.. ..# #   .#.. ...*#. .   ...#...* # ..### ....... .*.*.#. .* \..#..  *\....\#
# \.#....... *#.....# . ...* ##.... #.#* *#*.##..\.. .#   .. .*..*.* \..*..*..\\ .....* ..#.*.\....*.#\#  *.*... * ##... .....\ .......  \ .*.\..*...#
#.. .  ...# ..*. \..# *.#.. #*.\* ...#.#.\. #*.#..#. .. ..#.... ...\...# #. .   #*..\..*.\....*..*..*... ....  .#.\** ..*.**. .  . ...\.##..*# . . . #
#.#...\ . ..* #...\...\* .*.#.\..\..\ *... .\.#.....*..* .. .*. .. .\.#\. ..*.  .... #.\* ....#..\. ..........  .**. ... .. .*#..... . ..... . #. .###
#..  #  .# .#\ *.# \.....#. ..\*.. ..#... \*..#....\.*....#..# .\. #..# *#***..\ .. #.  ..# ..  .\*.#*.  .** . .... .# .***...*  .# ..  . ...# \...#.#
#..*#...  . ..#. .\..\.* .... *  ........   **. ...**... .*..... #* **... \.  .* .#.*..#. # . .  .#...* . #.#.   ....# .  ......#  ... . .#.....#... #
# #.  ....#..  ..#..##.  *.*.  .*.*. . .\. **...  ..... **#.## ... ... #.*...*\  .. . ...*.*\.*\*.... .. \.. * .....  .#. . ..#*\#*..*# *.*#... .  .##
#..\...\. . #.......\\.\. *..##. ...#  # .#.....\........#... #\..* .....*..  *#. .\.  ..  #* ....*...*.#.# . .... .*........# ##\....... . .  ..... #
#. *..#.....\..#..*.. .  . ..*#.... ....*  ....#.\#. *.. ..#.*......... .. .  \.#.... *...#......##.# ..*. .. .\ .  ..\.......*.. #...# *. .. # #....#
# *.#...\. .  ....\... *. #.... ...*  **....#. ##.\*\..\...... .#. . .....*.... *# ..* .*.\*.....\. # .  . #. #.#*.#.#..\...  ...#\ ...... .. *#. .#.#
#*...*..#.#... #.*. . .##\*... .# ..#...  *...*.# ...*. .... ..#...##......*#\.. .#  \..*.......*.....#.  .... . # ...\.* *#.. \. ............**#.#..#
# ...#.. ........  . *.*\ ## .*#*.\.....  . # .. .*.\.#.#*# ...*  ......*..*.#  \... *.....#..*...#..  .*. ..*.*.#..***.## #.**\ *..... ....*.\#.... #
## .#. #.#....*   ...... # *#..*.. ..\.#.. ..*.#......\#**.# *.#............*..*\  .\* ..\.#.. .#.  #.*#. * .... .  .#.... ..*. *..# .* .. ...* ...  #
#. ....**.\.....\....##. . *....*#...*#  .......#. ##......\*#.*.* .. #.\ *  #.*# *.*.* .. .. ..\#. ....\.  ..#...#..  ..#*\ ...\...\.....#..#\ .....#
#....  ...# .# .*.**##..**. .  \ ... \. #.. .. . .#.. *.  #...#...# #. .. * .#\...# ..\\ ..**.*# ..**#. *#\*.* .....\.. ...#*...# # ..#....*..    ...#
##...* ##.. . .\.*\.* \.....\.. .. #.*.*..*...**.*.. ..#  .....# ......##.. .* .. ... *.* ..#.*... . ... ##. .. ....\.*.. .*\   **.#** .....# .*#....#
#....*.  ..... .... .#.. . .*#*  .*.#.* #*..\..  .####..*#**..#.\ *.*..##. . *.........\\  ....#....... .#\*\.... ..  \....# *.*.. ..\#..*...\#....\.#
#..#....#**.... \* **   . . *...\\ .#*. .....#*#.#. .* ...... .. #.. .........#.*##....**#\ #.....*#.\.* *\ ... .....#....#*# # ... .....#.\... *....#
# #  \*.** .. ..\..\.........##. . **. *.  \...*  ...*#. .*. ..  \. * * ..##. ..#.#\\\..  #\. .*.#.  *#.  . .. .#*..... ..*... .. ..#.*# ** #\.*  .#.#
#.. .#**\.. **.**.*........ #.. \....   .#...... .....*.. .... ..# .\**...*.#.* . ..##*\#.## .....   . #......\ **.... .....#.. \#*\**.\ .........*. #
#. * . .*#...\.\. ...\ .....  ## .* \ .*.\....*  ..#.. ....  ..   \..\#...  .... \..... ...  \....*\.. ..##*  ..  . .. ... ....#*.# \ .... *.*..... \#
#......... ... \..\...#...... . ....#* *.*....\...*\*.*..... # *.* #...  *.    .*. ..**\..# *. * #.##..*#\. .*...*\... ..#.#. #...\. **.  *. ..*. #..#
#.*.. .#*.   #..**##..\*. # . *....\.....\* ... ...# .\.#.  .#..#. ..*..*.....*#**.\.*. ... .. ..... ..... .\.#* #..#.\ .....*..*# .\*............#  #
#..  .. .......... .....\.*. .##*..#..*.  *.#.........**.*.*#.*. .. *... .#. ##. ..* .*..*..*.*.\#..##.. .. \. \ .* . ..... ..** ...  #...\*..#.*.*..#
#. ..#.#*..... *\ .\.* #..#.#.. #**..*#.. #.. ..# ...\. ...* \. ..#...*\ .#... #.  .....#....... \.*....\\* ..*.......   .. .............#.*\* .. #  #
##.... ......*#. * .  \....#.# .*. ....#.. *\....*.*#....# ...  .....*.\  ..#\*..\..\.\.*..*. .##*. ..*.\.... ...#.. ...#.\...*.. *# *  \*...*.. .\.*#
#.. .  *.* .#*.##.... #. ..\.*.......  ..\ #*....*.*.* . .#...... ...*.. .\  \. .#.  .# ..#\.*\. ..*... ....* ..\......#.#.. . ..#\ \. .\.\ .*.*#..*.#
###. . . ..... . *.*.#.*.# .*.* .....#*..  ..*. *#. . ....#... *. .  # . .  ... .* .. . .. ...*.... .. . \* ..\#. \ .. .. .  ..*  ...#..*.... \#..##.#
# .*.\.# *...#..*\#..\..\  ... .*.. ...\.\...#**.\........ # ..  .*##..* .#*\.... .....#\...*..#. .* ..\ # ..*. . #* ..# .# .**. .  .  ..  *.. . . #.#
#...*  *..#.#..   .....#.  .*. .....##.... ..*\* ...*...#*..... ... .#..#.\ .* ...*#. .*......*......\.. *..*.... ##.#.*#... .* #\.*.#......* ..*\. .#
#..**\. .*.*  ..#...*..*.#*..... ..  ..\...#.* . .  ...** . ...... . .*.*. *. ...#*... . # *...\\  .... #. . .\##.# \.#\.#.. .  .. .#.... *. \.\*.. \#
#    .. *#.*. .  . .\*#...* . *#.*...#. ...* .#.\.# .* .*\. ......#...* ..\*#* #. ..*..#... \  .. .  **\.. ..  ##......*....#  . #* . ..\*.*...#.... #
#\#\\..#   .#.*.........#..#...\..  ..\. .. .. ... . .##\..*\.. \....*#....*..#. *.. #..... . . ....##. .....# #   ....*\#........ . ..... ...\. *#* #
L.# ..*.**#..# #\.# .*. #.. . *\. .*#\#.##  .#.*#\.*#......... .\*\... .. . *......*... \  .   .* . # #....#.. .*\.# ... ..#.#.*#..#\.....\.#...\.\..#
##. \..  .  ..#.....\\ ...#\# ... .. . #\*.. .#. *.#..... .......#..\.#.*\..# \.#\.....  ..... ...  . #.......###  . \.#.##* ...# #...  ...#.#...# ..#
# \.#.#. *..*.#..#.... ##.. . ....**. ..**..\  ....#..\ *# . .##....*\.. .......  . .  ...\#...*. .* . .......# #. ........**..# * .. \*......\ \#...#
#*.#.. ...#....    #*\.... ....*#....*..*. .#.\ .\..#\# ..*...#.....   .\...*.. ..#....#..# . .....#*.#\#...*.. .. .. . # ....*...#.......\   .... . #
# ... .#......*..##....*... . ...... #.*....*.#.. #....**## *   #.#...*...# . *... . #  .  ....*....*.#**\#.#. .*. .. *. ....#\*.#...#.. .... .*.#.. #
#.** ....#.........**.. ..##.....*... #*..*.#.  .*#. .*.... \. .#.. ..#...\. ..*....... #\..  #\\. *... ......*.*\ .##** .\ . ...# \.. *.... .*  *. .#
#...*.*.*..#..#.. \.\. **...#.#  \.*..* .# ....... \.....# .......\*  ...... \ . ..*..##*......*. #.* .\.. \..  .  .. #. #......*.#. .*.## *....**.. #
#..  .... . .*....*.# *  .   .* ....  .. .#......###.  ..*#.*..#*..........#..#....*.#.*. \ ....... ..... ...*.\....##..*..  .\# ***.*.....* ...\.. *#
#.. ..*#.   ...*..  #*\.....# .\.. .*.#*.. ##. *..  .......\...*.......\.#.* * .*. ...\ . .  ..*.*..    .......... .#.#. *.  ...#. *#.#.  #. * \..* \#
#***#*.#.\#*.  *#\ *...... .#...* ..\.*\ ......  ..*   ... ..# ....#  *.**.. #.\ #.......\  #.* ....\ ..\.*...  ....  #.#. . #...#. .*. .*  *.......\#
#. .#. ..\...** #  ....   .. *#... .* ... #.*..*\ .*..*..#  * .# . .... ..\ .*.#... .... . ....*.#*...\.#. #  ...... \.. .* ... .#..*..*..\..#\*. .. #
## .\\.... ..\ ...#.....\...* .*...#.. ...* ....#...*\#..*...... *..#......\  . *.. ... .*.*.## ..*.\... . .....*#..... .#.*...# . .........\*#... ..#
#......#.# .\#*...\*.#. .#. ... ...#.*.. .. ..*..\.*# #  ...#.#.. .. \#* ......\.........## .  . #.  .......#. *. #\*...  ..  .#.  *. . .*. ..#.#..#.#
#.....*. ....# ...#\........#. ......\  ...**.. . *#.... #.. ... .  ....  *....* **. . ..  *##* ..#....#..** # .. ....**  .... *.#...   . * .\..\....#
#. ..*. .. ..*.  .. ...#*.. * ...*#.\.#....   ..*.\..  .#.....  .#.. ..  .. ...... ..#\*.\.. .  ...#. ##*...*#.* # #....#.  \#...#... ## \\.... ..   #
#* .*..*\#..*.##.  ...*..  ..##.#\.....  . . #.#.. \. . .# ...\.. \.... * \  *.. ... .*.*..*. .*... .#*..  ...*.... #... ....#. ..#..... .#.\.*# .   #
##... \..# ..*.......*.*.. ...\   ..*\..\  #. .#*....*#.* .* ..* ...#..## ... .   .#... ..#....*..*. .... .#.. . .*..#.\ ..\ ...**...\. #.. #..... .*#
#..... # .... ....* #. ....#. ....*# .*.*#*.**.*.\*....*. #*..\ ....... .. . ..#.. .. ..\ . .\\.... . \*.#.*#.... ...## #. .... .....#\  .. .*#....*.#
#...# ..*. \.  .. ..... ..........# ...  #.# #... \*\#.\.*.#.#..  \  .#.*...... *..*.*  ..#.. .....*. ##..*\. . .#*...*. .... ....  . ..*..#.    .#..#
#  *.\*..... #. **.*.. .  ... ... .......*.......## .   \.. . ..\.*. .\#.*.# . ........#  ..#. .#*   * . ..# .*\..#. ..# ....\##.\#.*.... .. . .. \#\#
#. \ .#.... ... **....*  . #. #.#\ .. ..* *#.\.....*.**.*.#\... .# ..* .. .#.*... *...  .*  .......*\...#. . #.#.#.\**#. . ...#\..\. .* .\...\#.##.#.#
#.#.....**. ...\..*..    *.#..#. .*   .. ....\#.. . *.. *.*  ....#* .#*..#..#... \ #**# # ..\.*...**.. . ..*.\ #. #  .*....... ##..* .  ..*.\.. ..*.##
##.* ... # .* *#.# * *# .**.......**.#.  .* .\##......#  ..*... ......*.*.*. .*.....*##.*.*# ... . ...\\#. *...... ...**\#.\... .....*#. .\# ....#.#\#
#......#.*.\.\.. .* ....   .. *.  .#......#.. #... .. *.#\\*.  \. *..#... .#\ .......*.\ ..........##.*.. .*.  .\# \.  \..#\**#\...  \ *... #.. #    #
#....#.* .....#. ..#. .*. .*. . .\...** .#...*.. ......\* *....\.\#...# .. ..*.* *. ##...#...\..## .# ..*..\. .... #....# .*  ......... . #..... ....#
# .#.#*..*..... .*...#.. .  . \..#\ . .\.. . #. .   # *  . . . ......#.*.#........#.#..#. ... ...#.. ..\...\...*#...##*.  #. .  .#.. .#.. ..   .*.#.*#
#..* .\.#. ... ...##*..*......#*... . ...**....#\  *. *....#.... .. #...#*.......\...# .  ......#  # . ...#.  #..** .. * .  . ......*..*.#\\\ .#. ...#
#.. .. ... ....**#.....##. . #\#* ##. .# \.*#.#. .##..# .*. .. ..*. .#... # *.. . . ....\#..* *#.*..#.  \. .... #..*.**\. .....\#...#*. .#. *  . ....#
#\....*#........#....\.\\..  ..*.  ....# # ...##. #.# .*.\\#  .## .#*#.  .**..........  **.*..*  \*.... ..*.#.... ##. #.#\. .. ... * *\.*  ....**  ..#
#...* .#.#..*..#..*\. #*..*..#..*..\* . # \......\.#.* # .  ..* .*..*. ..#..*... . .. ..*.**.#...\ .. .#.....* # .. .. # ..... ***.  .... ..\..*.....#
#.* ..** . . ..# ..#..*...*.*.# ...*#**\ *.. ........*..# . .#.. #. ..#. . . ..\.  .  .* ..*###....*.. ..*..........#  ..\.\ \ . ....*.\.*..#...#... #
#..* ........*  .  # .  #. #.   ..\##.. .**..*.\*\  #.#. \*.. #. . .\*.   .*.#..... *#... \. *..... ..  \#*..\* ... . .  .#.#....*...\.....*.. \ \ ..#
# ###. *.*..... .*..... .#*# .. .*.*.... .*.#\..*.#  .#.....*..#... .#.*......*  . ..**.. * #*. .. ...  ... *#.#..*...* .*.. .. \.\*...\.  ...  ...#.#
#....#\\......* ..\#..#.. ...###..# . .. .\.\..*.# # ....\#..   ...\. * ..#.. ... *.***....# ...*..*... ... *.....#..\*.*#.  .. #. ..... .**..*.....*#
# . . .*........*..#. ..\  .......\ #.* ...... .#.* #*.  . .*  .#.*...#  ....#........* .*.. #.  ..\*\..\. ....\...\...*. .#...\.#...*#. .. *\.\.....#
#*. ... ...\. ...\\.#. ...*.\.... ...*......*. ....*.# . ..... . .......***\.. \.# ...#. .#..**. # ....*..#..#....*...**...  #.. ..* ...*#  ..\**..*.#
#. # \ .#*.*.#* \*#....  . . *...... .\*##... .... #  ...*.*..*\..#....###..# . . *.....  ....... .*.  #  .... .* #.#..**...  . # *..  *..* \.. .. .##
#. ....#.......* .  ..\..\...... . ... . .... .#\ .. .*\# .\.\#..\...... . .. ..*. *.....\.... *... ........##.......#.  ... \.... ..*..#.#..\.* ....#
#....  ...*.#.#*. #...*....... .  #........ . \#....#..#  ...... *.......#. .#  . \..... .. #... #* ....*  .# ....*.**... . ... ............\ ....\  #
#...#.#........ *  *#.. ... ....  ....**.\.  *.   ... * .#.#..# .\.*.*..  .*.#*....#..\.....\.\.**...#. \\... .. .. #. * #.. .... ... . . ..  ... #. #
#.... .#.#. .* ..*.  #...#  *.*  ...*..#.# .. #* \. .. #.# .*.* *..#*..#.. *#.. *. ##  ..*....\  .#*...#   ...  .#. .......\. ..#.... .*.. ..\...# .##
#.....#.#. ..... .....#*. .. *  \..*. .*.. #*.*.##. *..#.*#* .. ... * ...*.....  .  *.#... *..\...#..###\ .#. ..*.....\...#  .*.\#  .* .\..#...\#.*..#
#...*  . .#.  .*#. * .... * #......   .#..   .. \*  ..........# #...##*.....#. .*\...... ... #.. . ...*. .#.\ #. .. .*#...\.#..#.#*..*..... ...#*. .*#
#...  ...*...#.* ..*.#*..\ .*.\. .. ..  **.. *.. \###.....# .##  ..## ...*........#. ...*.* #*.* . .. *...*.... #......*....* .* .#.\* .*.#.*.#*#... #
##\#.*. *.  #..#...\ #...**\. . ##.** ..  ..#.#........*#\##\ #.#* #...... .#  . #......\.  \..\...*\..... #..#......*. #\\..\.#.. .  .#...... ..  ..#
#...  . . ..* .##....  \..... .\.... \....\....#. *.*. .\##*. . ...#......#....  ......\.*....*..... #. .##.  ..* ...# ... .... ....... ... .......# #
#. #.*...* \..*..*.*.*.*.#....#### *..#.*..*.\. .. #.. .*. .\  .\* ....*..##..*..#.**..#*..\*.. #*..# .#*.*.#  .*..\....*....  .... ..\.#. ...## . .*#
#* .*#..  *.##\#. *.. # ...*#. #\.*.*#...**..* . #.* ..... #..* \.  #.*...#  . ....... . * ..* ... *  .##  . . .** ..# #.#.... ...*. .*.  \*.# #.#.#.#
#*..........# .. .... .*  \.\.#.**.. .#. . ..#* .*  .. * ..##....\. ... .# . ..#.. ..\ ... *  ** *.....\ .#... ... .*##\. .......*..*## #*##..# .\**.#
#\*... .. ...#..  ...#... .......*..  .#.*...# . .. ... .*.. .  ...\.\.... #...# **#.\.\...*.**....#*#.. ..#. \........* .. ... ...*.......#. . ...*.#
#. ..***## ..*.*...*.\*..#..  #*....**...#.#.. .#.* .###.#...#.*.... .   ###*...#. ...  #....#... ...#.##..\*\#...#.. ...\ \\.  \... \\.##.#*\\*.  .##
#.. *##.....#.... .\..  . .* \ .. *.*#\..**.\#... .# .* .#...  ...*...#..*. .*. ...  ..\... . .#.#.#... *..#. *..*...*\..*.#... **.*...*  #.... ..   #
#...... * ...# #..*  ..# ..*.#..# ... **.   .. * .\.#. #......  #...#\  ..  .*\*. ..#**.#.*\.......... .\... *  ......\#. ..#..#...#.*.. #\.*\..*..  #
#.....* ##...*.. ..#*\. .*. *. # . ....... * . *# *. .**.*. \# ..# . *........#..#..* ...# . .\ #. *....#.. .*.. .  *.#..# #...  .. .. .......  .##..#
#\......... .... ..#..*.. . . *. #.... .*.*....... # # *......#\ .. * ...#. ....\...*...##.... . . ..... # ...\  ...#.#..\......\ .......  ...* ...**#
# ** ..  #...... #.....*..*. .. .. ..*.. *...*# * . #....*.# ...# . . . .  .....* ... .....##....\ .....\ \\.\##. .*  .. *..*.  ...   . ...   \. #*. #
#....##\* ..*...#\.... .. #**  .. ...\*  ... .. .......... . .\  ..\  ...\ . .*.  .  ... \ #...\.. .. ..* *......... .**.*..#.... #   . .* .. . .*...#
#..\ ..*....#*  ....*.. \ ...#.#....##\.. . #.*.\#.....*.*...... .#\\ #....# .#*..#..# .#*........ # # *.... ..... # . #***.\..\..*. *...##.. . \ .#\#
#... . .\... \#..*..#....#   **. ...#.. .*.\ . **.#\  . .*... ... .\#\.\* .....\.#..#... .**... .#.##..#*\  .#...### . *. * \ .\. .. *# ......#....*.#
# ..#..**.#*. #*.**\.**... .*....   * ..#.#\...*  #.... #.* .#........... *\* ....## .#...*..*..*..#......# .*... *.......* * .............. \. .   ##
#..  \. .#*.*\. #*..##*. .***..#... ..... .# \..*. .\. *... . . ..#. ..#. ..*.#..*... ## #. ..* .......\..... #*...#... *\.#.  .. ..\...   ..........#
#..*.##\.. ...#.*  ...#.......#..*.  ....\..*.....\ . .#. .**# \. .*   . ...*...... . *.. . \. #. .**. .*. ..*\ *#*.. ..\ . ....... ....\ .   *#*...##
#..\.......*.....*.. ...*. . .. #.....*..#..##...#\..  ..*#\...* ..#. ...#.#  .\ . . ..*\. \.. * *  \* ..  . . .....*. . #... \.\.....  #\.\...... ..#
#.*.*. .*.\.. ..\ . ... .  #.** .#*. .#.. .......##.#.#*... *....\*...*##..* ... \ .*.   *.\# .. \. .##. . .# .\ *.*.. .*....\\*...#.  ....#....*...*#
#...* .. ........ .. ... .... * **\* .*.\.#  ..\.... . ..#..#.# . . *..# \ ...*\ \....#.  #.#. ..*#..#. ....*... ...* . .*.\...**.\#..   .#.. ..*... #
# #..#.. ...*.  #. .. ..# .. ....   ...#.#. .. ...\..  . . . .\.#.#...\..# .# .... *#... .#... #.#\.# # .#.\... *.*.#* ... ** #  .*. ..#.... ......\*#
# #  #..*. .*  .. ...# ...#.#..........  . .  ... ....   ..# \.. #.. .*#** . .. ..... ...  *....*#* *.*\.. .*.**.. ...... \\ **...\ .*..#\. #.*#... .#
#   #.\ \..*#.. ...# ....*..#...\..#.##*........\*. .  #. .*.## ........#..\ .*. *\...\. ..........#..* .... . .. ......   * ...\..\...... ..#. ...\.#
#.#*. # .#.#.\  ........\###...#.. ......#.\.#  #** .#..*....#...#..... #..\.  *.\...#*. *  .*...*###.#..#\ ......\....# *  .**#...#*..#..## ....... #
#.\#.\  *.......#  . ...... *.. *. . . .... .*.*#\..*... .##......*..#..... ..#\...\ ... .... ... . ........#..... #  .........  *. .* . . .. ..**...#
#... .#  ......*.*....*#...# \\..* ..\#. ..... ..# ..#\.. . ..  . .. .##*  ...\ . ..*..\..#*......#..... .#* ... ..*........#.. ....\.*.....# .. ....#
#.* .. ... *.*. . *.\#.*....# .*..*.*.. .. .......\.. *#..#*.. ## ... #....* \..* .... . ....#\.*# .**..* .. ##..**.. ..   \.. ..*.#.# .. \#..#.. ...#
# ....... . . *.#.#.. ...*.\ .....\............ .. .* .. #  #.  . ..*.  * \**. .\.......*..* . .. ...#..*..#.  ....**#..... .. .#.*\. ......  *...*# #
#. . **... *.. . .......* #. ... ** \#.... .\# ..#.*.#. . .#.#..**.\..#........#.  ##*.  . #... *.#...*.#.. ..#\... ##.* .\\# *. ....*#  .....\.*.* .#
#\ \..... # .#\..... .. #*.. ........#\.  ##...* # .*\*\...*..#  .*.. ..... .*.... .#***.# #... .\ . #...* .*.  # ..*......... .\ *###\... ....**# #.#
## .... \..#..#..*..##.*.. \...\. * ..* .# .. ... * \... ....* *...  ...\.. ..    *. ......\ .... ....#. *# ...# ...*  # ... ..\#*.. .... \. .......*#
#..#.. #..## .*. ..\...\...\#..#*.........\.. ... ... .....#\... .*..#....  #.#..  #.. *. ..*\\.# .#....\.. ..* ...##.. ..# ..\..*..  ... ..#. ......#
#. .*. ...  . ....# ..*...\.*.\.*....... ..#.. ..... #... #\........ \.*  ..*##. .. *..# ......#.\..   ...* ...... ..   ..\....#...  .....*. .\  .*.##
#.. #.....* .. .##...\*#....*.**.*.\..*......#..*.#...  .# ..\#.#. .#.. *...*. .  ........ .. # ...#.. . #......... .###\\#.*\  *... \.. . #.\*\... ##
# .\ *..\... .#.. *. .** ..#.....  \...#..#*..# ..\.  \.. *.#. ..#*\\*.... \.# ....... ......*\..  ... *# . . *...*..\...*.#*   #.# .* . . .. *....\ #
#.#.  .##..\.  *...* .*....** #.#.....*..#....#..## .*. ..# #.#*...*.# .. ..\*.......\ #....#.# ......... *.#  ....*.#..*...   .*...##**#*  ..... . *#
#.. ... ........\.#.  # . ....... ..*...*.  ..*....\ .#.## *. . ***.. ..  .#.. ...*#.  .*..#.#* *...\* .\.*...  ** ..*  #.*.*.*.#...... ..*.\.  .  ..#
## .#   .. .\.##.\ ..... * ** #. . . ..# *.*..* . .. #.#...... *.  .\ ... .#.#.#..* .#.*.*#*.... \. # . . *#..* *.*....\.. \.. . ........#..#..#.... #
#\..  ..... .\...*#.#....  ....#.*..#.\....**....#....*.....\...#.#. . *...... .. *\.. .......#.*...*  ..#.\*.... .* #. ...\... ..........*..*. ** .*#
#.....#*. \.*. #..*#..#... ..# .*#..\.#.*. ..#.#.#.*.*.*........#   ...  .*.. .. *......   *.** * \ .#... *...#. .# #* .*... .*. \... ...#. .\   .. .#
#.....\.. \... ..*.#.. .*...* .  \  . .*...* ...#..#. .......... *#...#.... *\..........\..\ . .\#.. ....#.#........   #\#. ..* \ ... ....*# .##.... #
# \. *#..*.\.#.... ...#**  .. .....*#*..  .............. #...# ..*  \..*.# ..\.#......#.# .....*....#.. . *# \...*...## ... ...* #*.....##....*..#. .#
# *.. *..* ... .... . *..*.   ..*.#.* .....* *....... .....*..... ...* ..*.#.. .\...... .##. . ...  ...#*. .#.*. #*.#  #.#..#..* ..  .....* .\.......#
#. .##.*. ..# * . . #..**....#.\..#\. \.\......... .\#.. ... .....#.......#.*  .*. *...#. ..#    .##..#... . ....#.##   . .#..... *.\#..  ...\ *.# ..#
#..#.. # . .*.## ...... . *..... #....#.*.# ...*#  .......  ... .\  ..*##*..\......#.*...  #..  ....#..#. ...** .\..\*.. .. .#.. ......\ ...#.......##
#.\ *. #.### *..\ .  .. . .. . #....#...# . *#.......\.. .... ....\   *. .\***. #........\......*.... .... ..  *\. ## .. *# . *..#\*....*.*.\\.......#
#*. *.#. .*.. .*\.#. . .#.##.\... .*.*\*.. .\\ *....#..\.  #. ......   .*........\. . ....*..\.*...#. ..  . . . .... #...* .......#* . .#..#. . . .**#
# . ......... ..\\\\\.## .\.#..# .. *#.*.. .. #*... *.*.......#.#. *. .# ...*..\ \ .\\#....  \..##*.....  ...#.... .*.. ....#.. ...   .......   #....#
#...* *. ...... .. * #** .... .....*\... ..* .# . ... .... .#.#**.#* ..\** *....  .*#....\  .\.#...**..# ...  . ..*. ...*. .#..*# . .. ....*..*.. .. #
#.\. .*.. .. . *##\..*... \.# .\#...\..  .*..##* #.....* .*\.\. \..... .. .#\..... .#.#....#.  .#.*.#.*.#....*.  *.**.  ..**.  * ..... .#... ....### #
#. *....\..*... *.#*#....*..... #  *.#.* ....# . .\\\ ....*... .*..#.. ....\. .... ..........  *.......*....... .......##. * .#.  ........ .. #**.. .#
#  ....  #.. . ..\...#.#....\.\.#. \ \#..*\.#*..#.. ... \..#.\.  .#.......\...... #.\   ..........# ..   .\..*. * ..... ... \**.  .* .....**... .#...#
# #\. #..#.....\. #..  #*...#....*\#..\.*# *.......  * ...*.. ..\*..# ..*. #\..*.. *...\#  . ..*  ...* .*# .#.. *...*#...##..* *..*. ...*. *#.# .. ..#
##.#.....   .*..... .....# #....  .....#.. .# ..\.\ . . ..... ...#.#..* .  . ..  ..*\ .. . ... ... .*.\#......\. .#.. .#.\.. .. ... #* ..\* *........#
##...*#.... \ .. .. ....#.. . ...*..\. *... ..*\. *.**.* ...\*#.*.# . .#.....*.*..#......\## ...#.# #.*... #......*# .#**.  .. .#.\.**. \..\..*..\. .#
# . ...... ..*### . \.*..*..*\...*.*#.... .#\..   ..*.......  ..# .. \......#\ #.....*. ..**##..*.. *#..*#....**. .#. *. #\#.. \# ..... . #.#.  .# .##
#* . ...#\ \ .. ... ..** .*..\.\...\ ..#  .....  ..... ..\... ..#..# .  #*........\\\ ... ..#..#.*  .#  .\...#.* ..#*.*... ...# . .**\.  .*.* #.\..  #
#*.\*\... \.#\#....*.* .*..# ..# \ #\ . .#....\.. *. .. .* ..#.*.. .. ..*. . ........ ...#..... ### .\...#.\ #........  .###..##..\. .. ..... ..*\*.##
#..*.\.....*#\  .....* # . ##. *.*..   . *. *.\.\ ... .......**. . .........#......*\ *.... ....#.*.  ..##. \# *##  .*.*.*..  #.\ ...\.. .#.#.. . ...#
#*.\..#. ***. ..\.  *......#.. ..*# .. . ..  ...*.....  .##.  *.*  #...\ .  *..* #.*......*......#*#*\* .#\*....\# . #..* #. .#...*... .*..\*.  . .#.#
#..#.....*.*..\..# .. ##....##\*.*.#..*### .#......... \ .# *.#....#* #.....*...... .#.\ . .  ##.#.. .#.#.*.....\*. *.. \ ...   ..\ # *\* # \. *. *.##
# * . *.\. \#...# \.#.... .#*\. *.  .....\.\ .  .. #*..  ....... ..*.\\ ... .#. \ ....#.   *.*#*...\* *#...*.\.*#  . ..\ . *.   .  # .. .*. #..\....##
#..#..  *#\*... ........ \.*. #...#*...\.. .*#...........*.  #....... *.*... ... ...\*....*.#. ...\*..#.........#.#...  ... ..\..*...... .#.. \....  #
#. .... *.......#....#. **\.## ..#.# ..# . # ... .*.* ... .**. *..* #.*.*.. .*..\. .*.....\......  .....\..\ . ...  *....*\..... #.*#.  .#.#......*#.#
######################################################################################################################################################