######################################################################################################################################################
#.##  ..*. ..#....*..## .... ... ..  ..\\\. .*.\.#*#...*#. .#......*.#......##....#.#   *. .....\...#\  * ..\.. **.. .... .** ... ... .*.. ....... *.#
#**...*.#\. ..... ...\. ..  # *  #.\ .... ... ....... *.. .*.. *.....* **#..*...\.**... ... *...*. .# .* .\.#.*.#* * ..... .......#\ \. .* #..*.*. . #
# ..*.#.. .##*.#\# ....*.  .*.. . *#..*..*.. ..\.. ...  .....#.. .*.* ...##\..**. *  ....##.*.  .\... .*# . ..*\#* #.*. ..\..*. *\.# ....#...*...#. *#
#*.... .#.. #.*....*#...*.. ..........\.\* ##... .#.# .*  ...... .*#.##.#*  .#.... ..  ..... #\.... ......\..   #\* .** ...   #..#.  .... ..**.*  \..#
# .. \.. .#. ... ...#..*.....#........#.. ....  ...*##*# .# . \ #.....#..#..  *...  .#.. .. *..  ....#*..\.*..\*......*. # #...\.. . ... . .  *..*. .#
# ........*.*....#..*. \...*..... .#. # .#* . ....#. ..#... .# .**..*.##* ....... *.  #.#.#.... .....#.. ...........#. ... \.#. .\.. ... ..#\##......#
#.*\..   ..#....#\ . *  .#.*....  .#*.\. ......  . ..  . *.......*... ....*  .. ..\#.  .. . .*.#.#....\.#..*......* . # .*....\... ..   #.....#...\  #
#* ....  .. .#.#...  *# ..... .# .... #.*#. #**..* ..  ....#......*.# . #\..*.. * .\* .. ...#. #. . .. .....\.*....*.. .#*#.  ....... . ....*#*.# ...#
#*. .* ... ..*#..#.. .*.\.....  *...#\. *##**.....*....  ....... .. \ .*.\#... .. .*.#..... ....  .#..\...... ......# ........*...\ \*.....\.  #*..#.#
## *..# . #*......# ...\. ..*. \..... .... ..** .#. #.. .....\*#. *. .*.. ..  ..*...#.. ..\.. # ..*..\ ..*.* \*. .*.*... #...\ #.*.. .\*.. ...*\\. . #
#....*... ... . ........ ..*#.#. .**.  \  *.\.....*. \ # ... #.* ....#\....*\**#.  # ....#.\...# #.\*.. \  .. **.\.....\..*........*.**. . ..* *. . .#
#.**........*\...\.....  .#.  . .* #. \...**.#.\ .\ * ...#. ..#\.... .  . ......\.......#.\.#*....#....\\...# .. ..... .*.\  ...* . .*..#. ....*.. .##
#..\.#*...*...# ..*# . # ..\.*# .#.......* ... .... . ..  .*... # .*......#\#\.......* .\.. .*...\*...*.... . *.\..#.....\   .#.. #.  . . \ ..\. ## .#
#*. #.*. *.....*#*...*. * .*.#........ ..**.#.# .#.   *..\.*.#\. # .  .*  .....  *....#*#.** ... *.. \...  .. .*. ..* ..\...\* ..  .*   .* \#.  *. #\#
##......*... .#..\...... .. #.*.#\ .  ........\\.** ..*\ *#....  .*.  ..#*. ...#. .# .*. ... #. .....*#... .   .  ..#.......  #. *...*.\#...\...# #. #
#.. #.....  ..*.#..#..##.#*.  *.*#...*..#........  ... .#...# .*....... .#. .##...  \..#.   ....* .. ..#. .. * .. #. *. . ...*\.##\. ....#. #.# .....#
#.##. *.*...# .#\ .*.# \..   *. . \ .#...\.#...#   ...# . .# . ..\.*..**.*.#. ......  \*\*.... *#..*#..#..  .#. ..   ..  *.. #... ..\.#.. *...\.*.\.\#
#.#. \..\.#..*#. * .*...*.... ..\\...*   .#.......   .*.. .# .. #.. ... .\.#.#\#*. ..*...... .  .\#..  #.*..#  *.\ \...##... *... # . . .....* ..... #
#*.. .\....# #\#*#*. #\.*.. .#.  .. *.. .#..\.\## .* .\  ....#.*...#...... ....*..#\*..... .*..#..  .....\. **.. ...  * ...*.*. ..... .*.*.  * ...\..#
#...\  .*...* ..# #....* \.......*... \# ..#.*. ....*..*. ..*.*  ##........*.. *\ . . #.....*\.\* #..*.#\..* ...##*. .  . * **# \*. \.*..\.* . .... .#
##.. .. ....*\#.* .. #...#..#.* .... \\#. ..##*...##.... .\.  .. ....##*..*... .*..##..*..#..  .....*\.*.** .  ... . .* .#.#..\. #.** .*#    . *  ...#
#*\.....*.# * . ...## . ..*......  .* *...\.# ..*.  *..* ... ...*. ..#. . \*... .  #.#.   . * ... \.*..*.....#..  .. . .\..#*...**.. ..*.* #... .... #
#*..*...... ...\#.*\.#..** ... . #.# ...   *#.... . ..* ............ **....##...#.....  # ....#. #*.... .\\..*     ..#.#..*.**.*..... .\ .\ .\*.. ...#
#..#.*.\..*. *...#...# ........ *..# .#..*.....# .*.\.*......#...# ..#  ..\.. ..  ...  . #.. ...  #. . ...#....  ..\    #\.....\  ...#. .* \ ..#*..#.#
#\...#.\.#.\   ...\\. .....*\**.. \# .   ....*...........*.. ..##.\ . .......*..*.*#. #..... #.* .........*..#.# .* ....... # ....##..#.... \.*..... #
#.......#*.\ .  . \.\... *#.#.*.\. *. . ..\  ... \...#.\..\.*..#*.#......#....\.   .. .##.*#.#.......\..# .*\.....  ...\...*** ##  .# ..\*.... #..\.\#
# # .... ... *.#* #*....## .#............#... .........#. . .#... ....# ...#..\  ...  .... .\.#....*\ #......#......* .....*.. .... #*...\..* *\..*..#
#.. .\ # # \ .   .*  \.*  .#..\..... .#.# .***... ..\....*#. .*.....#. *.........\.*.*  #.#.......... ..* .....\*....# *.#***\....  .# .#..*  .\..* .#
# ..*..#.# .\#.*. .# *\.#.* *...#.# .. . ...*#\.*...*. .*....* .  \.  #.#.... *##* .... ..##......*##\.. .#. .. . .  . ..##.. .... #...##\.\... .#. .#
#.* .#...*... ..# . #.  ** ..... .# ..\...###\...*\.. ..*. .*#...*#.#. .*. .#.* . .*..* ..# . #.* ..#* \\..... #*..#*#.*.....#. ..*.#. .#... .# #...##
#. #\ \..*. . .. ......*.#.... ... . \*#. .#. .. .....##..#\.  .\...#...#... * .#...\.....#....\*... #... ....\ \. ...  *.*..* ...*..*....* ..* .... #
#*.....*..*..*.#*##. *...\...#.  .. #* .... \.*. ..*  .** .. . .#.## . .* .*.#... .......# . #...* ..#.\. .#......*.. ......  ........*#.....  # .*.*#
#.....*.# .. . . .* ...  ..** .#.. . .#*.#.#.#  ##..# . .. .........* ... .#....  ## .#*.... .....* ..#. .... *..#... .*.#.. * .. *.#.. ..#.. . .*...#
## .... ..#...  \ ..  * ...#. . #.  *... . .##\.....#...  ..*\....#....\ *..*\ .........\ .#* .** *.... .. *... **.. . # .. ..  #. * ...#.  \*. #*.\.#
#\*.*. .  ..   .\.. .#.. #....*.## ......##..#.... #..*... ..*#. \\..* .#...  #... ...*....\.*\...#....##..\*.. ...#.. ...#*#.  .. ..*. .*#  \ .**...#
#.......\*\ ..............#  .*...#\.....#... ........ .##.. .....*\...*.. \  #. #####  ..*. ......*..*. ..*.*  ...\ ...\.. ...#....#.#. .#.#.. .\..*#
#....  #...\ #.##...* *...*\#.##... # ..*.#.........#\\  .# . \*. ...\..... ..*...#.. .*. ..\.*.. ....\  ..*. ... . . . . .\...*. .*.\* #..***...##..#
#\#...   *.  *. .*.##\. ...*#.#.* ..... ##.*#....*..#. ##.*...#.* ....*##...# . . ... ..  #.#  .*.# . ..#..#. .  . .*.. ..... .. #........*  . ... *.#
#* ..#\. .. .. *. \.. .**..# .*# .#..*.....#....**#.#*.. .* .  ... .#*. ....... .** *..*...#.*\.## ..\. \...  ...###.\ \*  \*** .*.. \. ...#. .   ..##
#.  ... . . ..  ..*..*...*..\ ....\#.. . ...#\.. .. ... .\... *.*  ....*#.#.#**#*.\ ..*#.\.# *...... ..* ** .#.# .. ..*#   .*.#. ..*#... # \ .. ..  \#
#... #.\..##.. **##..\\*.##....\.. .  . .. #**. .*\....... # . *#...\*.. . .**\... .... * .. #  *. ..# ...*#.*##..#...**. ...  .*..  .#.. ... . # ...#
#.. ....#.. *.*....... #....*.. . * *......##  .......#  . \.*..##.....\.# #...\. ..*  # .  #. .\.... .**.... . . \........**....#...*.. .*#... #  .*#
#.. .. ... \.\.  \# .*# .##**\.* .# ... .... . .#...*\* ...  \... .##....# *.. ..#.##. .*\.  .#*.  ##\ .# \..#. #..*.  ..**....\. .... .. ......\* # #
# *......*\... .....#. #.. ....\.* **#*  ..#....\. .....  .. \ ........#. .#. *......\*. #. .**## #..... # . ..*.*#.#.*..**.  ..... ##.* ...##..*...\#
#..  . .* #.\.... ....*.\ *.. .*  . .###.. *.#.*. ...#. .. .#. .. ## #**.*.  .. .#.. # #...  ..# *#..#...*\#. .. *.*...  .#.  *..*#  * .**.... #. . .#
#.#....  .*...... .. \.*#......#.....## #.....#...#  ..#... ...... *.  #...... .. #......#. . \ ....\.....*\ ...*  .. .*#  ..*\\.. . ..*. .....*.\...#
#..\.#.. *.. .#.. .  .  ...*. ....  ......*. \\* #. #.... . \.... *..*.....#. *.. .....# . *..... ...#*..**.**# #. ...* . \*#*.. .*.. \\.  .\.#\ ....#
# ..*..\. .#..... ....*#\ #.*.\. ....*#... *#..\ .# ..... *...*.*#..  ..*....#\  .*\#.*\ .*.#.. #...*#........\#*...  ...#...*.. .. . . .......#.....#
#..  # #..*....* ..*..\..#. ......... ....  .\.*. . ..*.. .  .....  ..........  .#*. ......\...*..*.#..... ....# # .... *... * #**. . .... . ..#. .\##
#....*#...#..\..#*.....*.... \.#..  ... .* **. .\ . *.#. ....   .#  .*...  . . #..... . . ..\.. . . #. .   ##.*.. .........*....#.  ... *  . .. .#*.##
# #*.#. ... *.*..# ......*.\*\.\#. *. \.... ... #...#   .#    *\\.#  \..*..*..#.. *\.  ..\#.#..#..*..* .#.#\*  *.# #.#***.. *\.  .  ..\.#*.*..* *.. .#
# . .\.. \..*...   \ #**# .\## ..*.# . .#.\.#... #.#.  #. ...*...#*.. #..  .. .. ...#  *.#. \..*.....*.. .*#\. .# *..*....*# *.**...  .... ..# *...\*#
#\.. ........* . #.#* ...##. .# ....#  ..#.*....#..**..#..* . .....#*..*..\ ...*   \.   #...*.. .... ....\ #....**# #* # \ \  .*\#....\ . *\. .. .##\#
#.. .*  .#* .*.* ..*..    .#.#... #..***#.#... . . ##\..\. .#*.....  *. \#*..#*..#. ##...#...  * #*  ...... #.  ..*.* #.. . *......#. #.#....*.. **  #
#*#*#.   ....#........#..... .....#.\*..... ...#**.#...#.\...\..*.......#..*. ..#\.\......... .#..* *\.*........*... .*# ...  .  *  .*..*..#\#*. .##.#
## . . \. .#.\ .....*... ... ..#.\  .\.#... .....#..# . ....#... ....\.#\ ## . . .*..\ . .....  \***.  .\.\. *.. #*# ..* .. *##.... .*..*.\......**#.#
#.....    ... . ...  .*.\*. *#. #.*..#..  .\. ... . *#*#. .*. .. ..* .. ..*.*.*...\... \. . ...* #...****\#..##.#..... ......#\ ..  #\.. ...**.. ..  #
# . ..**..#* *  #  ...  . *.  ..*...#*.... \. ..#..... .  \........ ...*..*   .... ..*##. ..*.. \.. ..*...*#*..  *. ..#..#  .# #*....  .\  ....#...# #
#....#  ..\#.....*#.##...#.. .. .. .*...* .***  #\.. *. ... ..#....\.. ... # ....*  *.\# ..# .  . ....#..\*... .##....\...*#.#..#.#.. #* .. .. * ..\ #
#.\#.#*... . . . #\.\....  ... . #...... .... .#\\*... *#.. . \\*\....... .\....##.   ... ..*#*.. #.\ ...* ...*.\*  .. ... .\ . .. ..... .* .*.......#
#. **..#\*..\. #\ ....#.*# . *.. .. .*.. .* ... \......   #.. .*.*. .\ .....\.#**  .... .*. .  .  ...\...#..*  .. ...... .. ...**..*.. #..... ...#.. #
#*#.#*. #\  .# .  ... #.#.. # #....\*...... . ..   .*. ....  *. .. .....* .#. .#.#  . .*.#...*\. # .#.....#.#....\.....  .. . . ..\.*.#* . .# \. ..*.#
#.....#..# *.* . .\....# ..*.....**.. * *.**.\ .\......\...*..#\...... ..  .\.*.  .#. # . .\#... .*..*.##. #....* * .\.*...*#.... \.#**# .... .*.*...#
#*  ...   . * .\..#..\.. ..# # #....\. ..##.#..... #..\\..#...*  *. . .. . .#.*.\.... .## .#..#....*##*..#. . #.*#*...  ..... .....  .##..# ..## .  .#
#. .........\ . .*.*.#... \\  .... # .... ...\.*#.*  .....\ *. .. .\#*# *... * ..#.* ...\ ....*.**. ... .. .......#\.. \ .#..*......  #.. ........\..#
#.\ #\\ .*  .#\   ..  \\.....#\.. .* ...* *.*   .\ #....**.#   .*# *..\.. *.. * ...*...*  *...##.\....*...  .. *.....#.##.*.# * .#*...\\...# *...#*. #
#.*.\.#. #.*. .\#.. .#.#  .#.*.*.#*..##.....#   ...\. *#.#.........#. . . ... ...\.\  ..#**.#...... *\\.# ..#..*. *..*....*.  .\.##. ..\..# ... #.#.\#
##.\.. .*...... #* ..* \.\. *.......*.# #*#. .\ #. ... #\ *...##*. #*. ...#.*....  .*.... .# .#.  \ *...\.........#.  \ ...  * ##..\.*\.... * # #*.\.#
#....# ..*.*. .\. . .. **#*# . .\*\....\... .#.# #.  .\ *.*.\ # .   .. ..# .# .#..  #.... .*..*#\. #. . #.....  .*. ...*.   * .\......**.. .*.. . ...#
# .#.#**#. .... #. .. ..*....*. ....#.  .  .#...  .\. ... .\\...#....* . ..  ..# . .. ....#.#...*.*..* *#.... .*.. .*#... ...##.\...\\  #..#* #...\.##
#.#.***. ..#..### * .....*. ..\..  ......*..*.... .#  .. .. *.... .... ....*.. ..#..  #* *..#*#...\..   #..#. #..... ........ ..*...*.# .* ........**#
#.......#. # *. .... ..#..*#*..#. .\#.**............**\ ..  ..\#.*... . .....#* .. * .*..#...*..  #....*#.. .. ....\ .. #*.......*....  .# . ....*..##
# # #....   ...  ##.#..#. * \.\ \ ... ..*.\ ...#.# \\*# \......#. .*.. . .......  *. .*. . *\.*... ..#.#..#..*..\.. . ...*.\.*.#....*..* .... .. #...#
# ....... \..# * #\..*.** .. * .\ . *..... .... #..*...... \..#... .*#  ..#.#...  ...\ *. *.... #  *#..*. #.\...... ..*  . .#....*\*#.. #..*  . .*#  #
#.# \ .\ .. .*..*.  .. #.*   .  **..... *. . . .. #..*.... ..\# #\.#*..\.  ... .#...\.*.  *...... .##..#....## #. .....#.#. ..**......  ..#*# ...**..#
# .. .  .....*........ #  ...*.**...*#\....  #..*..  .*.#*. ....#*.#  ...#..*....#..#. ... ....\* . . *.  ..*.**.. . .\ ........\ \*..*#*..*  .*... .#
#...*..#.\ .#*.. . ... ....\. ..*...*.....**.. \.#..\ .*... #.. ... \.#.. #*..#*..*.#*. ... .  ...#. .* ..* \.\.\ #\ . ..#. ...#. .......\.  . .\\.*.#
# ...*.  . .... ....##  .*..# #  .. .*.####.# ....\  \**.*..... #.#\..#...#..*. . .**. #..  . #.. .# ##.#.*..## ..*#***# .#...\. \.#.....*..\   **...#
#. . .........# ...#.* ##.*#.**.... ......*.# *.#...\. ..#.  \..\ *.*......* ... .#.\  *. \. . \\..##.* ...... . #.*.#...*....... ... ...\#. .#.\\ .\#
#.......  .  *.   ...\.... .. \\. .. .. .. . ... . ... ..#. . .... *. #.*.#..  #.#..**..*  ......\ ** ..##. ..* ..*. ..*.... #*#.. .. .. ## . \...*# #
#.\...#.. ... .# #... .*..#.* .*\......  .*.....#*. \...#\. .. * \. ... .... .#*.#.  .##**. #... . *#*.\.... . ...#....# ... ...... .*..*...  . ..*#.#
#...#\ .   ..#.. . *....#* ........ .*.*\.... *...*..#.###\#..  # .  *\. ....*#....* ..\. .#...* .**..#*.***.\.#\.#.\ . . \...\.\.  ..\..  \.. .\*.\ #
#. ... ..#.  .. ......\. *.  #.* \ \*..*. #\ \..  #..# ..#...  .#  .. .*# .*.#..\*....#**#....#..........#*.. .# .#.*.  .*.#...*. .*.#..... ..##  .**#
#.... .# *# ##  \#.*....#..........*.*. #.*..#**\# ..#.\*...*#\ ...\. #.\#\  ..*........  .**.*....  .\..  ..\. * .#\....... *.#.... ..\ .**..  .  . #
#. ....*.#. .....#. #*. . .. . ... .....\. ..*..\  ....*\....... .. .....*..*.\*.  .* .. ....  *.. # .. # ... . .* .#..#.....\. #\#.\ ....*.#.*. .#. #
#*....\**.\..* \...... .. . . * .\.  #..\#..\.   ...  * #  .. .*........ \.\#. *#....... ..\... #.. #....\.\ *\.#..##  .*.....#...... ..\..#\ *#...*.#
#.*.... ...*.*..*... ###.... ..\.. .....* ... .. .. ...*. ...#..# *. ...... .....#    . ..\\.*\#. ..*.***\\.\...#..  ...*.#....#**..*\*.....*#..\. ..#
#.. ..#* ...\....*  #..# .....*.*..**.. .... *.. #....\#....*.\#.....*.# .... **.**..... ..#.**# .  \ .* ..#....#. . .#..  . ..........#\ #.#.*. #...#
#\**. ...  #.*.\\\...*. ..*..#.# #. ...\#..#\#.....# #.*** . *. ....  ... **\......  \*.... ..*.#.*.....###. ..*\..\ ...# ......  .. .... *. .  .#*. #
## #..\* .#. .  . .*\*. ..\*.##..*.*......### *. .....\. ..\*# #.. .............*. . .\ .*.  *. ... ..*#*# .  #....* ..   #*...*\....*\.*#\.\...... \#
#.....#.  . .\ ...#.....*.* .. .#..*.*. .*.#* ...#.....* .\ ... .... ..*..*.\\#. .#.......  ..# ... .. . ......\#.....*.   ....*..**. ... .  ..*.  ..#
# .\*. \#*.. . . . ...... .*....# *. ..*. ...*.#.  ..  ..\\ ...##*.##.  *. ##.. .# .  \ *.... .......... ......... .#...*#......#\    ..*.#....*.*...#
#....#.*#*......#\... .. ..*\##  . ..  ..* .#.......## . . ... # . ... ..*.## * *.#..*\#... .... *....#.**.. ##. #.... .  ....  ..#. ..  #...\  ... *#
#... # .#.... ...*....\ \... . *##\. ..\..\. . ..... .... *..*# ....*.##..#.  .............. .#... .  \#...***.#.. . ..*. *.##... \... ......##.  .*.#
L.... .  ..#........*##...#.#.......#.* .*.\#.  #.#* . \ \ .# *... ..#.... #.*.. *.   .*..... *#.\#\  ... *. ..***....\..\#......   . .#. .. ... .*. #
#*   .   ..  ... *#.......*.*...# .#... ##. \.* ... . ...#..*....#*..#*.. . ..\.. .* ....*..*. *. ..... . ...  ...  . #.##.* # #*.\*..    . *...\ .. #
##. .. * *\ .. ...# #...... . ...#... .. .*  .*  .#\....#.... ...\.#..... ..*...  #.  ...#.. .* ..##. \..*.\*...#.. #.*.# ....  .. .. ..*. ... . ....#
# ... .#..*...*.\. ........ .. ..\ ..  *.. *. ....*........*. . .. *.... # *. * #....\#*..*..*#.. #.....*. ....... \ .*.. ... \**..#*..#...\....*..* #
#.......#.#.  .*. .#..#.#. **..#.. .#... ..  #.* # . # ##.* *  . \ . .. . ....  ......... .#.......*.* .# #.#*..#*...... ..\\\. . ...*  .*...*.#... .#
# ... ..#.....  .* ....#..\...  # ... . . *.. ....  *.....#\.* *.....  ........ #..#....#. #  .# ... *..##....*. *.. ...*...*.   ....... ..#. . .*#*.#
#....#.. ...... .#.#... #.##\... ...*......\ . ... ... ####....  .*  * *.* . .    #.. .* .* \#. ........*...#...\ # ..#\ #..  #. *. . ...*. ##.  . . #
#\ .#.  #\.#.* .. \.# ...... *.. ..\.. .**#.##. . .. .*.  *.....# ...*.  **....#..* .*.*..... ...   ....# ..\ .#\ . .*......* ##.#  .#..*.. ..*. #..\#
#\... *. .*..  ....# .\.*... \.   .*# ..#  ..*...... . ..*.#.. .. . .. \..*..\.*...*#..# #...... ....*..*.#... ...*.##  ....*.\#..#.*..*..*##.#.*.* .#
##..*...#.... .#*...#*. ..*.\. ..*.... \..*.....*#... . ... .. .. .##..... \#...   \\ .. .*... . #..  \.... *#.#... \.. #....  #. # .#. .   #\..*#...#
#........ . .... #... ..*...#.*..#. ...#.\...#**.. \#\.#.#...... .#. ..  . .\.   .*..*. .....#...\.#..........  ....... .\.. .*..... \ . .*.*# ......#
##..#...*. .##.. ......\.#*.. .* . .. ...... #..# **.....#\*...*#* ..*.#.# ..* ...#..... .....#.#.........* . ..*\..  .. .....**.. #... ....#.\  .\. #
#.... *... .\*........#. .....\*# .\..* .#.*#**\..* . \.*..\..... ..*.....\ .  #* . . ..# . *  ...\ *. ..\.. .\....\ .#.#.#....# .... *....#.\.*. \ .#
#.. #.\. .\  .\. ..*... ..  ...\.. ....*. \ #.*\* .. .*##.. ....\..\.\ .. #..* *. . .   .\....\. *. . . * ....*..\ #.... .\. ... .#.*#... ## .. .\ . #
#*#.# . # ...#  ........ #.*. ...  ..#...*..* #*\.**#*\.*...\ .. #. ..#*.*.  .... .#. .#......  *# . ...#. .. #*..*....*....  ....  ...\#... #*..#.#.#
#.. . ... ... .. .. # .....\... ##...###.. **.#* . ..  # * #. # *. #\.*...   .. \.#.#.\..*\*...* ..\.   * .. ... .. *........  .\*.. ... ..\* * .....#
#* .. ...  \#. .#*...#.\. .#.\.*....*.**.*.**#.... ..*#  *..*....\\. ....... ..   *.# ......#.#... ..*\\ #\\.#........*......\## .### ....  .* *.*.  #
#. \....#.. #*  .#.#.. . ...*#...*....... .\... ..#*.........*.*. .#.###.\.... ** ... * \ #...*.*.... #.*** *....#..#.\. *#..   *.. ...\..\  #. .*. .#
# *.*.\.*.* ..#.*. .##.*...\#.... ... .\#.. .  ..*.  *... #..*.  .#.#.. * .# \.*# .##**..#..\  ... .. . .. .*.... ...*\....*.#.\ . #*.#.  ..*.#. .*. #
# . .... .\.#***\.....#.   .   #.\\*...*...#.*#.#. .\\..*.\.......*..**.*\ .*..   ..*. \...\*...#.##...  ....\ # .. .. *...\... ...... . ...#*... ..##
#. #....  ..* * #\.. *...*.......\ .* .........\  .....#. *#..*\#....* #.  *.#....... .....#. ....# .*#..... . ..\. *.**\..\....... .....\# \... ...*#
#...*. \ ...#... ... .......\#.......# . .. .. *.  .. .#...##.  # .#..\...*. . . .. . .. .. .#.....* #. #..*.\.*..# *...*..*.\\.. .* ..  ***...#\.\\.#
# *..**...  ....*.........*. #. .*...... .* . **#....*.#..#.\.*#......**\..*\# .#.#... ...#.\..*.....*.......* *   . .#... .........   \...# .......\#
###\.\..*.#... .. *..... #.*.....*.........#... . .   . *..# .#.*..*.#.. ..\... *..*.\.#*...#.. . **...\ #...#....*.. ...#..#..*...#*..\* \.....#.* .#
# .. ..* ... . ..  ..*.#\* *.\. .  #. .*...*..*... . . \. .\*.....#  ...#..\ .#  . ..\...... #........*#..\....*.. .# ........*.#. ...#.\#   ...... .#
#***.......*. # .*.. ..... ....\ *.*.........*.#*.....  . .#.\.*.....*# .#.*. .\*. #. .\*...\  *...#....  ... . \#..... ......*....... ## *..  .#....#
#. *. ...... ...  ....  .\.. ......... #.  \. ....#\... *..* *.* \\...*..*#*...*.*#. ..#....*\.\ #. ...  .  . .\........ . .*....\ ..........* ... ..#
#..\..  ..\. \..#... .#..*..*..*.*...# # . \.. .#...*..... . ....     ... ......# .......... .. ..* ..  ..#* ..# . ..* ..* ##.#.## #..*...\..#.*.... #
#...# ##...# .\.. \*#. ..*...#.  ..#. .....  **\*#..* \ .#...*   ..##.\. \.#.. *.. ..##...\#....... ...  ....*#..* ...\\..#... \ *..*  .  .**. ..* *.#
# * .. #...#. .#.......   #.*. .#...*#.\#....  # ....R.\. .... #.. .#\#..#  ..*. ##..*###. .#.  .. *.  *\.**......  . #.   .. .......*.\. ... **#... #
# .  ...* *.# #* ...\. *   . .#......*. ...*# .\. . # .... . ..   .* #....\.. ....*..*.*... ..*  .# ..*.#...  *.... .  .*...# .. *.\**. *\.*.\\......#
#... #  .#......#..#....... #... .   ..* .  ....**. .. **  .# ...... .. #  * .\ . . #. ..*....#.* .*...#.......#.... ..\.# #  .*.\...#.*.. ..#...*...#
##\ .....\#......*.##. .....*.*...* .\...*# ... . \\.....#\. . ..#....###\.. .#\ ... ..*##\ *\..\*.*...*...# ....\. .*  \#..#..##. .**....\ ....*....#
#.#.## .. . ...  *. *#... .....  ...*# . * ...*#..# .. ..\  \ \.... . ..# ...#...#  .. .*..*... # **. ....  ..# ..\*..\*.**....*.  ..* . * ..#. .. .##
##..#.\.*.#....*..*. ## .. .. ..#. .. *..#*#. #..# *.. ..# \..##.*. *...#. *\ .. .. \ ..\.. # *...\....*. .. .. *.\ .**.*\ . . * .# ..#..**.. .  \...#
# . .* .#.#..... ....\...# .. #*. #  . \.. . #* .\ .\..* #.#..#....  ..* # #*.#*.*..#\.* #..*#.  *\*.  ...* ...#.*... ....* .. #  .\. *. ..*... ..*..#
#\ *...*.#.#.\*. ..*..*\..*# .#....*......##.* ...#....\*....  ... ......*#.#...##\......#.\.......#. *#. .#...\.........\ ............#.*.. .....\.*#
#\#  #. ......#...  .... *.*..... .*. **.#....*#..  . ....*.. . \#.. .. . #..#....#...##.*...*\..... # .   #\#.\**... \..   ..\. *. ...*...... ..... #
#. *.#..... ..#*.#....*.... . *.#... #   .. .   #. *.#.*\*#..#...   \..*. * ***. .*. .\*.*.*...#*#... .....*.#...... . ..#..  . ..\#.*##.  .  . .*.# #
###..\.\ .*...# . ... ... . .* *  \#.*.\\  #..#....##....  . #... *..*.#...  * ...\.#... ...... ..\. ...#.*..... .#.....\.**.* \......\...\. ..#... .#
#..#.*. *..## * .\* . ..........\. . ......* .. ... *#   ...#. ..*..... .....  .* ....##.*..*..*... ..#. #\...*.. *..\#. .......**...#... ... ... ...#
# . ..**. #\. .... .  ..  .. .\.\#.#... . .\....  .. ........##..#.\.**#.......* ........ .*... ...#..\......*.. **...**### ........#.. *\..*\.......#
#.#.... ## #.* .#.#. ..*..... .  .#* #... * .#  .#.....##. .*\\ **...* ...\\.......\.* #  . ..#  ....* ...*.  #.. *\ . ......# .##.*.*..\ ....*.... .#
#...# ..#\ #. .*.# . \\#. ...   # *#*\*\. * \* *.... *.........*....* #\.. ..#.. #* ....#.**.. ...* \\...#.. .... ... ..*...  ....##..\. *#. ..\ . ..#
# ##..  .* .. ....#. .\ .    #.. # *#. #... ...  ......*.. *\.\\. .#.. . .. ##...... .......... ..#....#.*...*. # .*. .........*...\... *.*.#. .. . .#
#....  . .. ..... # *. .... *.\*.*. ..\\ # *\ .#  .....*...#.  ...#...*\.  *#... .. . .\... .#*.. .. #..*   .....\... *.*  ... .*# #. .#**..\*\... *.#
#* .\.*... .#..#....*. .....*.  \...#  *...*.**.  ........*.*..*. .##...#.#.. #.. *.*\ .#. ..... . ..... ... *##....#.  ..... .... ...# #.. ..**. . .#
#* .* . ..  ... ..* *#..# *#.......#**.#...*. ....#.\. *#. *...\.. *.... .. ...*..#\.. *. ....## ..#.#.\..  # *  ...# # .#....#.   *.  .#.\...*.. .#.#
#...\# .  #\*...*   ..#.....* ...# .**...#..#...#. \..*#.... #.*. \........*... # *... .... #......*..\. .....*.#\*. .*........# ..\.. *##..#*#.# ...#
#...........#.. .......\..*# .....* .*.#\.*** **....*.. #*.*.. *#.#.# .\\  \# .*. ..*..  . *. \*#\..\ #. ..*.#.\# ..# ..* . ....#*. *   ... *** .#.. #
##..*  ...*.. .   ....#\..*.#. ....\..#. ....*..*....... . .** ..#.*.....# .....* .*#.*. #*.#.\ ..**... ....#.#.. ...#.....*.. *....#..*#\ .. .##. *.#
#...\# .... .#...#.. ..... .*##..... .....\ \...\...\..#.... ..\.    ..*#...... #. .... ... \  #..\#..  . ...\..\.....  *.. #...**#..#.#.\*...\. ... #
#.. ....  .* ..* ..  ....# ..... .# .....*.. .# .*\...#.* ..... ..*.........#. . . . \   .##..\.\..... .*. #.#.... .   ### ..\.#*.. ..#..#......... .#
#.. \......... ....\  ...... . ..  . ..... *..#.  .*.*. .. .......# \ ...#....... *.... .# .. .\ ... .* #...   ... . ..  ##...*.## ** ..*..   .\ ....#
######################################################################################################################################################