######################################################################################################################################################
#..\.\\..  * .. #..#*..**#  .*.*\.  ...   .#.* .. ... .###.#..*..*..#... ** ....* . ...#\. .*. .....*.... \.#.. .....\....#. ..*.\ .\. .*.# .* *...#.#
#.*. ... .#........... #.* \...*. ..\*#..*  . .* *\...#.*. .. .#*. .\ . .\*...   .. * . ..**..#*........#. ...... .......*.* *... ....  #..  .#*. .#*#
#.. .... \** \..*.  . #\##*.*.  . ..#.\.. . ..... .   . .* ..... ..    . *# ...*. #..#*...*...#..\\#* *.\.*...\.#*\.*..... #  ........ *## .....#..\ #
#.. .*.#*# .... .. .  # ....*...* .. \.  \ ..##. .## .... . *.. * .\.#*.... #. *. #\ ....*.#.... *  ... .#\.  ...\ .#*..#. .* *  . .#. * ....#.#.... #
#......  .* ..#. .\...* . #..\# *.*#..#.**..*..*..# #*.##..#.. .\..*.. .....#. ....*.#. . ...   .#...\......#*... \*\# .* .  .........*.\.... *#*..#.#
#.*..   .. ..\.\.. ..\.....\.\..*.. ... .* ..#. #....... . #. . ..  . ..#.. #....*.*...#*.*.#..* # .. . . ........\...*..\ *#.. ..#... #*#. . . . ...#
##...#  *... *#..#*...#**# .*... \#..* #\.#....* ...\. * ..\ *\ \.  .\.# .... .. .# # ... #  **.......*...\..# .......*  ..   ... #.#*  .*.**.# . . *#
#* .# .. *##.*. ..#.##..#...... #..  .  ..  ..*.\... #.  ..#.. ...#.. ..  *#. **.\..# . * *. ...*. .#\.#.# .. # ..*....\#.\* . .*..#*\**...\..   ...##
#*#..\.*. *.\  .\  ...*.#........ *  ...\..\. ..#.. . ... #..*... .. .  ..##....* ....  \\#\*.# \.\.......##.#... #   #.......*.........*. *.\\.* ...#
#. **....    . #.#*.#...#*. . \ *...*... # .. .#. .. .#*. \*..*  .......\........## ..*...  .. ....#  \.# #..*.\ .*. . ....... \ ##..#.....*. # *..* #
##.*\ ..... ..#*#\..**   . ...*...*..\..*... ..\.. ....##.. .....# ..*... ..#.  ** . ..\....................\*....... ... ..\\... ...*. ...#.#.#... ##
#.  .##...* . . .  . ..... .*..#.*...#....\#..... .  . \\ . .....#. #.......  ..*#.*. .#..  . .\.. *......... #..*. .#. ...* . #.*..*........#..#** .#
#. *  *. .*...*.\.* .# ....#.*....*..#.* .*.*  *.. ....#.** ..  ... ..*.. #...*  #.#*..* #.  .... #  \.. *.... ..##......... ...#.. .... . ...#. \.###
##.\....\#...#.....*  .\.. .  ..\... .### .  *.. . ...\...  \## ....\**... ..\\.#..... .. ..  ... ..#....  ..*..........#.. ......*#.# ...\..#.#.. .##
#....... \ #..*.# **. ..**... .  .*.# .*.*\ * ... ... . . * .......*. * .#. \#*..\. ..** .....\........ .......# ..*..#.  #.# ## .*. # \.#.\\\*.*....#
#.#...#.#** ..\.##  .. ..*.#\ #. . ...*.*# ...**.  #.. **...*...... ....*#*  ...#.#..*.*.#....\ ...# ...... .* .. *#... .. ......*... ... . *.*.   ..#
#. . .\.#..*. ....* .....#. .  .#....#. \ . ..#*....\..........*\... ... ##.\#*..  ...**......###..\. .#.... ..  .#*..# .#... .#...*.#    .\.*. .....#
##.\\.* #..#  \...*.....*.*...*.* ..... ..#.*... . #\. .. .*  .*  \*#. * \..*.... . ....... ..\#.. ......\..*##...  ### # *# ...\. .. .... ..\**.....#
#.*..... .....#\\ #. .. .#.\.* .. ...  .. \....\....\....  .  .#..*..#*.\.....#.\.*..#... ....# ..#......*..\..***.#.*\. ..  .\#*...... \. * \# .\#. #
#.... * *..*#*.**..  ..#\ ..#...  . .. .  ......#.....* # ....**.. #.\*   ...*#.*\..  \.....#...\..... #........... .* .#.\#  #.  . ..#.. ...# ... ..#
##.. ....*...*..* * . ...*.. . .\.** .. .....*##\... .... . . .. #..  .. .*..*.\*## *.*..*  . # .#.\.....\#. ......#.....\. .\. .#.##. .. *.. ... ##*#
#.. ..# #\  ...*.#. #* #.*  *.#... .... . ...  ..* . .*....* \. ...# ..# ... ..\.*# ..... ... ..*.*....# #*..#. . #..#\.  .  .**#*...**.# ..*#*  ..# #
#...#. ....#...#.#.....#.  .... \. . *.#. ..\.## .* *. #..*.... #  .  . *.#.* .#. #\. .#..... ... .  .  .*.#......* .. ........\ #. .#..  .*\ ...# . #
#.#.  . .... . .#. .. \\..*   ..  ..... .... .# ..# .#*....\ **......*.# #.............. .. ....* *. .##.. *.#..*. . ....*...*..*.. ...# .   ..*.. .*#
##...*.\........#... ......*.\.  \#. .* \....##.* *..... \ .. *.  ...* .**.#...#...#. ....##\...  .*..#*....   *\*.***#...#...*.. .\......*.**....*  #
#  ... ........... .. ..*..#\..# #...  . ..#....# .#...\.#...##*#.... . .#.*. *#..   ..*#\................  .... .#... #. .#....#.. **..# #.. ..#.  .#
#... .#. #*...*. #..##.#...#  *\. *.* .#.#..#... ...# #......  ##  ...... ....#..\.  #...# .*\  ..#.#.. ..# .#...* ..\*....#  #.. ... ..##.##\**..  .#
#.*.#...   ..#  #.#*... . ........#.\\...*..... #.#..*.*.# ..##.# ... .#..*.\ ..#* ... ..#   #.#  . #... ..\  # *.*..**..  ....* ...# ..*.. .. ....#*#
#. .# ..\.. #.*.****.. ....#...#.*.#.** .#  .. ..**.*# ..##\.*. #... ...  ........ *..# ... ..#....#\. .. #.*.....#*.   *. #* .. .#.. ##* \\.**##*. .#
#. .... ...*.*  #..... ...\. ....  \ .## ....\.... *##*...\.*#..#..\\.#..#* .*\.... ... .......*..  ..#  \#....***..... \.. .....#.*....#.....\  . *.#
#.#.#....#.*...#.\#  .........#*.\ ...**.. ..   ..\#..... ..#....*.\... ##.##*.* *#.* ... ...*....... .# ... **. .\.\* .#*.. \..  #..#...*...... . .\#
#  ##.#..* * \ ..\. #.*.. \. .....*.*.#.  .....#...#.    #....#..\.#....#.... \. ...\. ........#.\..........#... .*\ .#..*.. ...*.#.#*.#.#. *\.#.# # #
#.. .... .  .. .#. . * *.*... . ..** ...# *..#. .*#... .  ..  #.\# ........  .*\. ............ *..... . .  ..#.#. ...  *#..#. ....*\ . ..#.*..#.#..  #
#\\##. * #.  \....*. #..   .*  . *.  .# \ ## ...*#.. . \ #....  .*.*#.#.\..# .#  \... ...  ..#.\\  *...* .\... *...*..\ ...#\.... ..... .  .\.#......#
#.\.. .*.\.....#....# .#\ #... ###..\..... ..*#.\\...#\.. . .  # *. .##. . ....\.#.. \...#  \.. ..* .\ ..#  *.  ......\.... ...#... ... .. .. . ..**.#
#..*#...#....\ .# .#.....*...*\..#.#..# #.*.. .. .*** . ...*# # #.#... ..... ...*..#.. .*.\*.*.*..#*.*. . .##......*.*.#\. ... .* .*..*.... #... *. ##
#.#.....*...\ .....*...* ...\..#..\.*. ##.... # #\..*#### .\. ....... . ..#*.. # *.....\ *.#* .# .\....*...\. #.#..#..  .\.*.# *..*...\........ .. ..#
#*.*  . ... ...  *.  .*....*..*. ..#. .....#.**  .# ......\...... ......*..#.*.*  .  . \...# ..*# ... ..#. ...\..  .........#...#...... . #.#\ .**...#
#....*. ..... .. . . .##. #....##......\#...*\* ..*.......#.  .*#...... ..*...  \.#.. # .. . ..**.....##.  *..*....\... * .. ...# .#\..*.. *..\##....#
#...*\..#.... .. *.......\ .#.#.. .* ..*. . .*....#... * ....#..*.... . ## #...   *\.#\\.....* . ..... *  . .. #....*#..\. \....\. .. ....  . ....\..#
#*#...\.......\.. ...*.#..#.....# *. .\*....\..\## ....#..# *.  ........**.**..*..*..*.#\. ... *. *..#..............* .#...** ..\. .\...#. ....   .. #
#...*. ...\..* #.#..... #.*# ..* .\ ***.# . \. .  ..* #.. #.  *. #*...#*##.*....... .#.. . ...#. . ..*.    . # .#.  .......##........# .. .. .    ####
#...#.. ........ \...*.*.\.. ....*.... ..  .#\#. **....#.##   #*...*.#\..#. ..**\*.*.*..*  *..# .*#... ......##.  ..  ...*..\. ...*. #...*. . . # # ##
#....   ..\..  ..#....#....... ...... .. *   # .*..* # *.###.*....... *..#..#....\.  # # #.*..#.*. ..\.#...... .... .\ .*..#.*... . \\*.. *..... #. .#
# \*. ...#..  *.#.# \#....*#........* .#.. . ##.......... ..#.. *.*. *. ....  ..#.\...  \..\.......# *##\ . #.   ...#. .**..... .. ..#. .#. ##.#.# . #
#. ...*.. . .#.*.. .   ...\..\\. * \.. ...*..#.... .#.....\.. .  *.\.   \*....\   .*.... # * .   .. .........*..\*.. ....*  *...\.#.. .. \\...  ..*..#
#.  . .# .. .......# . ... ... .  .*.... #.#........#. **.# *.\..*......\.  #...\....*. *.#* .....# .. . .#..\..*.*.#...*.#......*.  *.*...#\ .   *.*#
#....... ... ....  ..  ..#. \.#*....#.....#.. *.*....#..\........ ..#.#..#. #..#....# ... ...    ***.  ...* .. * ..*\.. #..  .\*.   .\ *# * .......#.#
# ##.. ... .. ..*\ ... . ....#*..*... ...\.#*\**. .. #.#*..*.. ..#.**. .*. .##. . *... ...... *\..\...#. #......*#......   ...*.\ .. . *....##.. .  .#
#..... ...# ..##**.\.. \.. .... .#.  *..*#.\......**#.. ###....  ..# ...#.#*# ..... *... *.#. .. . *#.\....# .#.# **...\*..\.*...... * .*..#.. . ....#
##*.*... ..... . \# ....*..\.. #\. #.. ..# .\.. ..#.  #*  ## ..*.****.\. # .\....#..*..#...#. * .. ..# #.#..#. ..#*..# .. . .. *......*.... *....... #
##  .* ... \ . . ...   .# ..*\ .#..*.*##....*##. .#. ..*.. .... # . .*.. .* ....*# ...#.##....\.. ....# ..*.\...*** *..\... ..#..#.... *.   #. . #. ##
#..#*...  *.\*  .#  .. ...  .. .* ..*.....\.#..*...... .....#**.# .*...  ... .*.#*  ..#. .\ ..\**.. . #  #. . # ..\..*.. #\. ...*.  .... ..   ..... .#
#\.... .\#. ....#..##.#. ..#..* \. .  . .....#...#. .*...#\.#.\.\.. #  .*....\** .*.. .*  . ..#....\.##...\*\ .........*.....#.*.*...................#
#...\ .. \..# *..#. *\...*... .. ..#.. . ..##* .. .*..  ....\.\.. .\.......  .  ## ....##. .#\ #   ..\. \.# ......\* *...#.. . #.. ..*# *.*  ...\.#*.#
# ###*......... *.#. #..   ..\#.*  .  .#.........\.  \........# #. .... ..\ . ..* *..*......#...... * *...... *..#.#.... *.#...##\#. . ..#. .#.#...###
#.##. .\... \.. .. . * #. .#..  . .*. .*   ..... .\. ....* \.#. ... . * #.. .*. \ .\ ...  \#\.....*## *#*...  .#. . #* #. ...... .*\ ...#*  .\..*....#
#. ...#.\. .. .......**.. #..#\ #\..\..#.#.. . \ ##\.....*#. .. ......  **.#.\.. \*..   . .\.*.##.*\.\...\.. #\#. ..##.\.#..#.. .# \..#. ..   ..*..*\#
#*......\ .*...*.#. . #\\. *. ..*. ..*#.\..*....  .** .... *....\ ..\\*. .*#.#.   ..* ... . #..**. \..\. ....*.##.*.*.#.....#\ ....*....*\.. ...*..\.#
#.....#.* .#\.....# ..    .\.....*.#*...   *..*...#*.   ...\#  .*.#....\..# .*# . .. . #.    ..***. \*#. *\..#*.# .#..\  * ...*..  \.*#...#*.........#
#.. .. ....*#..*....\. .. ..#.. *#*. .*.*....*.. .*....\. .**... ...*.. ......\... # #.*.. #.   .#  ...... \\.# .#...\ .... ...\\. .#.#*#. ..*.#...# #
##.  #...\. \... ....*#...#\.# *...... ....**....#.*..#..#  .*..**#.#....**  ..*.* *..... ....#..#..   \..........  .. .*#.#... ...#*.\ ..#*..#*.*...#
#. ...* ** ..*\\..*#.. **...  ... .* ..#* #. * . .*...\ ..*.*.... .. ... \\ ....*.. *..* .\*\* .*. .\... #\ *......#.*..\ \.#\ ..*. .#   *.. . ......#
# .* * ..... . #.#...#. .* #.* *.*.#. ..  **#*...  #.\....  ..  .\*.#....*\. #***..*....#*  # ....  ...# . .*.*.........\#. #*#. .  \.*....#  ..#....#
#*\.  ....*.*.\.\..#...\.#*#.*....*#........  ..\ .... ...\ **.#. ..\*... .#..*. .\#...** . \.....#..*.**  #.. .. ##.# ...\ .#....*.  .. .. #. ......#
#. #...* *.*. . .#........... ... ....*... *..\ . #*  ..  ....  .*.   \*....#..#. ...# #...*  .\ #...#.. .  .. #..#.#.....  ..*....   .##.... #.....\#
#... * ..  . #\.  *  .... ....\... .....  . *\ ...# .**. .... .. . ..  # ..#... .\ ..#.. ....\ .. #.*.....\. ....*.**\#.....#..*#  *# .\#.... .......#
#.. . ....*  .....  # #*.* *#\ ....*#...  *  .......\#*..*.*. .*.#.......  .... .\..#.. . ...*.... . .*.#*. \..*..... #.*  ......  .#*.  \\ * #.. #.\#
# *.#.. . . . .\.*.*.\.  . . .#*.* *.\ .... ....#.... .  ..#.\..\.  ** \#.   . . ..# .....    ..*..*.##.*..#.\. .. ........* .\ .#..##.*..#. .*.... *#
#.....#.... .#..**..\# .*....  ##.*.#...#.... .*. . . ...#  #.*.\   #.... .*... ##  . ....\  #.. .#*##. ....*.* .\\. *.\.....\.#.#* # .. .   .* . # .#
#... .#...# .. ..  ..... .. #. .. .....\#*. ..*..  ..#.##.....\**  .#* ...#... ..*#......\..  .*.*###\....#.*..*.#. ........ .. . ....\....#*# ...\ *#
# ....... *..*.* .#.. ..*....* *# \#........  ...*..# . .** ...*#.#.... \.*.*** . .....* # .*..\  .\ .#.... *.#.#...\..\.  .. ...#***  #* ......\  * #
#.#..#.* ...\.* *... #* *.*. #. . ...\.... *\. .. *. .\.*.. \ . ..*..  ..#**  .#.....\  .........*#.\\........#.*. .......#. .*#* .. .....*# .*#...* #
#.#....... .  .\.. ..#....*... R.. ....*#.##.#. #..*.\..#.*..*.... *.*... \. *......... # *.\##..* . ... ....#* .. *.##.......#..*..  .. .##...\##...#
#\.**.*.. ..*##..\  ...*\.\*#.# . . #.# .  ..#\#*  #*........ ....#..\. .**.\..*.\..\.....# .##  .\  ..\\...*... ... .\#.*# ..*.#. \  .# .... .#...#.#
# .# ...#. *. .* . . *#..*.#* .*. ... \. .*...*.*.....#. #*  .#.... ....... *#. ..... .*. .#.# # .# .........   . #.. ........ # .#..*  . .#  # **...#
#........... . ....#..  ........ .....#  .\# #\....*#.**. #.....  ... .*\....##..... .* \.#* .#.\..  . . ..#.#..*... . .  # . . .*.*\## . ..# ...#.#*#
#...#..\.....**#. .* #.#.*....#.* .. *.\ . ....... . ..  #.*.\*#..#*#.*.#...#....* \. . #.#\.#. *..\*. ...#.........  *#..  ...... *...   .\....*#.  #
#. ..#... .\. . .*......*  ..  # .    .*.... *.. ....# .##.. .  .....# #..#..\..*.  ..**.*..#\.#.*.*.. .... .\..#\#........ .\#. ...\....#...#\.....*#
#... # ..\*..\ .#..\.. .*. ...#*#.....\ ....#  .*#.\.**..#.. .\...*##\.\.##..#  \...#.. ...#*..   .*.  .....*#.. *  #*.... .. ..#.*.*.... #  ..#... .#
#..... .#. . ....\ . \\  ... .*. ... .**#.#. .\#.. *.\# * .*...\....#. .#\#. ..  \.# ..**. .. ...##. \\..  #\#  ..#.  . ....... .. #...  ....  \.#\..#
#.... # #\*.  ..\*#....#   .#*. ... ..*... ..* . ..... .... .#*#*  . .. .  ... .. . . .*\#*..#...##. ... .*....\.#. .#.#\ *  .*. ... *...\#.*. . . ..#
# *.#.*.. . # *. ..# .** .\ .   .#* #..*...#.  ....#\. .... ** .* **  ## # .#.#. \# . *.# *........... *..*#.....#...   \.....*.. ..\.. . #. .\... \.#
#.#.*. ..**#. .*.  \...#.\*......#.#*.*.. .......**#..##.. ........ . .*#. ..## * . #...# . ..\ #....*. *\.# ..\..#...*.# .\  ##*.   .\ ... ..\ . .#.#
##. ..\.*..*..*.\.... ...*...   #.# ..#. .... \#.. ... ..* . \#**.#...#  \.#.......\.# \ #..  .#...#..* ...\   ..#**.# \ #.. ..*#. .. .#..#...*...\#.#
#.*...  ...#...#...*.*  .*.**# \..#..*.\..* *# .......#.\..*...... .*... ...##.  .*..#*# ...*.#... \.\ .#..#*\.# .*.... . #..**.#.#.#.*\   ....\#\. *#
#... ..\... .*\..#..  ...# . .\..*.. .\...*... #  .## ... ...**.*.  * #   *... .\.... *. .#...\.#. ..\ *.   #..*...*.\ ..*.\  .#.*.. .....*..**. ##..#
#..#.....   #.##. \..*#....*.#.## ...#..  \*.*\#.. .*.*..*.*#*...#.....  .*.\.\. .. #  \ ...*.\.. *..  \.. ...*. \. ..\.....#. *....#....\#*.. .. ...#
#\.*..*.*..*#.#.    .. .\#.*. ...*..*.*\*.*.  .. ..#... ......## . ... . . ........#.\#.#.\ . #*.  ... .... ***...#\.. #....*.... ...#...\ *#.. .....#
# # ..#.\#. ....#...* . ..... .*\.   .. \\.. * \.*. ..... .. \.....*..*..* .*... *  ..\.*   ...#... .. .......*.*.....\..   . ..*...*.. ..*. .. ....\#
#............## ..  ...... ..* \\*.# ..* # ...* .*#. #...#..... .#\.. .... .. #* .....*.  ..*.# #.*.##. .\*.* .   *. .  .#\*............\# .. *  *...#
#....#..*.**...*.. #. ..\....#...# ........*#..... .. ...*\**. # .*....... ..# ..# *. #**...*...*...* .. .#.#*. ....... ........ .#    *#\ *..\** .\ #
# ........      ..#.. * .. .#........ .#.......#* ..**.*. ..# ........##*\.* #. *  ..... .**  ..#.. #...\...*........\....  ....  ... \ ....*...#..###
#...#...*..# ...   .#\.  .* ........ .* .. #..\.. .#*#\.\.\...... ** ..#. #...* *..\.. .# *#..*...##. *. #..*.**.....  . .####.\...\ ...# #.*.. .#...#
# ............  .  *.... ...\...#.#.. *.# .# . \... \#...*..*\  .*..   ... ....  ...##  *....#. .*.*....#.#..#..# ... ....  .. #  .*. .\. ...#......##
#\#..*...*.. .#.# ..*..* .. .....#*. *. ..... #...##*#.. *.  ...  \# #...# *......* #\\ #.. .. .  ..\.*..#\..*...#  ..*..* \ ..#.....*.. ###.*..*...\#
#. ...*.. ..  . \  .#.#*.. ..... #. .#..*.. . ....#. ##.. ....... .*##\. .\.. .. #  # .** ...#.*  .#...**.*#... .  .#....*.*....... .\...... ..*.....#
####**\..*.#\. ... ..##** ...*.\*   #.*\. ... .....\##....*.... #...# *#....# #..*..\. .  #.###.*.. . ...*.  .* . ....\.*.#  . #\..# #. ..# .# #.* ..#
#  ......*........#\. *#..\*.*.\.*#\#... ..**. # \  \\...\..##. #.. .*.*.#. #.#.* * ..... ..... ... .#. ..*. ..\.  ........ ..#*..\# . .#...* . ..*..#
#...*.. * *..# ...#..##*\\.#....*.*. . *  #..\  ..#...\.. * *... #.*.......*#..#. ....#..\ ...#*..   ..  #*.....* #. .* \. \. *.*   .*\.#....*.. . ..#
#..  ....* #.**. .\...*.* .*....**.*........ *..#...* ..* . ....**..* .# .#.. .#...\....\..#.*......*......#*# #.*... ......#. ..\ .\.........* .....#
#.\.. .*\....*  .#. .*..#**\* .* .\ ..**.#..# .... .\.\ ..  #* \.\...\...*. ....#*...\....  ..\*.#\..*\#.. #.. .# ##. ....\*.....  ...  ...\.\. .* . #
#* *.#..  .. #  # .##..#...\*. . ...\\*\#.. .# .. ..#...... .. ..... *..**#*. .   .....*\...*. .. \.* ..  .. * .*....# .* . ... .#.# *.#.\#  * #\.#..#
#.##\\**.*. ..#*\... ..# .   *..*..* .... * .....#. ...##.. . . \.#......     .......*.#* ##.#\.*. *.*#........ ...* .*...#.  \**.  .. # ..  #. ...#.#
#.........\ .*#. \...*........ ...*..* .###. .# .. ....*.. # .#..  . \.....  #.#  ##.\#*\..*..**. *#...#\... *. #\# ..*.... . .  .*..\.. \ .  ....\..#
#......*.. .# \#*..# .*.. . *.. *. ..#.*........... ....*.\ #....#*.. . ...\*. .. .#.  ..... . ...# .  * .# *... \...... .*. .###*..#.........#.. .*.#
#\...#.#...#.....*.... .#.. ..*#.....\...* ..##*. ..#  ..* . . . .....\.#\ .#. #*.... #.. . *.#.*.#......*.....#.#. *.......  ......# .*..  ....#\...#
#*..# .. \.. .#.....#..*... ... . .**. .**..\. ..* * .*.  .\\. *... . .*\..# \.  * *..... .*. . ..\...*#\\\.*... *..*#..# #..... ..****.. ...  \. *..#
#\*#. .*..\... \..   . *. .\. \. #.*#.*.....#....... ..#..  \..... ## #.#...*\ ...*..*# \ . ... *. #....*  \. ...\ *..#.. #.....\... #... ...\...\...#
#.\.....\  .\..*.*.*....... .. **...# *... ......\.....\.. *. .#*......*..\.. ..  . . ..\.#   \.#.. ....   ...\.##. . .....*...... \\ #. *.  #.\....*#
#. .#   ......#... .#.. ..... ## .\* ..*.   #*.\..*.. #* .........* ... ...*..... #.. *..*.#  ..*.\\ ..*. .. .....##.. .*.*#.....*.. * . # *.......\.#
#..*....#.*  *.. .#   .#.#.*.#.....*. . . \.*. . ... .....\ . ..\....#.##  .*..  .   ..... .* .... .*.# ....*. #**...*.#\..*.\.........* ..  .**.....#
# ... .# ...# ..#.....*# ........#..... .*...\\ #....  *  * * *.... .#.# .  ..###.. . #* \#.....  .# \....#\\..... #. .... *#..*... .*.**#*.. .... \.#
#..# ..# ...*.\  *  . ... .#  ....*..  ..  \ ....*. ....\...*.. * ... #.*\#.... ...   .\. *......\ \ .... ..*..# ......   # ..  .. ..... # .. #\\....#
#*..\##.......##. ..*.. # . *  *. #. #....#.. .. ..#. .... \ *##...**#.#*.***.#*.\#\#.\. .  .......*....\ .. ..#**. \...* . #..#.  . ..## * ....* ...#
#.. ..** .#.* #..\..*.  . . ......#...*. ....#...*  . .\...#.......##  ..\..*. ...  ... ...\#...*..\..#..  .. **...#\* . \ #.. . .*..   *  *...#*.#..#
#* ...#\*\... ....*# . . . .....*.*# .\ ..\ .. *#. . .#  .#*.\. .. *\.##.#. \.#........#.#... *.#..   ..#\..\.* * .*....# ..*..  .. *#. .*.. ..... *.#
#.  ..*..#  .* ... .\ .*\.. .## . . \*..  .***.#*.\..*#*.\.#*. . #...##..... ....*... ....\...*. ..   ..*....  #*....\. \#. *.*..*.....*.......  .#. #
#*  .# . . #. #.*...**#. .#..... ..*.*#\..  .*.  .\....*# ..##*. ... ....#. \#*..\.....#. .#.....#.....*..\.*. \....#...\*..\...  #..\..##.... .\....#
##.......#..*. ...*..\*.#.....*..* \ **  ..\.* #. . *.#.*.#.............*.  \*#.... . * \ ... *.*.# . ...*\  .*...* .... .#*.  .. #*.# ..  .  #..\#\.#
#**# .  ... .*. . * *#... \#.......# .#..  ...*. ....   ... #  ..*# ..*... ..*. ...#  \....#... ......*.#\ **\#\....#\#... .... #.\.... ...*..#  #. .#
#.  ..  #.... *. *.\ *...  *\....\.\.##.###* #*. ..... ..\#\.# .......###.. .\.*..# .. .*#*#..... . ...... \ ... ...*#. #\..*.\..\.......\. ...#.*.  #
#\...* .#..#.*  *.... ..* .. .. ... *\#.# *.\.#..# .. ..*\...* ....#. .............#** ..#..#.....\\#.#......  .. #.  ...*........#..... ..... .. ...#
## \\**.# .....*.....#\ *... .*. ...  . # .\*...##.... .. ... ........#..........*..##. *...*.........  .* ....\.. *.#. * ...*...   . ...*#...\ *. .*#
#*.#.....*...#. .\ ....... .\  .*.\ ....\.\.\.\..#.. \...*. *. . ##  .. ## ...* .* .. ... ........#......  .##..##... ........ .#.** ..#. ....##.  ..#
##. ... . #.#.\.\...* . . ....# .. \ ....*..... .#...#.*.  ..#*. ..... ... . ... *#\.* . \..# .**.\. ..#. ....... \.**#. .  ....* #  *.*#..*.*... .*.#
#\ .\...*.  . \#. *..... .##... #.#..\ ..\ .#. .  ... ..* *.*.... ....#........#*.##.*\.*.*......#..... ... *  ....#\ . # . .*. **. #......  #...\.# #
#.. ...  . \....# . ... \#. .###.#   .......*.. .*.* ...*. ....*............\.* #..#.......*.  \ ... . .#. .. . #...\..*..\*. # . #.... ....*.#...* .#
#*.. .# . ........ .*.\ \*.. .  .. . *.** . ...* ........#*.\.#\*..#   #....#.\# *..*.....*.... .   .... ... .* .#...** ..* .. *...\..#..# ...\..\.# #
#..*.. .*...... . .\# ....... ......... . #* ... .#..# #...\... .#.. ...\ . ..**. .. .*   ......#\*#.... ..**... .. ....*\.* .   ...#.#........\.# \.#
#....\ . #..#*\*.... .*. . ...* .*..*#.\ . ....* . *....*.#\...**.  * ..*.... #..*.*...  .... *..*#.\.# #..*.   *   *..#.#  * * .. .. ... .*\#.#.....#
##.# ..  .. *.... ..* \.# ...*  ... *# ..... ...\..#*..\.* ......\... .\... .. ... ... . \ ....#.\....* .#. ** .**. ...... #.\ . .....   .  .........#
# ....#. .. .#*......*....# . \. *...#.... *.. ..... .*#...*..\#*.... #......# . ...*....*.*.##. ......*.#. . .. . #.** ..  ...........# ..#*.*.  .*.#
#..   #..  ..**.  #.\\ # *.  .... . ##.\  .\ #....#*...*..   .*.#.#...\..... ##..... *. .. *# .. *...#.  . #.....\*..* \   .# .. .........  . . #.   #
#.. ..* ##..*.* #...\.* #..* .. * ..*. #.#  ... *.....  .#\...* .#\.*. .\#.. ...... ...............\.. ...\ .....* ....**.\..*.**.*. ......#. .\\*...#
#. ...**# *.#\ ##.#.  *... .* *.#.\ .*.. *...\ #...\.  *...\#. \......# .   . #.........  \.. #...\.... ....#....... \ ....#..*.....#. ..#....#*. .#\#
#.* #....  *.... .  .....#..  #  ...#.  ...*... #**.  #.*.\...#.#....*   ..* .\..    .... .....#.*. #..*  .## .\ . ..  *...**.# .......#  . .#**.....#
#. ......#.. ... **. .....*..#*#..##...*.#...**.. #.  . .... . \*. ...*.\......#...*.*# .. **.*   ..*.......  .. .#.\....*....*......\.*.# . . ..... #
#\# ....* *..*#*... .....#**...* ..* .\*\ *. ..\. * #\..  . # .* .. ...*#. *..*.**...*..#.......... #  .# ..... *.... *.*. .*.#....# *.  *.# *...  *##
#. # . *\..  ...**... *\\.  ..\..# \ .*.\. ** #  .* .#*. #  \...*# ....... .#. ..\......*\ .\#. \ * #* .***  *.  .*. .\ .. #....*...*.. ..*.\  ...#..#
## ..*..#. .#.#....* .#.*.... .*#...\ .....\... .....*..*..#.*... ....*.  . ... . #.  .  ..# ..\ \\#. .\.\.. ....  .... ..*.   *   . . ..*..\..#.*...#
#.....* .#.... .#\..*.*... .  ..#. ....#.. ...*.. .   ... .\..*..\.# *.* ..*..... . *\..\. .* ..#....*. *.##.. ..*. #\. # .#.#...  .\ ...*. .#. \#. *#
#.....\#...# .*....#  ..#......*#... \*..... .#.. ..\#. *\ . ...#\#... # #\..\.#.. ...* .# #. \..*....#..\#.# ...## . ..... .\#...\. .. *#.  #...#...#
#. .   ..  .# *#*......\ .. ...*..* . .#...\....* .   ...  *...*#\ #. .# .*#..\#* #.* .\.. **.. .. ...... *  .#*.\.# ...#. *..........*.#   .... * #.#
#....*..#\.. #.# # *.  ..#...*.  * ...#.\.. *.*.*. ....   .*.*... ..... \...*# .\#..\...##..*\* ...##  ...*..\#.. .\.  ..*. ...  ...**... .##....#...#
# * # ...... *.\*......#.#..*.. \  ..* .. #.#..#...... .. *\  .#.\** ........ .. . *.*.* ..* \.#....  ..... *  ....#.... **#.....\. * ...... ....   .#
# .#...* ....  ... .#.......  *\.#... .. ...\#* ..#  # * . ....  #....*.*\...  *..#..*.*. ...  * .##*#.\...#..#..#..*. ....... .\.*.*. ...........\*.#
#.\ .. . ***.*.* . ..#.... . ..*...*.#..* .........#..#....*. .**.. .*.. ..\. .  *.*#. #  ..*...#*.#.*.* .*.* .*..#*.. ...*. . \ ...*..#\ #.**. ...#.#
########################################################################################################################################L#############