######################################################################################################################################################
# *.  \*. . .. . #.#. .. .**.*.*.\....#.** .*.. ..#.##... .. . ** . ..*.* ...\... # .. .\.#.#.....*... ....*.*#\..#.\..  . \.... #.... #........ . #*#
#.\....  .*.... .*.. ..*.  ..\..\##*.#*...*.....*. .##..\. .#. .* #.#....*  #. #.... .** *..\...\.. ...*. #.. . * ...* ....##. #...\*# ..*. *..# ....#
#*..##.... ...   .. * ..\.# * .... .*....# .....*.\.#...\...*.... .*.. **.*.  .\   . ..**.. . ...   * ..*. ....# . \ .. . ....  ......*#. \.. .#.\#. #
#...... *...  **#. *........ ......*..\*.   ..\.*....\..  . ##. .*.#. ..... .#*... *..*.... *.*#*.. ........ #. \  *... ..*.  .\..#**\.# ##.... ..*..#
# .*...#...#. ...*.*.#.*\*.*.\#. *... . .. * . . ..*...*..#..#...\.##..#.# \....#*### *.......  #. ##.#.*..*. . .. . ...#..#..*..*.*.*\.#\  .\# * #. #
#...#.# #*  .*...#..*..#.*.#...#...\.. ..\\  ..*...  \ # .*.#..... .....*  .. .......*. #....  .. ...\#.\.\.#.  . .#..  .  . .\ ##..*...#.#..*. .\.. #
#.\\. ..#..... ..  ..\.. .#..# \ . * *.* ...*#..##... ...# ...*. \.#...  * \ ..*...#.**....... ....  .*.   ..#. .    #....*\ . ..  .*. * . *.\...\*#.#
#......*.*.. ..*......  . .. . .\ #\...* ...  . ..#\..*......#..##*..*...* .##.#.  #.#.*\..* .. .. ..... .  ..*.#..  ###.  ..*. ...  ..\ . . \ *..* ##
#*... ... ...# .#..*..*.*..  .......... \. ..\..\ \.. ....*.* **## .\...#.* *#.. .# .#*......*......#...*# ....*..#  .##\...*...........  .#........*#
#.\*...*#.  #... *.#. *. ....#\\ ........ .*.*. ...... #.. ....... #.* *#\ .... *.....\*.  .# ##.*.**. *..##.\*.*..*\*..#... ..... # . .......##.# ..#
##. .  ... *...*....  ..* . \.. ...#.... ....##.  **. .... ..\ *. #. #. #...*..   ..\*..... .#. .*..*.**...\\. #.#...***. . ..   .\ ##. #*..#\ .. .#.#
##   # ##....#\.  .*  . . . ...*.# .#*.. *...  ..\ ... *\.*.*...##.\........#\*#. #\ ##\ ...*. *.... ... ....#..\* ...\#.\.#.*.*...* .**. .*# .#... \#
# *.. ....  ..\#  ...# . . ..\..*#. ...#\ ... *......*#....... ....#*.... \. .........#. #.# .. ...\.\..*.... .. # . .#... ...*#*.... .**...*..*..*\ #
# . #...*#.  \... \*#. . ..*  * *...#*...#......\  ..###..  .....*..* .   . ...##.. .... .**  ...\\. .\..\..#..#..\*....    .....   \ *..  . .*   . .#
#\#. .#..# .*.#*.. \#..#.*. ..*.\ ..#... \. ..##....  .\#.*.  .#........# *......# ...#..*.. ....**..#....  ....# ....*.*.#.*...... # #..#...*.\...###
##... .. ..... ..   .##...#...#....#.. #  .\* .... .#*. ..\* \#. \..\# .....#\ ..  \ \.. *.. .*  ..* .#. . * . *..  ..#. #... .\   . \.#......#.   .##
#..... ..*.... ..... . .   .*.....\ *. #...  #*......#..#.. .*. ...#.\*....#....*.\..  ...# *.#  .. # \......# .*\......\.....#*.##..#... .. .#.. #. #
#  #..*...#.. *..\.. . #**#.. #**##...#*. .#   .#.  .#....\.#....*#..\#... ..\*.\\.\*#...#  .. #*  #.. ..#\*......#.**  .. .#....*#. ..#  #. ..#...# #
# ..* # ..  ....*#.\...\.#....#  . .#.*  *## .* .#..#..... .....#\.*....### *.. ...\..   .. *#.. ... ..  .\#. *.#.. . ... . .*.... .***... ##. ......#
#*.. ..... .  ..*...* \.. # ......  ....  ...... ... . .#...*#.#... . . .....* ..#.   ... #..#.  ....*. ...# .     ..##..*. .\. #.     ..#.... .. .\.#
#....*. . ..*.\.#... . ..    . * ... .....*#.. ......*..* #..#.*. .*...\... \* ..... #.. .*... #..#. #.#  . .**....\....*. . #....#\ **... ....  .  .#
#***.*. .#\.*. . ...... ... .  ..*....... # . ...  . .. .*. . .. #....*..... #..\ ...\.. ... .. .... ...* ....#.  . .* . *. . ......#... ...\*... ...#
#....*....  \ . .*..... *. ..\  ...  ...  ....#... ..#....#...\..#.....  .#.* ....#.....#  #.  ..*\# ....*... #*\....*.*  .#.**....#  .##.#.  \* ....#
#..........* .. . #.. .\ ..#.#*.*.*#.... \.. #*\...*.*#.*.#..#*. . .*  #.\..##.. . . .  \..#......... ..*#...*.* . ... . .. .*....*. #. ..*.##..#.. .#
#. #*.... ... ##.#..... #...#*..   # .*.**..* .. *.*#**#.........#....\*...  ... . ..\.    .*....# ......#.\..  # ...\*.*...... ..*. .#.... .....*#*.#
#.# \..\.\.\*.*  ... \ *. . ....\.... ...... #  ..*..##**. #.. .\.... .....*..  ...\*.# *.   . ......\ #. *# ...#*....*#*. ..#**.# ..* .## .#.... #..#
# #....**..... .#.\.#.*.#.*.#..  . ...........#\ .. *....#.#*..*.. ... . .#...#..#   ..\.\ #  ..*..  * ..  \\*.#*.... \.*..*# .#.....  *\#....    *#.#
# .. #.##.#... .. . .\#.. .....  .### .#*#... * .....\  .#....*.\#. ..*.# *.\...#...#..**.# #...... ..\.. .....## * * ..\*. #.\..# . .*.........*. .##
# * .#  ..... . *..   ... . . ..   *\\ .\....... \..#.#.#*. #*....##..#..* ..##.. \\.\.*..#..*.. .#.* ... .*.#...\\#*.  .. .*...#..  ..#...... .#.####
#.. . . . ......*\#.* .  ..........\.... ..#... #....***.\*...*...# . ..* #\.  ..#\*.*\#.  . \. * .....*. *. ....\. #... ...#.. #\\.*... .*#...#.# .##
#..# ...* . .*.   .#..#.#....*\.#### #...\*.. ..  .  \.*... ... \ . .*. .* .\.##.. ...  ..\.. **   *....#. . #...*#....*\#*.\.\*.. ...#...  #..*..\\ #
##...# ... . . . .#....* . ...*.. . ......  \#...* ...* .*. *. ## .\... .*..#.*.. \#.*.#..# .#\... *.** ... .... #. .# ... #*..*.\ # .*...*.....  ...#
#..# ..\..*.  .. . . .#....#.#* .... .\ *....*. ....\ .*.#...  . ...##*....*\......* .\#..*.*..  ..#.. ..... .\.  .*...  .\*........*#  ...*..*.... \#
#.. .*..\....*.. ...*...*# .*. ....* #.\.*..*.......## .*..... *.. ...  ..  .... .##...#.... #..#.* .. #*..#. ..*..\.\#.# * * .#.. \.....  ..*... *..#
#.. .. ..    ..* #......#*..**#\  ..#.. *\.. \...... ....\.#\... ..#**..\\...* \  .# \...\. ...# .. ... .* .....*. ...#*.. ..... \ .\.. ....\... . ..#
#. ... .. ..\* ..#  .#*..#. ... .\. ............#..*...*..... * ....#*.*.. *\* ...###......#... ... .....#..#..* ....**...*##.#.\..# #.....**.#\..  .#
#..*.. ....#..\.. . ..  ......*  . ..*..#\......*.**\ .*\.. . .#.**  #.#.*... #.* .. *...#.........#......#  ...\#..  ....*.#. ... ...*...\*.. ..\#*.#
#...  .. .#.\#  ... ...... .\.. \.*# * .*.* #    ...\.....#...... #... ... . . ..*. \..*.. *\ .#.*# # . #.*....... ..*....  . *.#...... ..# .*....*..#
#......*..#.. ..\. .. #... ......\*... .. ..*.. *...\.*  .*..* . ..# ##.*. .........*\.*.. * ...#.*. ..# .#..#.     ..#*# \...\#......*.*\. *.. ...*.#
#.....#.. ....*...#.. ##.. #...*....#.*#.   ...**.* . .. *#..  .*...## ...... ..... .*.# ...... *.\ ...* #. ..\ ...#..... ..#.#.#  ...#*...\.*...#. ##
#. ...# .##.*.... #.#*..*..... ..\. *#..\##.....\\\........\..\.* ..#.. # *...#. ..* .#..  .. \.*#. . *. #.. .*.. \. .*... .*..#  . .  #.#*.. *..  #.#
#*.#. ... .*....*. # .. ...# .. ...#... .#\..\..#.*.. .....  #..* ...\.#... #.\...*#\ ..* .  ... .#*..*.#. \.... .. ..**.\.# #*..*.*.\.. ..# *..... .#
#.*.* *...*..  .....  * * . #.#...#..*#...##\ #.....**..*..  .  .# .\.. ..# .* . \.#..#.*# .. ..# ... \... \ * ..**...#. .. .*. #... #.. .. ...... ..#
#.#....*..*#.. ........  ..\..*.. .. \.###*..  ...*\..... #... .\*# .*.#..#.##. ....\..... ...  ** ..**.... .......*. * .#* ..#.#.... .. \....\...\..#
#..*. . # .#....# .*.\. ....\...  .. #..* ..\....\.#....*.#..*....*....\ .....##*.\\...*.......#. ... .  .. ..\.\ .* .. .\.# *\.. ......   * .......\#
#  \. *..*..*.......*......*#...##.. ..\.. * .. ... ...#.*.... . .... ...*..**....*..# . ........... .#.**.  \\....... .....  .**\.... .#....  ......#
#.# ....#...#.*  . . ........ ...*.#....**    ... ....*.. \ .. .\  ...\..* .#.# ....* .#..*##...\ **.. ..... . . .... ....# ***..#.  ..*....  #.  \..#
#. .  #.  .....  ..#. .# .#. # \*.... ... ..#\*#.. .*. . . ..* ..  \ \.\...#.  #* .\...#..* .# #..* ... ........* .* .#.*..*#. .   .. .\#.... \#.. \ #
# ..... ...#  . .\.*.. .*.* .\*.*.\ ..*. .*.\..* ..#*\.\#\....*.  . . ...#... .#  *\ ....* .....#* ..   #.#...  \  \.. ......   ..#... .\#..\. .... .#
## .#..\..#.. ..... ..*. ...#..*.. .*....#..#   #*.#. ...... . . ...# #. ....*.. .# . ...*...\..#.*.. . *... \. ..**.... .*.##.\.#....... ...#.\*... #
#..#.. .\#* ... # ....#\#.\\#*.....\*##..#.. *. . #\\#...#*.. .##.  .*..\.#.*...... ....#.......\...# . . .  ..*#  * . *#. .\. ....##\* . . .. #* . .#
#\  .\.. ..#. #..*...*. .# \..#\ #.. .*..*..... .*#\...\..#.*.. ... ..#.... .\*....*.  *. ...  ..  ....*.*....*  ..\  ..  .  ....\....\...#...* ... *#
#.\..#. ..\*.........#....... ...#.*.......* ..*# .. .\. ..*# #...*...  .. .*.#.....#... **.   #* .\ . **.......... #... .\\ #\....#...#......\... *\#
#.#..# .*.......**.\   .. ..... * .... \  *\.#** #\... .. .   . .*.*#*.*..# #**. .\   ... ....... .. ....#*.##. * ####.#  ...  .....##.. * *#.\...  .#
#.....\....#..  \*......#.*.. \* #*. ....\*....#. .... ##.* . . *\. .\.**.  # .#...* .##**\. .\ ..#... # . ..#...*.#.\ *.*....\..#. ..*..#.  .**.. . #
#...#\ *.. . .. .\... . ... .\. \...... ....  ..#*\...... .#...\. ..#.#... . \ .\..# ..*. *........*##.. . #..* . .... ..*..*.....* ..#.#..#.##..\. \#
#*....*. #.#...\#   *.#...  .#... . .#..#... .. .##* ..*.#.. *..*\..............##.##\\ .....##. ..*#  ... . ..*....#. \ .#*...#..*. .\...#...#...* .#
#. .....## . . .*#.#..  .. .. .#. .#.**#..#.....* *........ #....*.\ *#.*.* *..#.. .... ..#*.. .*..*..#.  \.*#..  *.# ...*....  .. \...*. \ . . .*..##
# .*.*... *.. *....\.. .  ..*.*. ..... .. .\...# .. *#....##.#\.#. *. .#.#.. .**. ....* ...\. .##...*.... \. \....... *..... .. .....#... ...#...#.  #
#   *.. \ .#*.*# ..*.... ..#*......\. ....#.. .##. #*.......   ..* .. *.#\.*.#.* ....#..\.#..* *.*.......\#*.\.\ ## . .##\.. \#\* ...*  \....* ..#.*.#
#...... .. ..  *  .*..#.. *. . .... .....#  .. #.\.*.* .*.\##..* . .\. *. ..* *.....#*.  ...# ...... *.\#.*.\*....#... ....* .....\ .* ..\.....* # ..#
##. *... \* ...*#...*#......*. .\....#....... \...#.*\*... *...#.#..*#. .#*# .# .##.........\.*#.. .... *.* .    . .*.\..*.  . \...#...#. ...  ... ..#
#... ......\........ .. #*##..#... ..# ..*\. . ...#.* ......  .*..*.... ....*. ..###..... .**...*..*..**# .** .*#  .\#\*** .. .. ..*. .\\..... ......#
#*......*. #. #*..\.#.....#.*. #. ..\ ....  .*.* . .*... . .*..\.*.# #..#*....#.. .. .. \ **. **....*.   .#.\.# ..#. \.## .. ..#  ....# *#.\.*  ...* #
#. .... ..#  **.. # ..\..  #..\.. ..\ . ..#...... ...\... ..\#.... **.... ..\.#*\*...#*....*.....\\..#*#\. ..\.*..... . ...\. .. **\ .. ..\ .#*.# .. #
#.. ..\.*# ....#.\# . ..**#.. \....#*  *..*.. *.*  .## #...#.#\*\ .\.*.. *#. . .#\.#.* ....   .........    *...  .  .  *#... # .*.#. ..*.*...#.... .*#
# .#. . ..#..*. ..\ \..*.*.. .* *.*.....#... .#....*# . .*. \...#.. .*.*. .#...#.*.....\\....##.*....#.. ....\.. . .\## ..#..  \ . . #...*  ..* *..*.#
#.. ...#.*\.. #...  .#*..   #..*.*...*.....*...* . ....... #. #...\#. **...#  ..#.*........  ....... *..#.\*.. ...*#.......* ...........*..* #..... .#
#*.\ . # *#*  . #  ...*  ....   ..##..*.....## ..\....\..* .  .*. ...*.. ..#... # . ....#. ..  ..#* ......#\...#\.* . .......*....*..*..  #\*.\...*..#
#.\.#... .**#......... *.....*..\..* .*.* .. ...* .. *...\. .... .#.   .#.........\ .#.. .#.... # .\....\ ...#*..#. ....\  . * #..#   #. #........#..#
#... #.... .#.** .*##..... ..*...  #. .#*...#\... ..........#..#..*  .. ....#.*\........... .\......\..  * .# . \ .\..#.#.  . ..*#..... . .. .... .\\#
#*.. ..*\..... ..* ...#..# ..#...#* ##...*..* ... .*.* ...#.*.#. *..\.\..#.*.*. ... ##*.. . ..*... ...*.#...\. .*..*.\*#. .\.*  \#. .# *....... #. ..#
#\.* ....*... .#.# .  ... .*...  .  . ......  . ...#.\.... ...* .. * .  *.#...*\#*. #* ..* \#* #..#.**.. ..*..*..#... ..\\.#...** .... ..#. #... .. .#
#  .... ......  . .*. .. .#*...\ ..#.# .#. *#.   ..  #. ..*. . ...\... #..#. ... . ...# .\. .# . #. # .......*.*. ... ... ....*..    .*#...... ..*. ##
#. ...* .#.... ..#...*.. ... #. .. #*...... .*#..*.... . *...#..#...#. .#*#..*.*  ..*  #...\..#....#..... . # ..\..\.# .. \. ... ..  ....##\. *....\.#
#.  ..*#. .*. ...#*# .. ... * .... *.*..# . ....  .. .......... ...  ...# .  .  .. \*.\ #.#.. ....... #.#.   # .. ....*#  ...#.......\**.*#...\# .. .#
# ..... . . ..# *..... .....#   .. \ #. ...*  ...*..\*.. *.#....#. ...\.#.#.....* .#..#    *\\*.. .  ..*.. .... .#.##....\.*#.... ..*.. ..#..*** \*  #
##**# . ##....#....#.* * .. \  ...  ...## .  .. \.....*.**.*.  ..... ... . ..*.*..*#.\..#**.... .....#*.... ..\....\..... .\*..... \. . ..\.. .. ..* #
#.\ ......#**... .#.*\. * . *... ... .. #..\... **.\  .. .  .... .. #. * .#. ..#*. \*#..*#. \..#.\.. .   ..#..\.#\# .\#. .... .  . ..   .\*. ..*\..*.#
#*.....#. *.. .#....#. . *.......#\. .#...\#....#...\.  .\.*#. .  . ..*..*.   \. .\ ......#......... ....\ ...... #..## \ ....*.\.......#.*....\##...#
#.*.\. .. * ** \...*  \#  .**....... ...\\.\....#.**#**.. #\..#. . .*.\.\. ....  *. . # ..*.*. .....# . . \.#. ..\...#**##... ...*....#.#*#.#.\... ..#
L..*.. ..*  ..**...#*.  ...*..* ......# #*.*\... .#.#...*.* . ...  *  .#.*...\.#..*.\.... .\ ..*# ..\.#**.......... . ..* .....#.  .\*. ......*..#...#
#  ... ... #...#.\. ....#  *#.......* .*...... ..  ....#  ...\.*.## .....**.*  . . #.#* .\#.*#\ \#** . ..*.#.#....* *...\....*. . ## *..... . ...#.. #
#. .##... ....***.*...... .....\..  ..  #* .*#.....  ...#. *.. .*...*....#\.#..* \#. #..###*.*\  .....#*....*  ..  .. *.\\...\.*\#.. . .....*... ... #
#... * . ..\.....\#..\# .  . . .#..*  \..#. ... .. . ..\ # . *.**... .. \*....*... \  ...#.*#.\....\.. *.* .  #.*....... ..#.\... ...*...*#  #....**.#
#*#\.*.... . .*.. # #.*..#..*....\.  .. .. .* ..##.#  ...#. . .... #*. .* ..  .#.. \*.\. .*.#.  .\. *..# \.*.\ ........#...# #... . #*.**.## .**.*...#
# * ....*...\# *.#* .....*# *#..... # .... .#..\.##.....  \ ....*..#.\*.#. *.*..##\.* # .*...#.\.*. \..#..*...#..* .....  *..\..#... \........ *.. . #
# ....* ..#..#.#..#....# ..# ...... ... . ..*... ..*......# .*\.#.   .. ...#*.*#. #..* . .... ..#..# ....*.#.... \. .. *#....... \ ... .##.#.\ ....#.#
#.... ....#. \. .#*.  .....*..#.#...*......\#.. . . .#*...#..#... .. #\...*.*.. *. ..*...# ... . \. .#. #. .#.# . .... .\........*..... ..#....... ..#
# ... ..##**. .#  #.. ...*#.... .#.*.\... #.. #........ . \.. . .#.*.\.\..*.#\..\ ..* ...# #\.. . ...*.  #.  #.*#..... * ...*.## \..\.#\.......*.....#
# ..\*.... . ..   ..*. .. .#...##. .\ .. .#.##*... ##.#.   *..*#* \... ......\........#.... *....... .\....#. #.... ** ..\. .   ....\... ..\. .*.#.. #
# ..... .... . #.#.*......#\*. . ....*...  \.  # . .\.#  . #.. .#*....# .##...**...# .   ..#\#*\..  ***...#.  ...  . . ........\*#** #..#..*  ....*..#
#*..*....\.* #. .## .\.*....  **..   .\\.\*...  \.....\.... ..#. **\..*\##.\..#.... ..... ..  *.\.#.**...\. .* #..\ . .\...\\...*  \#.. \....* .#....#
#\..\. .#.... ..**.**.#.*#   ..*#*..##....#.... ..... ..  ...*.*.. .#........**.. .*.*.. .#\ ..\.*. .. \#.. ... #... ...* ..##...# .  #....#.........#
##.\*.* *.. ....#... . .#.. .*\. ....# .\.# .\..   ......... .*...\*......*   **..**\  ...* .*   . .. .\##*. #..*.. ...  \#....... .*....... * ..\...#
#. ..... ..  .*#....#.. . ...   *..  ...## #..R.# .  .. ........... #.... ...#  .*.\.. #....... \ #*..*.. .  ##\#.#.#.....#..* ..#... . ..*.. .....\.#
##..*... .. ...* .#..*#*  . ..#... . \*...  ...\. #...#  .#.. . .. ....\\... #*# *.. .* \...**.*..\.*..\ ...  . ..*.#....*...*. ..\  *.. ** ..*. #. .#
#.#**.  .*.#\ . ..  . ..... #*#. . . ..###..*    . .*\.... * .\*..* ....\... .*...*##.*  .#\...*\# .*..** ................*. #....#..*\. .. ..*...#  #
#.....* .\...  .#.... .#.... .  #.\\.\.\ ...\. .. .  .....\ .\#. ..\..#. .* .#..... . . .... ..*....*\ .** .\..*\.*... .... *#..#..*....*.. .***.\. .#
#.#.. ...#.#*.# . ##.##.#. ..*#*. *..... .. .. ... ..\#*.  .*..\#.....#. ....#*\#. ..... .*.. ##.... .....\*\  .*.. . .\*. . # . ...*..........#.. ###
#\....#. ....#\# .....#.... ..##. ... *..# ..#...\.....  # . .#..  ... # .\.     ..... ......\#.#\..... \...#*......#.#.\. .. . .# .  *  ....\   .*..#
#....*. ... ..   #..*#.* .... #.#.. . ...*. ..#.. \. .\.#\..# ..*\..*..#\.. ##.. ..  *........*..*.*# #..*. . #\....**## .#..*  *.*  ...#.*.... ... .#
#..*......*#.......* *. .. .*. . .. * * .\ .#... . .. .\ ...... . .#...#. ..#*..\...\..* .#  .#* .**.#. . .#....*..\...*  #... ..# ..\ *...*..\. #   #
# ...\*  .  ..*....## ..#*#.*.  .*..#.\ .. ... ... #.#....*.*. ##.....*.#... .**\... .....\.    .. #...*.#. .... .* .....#.\* ##. ...  ..#*...*.....\#
##\   ....*##.\.\.*. .... ....#*.##*. * **.. ....*.\  *....\.  *..... .#\*..* ....**. *.....*..*. ..#.... * .. .. .....*.....  .......*.. . ........*#
#.. .#.   ..*#.. .*.. ...# ##..  .. .*#...*...#. .. .\\....  ..  # ... ... .#..*#  ...*##...........\#.....#. #.\.#   .. . ..#.*#\...**. ..\ \#.. #. #
#\.#..*# #**.. .... *.  .#.#. . *..#.*...\.*# .. ..*.. .  ......# . #...*. ........ ..#.#...#.. .....*\.#.## .. ..*.*.*.. #.. *.....*. ..... .*.#..**#
#.\#......*.*.. \. .*...* * ....#...  . .. ..#\.#* . ... .##..#.#...*..* *. ..#* *. ***. .......* ..*.  * \.. . .. .*..\ ##...#...*.... ..* #......*.#
#. ... *...*. .\.*.*.***. .*\*..... .*....... \*...*#...\....... ...# .# *.# .\..*.#*# .#. #.. *#. ... \.\.. #....... ...#\#..##..*..*..\.*... .... .#
#...  ..  \... ..##....#. ....#.\#*.....# .*..... .... \.  ..* ......  ...# ..#..*......\ . *\\.. . . ...    .\. #*....# ...... ## #..  .... .#.. .**#
#.. ..**  ... .**.**.. .....\.....*...###.#. #......\ . .. *..*. *.#.*.... ..*...##.. * . *.* ...# #*.. ##. *. .. . .....#. . ....#  * #*  *.\\.*...\#
# ...*..\.#*...#.... .. .#... . ..**....#*..#.  ##..**.  .#... .. ..*.. .\.. ....#  . ** \..\.... . #.. .. *. #.. \* #*..   .*...*.\ *#.* .... .... .#
#.#.... .* ... .... ...  #.\# ... ... ....#..   .##...#* .. .. *.#.. ..*.#...*.. #..# .*.. .. * ... .*  .\. . . . .#. ..#. \*. ##.....   ... . . ....#
#.**  ...*.#.. .. . . ....... *\... *.*... ..#.*\........ ..*.\#..#..* \. . ..##.  . .#*.#  ...#*.....\.... .*. ...\...* ........#....*\.... # \.\.\.#
## ....*# ..\.. . .**....\. # . * ... . ..*.. . *  .#...#** .\.#.*...\. .......  ..\. * #*#. *.....# .#..#* ... ..#.... .*.*..... .  ...\..**.#*..#.##
# \... ..#.... ......\#.#\..* .\. *.* ...#..#..\ ... ... \# .. ...*  ....#*..  \\ ..  *...* #.*...# . ...#.#*.  #..\*# *. . .. ..#. .* ...........\*##
#.. ...* # .**.*.... .  .. .... ** *# ... ..\...#..\.....\## ** #\* .#*. ##.*..  #.#**..*.*...*...# * .##*....\... . ..*.*.#.* . ##..... ..# . *.. #.#
##..#.  * .. .# *...*... . .*..  * ..\...   .....##\.... .  ...#**.* #* ....**...*.. \#. ...\.\ .*     .\.*...*\\.. ..#.#...... ..#..#.\ .#. #\ . ..##
#... *........** ...* . .\.. .... #*.#... . ...  ...   .#...* . . ..#....# ....\ . ......# . ......*.# ..#... .. *....  .#   * .# ..... . .. # #..*.*#
#....*  . .  *.. .*... *...  ..  ..\.*.*..*#.*##.\. .*.\  .. .# . .#..... . .  . .. ...#  .  \ # .. ..#\..*...## .*# \# .#.* *\ .#*.\.#...*#.*. .. . #
#....#..... #.....#  .#.. #*.... ..*....*. .\.....\*.. ..# ...#..###... #\..\.....  *.. .#....*..#.. #  .. .#..  \.  ##.. .*. #.   .*...* *..   #.*..#
#..\.*..#*.**...#.\**...\.\.  .... **#...* ..\..#. *. #.*\* .. .# .\ . . ...#*.#....   ..# ##   #... .. ....... *.#.*.....*. . *.*. #*  ......*.\*...#
#.#.. .....**#.\ ##..  #...... .  # . . . ....#. .. *..#....#...#..* #*.*....#* . .* .\.  .# ...... .\......#..... .... .\..## ..  .. .#*\ .#..\.\ . #
#.* ...*#.\\..**  .. ..*. .** **....#. *...... ...*.#.#.#. ...\ *..... # ..\#\*# .. *....*..#. .........###.. .*.#* .. . .\*...# * .........*.. .#  .#
#.... ....*.\  .....  ....   ..  .....  # ..#*..... ##*... #***. ....  .# .  .#..#.. ......#.\ .\ .. .\. *... .*....*  *.*..\.#..*. #   *....... .. ##
# .*. .*. .*. *#. .* # ..#...... . ** .#.  .# .*... # . ..    \....\....#.\..  ....**.*#. \.#... .. .\.. ..  .*\. \   ...\*...#  ......* \.  .. .\...#
#.. .. .#\.... ....#\ .. .#.#.\ .* . #*..\.. ...  .. *.#... .. #. ......*.\..* .#......... \..**.... # ...#.. *.... #*.  .......*.\##.#....#*  ...#..#
#..* .. ..\.... # .#  *..\\\*\.\##.....*#.  ..*.....*.\ .*.#. ..**..*.... .# ..  .\. #. ...* ..*.  *.....*.\   ... \.....#*..\.. ....  *.....#.....\##
# ....   #.# .*.# \.# .......*..#..# . .  #\ .. .....*.  ..#...#*. *\#. ..  .. .. . #.#....*.. .#.. ...#..##*.....*#  ..*..#* #. .* . .* . \..*  .. \#
##\..*. *....*#..**.#.*.. . ..*..*#.. .* .\ .. .....  .* ...  .. ..*....\.. .*   ..\#.*...#.\.* .* .... #..#...*.  . ..#..  # .........* .   #.*.#.. #
##. *. * .. **#\#... .....*..   .... ##\..* ..*#*......#...\.... . ..*.*.....*  \#\..#....*   ..\.......\..# ... .#. . .#*... ..  .. \..#.* ....*. ..#
##...#...*...  ..  . .*...#.... .*.#.\....  # ...*....\.*. .*.#*  ..## .\ .#.* ...*\ ...\ .#  .#*. ... .*# ...#. *.\ .*..*..# #  . .. . ..\\.#. .#...#
#.\. *\.  ... * .#. *\*\ .\...*....#. ... . *.. . .\*\.. .....#....#*..\... #*...#.  #  . #......**#.#.  .*#.. ..#\ .. ..\.#\.\#..*.*.\.##.. .\* . #.#
#\#.#\.  .. ....\  ....\ ........ . . ..*\###  .*# #  ..#.\..\***. . . ..*.\ .. #.#..... .#.*##... #.*#..# ....  * .#....#. .* .  ..\.. .*#..........#
#* . ......*.*\*.. ....\#.\...#..\ ..*..*#.**... \* .#.. *..#  ...**   ...... . .\..*.# \..... .\*\\.#.... **.. #.**.....\  .*. *......#....  *...   #
#. ....*  # ..#.  .....*.. .#.**\\## . #..#.....**. *.. ..*  *..# .#.#* #.. *#... . .........  ..*\.*. . .....\#... ... ....# ..#....#*...*...   .*. #
#   ..#.# ..\.  . .*.#..... .....*. ..*\..#...*..............#....*. .#...#.* ...* # \ . #.**...*\* ....*.. \ ..*.***..# \*... ..#*#. ..*.*.  .#.*#..#
#*.#.\ ....\ ..#...   .*.* #..*....*....*.\..*.... . *..*.. #*##.  .. . \..*#  *\**.. ...##..#   ..\.... .  .#. #*...# . \  \....*...* ...#.  *.*.. .#
##  .\...  .. . \# .....*.  *....# .##.....*..#.#....\. . ... ...  .# #.*..* .**.\ .. #.\ ......#.\.#.. ...  * ... ##. *. .\. * ..*..# ..*.*.\# *.. .#
##..  .#*.... ..# * .........#. .. .. ......\..#.. .*. #*#*.. ..*. *. .#.\...#    *\.# . . ..*. ...#   \#.....\ #.#.....#..*.....#..... \.\.*....* ..#
#...... ......#.  .* #.  . ....#*.\*#..\. *.  .........#*... ..   . ... . #.. * ...#..###. ... ...*#*.#....*    \.*.. #... .*#  ..*\... .. . .*\. ...#
#.. .........#.\ #*# #.* ..  * *\*..# ...##.....\.*  \\#....#. \. ... ..#..*..\#* \  ..#\*. . ##.   #\.\ \ # ......*....#. .*.#.#*..* ..*. ....*. #..#
#  .\..*.\ .. . # ..\* .\.\......*.*.....### . . #....#.. #. . # \.#  .#. ..  . **\ ...*.* .#.#.*. ... .#.*. ..#*...* #* .#.....**..... .....   . .*.#
#\. #. .*...#.. ...... *#*..*..*.#... .*.. \..**  .#*... ... ...#.....*.#.#..#.. \...**. .*....* . .. ..#. * .#   .. . ...*.##.......#... ....  .. . #
#.. . ... ...*\ \\.#.*\#.. .#*# .#. #*   ....*# # .*....\.*.  ..\##..\. **.  \ .... ...#.\.. ..# . ....# .....#..*\  . .  .* .**#.# ..# .. .. ..... .#
#.* ...#.. ..#.#.*  .*#.#  ..\*#........ ..##...#.  ..\.#  ...*...# \ ...\ .*...*#.#.* #....\#. *  ...\.\ . ...   .. ....\*.  .  ..*..\ .......\.. . #
#* *. . #*  #. *.* ...... .# .# ..\.. ....*# *..  ....#. ....#*.\.....*......*..\ ..  #..* #..\.. * ..#\.  .*.*... .#... ....#  ....#  ... . .*. #  .#
#.#.\... .\# ...#\..#\#...# ..\.\*..*.  .*.  . *..*.#..#\ *.#... .  . \...... ....... .\.\##   .....   .#.###. *....  .#  .  ...#. #*.#....\ #.......#
######################################################################################################################################################