######################################################################################################################################################
#.. # .. .*..#.......#.*.. ..\#.#* .# ... ...*  ..#.. .... \.#..... ..\ .. \#*. *\.# #.*#.\.......   .. .#.#\**...#...#. . .... .. *..   . . . * ...*#
#....*....*.   . . . .#.##.\*   .....*....\... *..#...\. *.#...  .   *... \.**\.......  # #.\*. \.*#.* #...*.. ..#. ...*. .* .. \*#*......*..\#....  #
#........  ......# *.* #\.. *#. #.... .#.. .  .# ..* ..*  #.*.  .* #.....* **..#.#*.#....*.... #..*..\....\ .\.#\.# *.  ....*\ ... ....... ..#..# \.*#
#\... #...#\ .*.....*....*  . *.\ .*....*.#*   ..... ....#.. .*..#**.#.*..#....\.#.....  .... . ..##.. ..#... . ....\.\. .... .#.. .... ...  .. ..   #
#..\  ..*    ....\. ...   .    ......**\ ##. ...  .#.\ *...*...# # .... .......#.. ..#.. .\ .*.  .*.... # # \.#\.. \.....#. ....* #.\....*..#.\*.  ..#
#.. ...  # *....#... .... ....#....#\*#*.  .#. ..*.... .*..#\ .. ... .##....#...*.........*. #  .. .....#.... \#\ ..\*.*#. # *..#.....*.\*#*.. . . ..#
##. *........... ...* .. .#.. .#.*....*. . .#... #....#..** .*#........  #.\#...#.....*. \#.... ##.\..*..***..*..   . . ...\ ..  ...*..#. ..#...*#...#
#...#*........#..* .\.*.. ..\. #.#...  *# \.*. . *##.*. * ..\ .........   ##\.#..#..# . *#  ... .* .. #.  .. ..*...#*......#.##.....#... . #*.. ...#.#
# ..\... .. ..*.....*.* #** .###. .\.*   ..#*.* ##*... \. *. ...#..#..#.\...  ....#..#  \#.# ...  *.#. ..*.#.**#.*.#..#.*........#  #..## .. ..*..  *#
#.... #.\.* *\ *. . .....   .#..   \ *.. .....  ..\ #..#.#**...*.*...  . .\*....\\.\..  #*............ #  ... ....... ... .. .#**.\.# \ .  #.\\.*. ..#
#**#........#.... ..*..*........*.#. ..*..#.. *..#. ....\\ ...*. ..#..*.*.  .\#.* ..**. ...*.#.# ......\\.## ....  .... \... ##..\ ...*.*\. #.#. . .##
#. ..#*... #....*..#.* ..* #..#  #.. * .....*# .\. \  ..*...*....\... #......... .#*\*\#......*.# .#\.*.. #..*..\ ..# ..**# ..* *..#*#.* .. ... ...*.#
#.  .......  . . **.. #...#* ..# ..... .\.  #..* .#..#*....# .. ..*.# ..#...  .**.. # ..\. .# .......*.* ...\*.#......* *\..#.\..#.#.......\..##... .#
#..#.#.. *...\.##. ....   *...#. #\.....* .# # . .#..\..# # .. *.* ..#*..#. . ..*.. ... . ....#*..\\.#.* \.....\..#**  .. ... \.........#\. #....##..#
# ** ..#.*..*.*..  #.#*.#.#...#... \* ..#. ..#....  .#...#.....\#.*#. ..\# *. ..   ..  .* .* .. ... ..... ##......... ... .#..\ .....#........  .*\ .#
##.#  ..*.. .##.#.. .*....... *. #.# . .... . ..#.#  . .##..#.. . #* #...*....#...   *.* .#.##\.# ...*. #* # ..  #*..*.\* .#*\.#.... ..* *. .  *.*\#*#
#* . .*......#.*.\.. #......#*. ...* *.. *.....*..\*.*.\.... ...  ..\ ......\..  ..\ .. *..*...# ..   ..* .*#..*. .\*. #. ... .. *## #\ .\ . *..\.#..#
# . .# .   .*.. .. *.* *... \.*...* .  .. . . .\. ...#*  \#. .*...  \# ........ #. .**#.   . .*\... ..... .......#...*...........#  .#.\.. ..#.#.... #
#.* . ....#**.. ..  . . ..*.*.\.. #.#* *#. .#.#.#...\.. . .. . .#.*..\. ...*.*...*..#..\.\\ * #..\#\ \.. ..........\ .#.#..\  . ......  .  ....*...#.#
# #.  ...# #  *\.*.. \....*..\...*# ...##....*..#.  .....#...* #. . #.*. .\...#.*.. .\. ** ..#.. #...*.*\*.... *..\...... *..  . .. # .\....*...* ...#
#*  ......\##.. .*..... ... .#   \... .. .* \.\ .. ..#......... ....* .... . # . . .  #.. \.....*.... * #  .#..#....#..#.*..*\*. #* ..*...  \.......\#
#.#\...*  **.#*.*. .# ..\\..#.#.. .. .#*..#*#... .***.. .#.. ..*... .. \...###.......\...#  .  * \.\ . . ..#.\.....#..*.#..*. # .#..*...   . *#...# .#
#.. #..  ...*... #... . ...... . .##.*#.*.*.\. .... ... ..*. ....*.\* * .... .# \...# . #.. #.*..... * .\......#.#....* ##... .**.... .. .**...  .\\.#
#.#.  .......\. . . ..*.\   .**.. ..# .*#*..\\... .*.*.\.*... ....#....# .*.... . * \##*..#.* .# .#. .... ...*  . .*.*..*   ..... .  .. .#.*##. ..#..#
#\.. # .... # ..#. ##....*#. #.**... \.. .. .  ...... ......*.  # .*#.......#  #  . .. *.... .#. ... . .... ....... .. #....*.**.#....*   .. * ......#
#. # . \.\...# . .#....  .*\...*..... .#... *.\\ .... .*. *#\..#. #... #.*.*.##*## #.. .....*...\.#*.....\.. .*.. .*. # ... .. .... . .##..... ...* ##
#........#..\.#...##*.* .....#..\.. #*.# ..** ... .*...#. ** .  ........#  *\*.*#.*...# *.*.. ..\.. ...*. .# ..  . .#.#\ .. .. .*. ....* . ... ...## #
#*... .# ... ##.... .**.....\    ...#.#   *\*.# ... . .\....##..\.\   ##.\#........## .. ..    ..  .*..  #. .* ##..... ..###... .#.#.#.*..# ..\.. ..*#
#.  .# ##. #*.*...#.. #* .#..  #............#\\* #.*... .*#..#.. .*.\ ..#...*\...# .. *......#..... . . **.#.##..*..# \...\. ... ..\.#*#.\ ...\ #*.. #
# .......... ..   #  .... #..*.........#..\.. .##*....\..... ..#..  .*....#.. **.*#......# .*.*..\*. .# . .....\ ...  .. .  *.\.*\. . ....#.   .\ # *#
#..*. .**.*.. ....... \.\... .. *... ........ .**.....#.  * #\#...*#.\.*..*....#. .#.. ...*.*..........\ .. * # . #.#...* *. ..#\.. .*#\ *...*.......#
##..*.*... ....*....#...*. #\ .. .... ..*.*.\ #.\*#.*.# ..*\  # .##  *... .....#*.*.\... ... ..*... .... \#  ... .  .#*\..# .. ..* ...\ \ *.. .....\.#
#....##  ...\ *#\....   \...  .#  #.*..*. .**##... .\*... ....\.\ .    . .* .**#.   ***..#. .#........ ....... \#... .....  ...  ...##..*..  ..#.....#
#\..  # ..*.\...\..*\** .*.  . #*.  .#  *.#..\..#   .#.....\.....\. .. ....#. ....... ..* *    . ... .*.#*.\.#.  #. ...... ......# ..*....**...\.*...#
#..#....*...*\.. **.*..*\**.\...#..*.\#\.....\ #...# ......###...  \  .. ....#..* .*. #.. ...... .# .#. .......  #.\\.\...* #. ..... .......\*. ..*. #
#.*........... #.    ... * *..#.#. . ..#. ........#...\.. .      #*...\..... . ..#... .\. ..*.**.. ..*\# . *\. * #......*\.. ..*..# ..\*. **..  .....#
#.....#....#..#. ..#... ..........#.  ...  .... ..\... .. .*...* # ......*. *.. ##. ....## . .   *..#.. .. .. .....**....    ..#..*#. \   ..\ ..# \. #
#..#..*.*. ..... . *.** .... # #. ......**#......*.....#. ... \ .. .\.... ..  . . .#...\.. .\. ....# . ..##....** .*.......#..*.#...\\* .. ..*.*..# ##
# .... #\  *....##.#*. .... .**...\#.*..\.*...#.... .....* \... #.. ..*#\*..*...\\. ...#.. #.#....*....**.# ...#...# .... .. *... .\..*.\ *........* #
# .... \..*.  ..#*.*. ........#. .. * ** ..#....#...**..##.*.*... .#**#*\..# .\.#....#.....#...*.*\ .\..*# . *...\* *..\. .* ...\.  ...... *#. .*..#.#
#. . \\#.. ....  #.... #.  *. .. ###.*.# .\.#.*#....#........**#*...\...#. *.#...*\.##*#\*....\..... #. # . ..#   ... .#... *..*..  .. ..*.....  * #*#
#.. .#  ..  ...*...#.# .#*.\\  .##*.. ..#*\.. ...........#... .*. . ...  * . .#.#..#.....  *. .#...  .*... . ...\ ...#. ..\.\...  #.#   ... .\..... .#
#.*  #.# *..... ..##. ..**..* #.## . ...\..  \.\ . # #...#.....\.  ....*#. .....#*.\.*...  *.# .*. .. *.  *.. . . #..#.* \#\.#.  * .* ## ..\\   #.\*.#
#... .. .\.  ..#... \*##.###... *....# ...   *. . *.. *....#..*.#...\... . ..\#.#.*#..#*. * .\. .#..#..#. ..#...* #.  ... ..*\  ..  .*# .#. . \......#
#...\# ..........\. .# . # ..  ........  ......  # *. ..*.##...... .... *.*.#   ....  # # #*# .. * . .#...\.. .....#. ## * \..#..* ....*.# ......*..##
# .... **..#. #\ *..\ *# ....  \#. .\*.. #\.#  .. ..  ..*. #..  ... . ...\*.*  .. ...  **..#..* \..... *.*#.   ... ..*   .  ...*....   ....\..\... ..#
#.\.#..*.....#... *...*#..#*... ..... \#*.  *.  * ##. ......\..*.*# ..#..... .... ..#... .. .#     .. ...*..... ..* .\.#. .#  * ...#. .#.\*   .# ...*#
# #. .... #....  # ..#.  . .*#. ...*. * ..#..#\# #.*..*..*... ... .  ......... .....#  #  .... .. ..#...#....  . .\\......  ...#.. . .### \.. *# #* .#
#..  \*.###... . \. ..\*.#*.....  *.\..#  .#. ......*.\.  \...\ .... *..**..*.  *.*. .*. .  ..*.#.*.. *.* ....... ..* . ...\ .. .#\ .* ..*... ....*  #
#*......# ....##.*. ....*.\ *... *.  ... # \..# . .\.. #* *.*..\.*...  ..*.##. .\.*. .*.  ...#  #.. ... ..\*#..... .. \.   *  .#...*......#.\.. .#. *#
#........##   .## \.. ...... .* ...#*.* #......#**#..**.. . #.**... #*.# * .....# #* ** .  .*.  .  #*........\.*    \**. ... .* ....\...  . . ..#*..*#
# *#... ..*..\. *.. ..#.**.*.\..\.*..  \..... ..  .#...#  ....#*..*.. .*#... .*#. .\..... . #..\.....  .....*.. ....\.#..\*.\..  .# ..\....#*..# .#. #
#......\.. ...\. .. .. .. .. .\. . *.#.....*#.\. ##\...#. . ....  .  . .#*\ ##\*...# ...#*....*#. #..* .#...*.... ...* .##  ..\ #... . . . ...#.#....#
# ...* # . ..  ......#\ ......... ...* *# ..#. *...* \.** . #.#..*. ...... ...\. . . .  ##.\ #.  . .*.....*....*..#\   ...\...#... .. ## *..\.....#\.#
# .\#.* *\. ..*\*.\#... #*.... *.  ... ...\.*.  \...  . ...\#..... *.. #.****...\.*#....#.... ..\*. **.*...*.# .#*....\*.\#.... * ..#. #.#....*...*. #
#....\*#\\. .......* .*#  ..*..\....   \....*..#*.*...\ **..* \.##... .\#.. *.\  #\..*#..#..    . ....## . #..#. . ... .\.  #*..*..*...**.*.**...# *.#
#... ...*...*. *... . *..#.  ..* .... ....*...##.*....#.. #...*\..  ..* ....*\ .\\. ..#.*.. ....  .  .....#.#...#.#...##..\. .\.\ ......\\ ......#.. #
#....... \..\...........\.. ... #*  ...*..\. *.\.\ ..  .#*  .* ......*  .** .\ .. #*.*.... .*... .... .... *.  . *#.. .  ..# ...*..*........\. #.\. .#
#\#..#..#.....#.  #. .... * .....\*#. .....*#..# ....\\  .#..*......#.. *... \.\.#*.\.\#.# \.#* *. .#... *.  *...*... ..# #.. *#....#\.\ ..*.. ...## #
#. . ... \ .   .#... #.#.... .  .. . ..**.... ...#. . ...\..#.* *    .#*. ..  ............   ...  *....*.. ..*.. ..# .*.#.#*.\. . . \....#* *. ..*.. #
#.\..#  .*#.... .##... #. ..  .#*.....# . *#.*#*. ..*   *..\. .\*. ... #.#.*.. *... ..*.#  . #.#.##*.\.#....##..\.\.......... ...... .. *.*.. \.#....#
#\ .#.**   \..#.\. .*.. ...*.###.. ** \#.....*.#  .... ** **\. .. .* \....*.# . *.. .* *.#...*. . #...\#..   ..#.\.*\#....* \.....###. .*.... ...... #
# . \.. .#. *..#. .. #.\. . *  .\..* . .#.#  #....\.*......\\ ....  ..#..  ... .#..*..*.#. ... ..#.*. ..*....\ ..   *..... #\ \# *...*.*...* .*......#
#. #... #.....*. * * ..*. ..\....# #...*. .....*..  ..... ..*#..........\.. *.*.. . . *.\.....*.***......\.#... #*.. ..#  ..\. #.#..**..  .*# *. ..*##
##  .  ... .#*.. .## #.*.\ .\   .....*. #.  ... *..\ .. .#...\ ...\...#.*... ....# *\.\. \..*.#. . ...#.... #\.... ...*....\.*. ....#....\  ...#  **.#
##.#.. . #.# ...# #.. *.. .. ..... * .. .  .....\..*. .#. #.........\. *  ...... .. ..#.. * \..*.. .......... *.##..*..*.*..##.#.. .... ...*. \.*.  ##
#.**..  ........#.# . \. # .*\. .\... \.# *...# .....  .. . ...  ....*. ... ........\ ##.... ... .*.*# ... ...\*  . ...#.*.... *..\.  . .....\.*. . .#
#*... ..  .#  . *  ..\. .......#*.\.....*##.  ..\ ...  .... ..*....*.*.. .#. .*..**.  . .#...#...#.#.* .. . * \.\....#*#.#. .  ...#.. ..**...*.*.*...#
#  .. *..  ....# .. ..*..  .#.**. \**#... .  ..#. . ***. .. .... **..*...#..   ..#**...* . *.\. .. ..\#... * ..*.#\   \ .. ......*.# . ...*...... .* #
#..*......\ .. # ...#..\. ...\..# .  ..... ...#.....*.#..*.  \###... *\  .... . .*. #\....#. ...*. #\..... ..#. \..* .#.#.#  #....  . .... .*\ .*....#
#.* ...*. . \*.#\.. #..#.\... # .#. *..  .... ..\*#... ..*.#...... #.\\ ..\..#\*..  .##*.#... ...  ...**  ... ..\ .. **...\.... *##..#.. .........   #
#.  .\..........#.. #. **.*.... ** *\.....#. ..*\ #...*. \.#.** .*\. #.\.  ....##.....*.#.. .........   \##.. ##* *\  . #* \.... .... ...... .\..*  \#
#.. * *   .... .  *..*.#*. . .. #.  .....\*....  * . .#. .#.   ..#... #**.. .......*...... # #**.. .. .# \  .#*.....\**  .*#. .*. .*#.#.. .*.  ......#
#* . ... .. ...**#.. ..*.*\\#.. ..#.... ....\...* .*..### #...* .*........ .. ..  .*.\#. ... ..#.\# #...*...... # \.**.\.#.*..  ..*  .*.#*#.  ..#..*.#
#...# *\.#.#... ..  .##..# * ...#*..## ..#..... ..\ \..*..*.    .#...... ........*.. .#*## #.#. .#*...*  ....\..    .\.*.. .. ..  \.. #....#........##
#..*.#... ..... ...#\.. ....##\...* *#... ..*...  *..#*#.*.... *...# ##..*.##...* .....*\..*.... ... #\   \\.*..\**... ..*..*.#. ... ..#. .. **\..\ .#
#..# .**... .. .. \ \*..* .**#*#.*.*.#.\..*...*\.# ...*....... ..... .*..#. .#.\....\.... .. ....*#..  ..\...#\ *...#.#.....  *. ...#. ...#... .# #\.#
#.## .... ...#.* .... #.......\. ##....*...##..#  .\*.....  \.\ ...#. . *\* .........\#\ #\.*#.#..#\... *.* .... #.#\*..* .   .# *. .. . .  .\ .. ..##
#... ... #. #..#..#..  #...*\..   .#\  ..... *.* #.  ....#. .\.* .....*.\ # #....\...\.. ...* .. .  ....  #..* .. . \**..\#* *..*....  .* ......\.*..#
#.# \  #. .  .. . #. \ .*.... .*.. \....#*... ...\...**.. **.*....*  ##.\#** \.#..  #..* .*... *....\..*#.. ..... ...  .*....   ...\.  \#\.. ..\ .*  #
#. .. .......*.*....#.\  . .. \**. ..*... .   ..#...\  ..R #.\#.. .  ...\...#*# .........\.*#. *.....###.   . . ..*## ....*. .........##*..##..  * #*#
#*  ..#.. ....... * ..*.#.*## **\.\.. .. #. .\... #  .\... \ ......*  ..\#.**......\#..... *   .. #*# ...\.....*...*.    ...*.# .* .*#.....##..*. ...#
#.*......*.*# .. .. *..# #.  . .*. ..*..*..# ..* .....#.*.  .. \*..#.#.. ...*#. .. #..\.###.. .  #. .#... #* .## .*. #.*.#...#..........##*..  . #.\*#
#\\*. \#.#.#*.**......... . .  *.*\... #\...   . #.. ..*.... ##....... . *. ...#** # \... **. *  .**..  .#......  ***.*..#*\.\.  #. ..*..\. ..**.... #
#\.*..*.  .. ...  . \#.**.*.*. .. . ... # #*##.*....... ..#...#.#.##.##..#..*. # ..*  \...* *.....#. ... .*............\ #. . .\ ... .. ........#... #
#.     \ ** #  ..*..... ..*\..... # .* ..  . ..\ .#.#\  \#*# .# .*#. *...\.#...... .. #*.. \..#..*.## **# . .\.\...* ..#.\.... .#*#....#..*   ....* .#
# . *..#.#.*..  ...*..##...*... . #*.... #.#*..\#.*\#.  *..#...*.#.*.*##. # .\*. . ....*...    \. . *..\*.* \ ...... ..*...  ..  # .\.  ......*.\...*#
#. .\\...... . *.*..\.....\\ **.. ..#. #..#.#.......#*. ## .\\\ .*#.. #\.\. .  * ...\.\..#..## #  ......\ ...\.. .* \###\..*\.#* ..*  ..  ....  *.# .#
#  \ *\\.. . ... .\..#*.\.*..*....\..... .... ...  . .*... #.#   ... ..\*.... ....#.....  .# ...  *.. ...#.*.. .#. .* ##. ..*..#..*..     .*..\..##..#
##..*....*.. . .*...*.# \...  .. ...*.\.#.*.... ..\.  ......*....... ... ..# \#.*...\...*.*..*.. *......*..\.*... * .........*.....*.. ..*.....* ...##
#.#.# ....  ...#..* ...#..*........ . .#. ..*.#......*#\\  ..#\.* ...  ..\#.#.\....\.#.*.*. ..*......# ..... ..#...  ..   ..#.*... ..\.  .#.#... ..**#
#. .# *.. . .*... .*..# . \.\...  .....#\  \.  . ..*..\........ *. .#.  *#*. ....... .*..  \* #.#  ..\.....*. .. # .\  ...*..* . .#.*.....#.* .\.\ .##
#  .*... ....*.... *#....*. *.. ...#\#. ..... ....  *.  *..\#.. .#...*#.**.*.#  .#. #.. .....*....#.*.   . ....*. .#..#..  . * ...##....*.*.#* .##.###
# .. .. ..\.. ..#.\\.#. ..\..*.#* \*#.. .  ##... \.*\#.* .. .#\..*. . . . . .  ....*...\ ...#.*.....  *\.  .\ \. . ....#......*. *#.. # ..#.*.#..# . #
#..* ..  ....#     .** .#.  . **\ ..\.#..\ ..#....# .#.#.#**.*..*#..#. .  ...#..... ...\...\.#.* ##.* ...#    .. .  .*  ... ........ . ... . .... *..#
# #**... .... .. . *   .**\ ......* ... .*.*..\......#.* #**.... . *...  ...* *.  #.  * *..*..* #. ..... . ..#  ....\.#.#*#.#.#.#.  \ .\*..*.\.....  #
#..## .   #..  ..*. .#...#. #... ...\ ........#.*.. \....#....  . .. ..# .#  ..*\#.*\....#.*..  ..# . .*.. ........ ##... .. *...  . *  ... *.* .*..##
#. . .\....*#\#. ...... *..... *..  .\*.....*.. ##.*. ..\. \.#. #.#*.#. ...*. ... . .* # *.* #.......  .. #.#.##........###.. \. .*.. .#.. ..*.*..#.##
#... .#......* .........#.  *.  ...#. . ...\.*   .. .#... **... **. ..#*..... \ \...# #.....*. . .#.. . ..*...... ..* #* .\..##.#  #. .*##..##.* ....#
#. ...\ ..*.....* .*\...* *..\\#..#  *. ....*....#..#.... ...*....#\.#.. *#.\\..*.* ## .###.** .. *.*...\.\.*  .. .. .#...... . \  .# .*.#* .\ ..# ..#
# \.. ...*.*........*#.\\##*. ...#  .*..#.. **.. .*...*#\..... ...##.**.*......#*#\ ... ..  #. ................ ...#....# .. .* * ..#..  ..\.. .\.#.*#
#...*.   .  .... ..*.. .\#*..\#.*.....*. *....**\.*.*.....# \...... . .\.. .* *#.... .*  .* *# ... ..*....*.. ..####..\.. .\**....\#......... .*..# *#
# ... \. ..* ..#.#. .#... ........ \#.*.. ..  ...* .*..*.*#..*. . .\  \..  \.......\.\#.. #  **.*#*\\. .\..##..* ##. .* ..\. .. *.#.###.##.. .#*.*#..#
#.  ..*...#..\*. # ...**#.... \ #...#. ....*. ....  ..#.\. ....#...\ .  \\. .* ..\.. #..\\\...*.#.   .*... ..*..#.. ...* ..**..... ..  ...#.\.#.... ##
#.*.... .  .. ...# .......*# ...#*. \..*.#.#\....# ..*.#..\#. #.\. \\......##\.**..*\.\..\....#  *..\*..#.#...*..  ..  ...#\# .   \...# .. .\ . . .  #
#.. . .....*#* ... .# \... .*. ......* . .. .....  #...... .. .......#\# ...  . \. . *. #. ..  ...*..  \* ..... *.. *..#... ...\*#*. *.......\ . * #.#
#.#..*. ..\.....*.. *.*.... #.#  ..\ ... .\** ..*  .... \......*.*.**.*\  . #. .#\. #. #......\...  .#. #...#. *. ......\.. #.. .**....*#.# *... ....#
#\....... \\#.#.*...\*. . .*#. .... #  .##.**#...*.. ...#. ...... . ...* . # *# *. *.*\.#\ ..#.... .#.#...\.#. .#..*. ... # ..  ....*..  #.*....* . ##
#... *#..#... .. . *..\*##.#.... \...* #..#.   ..#...\.... *.*  ..#  *.\..##....*..* * #.......## ** .  # .*.*\\##*#...#.....*## .....#.. .. ...#... #
#*..#.. #..... . .#. #.*.....\## ... .#. ...#.#..*....... \. #...* #*#.** \\#..*.. #......*.\. .*  *...* .. ...* #...**...#.\..#.  ..#. . .*. #.*.  .#
##..#. ..*. .*..... . #.*  *#. .##..#*......\.*.** . ... ..*# #\.#... #. ..*... .* .. #...#.....#......#...#. .. . .. .. *. *\  . .*.#....*.. #...* .#
#**#.. .*.  *  .* ....*...#.. ...# . #...  .....#.* *\.....#.**.##....  ..*.. ..\. ..............**... .. ..#*...#..# *... ....  ..\... *#.*.*  #.\*\#
# ...........#...  . ....*..# .#*.  ..\* \ *\...#..   .*.....#*......* #...#*# .. ... #. ..  ...#.  #....**.#...\* .\.*.....\.#....\#..*  . .\\.\ \  #
#..#. .\\\.#......#*..   * .*..**........#..* ..  ... . ..#*........ #. .*..  ..*... ........# ..  . . ...  .*    . ....... .\.*  .#.....* ..  *... .#
#..  \**. *.*.#..#..*...*..* . .. .. \.#. ... . ...##*.#. .   .*#...\#..#...##*...#*.*. #*.. ..* .\... .*  #..**....#\. .# .....#..... ** *.....\#..\#
#.. ..*# ..*.#.# ...*. ..#. ... \. *.*.\.*.*.*#*....#.##*...#*...#.\. ... \...#....*.\.**.. *. .#.\.. .\#.*..  ...... .  \.*... .*.  *#.......*.# . .#
#. .*.#.##..   ..*......*. **.*.\ *.... ...#. .. .    .##\.#. #.# . *\ ...#*... ..  #. #.# ..#...##. #* *...#.*.\..# \..... #.*. . ....  ..#.*..#..#.#
# . .* .*.... ..* #.#*.  \..#.* \.\. ..* . #*.  #.  .   \.#... .* .......#*. . ....... .\ ** \*. #\    ..\ .#..#....\.#. .#\......#... *.##..  .#.# .#
#. .#\...\*\#\. .* . #  ..... . *  . ...... .  .#. #......* .*. . .. .*#..## . *..\.......* . ..#..\. .#.*.* . .\.*. ......  ..##\   *..*... .#..*..*#
#\..**  **.* ....... .. #. ..***.\.  .... *    .. .. .#....*...#........#.\.. * .#..\.... .#......**#.. *.*. ... #.*   .*  ..#....*....#..\.#*.......#
#...**.\.....  . ...\..* #\ #  ...*.. . .#... . \# *.\. *.. .\.*..#......*#...**  ..\.#. .. *..  ... . ... *\#.** #.. ..*.#.... . .....#.  . ...\ \*##
#... ..#.#....   #.##.#. .. .  .*....# ...\ #.....#... .....  ..*.* .*.  .\.  ..# .... #.....#..........\ ..  .#*.......\*. . .* ..   . ......* ....##
#. *\........ .....**.. .*.*.\. ...#... .  .  \.. ..\...  .*.*  .. ... ..  #... ...... ....#.\..***#\#... .............. .......*..  .#...... .... * #
# .  .# .*  ..#\. .. \  . . \........\...#..*. #..#  ..*..##\\  .. #..#*.*.....  **#. \*   ..... #.... . *#**... ... .\..*  #. ...*...  *. *\. ...*\ #
# \ .. \.\.  .#* **..##.#*...##\.# .*.#... .. . . ... *.#\..  .. #...*.\ # * .*\.#*...*.\.#   .. . \. *..*... ....##* . **. .. .. .. #.. .#.. ..*..#.#
# ... ..#....  ..* ..  ....#.....\....\.\.. ..\* ..*#. # #.. .#*. . #...  ... *...*\ \... ...#\ .... #.\..\....  ...*.#..  ..#\.\.* .... .. .\.*...*.#
#. . .#...\ *#.. .*...#*.....# ..........*......#...\..#... \ #.*#.  .. .. ..#.*  . * .... \#.. ....*...* .*. ..##..# .*# *. ##..*.#..  . #....*## ..#
#** .*\*.*.\ . .  ..*.. .*#..*.. .#.##.. #  .......*. . ..\...# #.... #.*\... #..  ... \. .*. \*... ...\. .## *\*.. ...*... *.\ ..#.*. ...#.\...#. *.#
#*. . .*. .#.... ... .... .*  .. *##\##*##.#.\. .  .   ..#. . .*.* .\ .*.*#.. .#..  *......##*.##. .* ....\...*.*  * . *..  ...*..# #..... # #.#.*##\#
#.#. #  #....\ ...\.....#*..*  ....*..  #\*. .\#....*..*# *\.. .....\..\.. \.##\.#.. *..... . .......*........ .. .......#..  ..  . .\ .#..#..#... * #
# *.#  #....\..#....  .. #...#...##..#..\# ...#..  .#  #*..* .... .... ..#\ .\.**  . \..... . .........#    .*...*\... .# ..# .#.........*... #.. *..#
#..\*\*....# ..#... ...\..... .#... .*....*.#.# .. \#*....  .. #..  ......* . .** ....#..*# *#.*#....*...* *....... *.... ... .*.#.. .#....#. .....*\#
## * *.# .. ... ...#... *\..*.  ..*..*# ... ...*..\..... ....\.. .#. . .#   #*.....\..... ...#.. ....*.#*.\.\# .. ...  .. .*...\.*#....... **  ... #\#
#..*.\... ....*#.\*.... # .  *..*.*. ..*.. #.. #. ......  ..#...*\##. ..... .# .. ..#  ..#  . . .... *\ \. ..\.#\.\. . ...# *.\*..*. ..\. *...#.# .. #
#.  #..\.#..*.. ..*. *.* .*.....# .....#  ..# #\.  .......#.. ..#...#.....*.\....#  ..*#..#  ......* . . .....\.*...\....#.*\..*.. ..\  .. *.. * .  .#
#*....#.#*. .... .  ... .....  .\** ....... .*.. *.  \..#.#. \ .*...#\*...##.# \  \..**   *..*. *. . .# .#.\.# *# .\ ...  ..*.\..#.\ .... .\#** ..   #
#... . ..  .#..*..*. ....... ##..#...\ ..#.....#...** # .#.#...... ...*.. . ..#. . .*. .*.....#..****#* *...*\.*.#...... ..#..\\......  ..**. .... *##
#\  .......  ..* .*\.* ...** ...\..* ..\ * # ..# #...# #  #..*\....*...\\ .. *#. .#.#\..... . ......\\.#..**...*. .*.#. ...# .*  \..# ..*.#..# #...  #
#......# . *. #....\. \...* . .*.*\.# #. . . .... .. .##... ...\..  \.# .* ..#.##..**.. .**\*\*..**\\#....  .. ...***\..\..\.  *... .. ..\...* ...\*.#
#....#. #\\.#... **..\..#*.#.#.*. #*........*.. #. ... .#* . #..... * *\  .\*## # . ###.#  #*.#....*.... ...   .... ...\......... .#\  .* ...*...*.*.#
# . \ \... .. \*...#.. ###\.. .  .\#.\*  .\..  * *...# . ....*  *.#.**#.....  ... .  ... . ... * \#. .#.  .. ##.. ...# #... * *.#\.... *. ... ...#\.*#
# #*.. #..  #.. .   ..*.. .#. \..#  .#..#.. #*#...\#..*#..\..\...#. . .... # *. ..... .....#   .#.#.*  #.......\.# . ...*.....  .# .\*  . \ .*\ \ .  #
#. .* .....* ..*  \ ##. .... ..... .. *#. *#   \ .....#..\*.* .     *......\  **#. *.  * ..  #.. .\..#... . . .\. ... . ...*...* . . .  # .\.# # . .##
#  .. *.*...\.#.#.\... ..... #.*..*..*...  ......*.*......*... *..... .. .. *..... *.# #..#.##.*.\.\......# **.. .....\....\ . *..*\* *... ..... ... #
# \. #.*. .#. ..  ...*...#......   ...\......\*...... ...#* .*\..  .#...*.. . \.. ..... *....*.**...**.\.#*..*... *...*.  ..*#.#* *..*...*.\.......\.#
##.\* #*...#..**.#  .. ...*# ....#.*.. .... \...  #.#...\*..... .#.. ..\.# ..*.....\.\....*.#.* ...\ ..*.\.. *... ...#..\..#....#.**\.\ ... \..\*# ..#
#...... ...... .. ##. ...... *..*. #..... . .* ....**  ...##* ..  ..\..*  .*  *..  . ...#. #..*. . .#.....## ..\..*.#*... **# ..\.\.. *#...#..   # \*#
#.* . ........... .#...\  .....\ #* .....#...#...#   *#.#..... ....*......##... ... ...\ .#*.*.#. ..** .*..#... .\#..#\.\.. .  *\..**..... . .\...*..#
######L###############################################################################################################################################