######################################################################################################################################################
#*....** *..  .#...#..##*.\..#...... * *. . .\ .#... ...# .*#*....... *..#.  . ......*... . .# *#... *  ..#*.   .....#... ..... ..*. ....# . .  * ...#
#*...\  *.. ..*  ........... ....... ........## *\. ...... *..  .*# .#* #** *... #  .. *..... .*. ....*.. .#..  * ## . .... ......\.  . ... .*.... .*#
#.*.......**..#..... #..** .. .\ . .##  #. .  ...*.  ..#...#   .#* # . #.. . ..  *. ..*#. # .. **  ...# . #\.. . .\...\.........\....*#..#.........*.#
#... ....* . .  .*....#......... #*# ..* .* ..  .. ..... \ . ....* ..#..  .*..* \  . ...  ... #  #.# ...###.*R. .....#..*......\\..   ...*..\\.... \.#
#.... .\#. ...#.... ..\.. . * .#....#\.#***..*. **.\..... . *.\ .#  ..##.*#  . . *..*....#... .. .  ... ..#..* \......#..*#.#.. \#.  ... *\#... .  ..#
#.\ .. ...#.  ..**.\*.  .#.\ *... .#.. .#*. .#. . .\. .. .. .... .....#.*.** ...\..#..........  \.#.\ ...#.. #... .. #.....##* .* \   ..#*...#.. .*..#
#.. . .. ##.. * ..  .# #..#.  .* .*.*.#\\.\  . .  #.  .# *.*....\ \ \. *.#\.*... ..  #. ..#.  ... *......#..*.  .. *  .. * ..# *............*#*......#
#...*... ..#.. *.. ...* .#* **..#...* . .....#.......#.#..  . .\.#*#...#....   .. .#. ...*..#**.. *.... ..#.. .\\....*.....*.* .#..*..***......... ..#
#.. ..*..... .*..#..*....# .#.  ....\ #..*....\*.#..... .#.  .   ...\..#.........*\....#. ..........  .* ...... . . . .*.......*# ... ...*. ... .\.#.#
#..#...*  .  . .## .#.*\....#*.   ....* .#....  ..  \ ..### . ..#.*...##.\..*.* .#  \. ........#.....# # \ **......# .... .* *#..*..#.. .. ...#\.. #.#
#..**\ #\#*........  #\# .. ..  ... #.... * *....**#  ..#. ##.#  ....*.. . # ** #.*#..#.\.....#. \..#*.. .\.*\#....#..# ...\..## .... . # * ...#.. ###
#. .#  *.##.*.*. .* ...*. #...*...*#. *.##.*\**.* ..#.*# # .. #.. **.. ..#. .. .*##... ..  . #...#... *...##   .   ..\.... *.*. ##  *.#. .**  *. . ..#
## . # \ #........*.* .*... .*...*.#.\ .*\. ..* . .\*.*....\#.\..#* .*.. *....\*....... .... .....#..#.##*#.\... .*##.. .... ..\#.. . ...\.\   .. *..#
##. #\*..##.*... \. . .. .. \*\. .*...\  .*..\ .. ..**.\.. ...... #..... ....... *.#..... .# ... #**.. ..... ..*.* \**  #...... ......##........#\* .#
#.....*\*.*### .. \.. . .#.*....**... .*....  \......  ..*. **.   *#\.... .*\ .. .#\ ...*....#.#.\#......  .\# \.. . .....#.*#.#..#.\.....#.. ##.... #
#...*......#...#. ...*. # ... .\ .**..*\.*.#... ....  . .. .* .. #.##..*.........*.. **..... .... #.\ ..*...   #..  ... ...*#..#*. .* .. . .  ...#.#*#
#... .## .... \ \......#.*. ...... .. ..## ...*........ ..*....\.#..#. ..  #.  **.... *...#*.* .#.. .\. . *# ..  \.........*...\#.....\ .*#.*..*... .#
#. *.  *#. ..... . . ..**  .#\# ... . #.... . * .. ..  ..  .\.\\*...* *\..#..*... * . .... *.*#.*. .#..##*..  . ..\......# ............*. ........# *#
#.. * **..# \...\ .... ..... .#*.*   #....*....#. .#...*....*.*. ....... \... ...* \..##*#\. * \....*##..*.\ . .#.. .  ...*..#.#..... ..*.\..... . ..#
#.   *....\..#.\. \*. ............ . .#. *.  .. ..*.. ..  .\... *..* #..  ....# ... .*..\..*.#\#.#.. *....*.    . *. ...\ ..**.. #. # ...# #.....*\. #
#* #.* ..*.#. .#.....* #. . ...#..#*\.*\ ..#*..#. . \.. ...*. .. ..... *... *\.... ..*.\.#.#\ .#.#.....#..*.....  ....#.. ..*.  ...... ....\.#. ..*..#
#     . .##.....*..\.\... #\...  .... #.#......##.\*\. ....  .#...#.*........ \.. ..##.\.*.*..*. ...  ..*........ ..  #.* *.  ......#.#.... ...*# ...#
#...*...#.\ .*.. .#*.*.\.. . .... .#.. .*.\.. .\.**\..  .*.*.... ... ..... .  . #  . .**...\ .. * ..#.# .** ....\# ... ...*....*..#.# .. .\........*\#
#.\........*## ..  ..... ...\ ........ *. . ....  . .....#.* .# ...  .. ..**  #  *.#.**#.......   .#.\  **.**#....  #.*...#.\...**.#  ..*.. \... **.*#
#.. ..#..#....*..... * . *.... #\.. .*   . .*.#.... . ...\.#.#* .*  .. .##. .....*#...  .# **\.... \.  \..... ...* * ....#  #.......#\*...#. .. # .*##
#*..#. .*...\ ##  \ .#.. . ... ......\.#. #.... *#.* #...*.  #*.*..## . . .#.**#...  .  ..* .#. . ##.\\.. . .#....#.... .#\   .*.* #...\...#.  .\. .\#
#............. .*#.. * .   ..  ..#...*... ... .#..#   *.  \ .\...\.#\ . . ...\... . .\.\\. ...# *..*....##..# . # .* \*.....  ...  . ....  ..*. .##. #
#  .\*  ......\ .*......*.*.... . .....# ... * .. ... #** . .##..  ..#  ..#. .. *.#.#. .#..*.. \   ..... ... . ...*. .... #.. ..#**. ..# ..* .  ..*..#
#...#\.*..*... ....#.# ..\* .... ..\* .*\*\#...\\.*#... .......... . *...*  .. *#... ......#*.  ... ..\ .*\...**..#* .\ . #. ....#.. *#.........**.#.#
#\... . .. # ..#..#.#.\. ..#. ..\  \.. ........ .* ... .*...#.. . . .....#.....  ......*. \..*. .\.\*... .........*......*...*## . ....\.# #.*..\. ..#
#. ..#....  ...\.#.....**###.*.....** .....\#\..  .....*.. *. .*.. .#...  . . #  . ..#......#. \..#\#  .........   .\.  ...*.# .. .. ...*.*.....#. . #
#.*.*.*.... .*..  . .*.\\ ........... .. ...#\ #..*#...*#  .#.\*\.. #.  .  #.   . ...#.....\* ...*  .\......#...... *...*.*... ......*....#.. .\.* #*#
#....\* ...\. .*..##.*....* *..# ...... ..#. *..#\  .*...*\.\*** ..... .* # . .* . #   ... #. *## .....  .\ .....*....* * ..\..... .....* * . #... **#
#..*...\..... .## \.#**..#.. ....\\...*...#.. .*.#*.#*.  \...\ ... \..# .\\.......  .......*..  *#.......#. ...*.*.. . ..#  **......*. .  . ..... . .#
#..... #.. ... *...  ## \.. * ...... .# .#.*....**. ... .. \ .*.\.. . .\..*. .. . ....  #....  ....*.. #.*.\ *##...#.. \### .#*..   *...*#..**  .....#
# *\. .# .*. .. ....*\ .*. .. .. .    *.#..... .\.... ..*..*..# ..*..*\..\..#....\.. . .##\.#*\.#..#\..  .*.\.*#  .. ... .#...*..#..  ..... ... #....#
#... . ... ... #.. *.. ...#   .\..#\ # ..#..#. ....  .. ...#. ... .. * .*.*.. # ..***. ##*.. *  ...... *#* ..# #*. .. .....#.....#....##..... .##... #
##..#.. .*.. ..##* ..*#. ..*..*#..*.# ... . ..#.*#..\*#. ......#..*...\...#\#....*... . *. ...##  .. **..#\...# ..   .... * ..   *\ ...  ..  # ......#
# .*.#........ \#.  . .*   .....\.. .  . * ....... ..... ... .*.# ....*...*...   \ .. .... **.*  ..#### .#...*..*#\*. .. . .*.. . .....#...# ##. .  \#
#..... . .#*.# ..*... \..   #*....*....\...  *.....#........\. . \.... #.....# .**.*.      ..#\\. .... # *.. .# .\.. .##.  . .. #.. .*...  ..#.  . ..#
#\.\.*..*..#. ... . ##.* .*... ....  *..... ......# # .*#....\.#..# \*#  ....\...#..\.# #... * \*. ....*...\....\..# ...... .. *.\.. . ..*. ## #.*...#
#....\ .  \. . *. ..\ .\#..*. .*...... . ..... ...#.. . .#   \. #. .....\. .#..* ..# .*.\ .* *...# .. ..   ..#*.. ..*  # #...*#\. #..... .#...  *\.. #
#.#.  ......*..*.... ..*  #.**# .*.#\. ....\... .. .......*.#*. *. ..# #....\. .#.#**.*.#*.#.. ...#...* .. .. *##... .... . .  ..  .**...*\. \#*  ..\#
#.*.\.#\#.*. ... ...#........#..#.#.*.#*#..  ..#.*.*\ ...#.\ . . * #.. ........ .. . .. .*\#..*. *...\. ..#\. .#.*.\... ... ...........#..*.*..*. .# #
# *. ....*..# \... .. . ..... .. ..#   .*  .. .\.#. ...* #..#.##\. ***.. ... # ......\ ...#..  ...#. . ....#. #*. . #...... #\.. ....\..   .\.\ .....#
#*. ........\ .......... ...*... #.*..\ ..* #* *.. ...\...... .. .\..*..*#.#.*..*.....*   .#.* ..*  .. ......#  . \*. . ##*... ...\  . .. ..  .....  #
#.  ...# *. \ \  ..*..\#. ..**.\#. ...#..\..#*..# ..\.. ##..*..\.**..*.#*\. . ..#....... ...#..#. .#.##...\..#.#......*  \.......#........ \.#...*.. #
#. *..#*... .. #..#.\ *\*....\  .......#.  .#..*..\. ... #.  ... .. ..** .. . .. ...*\ #\#  ..\ *.....*.. ..***.#*\..  .. ... *#... . .**..  .....\..#
#...##.* ..#..\.\. *...\..#\.#..**.....#  ......\...#.. #**......... .#\** .  .#.*.\ ....#.. ...\*.. .\.# \.... . ....... #.\#.\##.. . #.#......\....#
##.\....#* ..**. ..# \.\.#.....# ... ... .*.. .#. ## ....#...#. .. *..   . ...## #    ..##...*.\ .. ......\*..#..... .##\....*\*.  .#.. ..   . ...*.##
#... . \** . .# .\ \.. .. .#\## \..*  . .\.*..... ...*.... ..#.........# * #.#* ..#..*.#.\. .#..*\ .....#.\. ..... . .#. ..#\###*.*.## #. ..... #*. .#
#**.#. . #. .#. ....#...**. . ..*#. ...... .***...*..#*\ .......  ..  .. . . ......... ..\  ..\\. .. *. *.*   *##.*  .#\.*.. #  ...... . # .........*#
#. .. ..  #..#. .  .* ...\.##\   .*. ..**... .#....# .*.*#.... .#....**. #.# *...#.\*. #.*\*. *# .. .#.....#.. *... ....*.....#\.\. #...\..* \.. ..#*#
#............#. ..\\......#...\...\... # \#.#*# ...... .#*.\.....#..\....#.** .\ ..  ....* #.. .. .   #...  ...\..*##... .\.#.. . ...* .   ..........#
#..\ .. ... \..*#*.\.* . \.. \ .  .. ..*..##. ..#..*.....# #.....\.#.** *\*..#*....*. #.....* # *.... #...* . ..#.*  . **.** ... .##.#.#...#*....  .##
#.*.#. .....#..\.#. .   # #. .. *#\.#. . ...# .. \.....#...... .* #.#  ...#\*............ . .#.......\    #.*.  .......##*#   \....  ..\.*..... ....##
# . #. ..*#.\*...............*.. .#**. .. ....*  ..   ..... . *.... .\.#  ##.... .. ........*.**..  .#..  ...  *. * \ ...\*..*.... .. ..\....... ..#*#
#. ### ... .* .... .#.    ..#. # ... ..#.#.* .#* .#....*\#..*. *...* # ...  . # ..    #...*\.\...     .  .#. .#..\.. ...#*.\ .**\  . .. .. .\. . . ..#
#**#. . #*#..#*.. .#.**..*.*\.. . ....   *\.....#...#.\.\..\*.#* #*.  .. .......#....  * .** .*....** #.. #.. ..\ ....\\. . ..*.....**....#\.\ #.  .*#
# ......#.#...#....# . .... **.#.*#. .#..*..\ . \.. . .***. ...\.*. ...*.  ...\ ..*.*#.... ..#.....#. *..**... \...* #......*# . .*..#.  .. *. .#   .#
#. .... .  ....\** .  . ..*\ ...#\.*. \*...#. . .. .. . \*.#....*. ..# ...* ...# \..# .... .. ....##.. .#.*. . *..#.*#. .*.\.... ..# ..  . \*.# .\..##
# #* #.   .#....... . \ ..\. \  .*#* #.... .*.... #.. .\*..\* ..\..#...#*. .\*#.  .##*. .* .....\  . .#.. **#.  \\\#.*.*. **.... .#.#*####...###. .#.#
#.* .*....... .  ##.  *..#...*.... \\ **.....* ..**.........#.\# . .#.. ... .\\  #...*...*. \.....   *.#. .#.#*.. .\#  .  .*.#....\.. *.*...#*.#. \..#
# ...*. .#*. ..  .. .. # #......* .# .\.. *... . . . ...*.*.*. ... ##*. ...  *\ #..... ...#*.#*#........  .#.... #. \. . * #*. *. ..\.#* *..**. # . .#
#  .#....... .. #. .....  .#....... .. ...\ .. .\.... .... ..#..**.   .*.#..  \.* . . ..#....# .*..# .. ....... \.# .....*...# .\... ##....#.... . ###
#...#*.......**... # ..*#..# . *....*.. ..##.\.#   . \..  .#.. ..#....*..    .#..## *## .. # #..* #. *# .*.*   ..# ..*.#...#. ..... .#....\.. . ..* ##
#*.......#\#..*. ... *#..\*.*.\.\.. ....\ .\..##.# *.. .....*.. .*... ..#..*..\..\# ...#...   .......\. ...# ......  *. ...#..# . .... #.  ..*.# .#  #
#..#. ....\ ....*. . . .  ......###... .\**...#... #...  ###*...#*. . \. ..#....  ..#*.*..#.\....... .. #. #*. * ..#.* ...\\...*. .\. #...# *..... *.#
#**..*...#..##. \# . # .#.   ...* .*...\*... ................* . ..*#..#... .#...*.... \.*..*.*. #.*.. # ....#. *##. . .......*\#.. .. .#...  #..\...#
#..*... # ...#. ........*. ... *. .....\.*... .... \...\*#*.\...* *....*.*....\ .\. #.... ..#...#. ..\* * ..*#.*..# . \....# \........... .#.  * ....#
#* ..  #....#.  #.....** *#......\.#....#\........# ....#.#. .. . .#........# .. * \ ........*...#..** ...****. # .. . ... .. ..   ... ...... .*. *.\#
#* . .#. *...##.##\#.....#  .#...#.#..# #   \...\.. #.# ..  #*...... # .. . .*. . .*.*. .    .. .# *....... .#. ..  .#*#....#..  . #.#.. .   . #. .. #
#....#*..*.... .. . .. ..*.. # .  ..\.#.....\ ....*.# .*... * . ....... .*.*..#.\. .\. .  . .# ...*#.\..#\ .#.*. .##. .*. *........  ........#.. .\ *#
##..*.. ...\.* ... *..#   ..... .*.... \....\*.#..#\*. ......... .# ... .#.\###.....................##.#\#.#....* #...*... .. . #\*\#..#*. *.#.#..*. #
#. .... .***................  ...*#*.  #..\ **.#.# \..*#*\* . . ..* ..   *.#*.. ##... .   \...*.... .*.*...#.*...\.#  ..*.*#. #   *. .#\.*  .. .. ...#
#  .** #.# ... .  ** . \...#....\ .*.#.......#.\#..... *..  . * ....*...* .....*.#**\  .\..... #..* *.....*. .#. **.\##.. #...#.*.. .#....*. .  .. ..#
# .\  .   ...#. * .......*#.... ..#*... .#... .. .* *........#.*. *......* .#\..... ## ..*... #.  .. *. *....\..* * .*\ .  ..*..  .*...#.* \ ...#.. .#
#*..\#. .#. \..#.....#....*. .... ......*.... . .. .*#  .  .. .... . * ...*.#.....#.* ..\*\*##*  # *.#.#. . .   \\ . **.. .#*.....# ..*. ...# .*..#*.#
# ... ....#...#  ....# . ...\.....\# #.*.#. ........... ..#...\.. .#..#.... .# # ..* *.*   ..#...  ...#...*..\..\..#.\.. **.... .    *\.........\..# #
# #*.... *#..\.....#.. ... . . ......#... *##*.\#. *  .\..  . ..... \.. .. ..*.* ..* .*.. .\..\ ..  ...  .##....  .#.* . ..... .*# ..**\ .. # \ #.#.##
#. .*\...... ..#....#..*.... #. .#\....... ..\.*.*...*.. ...  .\. *... ..* #..*# \.. ...  ..*  ..\.#...#.\ \..... *. ..*#...... ..  .. *.* *#.*..#*.##
#..#.#. ..\  .. .... #.#....  .....#*. .....*.\..\*. ..  . .. *.##.#.*..  * ##.. .. *##.#..# . .....  *.  #...... #.*... ..\.##. .. ..... ..... #. ..#
### \..#. ..\.....*\... .  *... #...#* *......* .\.....* .#..*. .\ .*.. ..\. *#.... .#..#*...*.  ....**.\ . #... .. **.**.\..# ...#.#.. ** ...**..# .#
#..*#...*.\. # . .*... #. ........... *..... ...*........ .*. ..#....#..#....*\\.. ..\ *.*... .*....*#..#....\.#.*...\ ..#.. *  .# ... # .  .. . .  *#
#..\ *.## . .#  .#. * .  ..*...# .# ..\\.#..## .*  .*..*..\. #*  #. .*..#..##... .* \. ..*.. .**..#\......# ..   *...#\ . ............\* .*.*..#...**#
#\.# ....\ #.... ..#..*.... #..#* .   *\*\ ..#. *... ...  #....# .... \*.. ...\.#..#....#*..\.* . .*.#...*. ...  . . # #*.*..\#....*.\ ..#   .#\.*...#
# ..\...# .#........ . .#.*..*.*.. \..#.\#. # . .....#....  *.....*\.. ..\  #..#...........##......... .  .   . .*.....  ..#..... ## ....#\..#. #.#.##
##..\* \...*..*..*# ... .## #....#..\#....\.\.* .....*. . ..  ..#.....*.#*... .. ...*#...... * ....#.#**...*\.. ... ..*......  \.   \*.#.....#...\.*##
#.. #  *....* #*. .#... .\ . * . \. . ...**##.*.#*..*. . \.. ..\.... #  .. ... ...#.#....*.  .*#.\   .*... .   #*...*..# .***. .# * .....  .. ..**.###
##...\.*. ..# . .........#... ...... . .. .. ** .. .#....*..  .\... ..#...#*...#* *...#* ...#..#\ ..**..###......  .\##. .. #*. . #\ ..  .....#.... ##
#... \..............\.*#.....\ ..#\. .. #\*\ .**........# ...\...  .....#.... ...** . . \# .*#.....#. .*#. ..#.. ..* *  ...... ... .. .. . ..##..#.#.#
#...\...... *..... . .  . .*#...  .  *#.....** \..#....\..... .. *... ....**....#..... ..*......# . ....\##.\*.. ##.... .#*## .. #*.. ......**... ...#
#*... ..*\ ..*\ .. .*...#. ...#...  ..........  ..#....#. ......*...\... ... ..#.#..\ ..* ..\... ..*.  ..#... ...*. . \ ..#  .*... * .......# .......#
#..#*.. . ....\...** .#.....*..*.#\. . ..# ..*..#.\... *.\. ....  ... ..*.*...***.. ..  . .# #...#  \ .........*.. ....#.*\ .\. #.. .*.... ....#.\ ..#
# .#..... .# # .# .*..*.... .*....*  .##*...*..# .*..**\ .#. .....*..###.. ... #.*.. .  .. .  ....* .....#.* # ..\*\**...*.*\. .... ...  #.##*...\* .#
L... # ..   .**\.*...* *#\# .#. #...#  .*#...**....* . ..#. ..#... .*.. ...#..*#.. ..  .*#...     .. ..*#*#. . .\#.\.#....\ . *.#*  *#*. \.. * .. ...#
#....#......#. *.*. #.*..#  . .#.. .# . .. ..  .#.\...*.#....#. ..* . \ #.\ .  \......* \\.. ..* .... #...#.  .....*.*......#...  ...#.#........\..#*#
#..**. #.. \. ...#\ **\....\#.#.*.#*\.##..\. . #...*....#..\ .. #. ## \.#... \ ....\..*..* # ...#...**.\.**.\ .   ...*........ . ..#..#.\........ ..\#
##.. \..**.\.   .*#.#.*......    ...... #... ... *..#...\##  . .# ..*.#\. *..... .#...... *. *.. .   .. \*.#...#*...* .#... ..**. .\..... *. .*.\....#
# ** *.. .#\.**.#.*....*#...*...#\\......\  ..* ###. . ...# .. ...* \* . **....*. *.*. ..\.**..  ..   *.#.# *.. #..**#  .. . # ..#  .#*..\#*..*..... #
#...\\....\.#... ....** *...*. ..\. .. #....*...  ...*.... #.........#.#.. .#. .. .. \..\.\.#\*#*.* .......  ...*. . .*......* .....#*....*.....#.** #
#.*#..*. . ..... \..*....*...*...#* ...     ..\. ... .. .*.  #.*.#..#*. *.#...#. *.*#.....*. \.......**...\.. ##. .....*...*.. .. .*. ...*.*.. *..   #
#*....... .*.* .#. . .*   \......   .\.#..*.\ ...##**... ..*...*...#.*.\..#.  .***...*.....** . .# *. ...*.# ..  \.\*#*.#. . *.\*..*.\.  .. #..* *..*#
# **.....\.. ......\.#..#*....\#  .#\...  \ .#.   ..#*......## . **....##. .... . .*. *#.... *...** .# .* ... .....*.   .*.#\*..#. . #.  #.. .*#*.. .#
#. ....#........## #.*..#.  ......* ..#.... # ..\ . . ...\...##.* . ...#.# #.#..##*. ....*.* *..#. .#. . ... #....  * .. #\.. # ..*.*..\**\....* .#.\#
#* ..\......\.\ ..#. .#. .#..\... .. ....  .\....##.#\ ..*\.....#.... #.*..\*..*. #...#. .. .#.\**.#\\.*.. #* . . .  ..*...*. ...*#. #.#..... .... ..#
#*..#  .....*#.......*.#... ##..* ...#*....\.##.#.# .. ... .... .#**..#*...\ #....##.....\. ....#...*\.*............. # . .. ...*.... ...........\# .#
#.. ..#.*..*#.*...#.#.\..#. *.......* .. #   . ..#.  . .....  \#... .*.##  .# \\.... ....... ..*\ ....#... .... . .*#.#..*.. *.........#. ..*.* . *#.#
#*#* ..# .. .*#...  ... .*.....#.....#. .#.#.#..*#.#..#  *. \.. ..... .. **#. *...  .... .....*\.* *  * .#  ....  .. . \*#. *.#*\.. **. ..*.....*.* .#
##...**.#   ..*.*. #.......*. ..... . ## .* .*.*##\......# \\.#..*. . *...  . . . . *.#.# ..# \..*\.*\.*...#\* ....... *.# * ..... .**#. .#\ \#.*#*\*#
# .. .... .#.\.#...\... \\. \.*..  #.....#..\..  .....  \.*... .*.#... ..# .\.*.\*......*...*...#.....#\*.*. .....*.  ...... #..*...#.* .#. *#..  ...#
#.....#.# * .# *. . .*....#..## . ##*.# .......*\...#. * ...\\. ..* #... ..##... \.#* \.\# \....#.. ...\\ .....*..\ *#..\.#. \....*..  ......*\... . #
#..*.*.*....*.#. . #.... # .. . .....*.. ...  **.*#\.\.  ...# ...#*#. \..#... ....#. *..*.....*### .#..\.#.... *..\.#*....**... . *#.*.. .*#.*.... .\#
#\  .. ...*.#*. *......* .* ** ..*.#.... \.#.. ....*..#.* .#. ..**** *.#.*. ...* ... . .#  ...  .\#.#.*\   ...#...*.#. .# # .. #..* *..*..\.....*  ..#
#. .. .... ..\*.#.\*....*......*..  *... ...\ * .*..\...*.#*.*  .*..     ....  \.#..# #.#....*....... #.......*.  #\ .\###*.*....*\  .*#. .\ ....  . #
#...... ##  ..* . . ...## \ \# #*.... #. ..  .....#\ .*## ..  \....**...*#...#.*#..... #.. ......* .... #..... .  . \....#.#.*.*# ..*..\  . .*...*.  #
#...... \.# .    *\ . ..........\......\...#.* . ..#**.... \#. * ..#..   #..\#..  ..............#.\...  *..\*# . . ... .*. . .*...... . .*...* ..# ..#
#.#. \.#...# #  ..#\.. \..\... #.  . . \.. .#  . * ....*... . .* ..#.\.#   .\. ... . ##*#. . .\..  .#. ... .*..#. ...  *..#. \.. .. #  #.  *#\*.##.  #
#..\.. ...**. .. #\. .... ..#*.* ....*.#....#*....# ##\ . *#  * ..  . * .*...#*.... *\. . .*. #..\...   *.......#..#. . .#..*.. .. . ..  ... ..#*..#.#
## \.\ \  .. .*. ..* # #*.# .*. #. ..*  .*.... # ..*#...#...  .\....... #.. .#.. .....*  .#.....*..# .... ...*.#.. ... ...*. .  ..... . . .#.....  ..#
# ..   #  ..*  *..... #.. *.....  ..*......\\.#. ..... .. .. ...#.. . .*\. ...*......*..\ ..#..\ ....*  .\ \. ...*... .*.\.*...# *. ........#.*\ .\..#
##*  .....*##.... *.....*. .  \... . .# . .. ..*    ....#...#.*..\..#..#.   ....***.*.. .*\.#.... #   .* .*.  ..*. . ..\..\.*.  . ........* .....*.# #
#.*  .#*....#\.. .. . \ ..\... .........*..\..#....#..*..*...... * .... ... * ....#\   ....#. . ...#**.#.#.#  *  #.. ..  .##... . ...#*#.## .\  ..* .#
# . .#. . *..*#** . ...\ .\ *.*.   #.....#*. #...#. #. ...... .. .. .*...##. ...#..*** ....#.....#..**....*.... ..*.**#.* ..... \  *..#.\... ...#\\*.#
#. .. ..*#.#...*.....*...# .... ... *.. ..... . ..\ *....\* .*..... *.* .. ..#.. ..\*...#\....\.*.. ........*\.#*\  *.# \.#. .# .*...\\*.**..#... ...#
#.. .#.. .#... .*..*# .. .. . #.#..\.... ..# .##** *..# *.#..# ....*. #\.. ...\ ..#*.#* .......\#.*.*.  #. #.*.#... **...... **#..#**..........*.*...#
#... . #* .##\  ..#\..*.... . .*......\*.\ *..\.....#. #.*.#  . . * ......#. ..............*. #......*...* ...# #. .*......#.#.#.*. .\. . .. .#.  .#.#
##...#..#* .#. ..*.#.. #.  ...*..   .#........#. .* .#.........*. .* ..*.....*\..\.#...**. ..*.# ...#...*.#  . *.*.  . ...# \\  .#*#.*..*..#. # .**..#
#. .#.. ...\* .  .#\.. #.# .\. . .#..*.. ..  **. #  \.*..  #  \....*\...# #\***.......#...#**\. \. ..#....# .. ..\ **.....*.*..* .....**. . .\#*..#..#
#*.#......** ...## #..*.. .* **.#.... . ..  .#... *....#.* ..* * ..*#*#*..* .. . .\ \.\......    ... ...   .\ ##*.#*.. ....##.\...... ...#.*#*.......#
##*.*.. .....*.. .... .\*.\.*.#..*.. .#  .\...\....* ....*.*.*. \  .. # ....\\#  *.. .\..\\ .#*.**.. .\# ..#......*.......#. ....*....\..# ..#. . .*\#
#.. **\ ....* #..#  ...  ....*#.*. \...  ..##**.. .   . ... .* ..  .#* .\ *..  .* .. .#*............ .... #.....#.#.\. . *.# ..*... #.  ..*\..#... ..#
#... .\.. ...#..#*\ ... \...*..  *..... . ..# . ....*.. .\...*\ ..\. #.... .*..*. .  .  . .*.#..#.*. ...*..#..\**....\#... ...*....*..*.\\##*.#...  .#
#..*. . # ...#*.* .#. . \...* .## ... #*.** #* .\*..* ... .*.. .  ....... .  ..*..... ..#...#...\*# #.....#.*.*.# \..   . .*  . .* ...* .. ..## ...*.#
#\#.\*..*... ....#...... ...  .\\# *\.*#.. ......*. .\...... ##. .  . #.#.   .#\....#.\... ..#..#....*....##....* . . ..# ..**. . *... .*... ***.*  .#
#*...#.# ..*  .\*. . . . ..\.........\  # #\..##...*....#. .# .** ..#......*.* \..*.*..... \.. ........\\#  #*..*.\*...**.**.#.\..    . . .*.....\ ..#
#..*.. .... .*.#...*.#......\.\.\*.#  .*.#.. .. ..... ...*.. ##. ...\  .\.... .. .....\.*. *.# .. .... .*..  ..*.#...**.*...#. ....##* ............  #
#  . .*.#. .......*.#.#..#\ .....#...... .#.....\.. ......#. ....##  #. .#\..*. .. ..... .\.   #\.......#* . .#..*. .....##.\..  ..*....**.#..**....\#
#..\\#... ...#..#.... .....#*.\.......*...#.*.. .#....... .#. ..##.....#...#.. .... ###.. #.. .*...#..  .....#  ...# . .. .*.# .#...  #. *#.#\#.\...*#
#....*.# \. .*..*... . *..\.  .  .... #. ...# ###.#\#. .. ..#.#... #.#*.. *..#*..\......*  #. *\......* ... .# ....*\#.#..#\ \.#...  \* ...*. ..\ .*.#
#........*.#....#....#.#... \..\# \##. .*#.#. *.**...\*#.#. *.#... #..... \.. .*.*..*....\#.#.\.   .. .* ...\.\ . ..... .#\.. .#......\..  *#*#.* ..\#
#..  .  \ .\.... .* *.  .#*   .*..\.#.#  .\\.#.....*#.  ...  .    .......*.... . .. . ... . #*.* . . .. .*... .*... \.. ..  \**... \.. .....#. .#..#.#
#..  ..*.....#..*.  . ...\... # *.#..... . *. .   ......*...##  #\ * ...# *\.*...... .*.... .. . ..* .# ... ....#....*#...#..# .**....\..\. ...*. ...#
#\..\*. .\ #*...   .*.. ..*.#.# ..*.. *.. #........*..*...#. \*.* .   ...#....#........ *.*.*.**....\.. .\*...*..\#.# .*... .*.. *.. .##...*\... .#..#
#. ...*.. ....#** #. ... *......*# *.  # ...#. #. #.*.  *..\..\ ..  .......#\#\ ... . ... .  .#.. ..*....#... #. .# . * ...  #...#.  *\... .*  ......#
#*#.\*..#.\..\.#. ....#.....\# *...#*# * .. .##... .... .#..#.  .....#.\.. ..#...\....*....*.#....##\# ..#... ..  .*.#*... ..**. .. . ... ....\..... #
# ............#\.\ ... \ .. ... *. .....#. .* #. ..*#*  .  \ .*.. .**  . ..\..... ..  ..\  .#*......** #\ . \.. #..\ . ..*.....\   ## .#. ..\* *#\...#
#.**  ##*... . #\  .  ..\##...* ..... *..*.*.*.\.... ...   . .#....\\.. .. .....*......  ##.   . .. ..* \..*.\...\...#.. .....*. #..#... ..\..#   ...#
######################################################################################################################################################