##############################################################################################################################################L#######
#* ...#..... #.......*...  ..#\...*.\..#* # ..*. . .** ... .*...#. .\\..*.#.*.*. \  .#... #..  .. ..*\..# .# .*.#.*..   *.\.\.#. ...*.... *..*..\#...#
#...*.#..\..*.  .#\*..\. .\..**.# *.#......# #\##..# #...*.# ... ..*#....* . ..#.. .. ... .... ...* .##* #  .\.* .   #.\.#....#....* .\.. ... .*.. *.#
##.*.. .\ .. . . *......#.**....*..  . .#*..#.... ............#... *....*...#...* #.\\*\.  ..... ..#...#* \# *.*.  .#.. .\.#. \ . .**.... .\.\... \..#
#*.......*.*# .*##.#..*.#....##...\ #\.#..\..\ *... .. .##*. .*..\ ..  ..# #.\..#..#.*** ..#.#.#. ..\ *. *\\..#  *. .. . *.#. ...*.....#..  ... #...##
# #.#...*  .#........\ . * ..**..# ...**...*#..*..#. .  ... *... . .........\. .#\.*.#\.#  ##...*.. .# *...*..... .#.....#*\.#........*..#........ .*#
#*#*.*..*\\ *.... ....#  . .#.#  .....*#..  . \ ... ##.##...#.#.#.......... .\.*....#.# ..... \..... *.#..**...#*..... *.#......... **#.#.\.. *...\. #
### ...\*..\.....*.#. .  .. ... ...   . ....* ... ......\ *..#.. .*.#....\....\ ... .##. .......* .* ... \.#...*........ ........*.  .**. ...*#...  .#
#\#...#\\...*... # ..*..*\.. .* . ..*.. *...#.##....#* ......\*#.  .**.. \.  *.....\.#. *...*...# .  ...   \#.. ...#*.. .  ...... ...\..*..... ...*\*#
##*... .. *. ..#*..*#*..#...#....#....*. .. ......*.###.... ...\.*..# ....#*.##. #.... *##.. #. \ ##* . . *.. ..* #. .....**\\#.  #*..*....*.#.... . #
#.\.#...#....... . .....*.... #..#.....*.*.\....\. ..#\..* * .  .  ...... .  ...*.#..*.. .#... ....*.... .....#.... ... #  ......#..** ...... .. .. .#
#*.*..... .. *.    .... #\..#\.....*\*#   ...*.# # . *...#....*  .....\ ..*... .* ..\.....*...#. *#..*.....*. ..... #.\  ...*..\.\.... #..\..... .  .#
#*.. .......#.* .* .# *......  . ... ..*..***..**\\ .\##.#... \**. .#..*#..#.*..    ....*..#..\ .#.*. \\...* #.. .* .. ..#.*\.#..#*..#*. ... ...... *#
# .  *... ..\#. .#. .# ..#. .**..#...**. #.*.....*.*..\\* . ..\ # .#.#\#..#.#. *##.. ..*...*.#..\..\##\ *... ....... .... . .**.   . * . *#.... **.#.#
#.... ...**#...* \.. * .........\..\....***.*. .....#.  ...... .#.......*..#.. ......#.  . . .....#...#..*..\ . ##.\.*.#..*#*\.... \.*.  ***#.*  ...\#
## .....*   * *.*. ..##...* .. #.*# . .#...... #.#..\\..... ...*#....  .* ..#...#.#\# #........* ##. ....... \... #..#...... ......  .. .\#..\ .#. . #
#.#\**..***...  # .\..#..# .  *..#*\..  .#..*..* ..\ .#.... . \.\ .......... .. *.*#..*. ..*.*#.\.#...\...*....*.* #.....\.  \..........\  . * *. ...#
#  .....*.\ .#.\.*...*#... . . . .*..*.  #....#.. .#..# ..# .. .*..#.## .    .. ..#.....#..*# ....\.*....*.  ....  .#...# ** ..  ...*.....\. ..#*....#
#  .# \ ..#..#.. ..... .*  # . *....*#........ ..#............# *.#...**....*..* . .#....# . .###*. .\...*...# .* ..*..   \** #*  ...#....#.....  .**#
#**.. ...\#.#  ... .*...#.. \. *#.\ .. ##.. \*.#......#.#*.*.#.#.* .   ....*# ... .# .# \... .. . . .#.... ##.. ...\*\ **. . ......... .... .  #.....#
#*.##..#\ .*.*   *#...*\.*.#.*..\..*. ....... * .....##..\*..#\#....#  ...**   ##.**..* ....\#. . ..\...*..#..*# .... .......\.*    .*.*# .. ..\...\ #
#... *.*..*..  ..* *. .#. ... .......**.*.. .#*.. ....\ *.. #*..   # ..* ..... .#...  ..#...  . \....... . . # .. #.#..* #.\... ....  ........ .*.* ##
#.. ......*..#*   .....\. # . . . #\....*\..*#*...\... ..  ..***.....**.. #...  . #.. ...\... \....\  # . .\ # #....**.. ... # ...... . #.#*...#* .*##
# *#. .. ...# ........#... **  ........*... ......\.. .\.\ . .** *...\.\. .#*.*...   *...\ ...\. . ..\. *.#... ...*.# ..........* ..\.. . \.\...#\.#.#
##.. ......... .\*.... ..#*...#..#*. \# ...*.....\....  ...* .\\.....*.. . #.\..*...\.. ..**.*..*....\**. *..#.* *.. . .*..   .#..  *... \*.\#.##\#..#
## * ........*..\ .......#.. . *..... .*\ ...#..\... ...*...   . #..# \*.............\.   \..... ....... *..\... #..*\...#*\.*.*\..* ... * .* #. ... #
#\.. **. . *****  *.  *  ........  . .#...... .* .#.......\. ..... \*#... ......#... ...*...#.....\#.#..#.  .*#. . .... *.. *   *...*.# \... *.. #.\.#
#.*....\..#. ..#. ..*\.. \.  ..# *** . .#*\ **...##....# \.... *\*...#..**# * .... .#.#.##\ ....*...*... # \\.  .....*\.\.... #*#..#.. #...#. . ...#.#
#*.#.#...#.... ..#. ...  ... .......\... .*#.... *.#. .  .  .*.. *. #.\...    ... .. . \*..* #...\...#.*\.*.#... .*#....*#...... . ..\....  ... . ...#
##.#..\\#\*....*... ....*..  .   .#. ...* \ ....... * .. *.# ....# \  ..**......#.#.*. ...\#... ....#.. . ....\ ..* ..*.#*.*#*..*.... *.. .  *. .....#
# #.#.**  ... . .. #. .......\..*...*.* .. ..#. ......*. .#. .* ...  \#.... ...  ..#. #**.\.* .#.... *.# \.... .. \..*. *. ... #\# .*.*...\ .... . ..#
##\...#...# .\#\. .. ...# ...# .# .....\.  ... *..\..... .*....#... ...  ..... * .#.  . ..*.........*....  #..* .  ...\. \.*#\\......  ... .#...#. .##
#.#.. . .*# # . #.*.*.#...#*.#..*\..*\... . #.*.#. .#..   .##.#..#...\.......#.# ....# .. . . .. #\.. *......  *... .....\..\.#....*..... ....*..# #.#
#.\.*. ....# #   # ...\....\*. .\ ..* #.*.\...#*#.# #*... \.. . * .\\ # #.   .#. ..*. \.  ...... *.*.\.\.** .......#...\*  *#...\. ...*. .. \ #...* .#
#. ##.. ..* ... . ..*.\..... .  . .\ .*..# *... . .. *\.....***..  #.. .....* *.#. .*#.. *. .\.#.**.* . . #.  .  .# .\... ..#..\*\.....#  ..\..\...# #
#\.... #... ...*.....*...  ..*\#..*# #\ *...#.... .. ..#.#*# ..... ... * .. . .....#......\. ....... .#...  ....*. **#* .# *.....## .*.. .* .. #*.**.#
#  * ..  #....#  \....#...###..*.. # *. **..... \\.# ... .\. . ..#*  ....\..... ..#.... .\..* . ...# ..#. .. .#\ ..#... .* *.*. . .. \..\ ... ***\ . #
#... ..  ...* ..#.# ...*...#.... ......  #.*.*.  ..... ..**.. . * *. #...... . .* *  ...\.... . ..\. * . ..#...*.#*. ***....* .#..*\.#..*#.# .* ..#..#
#.....\* ..#\ ....... . ..#.. ...**...#..#.. .*#..# ... .... ... ..*...*...\.....*#...#..#* ...#...#...*.. ..*.   *.# #..**  ..##\.....* ... # ..#.# #
#...\.   ....... #. .......##..*#.#. . \  ##..\#....* .  *.. * .  ...# .# ..#. .....*.#.##.....*..\..*...#..*.. ..* *# # .#.....* #  *..* ..*..* \.*.#
#\. .\. \.\.....\. .... .*.\\...##  .* .\* .\.....\. ...\. ...*.# . ..#... #... . *##* *.....#\#.#.... .....\*.*... \...   ...*. \..\\ ..\\..* ..*...#
#.*......*.... \... .\... ..#  .. . ..*. *.\*#*. .* ... *.* .  .*....  .......#..\#...#.#.. ..\\#\ .... ... ..#... **.. *  \*.. *...... . .*.. ...* .#
#..  . .\.. # ... ..##..*... ..\....#.#.  .... *.*....**  #*.*\... #..*.##.. .. .#.* \. ... #. .*.* ....\ ...*  .* \.***\.......  .* ..  ..#.#* .... #
#.*. ..#.\# .*  *. *.\  ..\  .* .  ... ..* .# .#..  *\*..\\..#.   *#. ....#\#.#\.... # ......*.....#..........# # .# . .....\.\.. .#.... .  ..#......#
# . .\..#.. . # #. \. . # .#..\...........\..#. ...*.....*....#.\ \**..#.#.*..**.#  #... ..\. ...\\#.*.. . ........*\* ..\.#. .....#...... . .... #..#
#*. .... \*.. ..#..#.. ......#..#*....\#.  ...#. ........#\ # . .. .. . .*......\* .  *..#. ..*..... ...##.#... . ...... ... *#. .. . ..*.. *..   .* #
# .  .. .*... .. * ....... ..   ..  .....**.. ..\#........ .. . .*. *\ . *..*.\* ...###.*...#.   ... .........#.. ....#...\ ....  .*#........ .*###..#
#.#\   ..#. \*..* .*# . ..*.* .   ...#....** ...*# *.* .* ... . . .......# .. .*..    ..\...  *.* .*.*.... ... ##...  .....*  ...   ....#.*## #. ...##
#*.*..#.  \........# .##\... **...#..... . .*....#.*...*.    ... . #.#* . .\..\ ....#.#.*#.... ..##...  .# . .....*\... ... ....  .# ..*\.  ..#\..# .#
#....#\#. .#...# . ..# ..... #. .  .\.. ..#.....###.*\.. # ...\.....*....\#.. . .. .. .*.....*..#*.#.#..... .\\.....\...... *..... ..  ..#.. .* *...##
#... **.... .......   \\.#.... *.. #....#*. ..... ..*.. ... ..   .# ...... # .. ... ..... . .......... .......  ... .......\   ..#...... .#\...* #...#
# .#............# .....#.\. ...#.......   ......##... .......#. ..  .#   #..*......# . . .. #.. ...# .. *#.. #.*..  .\...*... .........*.*...##..... #
# ..#..*.#\... .*\.  ..   ...*#.*\**.*.....#.\\#.....*. .  ...  ..  ....... *..*.. ....   *..#.....\.*.#. .   ##.  ##*.*..* *#*\*.......*.  ..  ..# .#
#\.. ....\..   #. * #...* .##..... *#..#*.  \# ...\#..\..  .  \ . *  .\... ... .\. .#. ..... #. *\. .. .# .# #.  ...\..#.. .#* .# ..   #.... .* .#..\#
#.... *. .#...*.## ..\ . ..*  .. . .# * ....#. ..\. *.... ...   .  .. \....#.\.#\**.. .  .   *.*.\..  ..\##. ... ...#..*.... .*#...###\\...\.*  *# ..#
#.* \.  *..#.#\** ...*.#* . ..  . ..*.. * .*......*.. #*. \.   ## .. .*.*.......  ** #..##....###...*.. \.......*.....*.... *...... .. .. #...*#...#.#
# ..\ ....*.. ..#.#.... .  ..##\*.* *...\.\*.... . #..  ..* # .*..  .** .#..#* ... .. .. #*..\\* ..... #. *\. ..\ .#..........**  ... \. .*  *.......#
##...# **#......#* *.. ....#. #.# ...... #......# ....*.#......... ..## .\#\#.. # .#\... ..* . *\...\..#\*...*.*...#\ ......#..  ...# . ..\.. .... ..#
#....*..*##.#.......*. . ..\\.... \.#.* \ *....#........ . \. .....#.*#...# .*.....#....**.##\. \ .. *\# .#*.  *. .*#...... #.#.#* .... . .#.#..  .# #
#*...\.#.\.#. **#.#..  ....  .  ......* . ...*.* ..... #.*#*.\.* #....... ..*\*  .*.. \.*#. .#..\   .** .... .#.. ... ..... ..*\*.. *...\.* .. . .**.#
#.. .##*..#...#.##....#   ..  * \*.**... ..* .* #.* .....\...*#.... \... ..\. \**..#..* *...*.#.#*. ..  .  ..\. #.. #.*...*   ..* ....*..*.. .*.*#...#
#....# *..#.. ... .  ........ ..#. .* ..#..## #. ...... . ** . .*  # .. .....*...#.*.. . ...# ...*.#..*..**...#..#\.   ##..  .*...# .. .  ##..*....  #
#\#*.  .*..# .... ... ... ....#....... .*.. * ##.. *.. #\...*.\..\.. *..*...*. * *... . . .*....*.......  . .*.....#.#.\..\. .....**... ......#.\*  .#
#.. *\.\\\.#.  *### . . ...\ # \.  *.....* \.*.\#  .......*.. ... .\*..*.#.. #\.* .. #\. ..\#*... ..#.... .*.. \ *.\.. **#.# . . .#.. ...  .... .#...#
#.... #.#.*#..# ....# . *\* *.......... . .#..*.... ..... * .#.........\*.*. .* #.##...*.  ..\. ... #. * .....*.. . #** ....#.\  #*...*... .. \*. .. #
#  #  .\ .*. #\\.#  ..#.*#  .*#.... . .......*  . *..**##..* #... * .\ ##...  .\ *.*...#..*.*. ..\.*#*# #*.\ .... .#\.#...#*........ .....   ......#.#
#.. ..*. . ........ # *.#*.. .....*..*. ..*. .# .*. *......#.\** .....#.*... .....#..*.......##...*..\.........  .. .\....#..  * *...#...*#.. . . ..*#
#...  ..# \...  ..*.....\. ..#*..  ..  \ . ..\....*. #.# ... .....\# ..#* #. . ...\\*...    #.. .#.#*.#.. . *.# #.#\.. . .*#.... \..* * \.... \*.....#
## ....*.\# ... ....\..*. *.*. ...\. ..... . .#*...*\..*.....*. .....#  *......#. ..#.. . \.. .. #\*..#.......*#..# .#  ..#*..... #..* #.\. ...*...  #
#.#.*. *.\..#.*.. .#. *....#..\. .# .\.. .......**  *.. ..*.# .*.... ...*.  \... * *... .#.\.... . # ..........\. . .#\. *..**#.... .\.#..*...#...#..#
# .  *...#.....#.\#*..\ ... **..*...... ... . ...\  \. .\* .  ..# .... #.\. #.\.\**#... \.**#*.#. ..*... . .*..* #. *.#. . ....#*.  . ......\. * .. ##
#... .*\.#. #. #.... ..#.#.##...#...\ *.*..*. .*. ... * #\....\..... .. *.. .. \..**..\* .#\.*. ..... \#..  ..#*  ... ..##..   * . ..  .  .   *.   *##
#...*#.   . ... . \ #...\.. *  ...*....  *. .\ * ... \*....#. #.. *. .. .#\#..  .. *#... .. .. *.. .\  .....*.* . **. .. *....*##.\. .#...  .*..* .. #
## .......\.*##. ...*.**....**...#..*\ .....#.*..*..  ... .*.#.\...#. .  #. ##... .#..   .#.............** ....#....\.  #.....**. # .#....  .\ ...  .#
##...\.....#.... ..... .* #.*.... #  ###..  .....*. ...\........*... ..#...#   #.#...#.\...# \**\*...**###.........\ *.*..**.* .**#.\.#.  .*. \. ....#
#. ..*. ... \   \ ...*..... .. \.*.. ..... . . ...#  .   ..\.....\#..... ..##\..*#.. ...*. ***.# .  #..#* ..  . . \. .. .*.\....... .... ...#*#..#...#
#....*.\.  ... #\.** .#*...#* # .*... # ........ ..*..\... .**.*.....  .#*.. ...  ..*..\.#.. \...\*.*.\\ .\.\  .... \#\.. *.\. \.##*#.  ... . . .. **#
#.....##\. ..   ...#..... \\. #.. **.....*....#..#. . *.. ..##.....#.#    ......\.* .  ..#\  *.*.\..#. ..\... .. .*... #**... .....# .  .# .* *#....##
# .*.........*.....# .  .#.*##.\.......#..... ..**... *.**....*.##*...*\.. .\... * ..#....\ #.#.\......** ..\*# #.#... \* . .**. \.............. .# *#
#....#.# .#  . #* . #  * .  .# ....# \.*..# *.....\ .. ..*. \#..\..#..# #*.*. #*.#.....\#.*....#*#... .\...\  *.\...#*#......#\.. .#*.#\.*. #.. \....#
#...*....  ....#..  ..*\  *.#. \**\.. ..... .**.... ..\..#*.. # #.\...... * #\ .*#..  * .\\.....#..#.. ........ ..\ *.#..\.*.*.  *. . ... ..*..#..# .#
#\ . ...#..**.# \.\......*.. ....\  . \...*. ......\... \  ..**  .. .. .# . ...###.*##.*.....#....#\..\ ...\ ..# .. \\......#....  \. ....#.#. . ..*.#
#*   .. .  ...##*. #. #...... ..#.. *... .*. ..# .* # \#..#....#...\. ...#... .....  ..\ . * ......\.#\. .....* .. *. . .....#.... . ..##. #......*..#
# .... *.. # *..*. ......*#.#*....*  \  .\# .   .*#..  #.*.....   #*.# *     ..*....#...*..**.. ..\# .*..  .*.    ...#*##\..*. .# .\*#..#*  ...  ..# #
# ..*#..#. ..  .........* ...*.\#..# .*.\*.#..#. .. ..#...#.. \.  .......     #.. #*. ***##.....#.#... . *# # . **..#...*.... . ....\......#*......R.#
#*# .#...#.*.*# \ #.*.# .. ##..* *. ..##*..## .....*.. ...........*..  ... .#\... #..    .. ..\.*.*# *#**..**..** #....... .\    ..*\. \.  . #. . .\.#
#. .    .. *.....#..#.#*.# *..#. \.  ..  ....#... .#.....*.# *..\.#  ..*... .. ..#.*.*....#* *\ ..*.... ..* ........\*\#. .*...  .. .*... ..#...  . .#
#.## ..#**.....#.. .....*.\....\.. ..\   #..#* ..  .....\ .. #.. .....*  .........#. .#..\.##..\*..###.*#..*. .\* ......#*#....#...#.*\.\ .....# .. .#
#*\. .. *... ...  ... .. .....*.*.* ..#.\ .  . .#\#......#.#.. #... .*.#  .# *#*.  ........#...#..\... **....* #........#...*... ..\\......*.* .*#.\.#
#....\.\ #.....* ...# *#. #..*...*. #.#.\. ..... .\\....#. *..  .*   .  . .. ..* .#.* .*....  \.\...#....#.*. . *. .# ...**#\...# ....* .*##  .##.. *#
#.#. *.* ..*... ... #... .*..... .\.. . ..*. ... . ...\....#.#   . ..\........ .\.\ ..*#..... ..*......#.  \    . .........**..#... ..*##.... ..  .*##
#... \.....#* .#.\..*..... .*#. .#..#.\**..... *..#.#..*..  ...   ..... *. ..... ... .* \.. .*....*#.. ..#*.\ .#.  .\.  .\ *#...#\*... **\# \\......##
#*#*#.... ..\  ..#.*. * ....\..#. ..*#\.#*. ..#...#.\###.  #...... #.. **.. **.#. #.  ..  ....*.*....... #.\.**.\*  . #\.. #..  ...*.*.\#.\.. .* .\..#
##....*.\ * .#\.#.......#.*##.. ... ..*.  *... ... ........#\. ..\.. .### .*..#.....\ ..\...*# .\## . .. #..*. .\..*.   #.\.......... .. . \.. .. .#.#
#..# . ..*. *.##.\. ...*\....#....* ..**..  ..#....  .# ... . .  #  ...#.. .  *..* .#.. .*.* ...* .#....***..\ ..*#.*.*... .** #. .......#..  .*..#.\#
#..**...#\.....**...\# ..# #...  #\ #. ..*...*.\.....*..... *.*.\#.#.#\  ....  #.#\....\.\..*.# .#.. **.*\. #  * ..  ..  * .\...*...**. \. . .#.  #..#
#  . ##.  ..#..*.#.* ....  #. ##.* .\.. ..*....* .* .# .*....#.#...#. . #.... #....   #.  *# . ..*\ ........#..... .*..#*.....*  .\...*...#.*.#.*  ..#
#\**.* #\ . .*..*..# #..*.*.*. ..*. .  #\ .*..*..*...#.\...#.........\. #...\..#.. *..\.\...#   .. .\#.#  \ .#*..  #\...  .  .\.\*  *.....*   .*.*. .#
#.#   ....#*..# . * ..... .##.....*\# . .*  \..#.  ...* .. .....  *.* ##*.#\.... .. .. .. .......  \.... .*...#... . ... .. *..# \.. *.. *...#...*.#.#
#*.#..  ..... ... #.#..... *...... . .#*  ...#**.\. . . #*.* ..* .*..##.# *   .#. .. .. *.... .*. *\.. ..\#. #.\...* ..  #.  .\. ... ... ..*.\ *\.  *#
#... *\#\.....*\ .\...\ . .....*...*....#. \**. .. ..*. *.*. ...\* . #.#*. .. ...*#...  .# *.. .*. #.*..*\...#.. ..# ... .#\ # ##\.*  .*.\*.......#..#
#............#\...\.....# . # ...#.....*...  #*.\ .*. #....*.*.. .. .*.**#*\#..#\. ..#. ....\. *  .. *....*. # .*\.#  ..  .  ..... ...\..\.\...*.#. .#
##.#.   *#.#....\....*###...*.. .. .#. \* . #...  ..  #..** *.*.*..... .. #\#... .  .\*.. *...  \.....*.. .*   .. .# ....... ....\...#..\* . ..###.**#
#. *... .*# . *.** *\.* . * *..#.....*. . .. #....  .... . ....# . .**.#.#.\.. .*. .. .... ... **.*.# #..  ...\\..**#* .........#.##. ...*..#...\.  ##
# # .......#.  \.*.*...... .. . ...  *. *....* . ... ....  # ... . .# . .\.# ..#\# \ ..#.. .*.\.... ...*.\ #....*##.#* .*.    .  . ...  ...#.  ..#\  #
## ..# . #.* ......#. ...# . #...*.#.\*.\ * * .\..*... .. #. *#.*. \*#.# .##..  #. .. .\*  ...... .#..*...\*#.*#*\.#. . .. .  *\ .***#....*#. ..  ..*#
#.... . *. ....*\*\. . ...\.*. . .#*..\\.#.\ \ .... .. .\..  . .....#...* . *...##.....*.. \. .. ..##.##....#.**. #.#.## ..#. * .##..*.  ..##...\. . #
#. ..#...... *\.... *\* # ###..\ ..... .. #..##\......  \. .\.**.#*\#..#.....*  \.. *. ......*...*.  ....   ...\#..* #... ..*...  #.# ....  ....#\...#
#...\#* .....#.. ..#..#.*\......* .#... #**.. ....\...*..#. .. ##\*.**.# .\..#.*#. ... \.. ##.. ....*. ....  ... ..#.\ ...\#.\.. .\*... .*..#.  ..  ##
#  ..\*#.\. . #......#. ...  .* * .#............#.\.... . ..#. ..  .*  . *....*.\.*..#..* ..#  ..\....*.......\.#.  . ...*....*.\........#......#.#**#
#   ..*..# #*....##   ..*  ...*\....*#...*.. \  \*.\\..\. *.*\*... ...#**.##.  .#*\..**# . *.......*.  *.#..... . * .*\..#..*..#.#.. ..** #. .......\#
#. .. ... *.. . ...\.... .* .* #\.........* ..... #.# .# \.... * *. * *##. ..#* ... ## . #. . . ..#.\\..* ..**.  . ..*. #....  ..**... .. ...#*  . ..#
#. ..\. ..#*..#.*....#..#...#.# ... ...*  ...\..#.*..  #  ...*. .\. ##..#.* . .\..........#\..\..**#\. . #  ... .....*. ..# .\.#.....#*. . . \  *....#
##...# .  .*.... ... .#.\.#...  # .##. #.\.*. . ............\..*. . ...#..#.#.......\ . ..*#....... .....#.*..#. #..\ ....** *.....#.*  ..... .. *.#.#
#.  .... ..#*......*..#.\....#*.#...\**.. .. ..\... ...*..*..  \..\.. ##... .. ... .*##... #...#... \.. ..*..   *....* ...  #  *#\....#.. \....  .  .#
## .*...  ##.  . .#....... .. . .\...... .   *# .... .\\.. .*..#  ..#....#..*. *... .# \. ..#*.....\..# ...... ..*.*....#.#..#..**..... ...* #....# ##
##\ .\.*.#......\..#  #...*\\\* .  ....#..## .*#.#.#.. ..*\....\ .*. . ... ..##..... ....#. .........#.#...\...#... .#.\\ .*\..... .. ......#... .#..#
#.\.....\...\.......*.*.\..*.*.. \ \.. .*. *\  .*.\....#.#\***# ....*\.....#*....... #.*......#*# \ #  #.  ..# ... . * *#...#.. ........  **. . ..*\*#
#.......* .. .*.... \#.....#...###  #..#... ... ...#.#....  #....... .\*. ... ...#.....* \# *..#..\. ......#  ....  \.*\*. ...*...*....  ...**.. .*. #
#..*#. *#..#.#..# ..*.....*..*  ##...*.#\...*..*...#..\#.*.#*.*  \#..*.....#.#.. ..#.\.. *.*.##....**#.*\.## ..#.. . ...**.*.*# # .....#. #\....... .#
#. .*#..\*. .#. .....*#.\.\. .#...  .. ....#...*...* ..#..... ..# .\\.\.\.#...# .. .#......\*.*...#  *. #.. ..**.....*.* .# *..\#*. *....#.. .. **  .#
#....#.....*.. \.. . .#.... .. ..........  .**. ...\.....#...#. #..\  ##..#..#...\..\*.. ..#.#..*....*..*   #*...**...# ## . \.. # **.***.*\ *. .... #
#..# \.. ...*. ..\#..\...# ..**   \ #..........##. .. .\ .\... *....\ ....  *.... .#....**.........*.**...   ... ..  .#.#.... \# \..#... ...\..*#..*.#
# ..  #\ *.#.#..... ...#..*..#... .#.\. ... ...#... . \..... ** .\.#. .#..*..#....\..#. .. ...##* .. ......##..\. *..\*..   \* \**.. .. .#..\..#. ...#
#*.#. #.#........ .....\#.# ..*  ###\.. .#...   . * #..# **. *.#. ..\....##.#.*.\. .#..  ... *...    #.#..   .#....\. ...  .....  .*.*.... .. ...\...#
#. # .....#.# ....#.. \*.#..*.#. # .....#. .\ .....*.... #..\ #....* .... .\.##* ..*.*. ...*\.#*..#*#\..\.*. #......  .....# # .. *   .......#  . ...#
#..#.. #...#.\..... .# *#.*# .#....**#   .  *#\ .**......*.*     *.#.#*.. #.. ...#.  ...\.#*#.... .#.\....#. .##.# ...... *. #.. ..*# . .. ....  .*. #
##. . .\# *.. ...#..*...... ........#.*.. ..#*... ...\.   #..# .#\ ...*...*.... \ ..* . \................#.\ .\#.. ... ...*.* \.**..... ..#.\.. *.  *#
#\... .. ...* ...... #..# .#.#.#.*\ .#  ...*.#....###\.*..*..#. *#\. ....... \... .#... *..#*  ..\...*...  *   . . ..... ....   ..  .\.#.. #.  .. .#.#
#.\#.. *# ......\   \. #*.#*\.* .......*.........*. .\*.\*..\\. . *..... *.\.... .... ........ .. . ..# . ...#.#.. ..*.  .#.. . **\..#..*.. .*. .*.. #
#... *..*.*..\. #.....#.#.#..#.# *. ..#.# .* .. * ......##\ ..* . ..  \..#\...*#. ... #....#..\. ..#.. . ......* ...\ .... ..*.. # \.*\.#......\.*...#
#.... ..............*.\ . ..* *..#....#..... \. #*  .* #* .# #..\...#  .#.. ..#.\*..  . *.. .*\.#.  #* . #.. ...  .*  . .##.. .. . #.. #.* .*... ...\#
# .... .#.....#\.\\...#*.....#*#..**...\....  . .*... ....\* .*. ..*... # ..... ..*..#. #. .\#*\ ..* ..*.. ..*.. #*.##.. .**...*\.#*. ...#....# ..*..#
#.\...  \  .\...#....\.   .##..*  ..*#  #.....#. #...#...... .. ...\.\\#.#\*.  .\....\#\....... *....  ...  .# ......#... . \.#\ * .#...  .#..... #..#
#.#.# \*.#.*\.....  \\**# ...# .\.... .##.....*. . #  .. ........*# ..  ...#..#.\#.#...#*. . .. ....*.* ....##*.#....   ......# #... ....  .#...\.*.##
#*....**... . .....*..#.#.*.* .*..* .... ..  # \. ##..#*. .\.*.*#.. ...  ......* .*.... ...*##.###.*..\.*..*\  ..#*..*#.# ..*.....* ..#...  ... ..#*.#
#* ..* *.. #..#..#  * *..\...\.. .\*............* \.  . *...#.\ ..#\#..#.* ##.....#...*#*..#.\.. . ... ....\\# ..#*.. . \#.\.  ....#... *..#...*.*...#
#...........  . \ ..*\  ...#..*. ..\..... ...*#....#\\*\*.....**..  .  #.  .*.*... *.. .\ # .*....*......*. ... . * # ..* .\*..#\.\#. ... ....#. \..*#
#.  . . ... **.#*..*.*#.* # #....*  ..  # #.\.. ....... *.*...#.\***. .... .. \.. #... ..  .*\*#.  . . .* #  .. ...*.\  . .....  # *#*. ......##.\ . #
#.*. .*  #*.##.*\  ....   ..*..#.... .\ \*. ...\ .##...#....*\.. ..* .. ..*.... ...* .. ..#.... . **... . ...*.......*.* ..\ .*.. .... ....... # ....#
#. #*..\. .# .......* # .  .#  ...\ .. .#*\.. .\*...*.  . ... ..*.*.#.*...........##.......\....\ .* #. .... **## ##.##* ...... .. .....#.*  .  ....##
#... *...*#. .*  .... .\..*... ...*.*.... .. *...*..\.*.*. ....#.. *.... ..\. .... #  \...*..*#.*. ... *.##.*\..*....#.....*.\.. .#.....*.... .\ .. .#
# ##...# ... #.##.... .     .*#. #.. ..#**\.\..\#*... ..# \. ...#.. ...  #\.#* .#\....\*...# *.#.#......# #..#..#\  .\....#. \..# *.....#... *#*.*...#
#.....#... .. ..*. ...* \ \..#...** ......  ...#..*....\. ..#... ...  #*...* * .....*....* . ..*...*..\..#\ .....  #  ...\. . .  ..#.. . #.....#*..# #
#.. .  ......* # ....... \*\#.. ......*...*...*....**.....* #. ...... ... #.*  *.. .....* \.. ## #*#.\...\..#  * \......\ * ........ #\#.. ....*\#. .#
#  #......\##..#.. ......##.#.....**....#**. ....*.#  . \..\ \\*. \. ....\. ....*..   ##.#\ #\**.*.#*..\#*\*\*..#.*  .. . \..*#  .*.....*.\ *..*. # .#
#  #*.....* .##*...... *#...... #* *...*. ...\...\.\ .... # #\ . \**  *#  #.* *.* ........#.. *. \ ....... #..#.  .#... *\... ..* . *. . ..  .. . .#.#
#....* *..  #.*......*.... ...*.....* #. .*###*..*.* ....\.#.........#    . \. #..* ..  .*. ... ...\.\...*#.#..#.#\.#. *#.#*.\#... ..#... .   . *.# *#
#. #.*. ..\*# ......#....*..\..#.#.  . ... .* *.......\.. . #....**. . *..\ ..#..#.\ .. .......*\ . * .  .  .*.. # ..# . ... ... .......  **.* ... . #
######################################################################################################################################################