######################################################################################################################################################
#* .*..*.....#..#.*...*.###*.....* . . ....  ..\.#  ..#\.* *......... ....#*......#   *.... .   *..* .. .*. . ....*#  #*......\....*.# *.#..#.. \.##.#
#. ....*........*# ...*. #. #..#.\.* . . . .*......**.#....#....\\..#. .......* ..*.....*..#.*.*... . ...*..#*. ...# .*. ..\ . .#*..  .* **.  **..##.#
#..## \.. .\......*..*.\  * *.*.. #...*.... ..*. *...#.. . ...*. .......#.\.#..... *..  .# ... #...*.#. * ##\#*  ...#..... .**   . ..## .*#.#  . .#*.#
##.. .. #. *.. .\.*.... .#....#..*... ......\##.. . \*..#..*  ..... ... .. \..... ..#*\.\. ....#.. ..*...* .\ ...\..## . . \.*  .*.. . *.  ..* . .\..#
## *.  .*.. *#.#..\\*#*..*..\.*..... . #.* *. ....... #...*.*.# ... . *.*** #.#\ *.  * *.*.  .. ..#.#..   .. . * \ \\.*....*.#*.. ....*. \#..*. * \..#
#.  . . ..## \...* .#*....  ..*.....#.. .*  ** *\\*.....#\...*..*.\\......*#.##.. ..*.#.....\....\.\... ....  .#.. .## . *.......* ..#.*#....#....*.##
#.. .....# #. ...*....# .#\*.....#..... #.#.*.*..## .*  *......*##  ......  #.#  .*  ..#***   ....#...#....# .#\. #\  ....#.. .*. ..*#.#*..   . *....#
#.........# ..##*##\*.. *... .  #\ # *. .#. .#.*#.. * .\* .. ...... . . \*  \....  *.\  .\...#*....*...... *.... ..  ...#....*.....#.... ... ..\.. . #
#\..*. *#... ..* ....  *......#.* ..... . .*.#..*......  .. ...*...\.*.#*#.....   # ..... .# .......# . * .  .... .*.#..*#.# ..##.*#.....\..\.#*\. .\#
#*.*..#... ....\..**.. *.. .**. ...#.**..\.. #. ...#\#. .. .\..#. ...#... ##..#.#.......*. *...*.  ***#....\.*. ..\... #...## . # ..##. *.... ** . . #
#.*.*  .......*.*  #\#** \*. .\. . # ........ .. .....# . .... *.\ .. ..#. #*.   . ..\.# .. ...# ....**.  . ....*...**...\.#. . ** ...# * .*..... .*.#
#. *.*..#. ..\.. .. .*... ... ..#. .. ..*..... #.*. . .*.* #.*.....\.  .. ....*.. .#. .##...*. ...\*...*. . \..#.. ... . . *# *. #...* ......*....#  #
# ..*# \  * #..   ...**\.... * *..*..  ...# . *.\.#...#....**.....\#\. ##. \.....#  .......*...   . .. .#..#....... .#.  *. ..\.\..**  .\*..#..\.*...#
#..\..* . ..*....*...  *.*..# . . .#\. .....#.. ....  ..#.\. ..#\.#*\.*#.  .. .\...... #. ...*. ... . .  \........ ... *... ..  *\..#. . ....* .   ..#
#... ... #.*..* ..#*.  . #...* #.....# ...##..## ... ...\  .*.#..*. #*  \... .. ..***#..## .  \.. ...*......#. ....#.#..***.\ ....#..... .#  ... .. *#
#.#*......... \.....#..*.#.#*. .  .#* .. ....# * ..#.#*....   ...*.\... #....*. .* ..  ..#.*... ...  ... #.# . .. . . ..... #\.  .  ..*.*. ..*...*\.##
#.\ #.# ... .\.#.* . ...\# ...# *.\.*.*..### .*.  *..... ...... #.*..  .....\#*.... ....#.. . ..  #.*..*..*.* .\* * \#\* ....# ..*....  .  . #.. .# .#
#***.. ...*.#.. . ...**.. ... \.*..#* #.. \.*   . ...# # . \. ..  ... # .#. *.. .   *\\..*..*. ........  ..#*... * *...*#.. .##.*\..#...\.\.. #*....\#
#. .. ... ...*.\*..*#\.*..#\........ ...\.\ *#.....#..#...  .\ .#.*..#.#.*#.*..#...... ##.*.*.. .....*....#. *..#.. .\.#.  . .*.......\.#.*. ... .* ##
#**.. ##. \#...  ......  .\##..\\ . ...##. . ..... .#...  # . . .#.*.*. * ..*.*. . ..#..... .* ... ..\ .. . ...#    ..*#...#....#.*. . *\...\.*. ....#
#. .. .. *.*...  *# * .. . ......#* #.\..... ..*..\.##* * *  \..* *   .*  ...# ..# ..*.#. . *... .#.. ..#.*...\.   ....\\*..#...* ..# .. ..\.... #..##
#*.*.... # . #..*. .##.*.*.*...* .....  .#. .#... ..... . ... ..#\#.. ... ...\*.... ... .##.  . .... .  . ..\* #.#*  . .*.\#.\ . #.#.#.  **\.#   # ..#
###...#*...#.... .**. #.*# . . .....\ .#*. *#.* ... ..*...\.  *..#.# #.#..\.*....*..\ \..#.........#\..\. .......*.\...#..*#\ ..*.*.  .....  ..#. . .#
#..\..*... ..\....*. **. #..... .. \. .*...*. . #.  . ..*# \#*. ...............\\.# ....#  .. *#.......*..#..*...#..\ #.  # #.#.. *.. * *.. ..\# #...#
#..*... ..\..\ ... *#. .\#\.*.. . . #.#..#.#..#\  .  *.*.....* .\   . ....#. ..#.#...#\#.. *#...  #.. ..\*  #...  .#... .*..  ...#\*# #...*.* ...#\. #
#.#..* ..# . . ...#** #....\ ...  . ..   **.*..  ...*** .\  .*.\.*.*. . *..*. *.*..... *.*...\ ..  .... .\ *. #...*#.. \.  .# *...  *......  .. ..  .#
##..*.....#\.  .\...#*........*....... .\.. ##... * ..*\....#.......*    .\..#..  * . ......... *..*......#* .. .##.# ..#...*.. ..*.#.. *...#..**..**#
# ...#* ..*.........  .#..  ...*.*...# .\#...#.*.. #*#*........ .. ..*\ .*....*...#*............... .**\....# .#...#  .*..*. \ #\.\.\..#*..*..\ .. .*#
#..*..*..*. . .....\..\#..# #. .#.# ... ...*.....**....... #..*.#....... ..\*. ...   ...#.... ....\..\..#\\ ..  *\. . .....*#.  \*# ..\..* .#*...\ ..#
#\.\..##**  ..... ...  .. ... #.. *  ....\.. ......*...*# ...*  . . .#. .... ...*.*..........#. *\.... ... ... #*#**..*..  ..*. .#.#*#  .. ..#.......#
#*.\#.  ....*..#*#.... *....#. * .* .*..\........... # \#.#.##* . ..*..*.## ##. .**#.\..*.. #...#* ..  ..## *. .... . ... *#\*  #.... ...#.. ...... .#
#........... \..#..* .#. ... .. ...\. . .*#\.... #..... .\. # . . *.#*.   ... .*.... *...*..\.* ... . #.#. *\..... #... . \..*..#.##.***...... .#\#*.#
# *..#..  ..  \.*..# .......  .#.**.. #...#.. **.*.\  ..  ...*##  *. **.. *...\.#.... ...**.# ...\...  \\ #.#.# ..... .# ##.\ .. ##...*... .\.#..\...#
#.#.###.....* .......#.. *....#. ##.... # \.#... .. **.\..*\.. *..# \. .#.#*.. .... #*...#..*   #..* # ...*#....#. ...#. .... ..... **.. ...* .*   . #
#. ..# ..#\ * .. *.*.#.\#.# ....\*. .. ........#.\#.##.\ .#.*........ ...#.  ..*...\ ...\.#. . ...  ... #.*. ...*# .#   . . ..*.#\**...# .... # ..#.##
# #.. #.. #..* .. .#. # .# . . .*.#... ..  *#\ ....*.. *...# .#...* .#..#.*\.#...  *.*...........  \.. *#.#.. * .. ... .*.#. ... ....*#.\ .#   ..\ ..#
#*..# . .\* ......\*####\ **....... . . .. .#.*......*..#*#..* . ...*.#... \. .....*.... .\..* .. .......... ##.*..*....\.#.\.## ... ..\ .. ...#*.  .#
#..........#....*. # ##.. .*##...  .   \ .*\**   ..*..*\*  .\ \..\.\..*.........\# ..#....... .. ..*. ..*.. *..*....... ..#.....#..\.*.#..  ..*......#
#...# #...# * .*#..\*.. .\ .*.*\\...\*.. . ..   *. ..........  .# .. ....... *.\#. .. . ..# ...#... \#* ...* ..... \.*.##** . . ...\ .....#\.....#..##
#....   *.#.#... *.. ..\....\.\........ . .*\ * . . ..... #...# ....# #*  .#... ..  ...\..#...... ..***..*... . #........ # ..**........*.*. .\# ... #
#. ...#... .#.# \ ..   ......#*...*.... . .#. *.*..#.*.*..\ .* . ..*. ..* ...*. ..*. .\..*... .\*#*...\*  ##....... .*.\#. .\ ..... .. .. ...\* ... .#
#*...#....# . ...#.....#.. .*...*.. ...\ .. #.*..*.##..  ....*#.#...#.* \.*. *.... ......* .* ##... *..  ....\ .   . ..*.. ..*\.... .** . \...\...\**#
#.  . . .......*...* \\.#*. *#.  #....... .*#. ...*.*#.. \ *.....#.#.\.* #.*  ..*#. .....#. . ..\  . .. ..... .#...    \..  ...\...\.  .. .. #*... *.#
##..\.. ....* .\........## .#\....#.# .### *...#.\.......... . .  .#  ..   * . .. .\.**...* .#*.. # ...#.***. ... . ....*..#\..**.. *... *...  .. \ .#
#.##.\.#.......... ..........\..#. ..# #..*.*... #.. ......#.*...... ..#..**.##. . .##.  .... *#..*.* .#. *..... . .\... .... ##  .##.   ...*#......*#
#..\...*....# . ..... ..*#......# .*...*.... .\.  #.#.\....#  *.##. *.*.......\\# \\ *.. *\..\..##  ..*\..**.....* . *#.. \.*..#*. .#... #. .. .#. .*#
#.....# #. ....\* #. .*..#. #.....#..#.....  .....  .##.*.. ..\*.. .... .#..*#. # .. .#....*   *#..*..\*. .# .. .. #....#..#....\*. ..\.*.....*#..\ .#
# ..#...#*#.\. ....*.**.\ ..... .....  .  . #*.* .  .##......#...\*...*.*..... ..*...*. ...*..*# *. . . #\.... .....*.\ ..... .........\   ..* \#\...#
#  * .* ..##..# ..* ..#..........*... . .* .** ...**#....*............ ...\...#. .#...\*\ \ ..#....#......  #.. . *. .#*.\ .#..  .*..\ ....#*.#......#
#.*. *#  *...*  .  . #  . ## #. .\ . .. \*.. .. #. .#....*.. *#........ *......* .\........##.. \... \. .....\.#. .#.. #* .. . .  ......# . .#...#.. #
#... *..\.. *....#.*  #.. ...  .. .##.#.. .*. *. #\\ #.. #.. . ..  .*..  ......#.. \....*. \..* #..#........   \...#......  ..\. ..  ... .##.. . ....#
# # .  .......*...\...... ... ... ..\.#.. ...*..... ...**.. #.*.\...\...  *# \\.   #........\*.\ ..  *  ..*..*. .##\. .*...*..  .....#.\*...*.. .#...#
#...........*...... *.......*...*.....#*..  ....*# .#..  . . #.  .* ....* . ...#\ ... #. .. . . .#. *.\.\*..* . #. . .....  ........* ...*. # #.*.#..#
#.. #..#......*# \....\. # #.*.....*.*.\  .#.*.... #  \ ...*.....* ... .. ...#** .*..**\ .*. ...\.\ .\...  *** # ..#. #\**....  .. .#. #*\ ... . \\. #
#*. .#.  #.**\...#.\.* ..  # ....# *.#...*...\# \...  *  ...*.. ...   . **# .\...\.\......  #.#..*.\.....*...   .... .\*.\* ..*.#*.. ....#.* .#..*...#
#...  #.##. ....   ...#..* \* .\## ..   *..# *..# . .... ..#...*.  ....###..* . .... ... .....#\\ ## .*....#...*..*#..\ \.. ..  .#..*...  . ..# ..\..#
# \ \.. ..\. ......* *..   .. ..   ..  ..\.#..\*. .*..*..##.....  .*.. .##...\ ......... ..... ... ....* ....#.. # **. .....#.....**#\... . ..\ .....#
#\.*.#**...#..#.* ..\ . \.# .*...\..\#.#....#..  #.. \.*  #..*\#*. ... ...  #\....\. ....\ #..#  .#. ....* ... .\*. . *\.##*.*.....*. ..  \  .  * ...#
#. .  *...#.. * ..#.\\.*# . . .......* ..........  .# *# ..... \.. .# . *.*....\ .  **...... \.\..**#*##.....  .*...*...#..#\.. . \..#. **.*\.*.*.**.#
#.##*\......*....#.**. * *..   *.\..#\. ... \  ... #..* ..\ ..   .#.\ ........\ #..*..\\. . #...*#..**..#.*. ... .*... .* .*.*.. .*.... .. \..*.  .. #
#..... .....\*.. ... .\.*.... .**## ... ....*..*.#. ..*....*#.. *\..  .. . ....#. ..  .# ... #...\.\*.... .#....#.. . ..\ .*.*..#. #... .. ...# *.#\ #
#. .* #*.*..*   .# ....*.#..\ .. .#...#. #* ..... \......* ...*#..\.#.#.   .. # ... ** \. #  ..\* .*##. . \.......... . ....\... ....*.... *. . ##. .#
#... #.  .\#* . ..#....#...*.*** ....#...   .* . .*#.......\\..#. ....  ..  .. ..#*   * ..........* ....*\. \ ....\ . .. *..* #  #.. . .  ..  ..\..\.#
#... .# ......#.\. ..  ..  . ..# .#.#. *..... . \..* .........**\.\*.. .**.. .# .#\...\.   ..*.  .....#... ... . .. ##...#.*. *\.... ... .*.....*# ..#
#\. .\ . .. .# .# ......# ..*..*.. .#.. . .......... . .\..#.*#. ....   ##........##* . ...\**..\   .#.* . # .  *.  *..#.*\.. *.*.\#.#..*##..#\. . #.#
#.\ ..  .\   ..##..*\..#\... ....\..... ........#..\.  .*.*.*.\ .....*\ .*...#*.#.... # . .. ..#. . #.*..... .*# ....# * . ... .\.  ....# ..##..\.. ##
# .... .. .. .*#..#.  .#..\...*. ##... #.#.*....... ...*\  * .*.*# .* \ \. ..#. ...  .*.. *...# *....*...#...\...* .##..# \..#*#.# ..*..#\...# .  . \#
#..# .\\.**##. . .......***  . . ..*. ..*...#.# . ..\.. .. .. ## \..* #* #.....  .\  #.\.**#.. ..  *\.#......\.*..*.....  ..*..# *#....... ..#.......#
##*.#. .*.. #.*.  #*****....**..#.... .#.* *\.\ .#.......#...*. ***.\ ...*#..*\.* #. ...*\.#....  ..### ..##...*..#..... . . ..\......##.* #.... * .*#
#\..# . \ ..\..**... #.* .*. ##..#. .  . ... ......... *\ ...**#.. *\..\.*.*.  .**... ..*. .*.#..#. . .\.....*..* .  ..\.\..*... .. **...#....... *..#
#...  #...# *.. .#..   \# ..#. .. # . ....* ........ ..  .. #.  . ...... ..*.*. #..# ..  # ..# .  .\... . #*...#. *..#.. ........#. #.\. *  ... ..#. #
#..#*.  ..\  ...#. ..  .. ... . ..*#\*#.#.  .# *...#...#* \.... #* .  #  .. *.**  ... .. . .*  .#. .....  \\. ...#...* .*  # ....*#...\ ..\   .\  .*.#
#..#.** .*..#. ..*  .  *..*# .. ##. .***.   ..**.#....##** *.#..\.*....\... #*..  . .#...#*.  .*... .*... # .  .*#\.*##.*.. ..#. #.. .#. ......  .*..#
#.*#*..*\ .*# . . .#. .... *.. .. \ . .....   ..#...#.# #......  ..##.#.#...##**\\.*\...  \.. .\.*..........#*..... \ #...*##.. .\....  #* #*. ..#.# #
# \. .. .. .*....  .. . ...........#* ## . #..*\\.. *.* . **#.. *.. ...  .#**.....*.. *.##.  .. \.. ....*.. .*......*...... .*# . ..\.* ..... ...# ..#
#**.#.\ .#... . ..* ...*.. #..#....*...*...*....  .*#\*..\* #*...*... *....*.... .   ...\. *.\.#...\. ..  #.#\.. . ...... .. . .. .#**.#*..#.. .#....#
#\........*..\   .. .#... *..\.#.*. ..\. ........ #*.. ....\..##.... .......\..........*.  *.#...*.\.   *#* *......*#.. .......... ...*  \#\... ..* .#
#.  *\ ...* ...#*.. .*.. ....    .. *. .....**  .. *#. #......# .#.\. .** #..*# \.. ..... .  .. .....    *# ....*#  *## #...*.... .# ..\.*. .*#.. ...#
#..# . ...*.......\ ....#..... .# ...    #*. .\......#.. ....#.. . . ...# .* #.\... .*\...#....\ \...*.*.. #.#*.*....# \.\ .#  ####.   #  * ...*.\ ..#
#. \.....*..* .. .. *..*........ .... .*.#.. . ....#..*  #. ...\ .... ...#*. .#...###..*..# ...# *......\...\*...\*.. .. .\ .... ..*.. #....# .....\.#
#.. #...*.*.\... .#... ......**.# .#.\......*.*.  .... #**....*...#...... #.*.  ..\# ..*.... .. *. ... \\ .*.#...#*. ...* #. * *....#.##..*. . ..\. \#
#.#\*.##... ..  . .....\.\.##  .....#.\....*\.....* ...*..... . **.... .*# .. .. .. ...* .... #.*.#.#.....#. . . .#....*. *\.#..*.  ..*..#  ..##..*..#
#\......*###. . ..* #..  #......#.     . ..\#*#..*... .*..*\.. *#.#.. *..*#.*..\ ..#.. #\ . ......\ .*#\# .  #...#*.....\  .*..\ .  .. ...#\#. ... **#
#....* . *.  . *.\  * *###.  \.* .... #..**. .#  . #..#. ... .*..\.  # ..*.. .... .........\...*. *#.   ...##...#*....\** .\ ...  .\.. . ..  \.** .*##
#..... . ...*..#\\*.*. \.....\# #..  .#*##.#.. .*.....\......#*...#..# *... * . **...\#. . ... .*..... \   .  .. .##\...*\#.\*\....\* .*..# #.*. #.###
#... .. .**#*..*.. # .*..\ #\.*\*.#.#*..\*.##. .... #. ......#...*........ ..#* . .**.. . ..* .... ....#\..# . ...* \. .. . .....**..#.  .. .#.. . ..#
# .. . * ... .*.##....*. .#*\. .#\...  #..### . . *........\ ..*....*...*.\\..#\* ....*#. **.... .  #...........*\ . ....#....\ # ...#.#.\. .# ..*.#*#
#.... \. #... *..*. ...*#.#.##.##.  . ..*\  ....##.\. # .\# \.... # #.*.* .. ... . . .. .\ ...... ...*..... *.*##. \* ....* .  .##.... *.. . . ##...\#
#.. .* . . . .....\* * . # . ..*....\ .. ... . .*......** ..*.. . \.  #...  ...#.#......# . . . ... #..* # # .\ #. .....# .. * ..\ . . .#..#...#.#*.*#
#.... ***..*#.. ..*.# \#.#.. ...  .*... \...##\. .* .. ..*....  . .#*#....... .. ... .........*.*.. .**#. \.#.\. # ##  .\\**....#.#. . ......\**\.\*##
#...*.. ...*\#..\. .. . *.\..    .#*. *#..#.. . ..\#.  .*... . .*..#. . ... * \#...#. #. * #...* . .*..... .. \.. **.* .  ...*\.  \......# ...*.....##
##.*   .*..  ..\.#...... .. ..\..\.#.............. ......#..\. # ..** ... .#*..*  #.#..*..#  ..*... . *........#. .........#.#.. .#.#.  . *....#..##*#
# .. \.#.#**\. ..... ...\. .*. .# .. #* . #  \ . . *\.#  ....\...##.   ...#.\.. .#\ .#  . .***.\. #*..\.\. . #.#..*..*.#.  \..*#....   ........ .\.  #
#... .... ....\***..  ..*. *# .....#.*..#* .** ..... ..  #\* ... #.*.#..*.*.*.#. .*... ...#*#  ........\...\.#...##.*# *....* ...*......#.. .#*. . .\#
# .... #..\ ... \...#.\#. .\......... .#. \#.. * *#. ** #*. .....*....# . ...# ..  ...*..\ \.  .....*#*  ...\.#........#*\#.\#..  .*.\...#*.*. ..*  ##
#. #\. .#  ..* ........*.\*.**..#. # .  ..  #... .. .\....##.##.. .#.  #*##..# *..#.........\ .*\*...#..#....*#...#...#.#.*.. #.. ##*..#.#...\ ... ..#
# .  . .# \... .. .*.*#... ............#. . . ...\*... . .\... .*\......\ \.#*.  .... ..\......*. .....\   .*.   . .....*.   #.  ...*#*\ #. ..* .. #.#
# .##  .\*.# \... .\.... ...  #..*.....#....... ...#. .#*. ..#*.. # ..#...  .  ....*.*##.. .#.. *...... . ..*... .#   #.\. ...  #\...* *... .#  ... .#
#\\.......... ..... . ...* .\*. #.* . ....\.#. . *.*......#... .. .#... # ..  .... # .... .. .*.  \ .\...... ... . .\..... .#  . .. .#* ..  ....#   .#
##.... #.. *..\.#...* . # ....*. ..#...*#..##.. #.... ...*. .....##**..*...  .#...#.. \.... #.  .. . *....#.. ..\ ..\ . ...*.*.#.# .#\ ..*#.. ... ..*#
#....#.*# ..*#.....\*....... ...*#....#.#*. ..*.* ..*.\*  # ....*#.\ ..# ..#..**. *..# .. \..\.* *#.. .. #\..  **.** #.. .. #..**#......\....*...\ #.#
#. #\..##.#.  *.#\.\\..  .#***.......#.  ......#.#.. *....*........ .    .... .#...*.*... ..*...**... * . .# #*. .\... #..  # .  .*..# .*.... .*#... #
#.... . . .. #*....* ........ \..*. #.... ...*..\.. .. ...*.*. *....*.\ ..*\....\*.. . #.... #.**.* .... ... #.#**... ##........#...**..... .* ..*. .#
#.#   ...* #...*# . #.... ... ..  #. ... .*.....  .\.\...\. ......   *.... . ..#...#..** *.* .  .#..  \*.  ..# ..#\  ... .. ........ ..#.....\....##.#
#...\#.... *. .# . *#* #.\.... . ..\#.# .*.... .#..  ... \..  . * ... .*.\. \.#. .    ...#\..*. . ...*.#......#. # .\..\.. *##** *.. ###.  ..........#
#.*..*. .... \....*. . \...** *.*...... ..  #. . ..\ #.*.#..\.....#. #.#.   .. ...*. ....* ... .\.#. \.... .......*  .  **#.  #..\#..#  .*#.   #.**..#
#..#*.... .\ . \.# ** ..*.   ..*...*#....* *... ..... #.... .#*\..#. **..#.\ ..#**.\. ##...*. .... ... ..* \..*.. .#... ..\.*. ...##... ...###.....# #
##  ..\..*.. .  .. .... .......   .. ......... ....#..  . ... .. ..*.* . .\. .. #..... *.. .. ..*...*....#.. ...# #\  . #....... .. ....###.#.. ..  ##
#... #... ..*.. ..... #.*..*\ ..  .. .*. .  . ...\ ...#........*. * .. *.*.. . *.....#.# ##..*\ ..*#\..#* #\#*..\#.... *.... ...*#...#..#\..\  ......#
# . .*.\..#. \.\  #... ...*. .. \..*#.\.#..... ..\... ...\.....\  .***\.....#... .*..*..  .\..* *\...... * ..\..*.\  .*..\.\  .\*\........*. ... .#* #
#...# .#. .#..*...* . ....#..# .. *...... ...#. .* ..  ...#.#.  ...\#..*......\...*  .\... ..\##. .\*# \. *.\. #.  ......  ..*...\\*..  ......* . \#.#
#\#\.. \#. # .. ... ....... #... ...*. #.*.#.#*.......#***..#.\..#. ... .#....*.*  .... ..*# .* .*.. .#.* \.#.*\..#*#.....#\*.. . ..\ #* #   ...#.#  #
#.\ ....   ...#.*#. .*.... \\.. . ..## .\.. .#\#.\\ .##. #..#....  ...##.....#*#...  ..*..#.... *#. ..*.  ........#......*. . \*. *\. .  ... ..*.*.#.#
#..*..#..    . .  #..   .#.\ .#... . \..##.#* #. ..#\.. *. #.\*..*.*....**..*...*..\... * ..* . \.*#\. ...# * .. .*..\.#. *.\.*. . **. *.#...*.......#
#\...... .##. ..# ...  . \#. .*.\* \.. .# #...#.\.\.*.. . ....... . *\. .\..... **.. ..*.**. ..# ...  **##.#  . *# ..# #...   #   *.........#...   * #
#\..\*....# \. .. .   ..*#. .* .*\.#...... .\. ...  ...*.... ..* ..... .*...#..# .\*.\....*..*. ....**... .#  .#\#...*..# \ \  *...#.... ..\* ... .\.#
#.. ...... ..*... #.* ..##..*..*.** .. . .##.......# ...#  .*.\. .*.. .#.#..\.\#*...# #...........*###. . ..*.. . ..... ..\ . .*.... .#. \..#. .#.. .#
# .   ....*......*. #..... ...#.*.\..*.#*  .......#*. ....#.*  ....* . #.... ....*\##  *#. .. .*.*.*.. .\....#. .. #. ..\.#.*.. ..*\**.#.. . \ . . . #
#.**.. ..*..*# # ..#. ..# .*.#........ ..#*..#...*.. .. ..\#.** *#....*....*# \..* **...... ..... ..#...#.* *....#*.. . .. ..#.\....#.#..\\. ..*... .#
# ..  ..**...#.. *.*. ..#. #.#.*.#.... . *#.*... ....*#.\... *..*#*#...#... \ # ... ......... .*....\.. . .*.#..*..#.  .*\..**. . .\......  #.*. ... #
#...  ... \.. *\....#.*.# \.**.. ....#..* \... .\..#...*.\.... ..\. ..*##*.......  **. .... ......\ . ....\*.\.#...*. . * .#. . . #.* \... .# ##..* *#
# .  .... #...*.\\......  .#...*.#. .###..... ..\ # **.* \....#* *.#...*..**... \#..\ .....*. #..##..  .. .*.*.*..*  ...* ...*#  . .*#.   .   #*...*.#
#..#.\*. .##..*.#*.* \...  .... ..\ .##.#\. ..*#.#.##.  ..*..  *..# ......* #...#..* #*.. ..#.  .......\.. .#  .* .#. #. . * .* .\ .#.  ..**#* #...#*#
# #.*..  ..#.*.. ....*.. .... ...**. #...\*...* *** **. .**.\.  ...#..* .. ..*..*#..... ... .*.*.   .. ..**  .*.... . .......*.. .* ...\.* ..*##.... #
#... # ....##.\.#.. ..#.. #..... * ..##* \.. #*#.*.. . ..*...*.*  .*..... #.#*..#..  ...... ..... . ..\#\.#*.. ..... #..\#....# * ..* ...\\..# . .. .#
#. .*..... . ....\.#... *  #.\*. *.. .... .. ..#.#. *.....#.*\*.*..   . ....*..\ ..\.*\... \.#.  R. #...#......* #. .. ..\\....#...\...* . ..*....*..#
#.. . #..###...... .#\. #..  .**** \#.*. . *.....*.. ... ... ..\  *... # \ .#.. #.# .#.#..#*#. ..# ..*....*.  ...\........#*. .*........ *# \*. ..  ##
# ..#.*.\.*.*#. ..  ...*#...*#..... \*.\\.    . .\. \\...*.... .....\#  \ #* .#.\\..... *.# .. *. .....\..\.#. .  .......#... .. \..... .....*# ..#*.#
#.  ...#... .#..*#..# .\#*... *. .*..  .# .\....\....\.*..  . ..#.... .. #. ...*..\ .#.*. ...  #.#.. ..**#...\.#. \..#..#\... ..#....#.* .......#**..#
#.  *  *\### *.  *.*..#.. .\..  ..\.... .**\.*# * ....*............##.* ....## .. \.   ...  ..\* ... ..*.. ....  # .*.*..  #.... . #*..*#\........ *.#
#\. ... \ .    ..\  * .*#.....#.*...  *...\..*. ... .* #  .*\. .*#\.. *.#.*.#*..\..#.. ...#.# ...##. .\ ..#*.#.*..#.*... .... #\# #  .. ..# ..#.*.  \#
# . .**.... *.**..\..\.....*. \.... *.  * . ..*.  .. ..*...\. .  .\.....  ...\ .#  ... ..... . #....\. \..... .#..*  #\..* *#.*.. \.  .. ...# . *....#
##*....#......*.\....  ..........*.....  .*....#.*...*...*.\*.*. ..* .*#.#*. ....# *..*.#. ...#  ..\..# ..\.#\. #..*.. #..*. .*..*..*..#\ #.... .. . #
#*. #...# .* **\#*.#... ..*..*##. .. ....*. .#....#*.#..*. . *........  . .#...\ ....\.#*.*..#*....... .....##.* . #... .\   #.*. \.\. .. #......#\ ##
# .*..*. .. .. **#. . .....#.  ... . ..  ..#.# #.. *..... .....   *#*..\...  .#. #\....#.#..\........\. .. * ..  #..#.*... ..* \.##...\*..## ..... #.#
#.*.. #........* \**..*.#...#\* ...#...  # .. \... ...#.. ..*#....    .#.... . #. ...*. ..... *.# .. ..\ #.. ...# ... ....#.... ... ......... ..\.#. #
#* #.. . ...*...*\ .*..#* ..#  ...##. . #.**...#.... .* .*.*#.... .. *# .... # ...... \. \\.#.. . \*.#.. . ........*# \. .#.*#  . ....  .*....*\.....#
#...*...#*.......\ . .... . *...* #.. . . .## \.*..# .#\. ......* ..#..\.....#\.. ... #...# *.** .. *#....\  .#.. ...*\ .\#*.. .**. *..#**.   #...*..#
# ###... *... ..*..... \ ...... .#..*...*. .  .\ #.*..*. ..... ....... #*#. .  ...*.. #.  .. .. ....*  .... .. ... .. . ..*....... * .#*...###.##  \##
#..*.....  .  # ..... . .#.   .......  \#*# ....#... ..# .. #. ..# ..... # .. #.#..*..  ... ..###..... #*......#......#.....#.. ... . .#....*#.. ....#
#..  .. *.* *.. *.*.*.\.**.#...# *.....*.... .\  . . ..#....*  ...*... ...*....# .....#  .#\..#. ....... ......  ... *    .. .. ...*.*. .....  . ..#.#
#.. .*...\.#  .....\.*........ ...*.#. .. .\.. .... .* .... .  .#. #. ...# ...#*..#. ..*.##......#... ..**.. .... ......*\..*  #.*.**...*#\... * ....#
# **. ..*.*#....  *.... \ ...#...\..# \.... * .....#.. ....\. .  ..#..*..\.*..\*\.......*.... . .....* .....#*.\ ......*# .. ......* #.. ... . ..\*#.#
#.. .....  ...    *  .\# . *.*.. ..\.**. .... .....*   .*.. \ .#.\. ...*.. ..#..#. .. ###. \ ..\..\\**.*.#\#.....    *.#.##..  .. . ....... **#*#.*.##
#*\... #.... *.....#*..*. . . #.........#. .#.#. ...**... .\ .#..## # \.\...*.*..*  #.   *. .#.\ .... #....#...... . * ..* .. ... ..* ......#...... *#
#  #.***..*. *.\ .#..... ..*#...*\*...#.... ##..*..   .\ . .... ...\.*. \.....#... ...*..*. . .#..  .*......... . \...#*.. \.... *.....\..... .. # . #
# ...  #..#\..#.#\*.#..\.**..#* ##*..  .. #. #..##.. ..*.. . .#..#. ...#... #...* \ . *...# .**.#.#.  \..  ....#..* .#..........\*..  # ... #**.** # #
##*#. ..\**.. ...#.....# .*...**.. . .* # #....... . .... ..... *..# *# \..#..  ..#.#.\\.... .\. *\ . ........ *..#. ...... *  *. #  .##.#..  ...#.* #
#######################################L##############################################################################################################