######################################################################################################################################################
#   .\*.......#*. .. ..\## #*.*#*#.##*.#.# ..#..*#...*#. ..  .....#\..*. .\. ...\. .*.. \ ....... ..# *..  ...*#.  .... **.....\.# ....   ..  .. *. .#
#. .#........ ..#*......\ .# ... . ........\*...#  .. ... *.... .....#.*##\.. .#  .# .. .*#........\..... #... ... ... **.\.  .....\* #..#..#... . *.#
# .\##*.. .. . . ...\*.\#.#..\. .  ..\ ....# .#.#. ......#.....\...#\..#... .**##.. ..  *#..** ..**..#.. #.#.... ..\\ .#.**#.#..\#**. ..*..\. .**.#..#
#* ...#..#. . .\#\.\ * ..* ..... .*#* . .....*....\. #. .#.* \.*# # *.* .... .....\.#*.#. .  ...\\.\.... ..#.#......#....**\\..* .#.#..... . .*.# ...#
#..##..* ....  .**..**..  .#.* *.# .. .....*.#. ..*\ . ..  # *..###.#....  .   .....*\. .*.* ....*# ...*...*.\#..........* \ \.. #  *.#.*  \.*\#....\#
#* . ... ...\.  ...... ##.\..#....\ ...*.. .#..*  .. ##. . **. .. .......... ... .# . ...\.   .*\. ..... \#.  ....... . ..**......#\  .*..#... .**.\\#
# \. .....##.. *. ......#*#. . # ..# *##... ..#.*..*. ..... .*.** #. #***##... #.#..#\. . ...#.\##..#\......\  ..**...#\..\. .* .#...  .. .. ..*.. .##
#* .*....*#..    ....... *\...**.#**.. ... ....*...#...#....   ...#...... .**...*# ...  \ .. ...  .. ..# *.\....R...*..... #...*.*....*.*.....# *. ###
#....* *..\ *.#.#.*##. .. ***...*.# \ ....#  .. .... .*.\*.#. .\ ...*..\#. .. .*... ..*...*.#..*.*.....*#* .*.#.##.........*#* .*..\ *..* \ . ... #..#
## * .#...   * ..*..##\. .   # *##.*.*..# . ...  \ ...#......  .# #.....\*... .. .#*. .. ... .. **   #*\  .##. \.... . ...\...... * .. ......*... .#.#
#....* .\ .\#... .  *...\.\. #* * .. . . .#............. . ..\* ..\*..\.*..* ....#..........*.#. * ..###..\.*.#   #..\.....# .... . ..*   ..\....\   #
#. .##\*...#*..*. .\ .... ...##..#..**..  . ....\.#.  ##*  . .*.## .* *\.##.. ..\. ... .  .# \ .#.*#\##\ . .. .*.*.....#.. \*.*..  .#.  .* *..# ...*.#
#**.*..# . \. ..** ..  ... *\ .. *.... . .\*. ..... # ##\. * #......#....... .**...# ....... ..* *\\.\ ..# #.....*.... .   *#........###. .*#  ...*#\#
# . ....#.......#... .   ..#.. ***  .....*#*.##.#.\....*. ....\.#*..#\. .\ #..#. ... .#.\........  ... .... .....#..*. . *.. #... .........  .#.**.*.#
# .#  .#*.*..... \ .....# ...*.. .*..#..... # ##..#......\. .. . ... ..  \. #.#.# ...*.#..*. #  ..... \ ...#. ...*.*# ...#..... ..#\.#........  . ...#
##..\. . ## * .*.*.##. ......#.........#. *... ......\.\.**.#........ ...*\*. ... .  \\.\.. .**# ..*.* #......*.. #.\.. .. .\. . .. *..*.......... ..#
##. ..\.*.* *. .*.#... .*. #...*#..#.\*\.. .. . . . .*#..*\ \ .... *.\\\.... ##.... . .. . ..\...  .. ..  **. .\.. .*. ..*....* ..#  ...\*.....#*\##.#
#..#*  ..\..*# .#*. *.#\.......   .*. ... . .#. ..... .........*.. ....  ...\...#\.. *#.  . ..  \ . .  \. .#.#.  ...#* *.#** *..... ..*\\...#...*....#
#*\..#.#...  . \#..... . . #....# ...* ..#*\.  .*#.# #....*#.... .  #\.*\. ....*. *#.. ....**..*. \......   #* .... .#.. ..*......\\... . *.....  ...#
#...#\....# *. ..#**  *.. ..\. ..*. .  .**\. .... .*#..#. .....  ....#.....#... \.. ..  .....*.*#.\..#...\*..*.. ... . ..#.# *##**....\. ..*..#.... .#
#.....#* ......*..*\.... ..#..*# ..\. ** . .... *... **. . ....#*...*....... .*** ... ....#. ..#*#.#.#.. ...\\* \...\... .#. **.*#.. \*...# ...*.#\. #
##*.\\ ....##. . #\... .#. ..# ...  ...\.  .* #. .\.. ..* .* . .*.... . . \....* .......#..#...... .*   #  *.. .. ...#.... . ...... . * ...\.\*.*.. .#
#.  ..*\  . .  .. * .....*.#. ...*#... *...#...\ ...*.#..#..# .##.#... . . \#.... * .#.*... .#.**.#\ ..*..  \#...#.*#..*# **. . .*    ....... ...\.*.L
##. .\.   .. .*..** . ....  .*....#...#.. .....  .. ..***......*.#..##*# #.*.\..*.#.* .. *.\*#.. ....  ...... * \. . .#*..*. . . ...........*.. #\..##
#\.#.*.#...## ..  .\#..\. .\.*..*# .\  . . .*... *# ** ..#..#*..#..  .*..\... . \.  .#.*.##*##*.*.....\...\  ...#. .. .....\.#\.... ..#  . ..*. # ...#
#..***.  ...    .\.*.. .. #.. .**#...*.\##\....# ..#\ *.  .  .....*  *  #.*##* #..*.. ..........\..## . .....    .*.*....  . .\...  . \ *.. ..*..#.###
#* .#  *. . ..#.... .\....*...## ....#.*. .. .. *.*  . ......  #. \.. .. .\#\.*.#.**\. .. ....*..# .... .*.  * . .\..*.#  *.*\. .. ...... # . #  .*. #
# ... ...\.*...* . #  . .  #.**.\###..*#...\\\    .. \.  .......   ..#* *.. ......  .. ....\..... ... ..* .. ...# *#. ..... ..*. . ..*.... .. .  ....#
#. ..* .. #.. ..*....  ....*.. #.#*\*...* ... *.*..#**  * .**##.... ...\.*....*# \. ......# .\#.\.......#......   ... ..#.  .*.  .  \.\*.#..*\.. *.* #
# .. .#\.....#... .\ ... ..#...\.#. ..*..**.#\...* ..*  .\ .  #.... .. #. .\..#.. . .. ...# ..* ... . .  * .* .#.. .. .... #..#*.. * ...#*.#.  #. ...#
#... .. ...*#. ..\## .. .#... ....*#..\ ..#.... #....#**. .... ..\*..\ *....*.......*.##   #...* . *\  # *.# .. .\... ........... .........*........*#
##.#..**. *.....# . ..*. .\.  #* \  .  . ......#.. . ...# .....#\\**   ... #*  ....#.#*.. ###.  . ..    *.  ............ ..  .....* . ... .\....... \#
# ..* #..*  *.....*..  .  .#\..    .....*#.#\ .  . .  ...*.*# ......\ .#.  .  #   #. * \ **.......  ....#..\. . . ... #.#*.##.*.\\##..  * ... ..#....#
# ...........\ .. ##.#  . .. ...\...... .# . \.##.*. *\..#..\. . *. .\...#.*.#..*.#...*#*\.\ #..#. . .# ..#. *....# .... .*.#.....#.# ... ..#*. ... .#
# .......#.. #.**..\...#.. * .  #.... ......*#.. .. * \.*. ...   ..# . *.. .. .* \. ..*. ....\...*..\ ......... .\..## *..#..*#........# ........ ...#
#. .....#  .*.#... *..*.. . .....\. # #.* ....  ... ..#. .....*#...##... ..#......#..  .. #*  ... #\.........# ..\.#... .\.# .....\*...\**#\.. ..*.###
#..\. .*  . \.. .... #.#.#..*#.. *.. #*. .....*#..#. .... ..*.# \*#.... * .....\....*#*. ..... ##* ...# * \.#*#*\..*..  .... . ....*.# . .\\.  .#.# .#
#\ #. ...* . .# * ...*..\.#.* ... .***  ..\........\.   .\....#.. .......\.*.\..#. .\ .  .#.... . .. #.*\.*.\.##.\\.#... .. #..*##  #*.  .#.#.....\..#
##...#*. ..#\.........*...*\#. .... .*. \. ...*..*##\.\.*.  ..\##*\...*...\..*.*\*. *. . ..\. ... .*...  .##* *\*.. ...* ... #*...  ...... . * *.. ..#
#.. ..   ..\.... .#..* .. \. \  . .#. ...#.**.#...   . . .#*..  ..#..##  .# \..\  ..* .....\\ ... ........ \  ..* #...## ....#..\*....* ....   # .*. #
# ..  ##. .... .\.. ....**...# . ...##...*# .#...#.* # \  .#.\\.... .*...#.#.....##........ *. ..#..\ #. *.  . *. . *.... *# .....     #.. .*..#*. .*#
# \ ##* ....* .....*.#....#..   *...... ...*#.....#. #.\. *  ..#..#*** .#.** .*#..#*. ...*#\#\.. \* * . #........ .. \*.   . \ \\.# .... ....\*.\#. .#
#.. \.##.... #.*#..#*.\\...#...# .... ...  ..... . #...\...* ##.    .*. .. ... .*\..   *...\.. ....***.\ .. .*... .*...... . .#.. ..#...*  #. .*# \..#
#....#....\.#.... ..\ ....   # \.. .... * *..  .**..#....\ .....  . #\ #.#.. *#..##\... ..#..  ... ..\*. .\.*.. . #.. ...\  . .#.... \\#. ..#.#.#..\.#
#  .#..*. ...#  **.  ..* \#...\.....* .. .. .\. ...*...  ..*.. \...**.... *...** ..... ..\...#.. .*#.. ...* *#....#   ....# ..*#.#... *\ \... ...  . #
#\ \........#. ... *#.\...# *....#*..*..# . * .....#*\ .. *...* .#.* \..# ....#.  ... \.\.......  #.#..  .*. \.#...* .. ..*# . # . *... ......#...#..#
#..  ...*#.*.. .**##.... *.*\  *..#....# . ... . ....*.#... # . .*#. . .#..*..  .. ..\  .. # #...\.. .. ..  ..\ #.*..*..  .....*#...\.\.....\.  ... .#
#*  *.#..**\*.#  ..##.. ... #. ..#..  .#.\ ... ** #.#.*#.\.#...... .#.\..* . .*.\.#.*.......\. .*#. ... ...  .\ .\  ... . . * #\.. # . ..# .*.*\.*...#
#\ .# \.*...**...#*....*#....  ............. . ..# .... .. .#.#.#. #  ...*..*....  *  ..##.. *..\ .....\ ...# ...\\. .*..\. ..*.......# .\##**. . ..*#
##..... *\..# .. \ **.*...   ..#.#  #  . .\....#.*. .\#..*...*.*..#...#.... . ##......... ..*#  .... .*..#. *##. ... \ ... #...\..#. ..# ##.#.... ...#
###*\...#. . .  * . .....#.# .**#... .##..... *....  #....*. .#..#...\.#....#. .*... .. ..#.*. \.......*. # .*\..\...**....\  ##*.##.. #*. .. #  .. .#
#.*...    ..  \ .... #. .\... * #.#  .#\ *.###.*** .. #.. .*.. ........ .  ..\.*#..  #.# *.#.#   ...* .  . # .*..\#..#.. ... ......#... ...*#\.#.*...#
#.*.## .. . \#.* . .\.##.#\. ......*. . ...* ..\#\.* .  . .*...... .....#\..#..*...  .... .\.#....*..  *. .\.. *... \ #.... ...\. #. ......*.. .. \.##
#.....*.... *.*. . .    # ..    *....##*. ... *. .\. .# .. #.. . .  . ... .....  .  .*.. #.#..\ #.... ..  .....##.#* .* #..* . .## .*.. ..\#*.*..\\ .#
#.*#..#. . ...* . .. ..#\ ...#.* ......... . * \.......# ..*.. #*.... ....#\\*.... .#*.. ..\..#.##  .  *..*..  .*. ....* ....#...**.**...... .. . **.#
##.#.#..##... .. . .. ...  #....*##.#.  ..#....**...*...*. ......*..#..  .#... \.#..#..*. #  ...*#.*. ..\#.*....*...* \..#\.. ..* *..........\.... *.#
#. #*.#...  *..*  .##..... ......*.....  *.  . .*.#.*...#.. .\#. ...*.....## *. .#..  .  .....\... ....\*..... #..#...* ..... ....#.. ##.#*.#.\ .....#
#.....\.. ........ \.. #..  #* ..#.*.....\....*...**.*..# #..## .....#. .#.#..* .. .#*. *  .  .  .  ...*..*. . . ...* ..#.#.#. #. #.#....\.\..  .....#
#.*... ....... .#.##..#  ..#*#.#...*....* *..*.\ . ..  * *... *..  .#.\..*..#. .... .# ** # #.#...#......#.*.... *. \# .   .*..**.#. *...*....*#...\.#
#.. #. .*.. . ...##*. .*...# #** ... .. ....  *..# .....#\..#.#.. .. .#..#..\.*. ..  #.. ..*.#...* \. ... .#*.#. ...#. .* #.#..\.. ....* . ........#.#
#.#....#. # .#  ..#\  ..#..#.# ...\.*#..#. . *..  ..#* .*. *..*..\ .... . .# .  ....*.*....  .  ......\*  ##  .  ..  * ..  ..... .... * \ #.*\... . .#
# *.*......\\*...\... *.......#...\ .#*.... ........#*.#\...*\..\..* ..#.#  ..* ..**..  #.. #.. .**... *...  *.. *. ..........\ . . . *\*....#.....*.#
# ## ...#... * . #\.. ...\.#. #...*.... *.......\.. .  . .*.... ..\.*... .#..##...\#.#\#.#*. ...*.*.*...* ...#   *... .  ... .*#**#...... . .. .\ ...#
#*.# #.... # .* ..#*...\*  . .##*. #\. .  . \.. .\.. ..  . . ...\ #.# .. ..... *...#... .#......  .*##.... \ ##\.......#......*#..#  \... #.....\  ..#
#.\..... ...   * . . ...... ..* #\. *. .. #... .** .*. . *....\.#.#..*#. .. .\..\*.* **...*. .. \.*.. ...*..# .  # * . *. ...#*  #.\. \.....\....   .#
#.*\ .. ...##...#....##.#.\##.\.#..*..* .#.\..*\.*..... . ..*\. .... . ...# ...* ...... .. **........#. *\... ..*... .  . .**. *. .*.\..........*.#. #
#... #.*..#.*. ......*.#.. ... ..##..... ........ .. .*......** .  .#.**....  . ......  .... .......* ..# \*. ...*  .  **........##* . \..#.# . .\ \##
#*. .     . .  .* ..#  .\  . .\.. #... ..#..*.* *.*.*....*..#.*#\.. ..*...**.#*#\...*..\. . *..##.....*......... ..... ..*...*. # ..... .*#*.\.. ..  #
#..##. .#.. . .....**.*.*.*.#...#..*.\.#... *.....  #**..# .. *.*.#* . *.\#\..... #..# #..   .  \.*..*.*#\#..*.*  .....  .  #.#..... ..# *. *. .#.**.#
#.........#. ..... .\.*. . * ....*..#...#.  . * ..\.*.*.   *...........#..  .** *..#*..  ..*..\..#*.  .... # . . .... \#.* . . .#.###.* .....#....*..#
#..  .. #\ ... .  .....*..  *#. .*. .**..*.*.\... \* ...**#..* .....  .. ....# .     ...... *... .. ... ......#...#.#*#...*. #* *..#... .# * #...\*.*#
# ....#.*.#*......*. . ..#.. . *..*    .. #*.*#..#... \....... .**....\.. *.*## # . *.*....*........#. #. ...... .#.. \..    #.  ..#\*#* ......  .# .#
#* ..  .* ### *...\ .\.*..* #. . #..*....# ##\...*.......... . #... ..**..#. .#\ . ..\....*...#. . .#.#.   # #..#.............\ ...#..*  .. \.#.*....#
#   #...* .  .\\.. ...\#\....   ... . * .*. ..  *.\.# *\*#*...... **#.. \. *. ...#*.. .. *....*.  ......#\.*... .#\.\...\ .\..**.*... .. \\* #..... .#
#*...**. .... .\ *#   .*. *..*. .......\.. . ...\. .*.* .*  *.# .\#. .....##.. .*.    * ....\..*..\*...*.   ....#.. ...........*........#*..**.... *.#
#... * *..# .#.\#.....\...**..... *.#  *. ..\*..   . ..#.  \\.. ....... .... *... ..*.\ .#. .\....  \* .#***.*. . *.*......#.*...# *....*....... # .##
#*.  ...#.* ..\....  \.. \\..**.. .  ..#\#...... . *......#.. ...#. ...*.* .\#. \.. .** \#* ..##*.#.. .*.# ..***...\ . .......#. ...* \# .* ..... * .#
#. #\ .\*\*..   ...*.#  .*........#\*# . .* . ..#. .\..*.. #.*#...*. *# #.... ..\.. ...*  *.... ..*......\.. ##.#...**.\###..... #  *. ..#.... . #*#.#
#.#... ...\.. .#.  #..... .#.. ..  ..\#.#\*. #.  ..*#.. .... ..#* ...#..\#.....  *  . .. ....  ...* . .   .* #....  ...#.#.. .# ..\.*\..*  #...\.*..##
#.*.*........*..  ..#*.**# . \.# .*. .....*.*\.  . .*..#\**.  \..*.#..  .\*......#*. .  ... ... .*....... . .\*.##*.#...#..\... .#. . .\.# #  . ...#.#
# . .*..# *........ ..##...... *.... *...... .\. *.#.. .## ...*.*... #  . #......#..... ** .... .\ *.# .##.. .....*#.##**.....#*.. ...#.\.... . . .. #
#*..**.**..\...#....##.#.\ .**.. .. .* *.. ...*.. ...# \. ...##..*#**....#.* .#.. ...*\ ... #**..*..**. ..*..... .....#. .##\..*...*..#.#.......*. *.#
##. *.#**...#.. .  ..*... .. #. #\#.................*.....** \ ..*. ...*..*\\###.#.\.. ...*\.. ....... ..\.. ..*#.....#*......\  ..*  .....\#  \.....#
#* .*..  . .. # ...#.....  . . *.  ...*.. *....*..... . .#.* * . #.. . *. *.*.*. ......#..*.#....#...\... .....  .*.#... .. \..# #.*.*.** .. **#.. ..#
#.#... . ... .... .# .* .#..#*...##*.#.\.# ....* #... .  .. ##....#.##..*..#... ..... ... .#  *\#..... . #. .**###.....#\*....#.  *#.*..... .#. \.*..#
##.#. .. #*.. \.... ...\* *... ...... . .\\.**..* *\. *.. .#....  .. ....  .\...#*.. * *\.\.#*..*\ ...#...  ## . *.....*.   *..*.#.... .#.# ..\..#...#
##.#. .  * *..#...*.. .* .* .#* . .**.#..... . . .\#...*....  . .*#..#.. .. ....... ..# . .  ..#.....  *. .*\\\. \#..........\*..*#*.*.\#. . . . ..#.#
# .*.#*.. .\ ..#.  .\.\.#. . ..#.......  . *...... .*\. .*.*#.*.#  . .# #.# .  .......\. .  * **. .*..  ...*#.. .# ..\......##. ... # ..#.#.* #.*. ..#
#. .* ..##.. *....*.*..* .   * .*.*...... ##  .. *.. \\*\ \.  #.# .#.... ..* .#.......... ......\..# ... .*.*. ...*.\ ...\#..##.*.#.*#.\.  . ....* ..#
# ... . . \  ...*....*.*.* * .\.# #.  . ...#....#. . *#.\. .. .... \*.#.....# .  .....*. ...*.. ..\..\ .* .. .\ .....##.\.. ....\ \.\ \..*\##   .....#
# ..*..# .\ .....*\....\...#....# .....\ .....   #. ..*..\# .....**  ..... #*. .... #...* ..  ##.....#.*..#..*.. . ...   ..  #.. .#.....#*.*.#\...**##
#\...#*..* ..#.... \......#.....#........##...\#.*...**#. .. ...*....  .*#..**..*....#\    ....#*..#..  .**.*#.. ..# ...  ....... ..\#..#.. .\..\....#
#.*\.. *.*...#..#\...#.. *..... .....\\...*.\.# .  .#.*#*...#.#..#\#.*..*.#.* #. #\. ...*........\.... . *....\\...#.*.#... ..#......\#..\  .\...**#.#
#*.. .*...*  .... . . . \*..#. ...\.... *\*\...... .*. ..... .. \.....#.  .*. .*.. ....*# *#* . ..# ..#..#.#.. ...#\ .# ....# .   . .*.\# ..#. ..\ .##
#...# .   .\.# .. ## #* .. . # ...# .   **.\..\. .##.. . \.*. ... *....\.#. . ....*.. \*.**.. \.**##.. \. ..... ..\.##.#*.... .**....#.#*.. ..*\*. ###
###...... ##.. .#.#  #  .. ..#. .#....  ....  #* **..........**.#.*\... \*...#..# ..   . * *.\. #..*.*.#....#. # ....#..#. .*.#..#* . .#. .. # . . .##
##.*... ..#*.. \.  \ *##. .*#.... ***#....*..   .. ** .\. ..#..#.#..... . ...**.\ .*..#..  ** *.#.*.\ *# \ . .*#. #..*....*.......  .. ..*.#* ..*.\. #
#...  ......#...  . ..*\..  ..#..#  #.. .*. #\. ... *#..*..*....... \..#... .## .. .......*..#. ......#... .... *.* . .*..* .*.  .. #   # ...#. ...#.#
#  #.. .  .#. ..\. #  . ..#\.. .....\..\..  \. ..... ...*#.......... #........  #.. .#...#*.... ......\\. ...*.# ... #*# ..\\ . ...*#  * .... .*#.#\##
#.* ...\.. ..... . ......\.\..# .......  .*.. ...* .#....*#.#.*....*  .*   ..*\\ **..\..... .   # *..#  .  ...#. .. *..#..  . ...... . .  * # .*..*..#
#...**...  . *.. #....... .#.#....\.*...*. \**.*.#** ..* . ..* ... .. #. #.* .\.*#*.\# # #\.. .#. .*. .* ...  ..*....##....#..#....*...#\ . ## *..*. #
#.. ..*.\*.#\....#  \.\ .....* ..*\..# ... .\.  .. ...*#*.... . * ... *\\ . ..\  #.. .*....... .... #.\...#....#\.#*.\.. ...#. #..# .\*.. . .  .\...\#
# ...... *.\# ..\. .\.*.\...#..#*.....#.. ##....#.#\..*. ..*.... .... ....#..  .... * *....\.......#.*... ....*##... .... .. .*\ .  *#*..#...... .\. #
#. #....#.   * *  ... . .. .\.. ..** .*....#.... *.. ##.*...#..\...\* .......\\..#..###\ . ........\.\.  .  .#*. *.*.....#\..#. ...\.*...\...... *.*.#
# .. . #..#  ....#*..#. . . #..#.*.# ...#*. .# .  .#... ....  ...*.\*. .. .\. . ...... .... *.#* .... ### .*.\*. *.*#  .\..... .. \ ....\*.. ....*#..#
#.. ..*..... ###.*.# ..#\. . ..#. .*.... .... \..\. ...** .*..*. # .. .*. .. ##*....**. ........*##....#. ...#.* ...   ##..#  .....*..#........###...#
##*#.*..#. .#......* ....**..#. . .# .\ ..\ .  \.....* ... . .*#*.#*.....#.\ .....#..   ..  .. .. .......\ \   ..\*...#. *.\.#..  ....#*.. ....#....*#
##**. .## ....* # .# .*  .\.*.   .#...\. ..*##...  .## *  ..*.  .#.\ .\ .** . #.\  ...#. ###. .. ..*.. .... ..# . ..* ..*......**...  *#.*..   ..# .*#
# * .* # #..*\...\. #....#*\....*#.  ...*....... .. . #........*  # . . .. .# *.*..  *... ...*..*#.* .............. ...*...\.  *..#*..#.#*..*.  \...##
#* ... ## #.. *... #. #..... **. ##  .*...#.....  ...#. ...#. **\..*  .* *\...#.\.  .. .*..\...#.... .. #..\#*\.# ..# * * #..*#.*. .\.. ... ..\ \# . #
#... ....   .#*.#.....#...........   ..*. ..**\. ...*.. ...# ..#.   * \   *. . .#* ..  .. **#*...#....*....#.. ..*..#..* .** *#*... ....... *#*. ..\.#
##  . ..  . .\#..#... .  #\.\\..*.... .\. .*. * ..  .* .  ..\*.... . .. .# .. ... *..#...\.* ......*..*. ......  .*....*.\*....\.  ..# .. .... .... .#
#..#*#.  ....#..#....#..#.#.. *\.. ... .\... \*.*..  ..  .   .#\. . .\... *\.... *# ..\ . . ...#* . *#.##....... .*  .....*.*#.#.....*.\.... ........#
#.... \.. .. *#....*.##\#.\.  #...* ....\..\* . .. * *. .* \.#...\ .#*..#... .. .* *.. .# #**..*..## ..#..##  ..*..#..#. . .#..\....* ..\ ..\ .*#.#.*#
# *# ..\* .##. . . ..#...*\ # ** .. .........* .\...\ *...   \ ...........#...#... . ...*.*.\.# * ..  .\. .. .#.. ..\*..*.#  .*\# .  \... #. .... ...#
#***. *  .** *....\ ...\*....* ...#   \.  ###*..... #..  ....#... .#*#..  ..*\#....*.**.*.*.  .\#. .......#.. .*.. \.. ......#*....\.#..  ..#.. .. *.#
#.\.. *..\ ........#.\. #*.*.\...#* #....  *.*  ......  ... . .#. . ... ...*.. *  ..# .. ..#.*.. .#*.  ...#...#.  .. .\##.  .....*#.*#.# .\ ... *.#..#
#\  *..  .*.*..*. ..\  . .#..*.#... #...\#......*\.#....#*  ...##  ##... .#.   . * .....#.  ..# *# ......\. ..  .*.... .....*#.\ ..  *..... ..  \....#
#. .*......* ... . .#..**.*. \  ..\*..*.....* ...# \.\* # . ...  .. ........*..*...*   *.**...#  ..  .\. ... .. ...#...#.. #  . . ....... .**..#.... #
#....**....*... .\..\\ . \... *.\. .#.....# ..##.*.......#..#\. \   #.........#.*  ... ........ . \.   .  #...*.. ..  *#.... ... .   .#.  *..\*.....\#
#. .... * ..# .*. .. .. .*..... *....#.#....* .. .#\ ...###. ....*..*. .\..... ..*...\*..#.#...*....*.#...#.  ..... *.\ * ...\......*\. ... # . ..** #
#\*. .#.*\  .*.#. ...... .#.... .. . .*..\.. .#.*....# ....... . .. ...... . ... ..#   . ... .*. ...*.....#....... *... . .*..........\.**.* #..*.#..#
#.   .\..  .. # *..#. *.*.\  #.#. . . .....# .   *# # #. *#*..#.\. \... ...#.  .## . ....... .  ..#*#....*....*#.#....\.###...\.. #..#...#.*.....# \ #
#.*.........*..  ..#  .  .. \...*. ***.... #*# .*#...*.#.#...\. .....  ... . \...\*.#.#\... .. *.\**... ....# . ..#*  * .*...\....\***.... *. # . *#.#
##...*.*.\..\.\.*#..\.#  * ..#.. *.... ..  #*....\.....#.# ...#.* .....*.... .*... ....*........\. ** .# .\ *.#.. ..*.*.... ..**.. ##......#..  #.#. #
##...*.... .#..*.# .  .. ... .. ........*...#.*..\*.#.  ....# .... .\..... .  #.#*.  ..#... ....*...*.#.. .... ....  \\ .... .*.*. ...# #\. ..  *#.  #
#\\# *\ #.# . . ... * .  *# ....#. .  *.. . ..#*....* .. .*##..* . .. . .* .# \#. ..*.... . ..#. ...*.   .*. .............#...*........*#. ..\.*. ...#
#.\..\..#.  #.*  .. ...#. ...*.*. .#.#*. .*.  .\.#.. ...... .**....*.. ...\ ..* .....*.#. ......# .. ..#* \...*..#.#.... ...... .*\.....#....* .\ .. #
#*..  \ ..... .   ..............#.........*....#. ..##*... #.*\\   .  #.\...    #... ...\.*#.. ..\...*  ...#....\ \....  .\*. ... \.. .......\.***.#.#
#.*\\  *\. ..\.... #\. .....*.#.*... . .  ..*.*......   ....\ .#* .*... .*.\.#..  .#....* .\\. . ..  . .* .....#..   ...... #....#..\. ......##.... .#
#...*...*#..  ..\\. **....*.....\#*.....*...#*.**..* ..  ..... #..*. ....*.*....\#. ..*##.. . ... . ..*.. .  . .   *.....* ...\ .\ ..# ....#.**.\*.#.#
# # .....\#.. .#*. .# ..# ... . .  .. . ...\..#.....#. ....... ..........\\* ..*..# #...*...* *... ......... ...#**#.*# .\.\....*.......#.. .#... ...#
#..\..\  #   .# .#..# # ....  .*.*....* #. .. ...... *#. ..#... #..#. ..# .#. . ##... ..*  \. #.*......... \.  . .. . .. * . .***.#...*#... . ..* ...#
# ...#  ... ...#.#. *  . . *.....#.*. ..*.\** .. .  *. .#   ..# .. *......#.  ..*..# ... .* .... .....\.......   *.#...\..... *...* #*  \ .*....\ \..#
#..  ... ..#*....*#... ......   .... . . ..#.. .#. ... .*.*....  ..*..\.\.# ..#.*.*.# #....#.* * *.....*  . ...## ......#.. ... ........  *#.  ..#..##
#.. .# .*..#.*#..*...... # *#..#.##.**...*..*....#....\. ..  . **.  #. .#....#*.. ...* ..# .\.. .** .# ...*.... \*\.... #... ...*..**.. * ##*#..**# .#
#  .#.##\. ..  ..* ..\. .#*...*.....#.. *#..#. . \*\\*. .#...*.# .\....#.*......*\*...##..\** **...*.#.. .*... ..*.    .......\## ..... .. #**.* \...#
#..#... .#.*.......  **. .*\# \. *#  ......**##......\.   .. \ ....    . .\...#..#.. .\.......# *... . ....... #..*...*.#.. *...*.. #.\..# *.*\......#
#....\\ #......#...#**..#..... ....#    ...  ....* ...##  . .  *...... .\..... .#.\   .* . .. #...#.* ##.*  ...#.*  .. .*#.##***# ........\..*.#   **#
#.... ....*. .....# \.#. ...*#..*..#*... \ \.\* ..#...*.*..*...*\#..#..#.##.. * ...*.*.  *.*.. ...#... \. .#*.# #.. *   .##.....##\..  .  *#....**.. #
#........ .  .\..#... *... **... *............*\... ....# . ... **....*.... ..   \ .#* ....# ...#.*# . *# .....**. *  ####  .. ....*#*...# ... .. .# #
# # ...... ...**#*...#.#\...*# *  ...#\.. ..**....* \  ...  .* #... *.......*  #\#.. ..    ...*#. *..  \.#.....#.#*.# .#*. .#.........*#*. *.#....\. #
#...\*.   .. .#..#* #... \*.. ..* ..  .*. . *. .   . ..*... .... *... ....*........  \ ... ...*.......  . . *..#\   .#.#.*.\..##... .*.. #. .\.\\.#..#
##. . ...    ...*.....*  . .*.* * ...*# #* *. ....*#.... # . ..  #.# ..  ... .. ##* . .......*... .\#...# . \\.#\. ..*...#..#....#  \ ...*.. ..# \.#\#
# ..#.*.#* . .........*.*. ... ## ...*....#.*.*... .# #.. *. ...... .......*\.. .# ..#*.  . #***\ ..#.  *... .....#... \..*\.\.*...#.* ... #*. .. ...#
#\  .\*.....\*.\.#.....*... . .\ *#. *... ....\\ *.  ...\.....\ .....*..*.#* .........#..#. ..#.... *.\...*....**\*...*..*#... .*...... ...#*. ..... #
#...#*. ... ..#...  .. .. . ..*.# .*.. ....*..\.....*....*..\\**##..#.#... * ... ..\ .*... ... .... *.*.*..*.  #.#* ......#.   ...#.\#......* ..## ..#
##.#..*......**.\.. ..#.\..*##**... .. ..*..#...#  ##...\\.........*...#...*.  .*. *.. ..# ...\....*..#\ ..*.. *...\....... .  ......*#...#.... \*...#
######################################################################################################################################################