######################################################################################################################################################
#..#.   .#.##. ..*. *....\.*..* ..\  * ...*#. ....* .*...#.# . *  *.* .* *.. *..  .....***.*..* ..#..*#.#*..#..... .#...\..* .....*# .... ..\#...#..##
##.#.\. .*... *\*.\\##.\..... .#.... #... ..\....\*. . ..   .# . *..  .#.*. . .....#..#..\..*...  . ..#.\... .*....*.# # *\* .\*. \\.*... .#* . . ..*#
#..#.....*.\*. . .## ..  .##.*... \ #.. .....**\..*#......#. ...*.* .....*.#.#.... .....*\.. *.#. .#..*.....*#.**.\...  *... ... #\. ##. # \  . .. . #
#. . ...\\ . ...  ... .\.\  . . . .....*.#. \# .. ..#*. \. .* . ..###...........#.. ..#* #..*... .. ..\.  *.. ....#.   ...\..*....\ .. #..... ..\#.. #
###... .#...*.  *....#...* .\..\.. ....#. *.. #**.#.*. *.  ...# .* . ........   #*.... ....*  *.# ..  .#  ....#....\.* ..#.  ... *. #. . *....#  ...\#
#.*.*.*   ..... ..*..#..  .** ....*  #\. ...\.#..# ...#...#..... * *....\.*.#.* #.#. .\. #..  *....\#.* #..\... . #\#.  ..###  .*#.....# .\.# .#.*.* #
# #...  .\ *.\ *. . .*. \.....#.#* .. .*....#\..*# * ..*\.*.*..#.#.\.# .. .......*. .# *.*#.\ . .. ## . .. # ........ ....*..#.#*.*  .   ..... ...  .#
#.. ...#.. .....#   ..*....## .*.##.. *... #*.\.#*#\...# .\# .. .. ..#* .#.** .#.......* #.#.#.  .. #* ........ ***.* \. \..... #  \ .....  *....*...#
# ##\ #. .**.*#*\ .  .\. .... ..#\ *.*... .....\.....#*..\  #....#. ...#...... *. \.*\...*.*. ...**...*.*.\... ..... *  ..#....# ..#  .*\ *....*#....#
#.# ..  #\ . ...\.*....* .*.\ #.... .\...**\#.* #....#* \# ..#.. ..*....\*   .*..#...*..#*....* *# *##..*..*. ......##*.  #. ..***\...*#. #..*#.*..  #
#\ .. *......*...  .#.#....\... ....*.#.# \#.#..*.#\#.*  .  ...\\*.  #*.**.. ...*. *..*   #\##. ..*.*#.. #  ...**. . ....* *.. #.#...\\.* ...\#.. ## #
#*...  ... *#*.. ##\.#*....**.. . *....   ..\ #*......*. .*.** *. .....\#. * ......\..#.. *...*.... ... .*#.*#\. **...\\ ....... #  *....\.. .#.#...*#
# ..# .\. #...#.  #.\*##.#.... *... .#   . #...*##...\* .. ..\.... .... ...   .*.#. ..# \.....#.#.....\ .*\.. *..\*.....*. .*. ... ..*. #....  ...\..#
#.*.. .#\\*...#. .... ..\.... \ .#..\... ... ....*...\#..  ......\\\ *#.. ...#* * ..##.*#... .... . . .....*#..... #   . \.*\  *...\*... ..  . .     #
# ... * . #.*..*......  *.#.#...##.* *....*..\.\* * ..\. \..\. ... ###*.#.*..\ .. \... *.#\. ..... . . . ..#. ....##.##.#. *.... .*.*  .*#\\#.*.. ...#
#.\*#.\\......#.#.**...\....\...#..**.*..*..  . .\....###. .#  . .......#.*#.*.... #.\....\...\. #*#.*.#.##*..... **.\ .*...* .....*# .. . . ........#
L. ....  .. \.*  ......*\...*...#  ##...#..#*\.*#.. \. . *#.#...*\. ..*\.* #..**..*...#*....#.  .  ..*\.\.....#......* .... ..... .#  #....** .\... ##
# .*..*... .# #  ...#.*.\. # . . *.....#. .\.. . ...# .. ..# #. .\ .#.. ..... .*  ... .\*..\. ..*...*...**. . .............. ...*\..*.*.**... .......#
#..........#..# .......*.... ##  * ... *# \..... .\## ... .\..#.#.....\. . *. * #....*..*........ . *##.*...\ . ....#* ....*........*..#.**#.* ...#..#
##......#*\. .*   *.*# ..\*...  . .*. *..#.. .....*##*.\* . *........#.    .#.#. ......# ##.... ..#.. ..    .*.#.#.. ...    #\* .. * .\..   .#.. ...##
##...##  #.... .* .....***. .# ...#  .*..#..# .# .# .  .....*.#..  ..  ..*.\ . #...*  . .....  .. #..  \...  ....\# #.. . ..... .. .#.....  \..... . #
#.  .  .*.  . .#  .# ***..#....*..#*..... *.#.  ..*.#*#*  .*\..**..* ..* . .....#.\\  .... .......*....##....   *........#*.. \ .\.*....#....\.#*.#..#
#*. .*..   ... *.*....*... . .#.  #*#*  #*...\... *.. .. # ... *#....... ........ .##...##.#. * .#...... ..*...  * ##*..#.\...  ......... #* * .*...*#
#...\. .*\#.#*..**...* *...\ \.. ... .# .#   .. ....*. \*#**..  * ..* \*. ...#..#.....#  .  \ .#..#..#**..\..  #.....#....    .   .\  ....\.#.....  .#
#*#.#.\# ..* ##  \ .#...#*.#...*# #.**.... #  ....#. ...*.. *... . ... ...... ...   ...*.**. # .. .\..\.#..# ..... ...*... #.... *....  ......\..* ..#
#...#.#.. . .* ..#.*.* #....*........#...#....*\. ....#. ...\..# ..*.......*.* ...*#. ..*  ...#...*... *.*.    . .. #.#...... .##. .\*# .\ .. * ....##
#..  ..... . . ..\ #* .. #. .** # #.. #....... .. .#.  ....#........ .. \#*.\. ..#**..... \..#.#..#..*#.....\.....*. ..\*.... *. # .#..\ *. .\.\*....#
# ....  #.... *. \......*#...\##.#.*#  .. .. ..... #.  . . .*..#  . \** #.#...*.* *. . . **.#. . ... ..\*.#\..*...  #...  .#*... ....\\   . .......* #
#.... #..#..*  ...\ ..\.......... \..#.. **\# . #.**.*  . . **..\ #...# ..  #  #. ...**#\..*....*....*.... *.#*...*.. . .. *. #\..# #........*.#.... #
##*..  .#.... .#\.#....#...* #... ....*. .. .*..\ ...#....*.#. . .*#...  ....#\..\ .#*. .\# ...#. .   \  ..*.#.....  ....*.*.  \... *\**.......*. . .#
#... ..#..#. #... \# . .... *.\* .\\\\.  *\. *\. ...#....# . ..  . ....#. * . .. .#**.#...**    ..  .. ..  * . \..*#.*.*.   .# *.. .\  #*......# .  \#
#.* ..#.#. .  ....\*...**\.\. ....\* \...*.**..........* # ... #\.. *#.\.#.  *. ..*....* .* . .......  ...\. ..  ....\.. .\##. .* .... # .\..* ......#
#..#..#.. .......*# .. . #.. . .\. .#.... . .. .*.#... .  .*. .   .....**..#........\..*...**.*..#..#.#.#. .. *. ..*.  .#.#.\\  .......*  ..\##....**#
##..*#.##.... .# ..*. ....#\  ..#.***.*\.... #*.. #..#..*.  . .# .# **\*.. .#. #... . .#. .. .. .#..* .*#* ...* ..*..# #* ##.  ...\##.#.. ...*.#....*#
#.*.*. ....*.* *\*... ......##.     * \**....\.. *#  ....*..\..## .. ..\  .. ..*#..# ...***..*....\.*...*\*#\.. . ..#...*..*..*..#..*.*. . *..... .. #
#.. # ...  ..*.#..  .*.. ....#\  #.**... . *... ... .... .#* .....# ....\#.... .. ........#...* .# * .\........*....#. . *...#\. ..\*.. .. #.#..*.. .#
##... .*.. ###. *#.....##..##.#.\. \.** #...... \ ...... #\....\*.....   .*.\\..***...*.... .  #. *.\.......#\ .**.*.#.**...  \. ..  ..##* #.#\##. .\#
#..  *   # ....  .. ..#..  ** ..  ..#.* ...\##. .\ .  ..*#. \ # .. #\. .. \.**#*..*....*. *..  ...*.. ##.... .#... \.\.. ..*#....\. .***.............#
#*.. *... #\*  .*.*...... . ...##*.... .#.....\. *....*#. #*..\.... \\.   .* \ ...#*\.. \..... .\.*..* .* #. ... # .....*.  ..  .*.#.. *... . #\..#..#
# ...  . \. #. .##*.#.. ..*.....\.\...* ..*.. #.#....... \...   .*. #... *. *...\.... .* *.#*.. ..# . ........ \.#. . ... . .*.  ...*.*.  ..*.. ... .#
# . .# *.\...*.. ... .# .  .... *##.*....**. . \   ##........ .\ \. .. .. . \.. ...*.\#\.\*......#.* # ... .... .*...\.......##....   ..*... .\. .#. #
###..*.*.#. ...\.......#.* . ..  .....\#..*...#\.....\.\ ...*..*# *..*. .*.. .#.#.* .# ......*  ..#...*.*\.*#..*.....# # .\ ....#...* .\........#* #.#
# ..#......#*. . .. ... \.#. * .#... ....*.. . \*.*.  ..##. ......* . .. .#... *....  #..#....*. ...*. .  .. ..\\.. .....\\. ..#... . .......*.  ....#
##.... ..##.. .*\..#.\ ......\*..#*.. ...#* ...\..# .*.*..##.. . .\... * *. . ##**.#..*.#..\...*.*......#...\.*#.....\\*..#*..*...**  . . #\.*....# *#
###. . ... .... ......\.*. .#**. .. ...  ##.* .*\#. .**   .....*.. . ...\# .....#.*....  *\..... ..\..\ .#    ..*.*... #..#... ....#.* . ... . *.\  \#
##.. . .... ........\..*......#. . ..#.\\ \#.##. ....#..*.. *#.##...........*.# ...*.   ..#...# #.   **#. . \. .#*. .. #.   ...\ .*........ .*.*..\ .#
# ..*.  \.# ... ##..  .# #\. . .#.# *.#*..#....*#*.*.#...... #.*# ..  * ...# \  .... .#..*.*\\. .# . *#.#.*..#*#......*\.#.....#....*.. . *  ..*.. ..#
#*\...........# . .. *.**.  ..# ..... *.**.* #.. .*  *.*.....*. ...#.*..**.   ... #...*.......... .. .\...... .*.....*...... .*.#.#. .* ..**#..*# ...#
#*.. .*.*....# ..\  .. .\. ...  *.*...#..*..#  ..#\.*##  \ #*... ...*** \..\.\#.* .\ ...##..*##..\...*. . #....** #\..# **......#..*.#............. \#
##... \#..   #*.  . .*....... .. . .* ....  .... .**.. *..\ \ \ *..*..*.. ..*.\.. .. .. .. ..... ...*... ..#\. ..... #...**.... #...... ... .*...*..*#
#...**. *  . .    .*.#.*#   .....\...  .#...*#.....   ....# .. ...\...*. ..#. .....\. .** #\.. *\.. # .# ..*....  . .\........ # .# ...# .\...#.\.\#.#
#   ..#.\..... ..**#.. . #..## ..*.... #\...\. .\. \#. \..*..*........ .\..#.#.#  .... .\\.*  ....#  # . ...#*#.\ \*...*. .#.....  ...\ .. ..  .#... #
#... * .#.*..#...#.#..#.*  . *.*#.\#.#. ..\. ....# ....  #.. .*..#.##... ...*.*..*.. *.\...##.*.# ...#....* .... .. .* .......  . .\\## *..#...*. ..\#
#....... .*.*.*. ..#.. ......*.. ...*.*... ..# \.*#.. .  ..  ... . * \# *.#.*.# #.......\... . ..#.**....\ ...#\.#. .\.. \ . *. .*............ *.\...#
#*..# . \#... ....## . .\ *.## ...# #...*...**.. ... #.. .*#.. .##..*. *# ............*. .\...\ .\.* ..  * #. #.# ..*.........*    .  ....  . *..*. .#
# ..*... . ....\....#.*. ##* \.    \ ..\.*.\. \#.*..... .*...  #.\... .  . .*. \.... ..#....**#..... . .\ # . ##*..\#.  .*. .#.#.   \*\....  .\..... #
#...#.  .....\\ ..... #.*#. . .... .. *...#\..\.*#.\.#.*.#*....\.. ..... ..  .....*#.*.#.*......*... *\... ........\.*. ..#.# *.*\.* *.  ..#.# .# ..##
#.........\.. ...  . .*..*### ... . *. *.. .*..\ \...## \*.. ##..##... ..\..# **.....##....* .\.. ..\*.\.  .*. .\.. ..#*#.. \#.. .###*.. ... . .# . .#
# \ ..#...... .......... ....#.*. .*. . # #. ..#*.#..*..\**..#.\ \....*.\##  ..       \.    .*.. ..* .*.......\...  \#. .* .  .*.* .#.#...*#.#. ###*##
##.#..... .*  .# .... *#*#..*. . .# ... ...  * .  *.##......*\.\.. ....#...    *\....\*   .. ..\#... ..*..... .\ .  . .*.#\ . *.#.........#..# ..# .\#
#. #.# \...*.  .....#\  . .. . ..... .*.##.* ..*.. *. .*.*#..\. .\*. ... *.#.\ *. ..\.  .......\ *...#..... #*...........*.....\* ..*. .*# *....  ..*#
#..\. .. ....\...##.  .\.*.\.\.  \.#.*  . #. # * ***..##*... #.\. #..#. ..*.*.**.#.\.. #...*. .......* ..*#\ # .... .....# .*\.. ....\..\*. *..#....##
# #.##*..  ...#   ....  # ...#. *..*\.   *#\*... .... # *#........##.\* .#\...*.. .#..... ..#. ... ..*#..##.* . \....\# #..** ....#.# #......*. . .#.#
#.*. .. ....*#.*...*. .*. ...#... .*.*  ......# *#....  #. .*........ #... #.\.\..*.. ...#..\....#.... ..#.. \.##.......\#. ..  #...# .........\ * . #
#\..#.\#. # ....... \...\.  ..*\#..* .\ #.* . .. . #\  * .*... . ....* ...* . . . \.... *. ..... .. * ...* \. ...* ..#. ..#..#..**.....\ ...........*#
#..\.#.## ......#*..#*.....* .. #   . ..  ......\..##..  ....\ ...#. ....... ##*#\  .\.*.*.*..    *..\#....     *....#.*  ...#...*.  * . #*.*#.*. ...#
# *. ..#\. #..... .. ....# . ..###..#.. ##\ .....  .\.*..\..\#.. #*.. .*\*..*..# ###.#\#*\....  .. ..#. ....# *... ..## .*.   #.. ..........# ...#**.#
##....\.#...  ... .*... \ ... . # . ... . ... ...*.. .*.\ *........ .. ...## ..*.... # ..\... ..#. *..\#....* ..* .. . #. ....#.  ...*... .*.*..  .#.#
#.. .. .##.....#..\#. ..**.\ \ .\#...#.*\..*. .#..\ .*   .........\..#*..#.##... *.. ....*. ...*..#....#  *\ .# \\..*..*. .#..*.... .. .\ ...*....#*.#
#*  *...*\..*.. ...*...\ . .\#.. ....  .# *....... ..*...... ...  ...*.. \# * ...*...\ #*\ *. #.. .....\*.  .\. .#.....*....*.. ...#....#.#..#... ####
#.#.....*.  .. *.*.\ * .** ..... .\. *. ....#. . \...* *.#. ..*.#.....  \.*...*... * .#..*..\*.. .........*.* #*....\.\\.#....*....\*....#. ..#..*. .#
#. .\ .*..*.#*.....*...#.*  .*....  . ..\....#.\*.. **...  . *...##......*......  ....\... #.... **##...# *\...# ....#  # * .\*...  #.*.\....\#.. .*.#
#.......*# .. *\\**.*. ..#.............  ...*.. \. #.#*...*..... .........  .#. \\..*.  .*. *..............# *  ..*. . *#.\.#...\* . \....   . # ... #
#  .....\*.#..#. . . ..... .. .. ....*.\. \..#  .. *...... ###.. \ ....#.# ..\#  *   . ..#.##.*.....** *\.....*.... .. .  #   *.. ......... .*#.#....#
#*.. ...*. .. .\.... ..**.*. .#....  \** .#.. .. . ...#.\...  .\..\.. #... *\.........*. *.#. *.... .#......\..#.  .\.. # ..#....*..# .# ..##. .# .. #
# ..#.. *..  . *..#.#... .\... #..... *\ .....*... *..*.. ..#**.\. ##.#....#..\\..#. ..\..# *\.#*.  *.   ...*. #. ##....#*.*..#...\#..*#\.#...# . #*.#
#.. .. .\.. .  \  #*  *.#. ..#...# .  .. * ..##.*###..... .. .  .. ......#.  *...\\. *# #..# \...*#.. .....## *. .....#. *#*. ..*....#....\ *.....#. #
# # .... \*.  .*. \.**  #.#. . * ....#.*...#...#.... .* .#\. * *. ...* * ..#.\ .\...\..*...*##  \.. *  \. #....*.. ..#\.. ......*.... ...\.*\ . .. .*#
#... .\....\  *#.. #* .. . .\   .###. .. \.##  *#... . *.... **.*.  \*. ...\.....*.. ... ..*.#. . . ... .*... .. .. .#....** .. . ....#*..\......#.\*#
# #* ...*...##.\.# #.#.*.....*. .#  #*#...##.. ....  .#..#... . *...#..*. #.\.\ ..\ *. .# ..*.*.. ..#. .......*....... #\..*..#...........  ..\.\..*\#
# . .**....  #. ..#.. ....... ..  .  . ..... ..*.  .*\*... ..\......*# ......**#.\.....*.#*..... ## *. .......  .*. ..#....#\*.. * . .# .*.. . .#### #
#..\ ... .#..*... .. ...*.*# . ....* .# . ........#.#.*..*.** #..\ .. ..\.*..*\. ....# ..#...\ .*\ .\ .........\.... .#.... *  .... ..\ .....*.  #  .#
#... . ..  .* *.... ....  ..*....*  ## .#....\#  .... #.....**.\.#*. . ..* .. *. . * ....#. #.\. . . .. .. ..... . .*.. .. ..  ..\..\.... . ....**.. #
#*... **.# .\*.#*.*..#........*.  ..*.*#.# #... ....#*..*.\ \*  \*....    ..# ...  ...# ..#*#\#..*#.. ..\ *\.. .\.... #... .*#..........\....*#.. \#.#
## ...  ...  \ ##...\........\.. .... ..# * ###\.*.. .***\..#..*. ..*.#*.\.*. .. ..  \..# .  #.*#...#  ..*.... #.*.....*..\..# .....*.* ......... . .#
#. .**##*... .\ ..*.. .*.#.#.. * . .  # .##.. .. \  *...*.   .. ...*..  . .*.   ...  # .. *.  .#.*#. \\.## ....\ .# .#...*..#. .*.**.##. \...* ... . #
#...#.*. ......##.. *..*............... \. ....#...  .##....*.......#..#*. .*  ....\\...#. \.#. .# ...# .. .. .*.#.....#...  .# .... # ...#.. \*.\#..#
# **.. ..#.. # #  . * #*## .. . .\\ ....... #*...**#..** *.. .**...#\.....# ..... .....\..\....#.....\\ *.  *.......#. # ...\.. ... ..**...*  .##.# .#
#.......#.\\ .... ...*..**...*...* .. .# #.. \.......#**..* .. *. ...#. ...*...*.#* ..*.#.. ..\ ..*...#. .*.\.#.....#* . #.#\...  ...\.**#.\ #*  ....#
#... #..... . #R...\..#.**.*.. .*. *.\ ....* .#... ..*...*..... ..*  \.*..*  *...#...*\.\.\*...##  *..#..*.... *##... ..*..#..#.* .# .#.\. .....# .*.#
# .....\ ...  ..#  \.\..* #.   \.#\..... ..*\*.#..*#.#.. #....*### * ...\... \ ... ..*.* #. ......\.*\.#.#  #   .*. . *  *  . ..\*#  \ ...*# ......#.#
#...* .#.*...........*#....*.#.....*.....*.  # .. ..*\......* ## ......\*.* *..* .*# ..* \  *   .# # .. .  *. .# \....**.....# .... # .. .. * ......*#
#. ##..\..\.*.*.*.. .. .#........ .\.. .. ..#\\....*...*.. #  ..  .#.  .... ..... \#..... #.#.\.#. .....#.... .#....*..#...\*...\ ..\*...#..  ...\# .#
#  .. *. ....#\  .#..... ..*.#\ .\#. *.#**..*.*.#..#*.. *.#. *.. .* .*..   .* *...#\.  .. .#.\. ..*....* . .. # **..# .*.  . ... ... *.* ..*. ..** ..#
#....*   .*  \.... #. .\.\ #* *.*  *  ...*.#*. ...\.\\...*.. .\.#.#.*.*. ..\ .    ..#..*. ..  .............  *.# .... . *. . # ....  *#.*..#.\.*.... #
#*.... ## . .. ....*\..\.... ..... .*. *.\.. .... .*..\*.#.#..*.#..*.\.#..#.  ....\. #.*.#....#.....\..#\#..*.* ..#*.*....# .#. #...\  ..##.......#. #
#  #.  \#... #...... ..  ......#....#.*..\ . ... . .*..... . #.#..*  . .## ..*... \ . .  ..**.....#.#.. ...*... .#. ...\..#\  \##* ..#.## *... #.*..*#
#. ... .....*...... *..*.. ..\ ..*.. ... #. *.# ... ..# #. . . * ....\ .... ......*.*  .. ..*....\#  *#....# ....*....*.*  #..*.*. . . \\.\.*  .... .#
#..**. .*\.. ..  .\ ... *..## . . #........ .#. .# ... .........\...#........#....# *.. ..*....* .* .. .#....# ..#*....\ ....#............ .*..#\#. ##
#\..#. .#\.. #   .*  . ... . . . .****.. *. ...\ .  . ... ..  ....#. *. ....\\*.  \# .. .  ....# ....\.......#  .\......#*.\ ..*.*..\\ ..*. .*.. * *.#
#    ... .......*.....\ *.. .. .#.\  .  .. ..#  . ...##*  ... .\... *. ..**##.*.. . .   ...\...# .  ..#.. .. . .\.*..... #  .. *..#.# ....#. #...\...#
#... .. *\ *. .. *#\..  . ##. . . .... ..# *..#### ...*...*..\..*. . .*.....**#.\#. . ..#. .\.....*..**...#.* *... .*  .....*..##.* ........* ##.* \ #
#..**#.*.\. # \#   .# .. .\. \.* .*....\.# ##..  .\. #..# ..\.* ..\.. ...#* # .#.....#.\ .#..*... ........* ..... ... #. .* ......*.*........#.* ..**#
#.....*..*.\#.. ...#..*\.#......*..# #....#*.   ..#.*... . # ....*#.*.\*..... .... ........   .#\.*#. #*....*. *#**# . ..*\..... .  ..\*..*.. . . .  #
#*.. .. . \#. .   ...........*.\*...\....##\.... .\ .. * ....*...... ...   .....#.  #*..*.  *.*.. ....  ..#. \   *.* *. *......#. ..*..##..  .....#..#
# #\#..*# \..... ..\*.*#... .....    ......\...\..*#.\#.. .. . *.\.#.* ... ...*. *..*  ...*  .... ..\.*.\ .*#  .. ....##..*..   .\.*...\ .#.. .#.. ..#
##*. #.\ *..\...#.. #.\*..*..**.* .. .... . . *\..  ..*. ......\. ..  ..*..   * #..# .# ... .*#\.*. .*... ....  ..*# *.*#.. .. ..*..*. ....   #.. #. #
#\*.........  #*  .   \.#... ...  .. \\.#..#*# .#.#..\.... .\..... .*...*..   .....    #. *... .*\ . *...*\.*  ..# *. #..\..** # #\.*..##\..*.... ..*#
#...... ..\..#* *##.... . ..  #.... \. .#*...##.*.. #....#...  #. ** ....   ..*...#. .\ .. .*.... \.. #\. . ...\ ..*\.... ..\.... .... ......*.*.... #
#..*\ ....\..\.... ........#*. \#........# \.* *...* .... .  .........#....#.#\.. . ..#\... ....   .# #.\ *.\. #. .*  ..\*..*.#* . \\*  #\.*  \.....\#
#***.*.#.. *.  ..#.*.  .\#*. *..  *.# \..*.. ...  #. .\.\.\**... .. #...  .*  * .*..\*..*.\ ..\*...\..*##...  ..*.....*...*....\... .#..  .... \. .*.#
#..*. .*........  ...*.. . .#..\*\#*..#. #.#*\.. *.\...#. ..# #*  .\ #..*.... #.#..#..**.# \\*.  ...  #.*....*. ..*\ .*  . ....** ..#.**.  #*....... #
#.*.. * .  .#..*\.#.#..   ...*.. ..#... ..  .\...\** .. \...  .##. .*..#.* \......##*  ....*.#..  \.*.*.. ...# . #.  \* \#..... .*   . **. ..#...# .##
#...*.#.\ #  .. ....**#.#\*#..... .# .#. \ .\.... *#  .#. ..* .*# .\. ...\..#....*...  ..**..#..** ....  .... #\....#..*.. * *.*.* ...... .......... #
# .  .#...* ...* \ ...... #.... * ............\.  .#  .#*.  .*.\.#.. .*. .*\ .. **#.#* *.# ...*. ..\ **... #. .*.....##.. #\#. .  .. . .. ..... .. ..#
#...# #.\.... .\.  .#.. .... .\....#**.## .*...#.. .#......  ..  . **.. ..\*..........*#..*.*... ...*#  ** ... #\.\#*. .. #... . #.....*.#. ...  #..*#
## ...#..  .*#..\*..#* ..... # .**   . *.**...*...\....*. ..... # . *\....# ...\.#...*..*. \** .*. .*  ###........ . .. .. . .. *.\* ..\\ ..\\.\ .*..#
#.##*.\...*.*.\. ...#...#...*.*..*.\ .. .\*..* ..**.\..#.#.. .. ....* ..#\*..* \...*    .*...*...#\ ..*.#. #.#. .. ......#.. *..\ . .... #..\\ .....##
#......*#.*.\*\..#..*.. *.##.. *... ..**.*..*... ..*. ..*...  *   .#..*##.....** \.. ....  ...# \ *.\... ..  #... .  *.*..**.......\.#..# .. .. *....#
#*... ..#.*..*.*..... \.\.. .##*  * ..# \.#. \.\*..  .*..#.* . .*\\.  .*..* .....#\.........* .. #  ..#.*#...\...\.. ...  \ \.......#. ..\.#..*.#.. .#
# ...#.....##..#*.**. # .*. ...\*..##.# *#.\#....* *.. .*.*. #\#.**.#.....# #\*...  .# .. \.*. *...#.* . ..#\..\ .*#..#.**.....*..*...#... ..... .#..#
#....# # *\... . .  ..**## ....###..#....*\. ...  ... . ..* .*\.* # ## .  #....\..*.#. .....*#.\.. . *.\    . ... ...  ..#.  ..  . .\...... ..**.. ..#
#..*...\#......... . #..\. ...#..*\#\  . ....#.....\.\..\...  ..*  #* #. . .##..\#..\.  .#.. .....#......*  .. .\.\  .......\.. .#..*..  .*. .#**....#
#........... \*.. .*..\..  ...# ......# .*. .. *... .... .**.. \ *.#...... .... #*   .*....##.. #. .\\ #..* .... .*#.*..##.. . ...\*. ...*. .. . ....#
#...... # *..*#...*.. ..# ##* .. .# \ *..\. .. ....#..*.#.. **.... .**...# . * . *\*.. .. ##.. . *......#*\.*#.  .... . .\*..... #... . .. .\.*...*.##
#.** ..* \.......* ...*..#..#.#.. ..#...#.  #.....*...... ...\..#.. \\. * .#*. . \. . ....  ...*#.... ..#   ##  . . #. *...*....... .#....* \. *#..#.#
#...  .##*...* .*.#.... .. .. *... #. ..\\ ..... . .....  . . **.\..  .\ . . ......*.\#.  .  ...\*...... \**...# *# **...  #\*... .* ..*.## * ...#...#
#......\. .\....*...... #.. ... .#.....   . .*.. .##\.\.#  .*.\*.*.# ..*.*\...#*.# ..**. ... ..#.*.* ..\* .\#**. ..\....#.#*\ ..#...**..#\.*. ..\..\.#
#. .... ...... ....#......*.... .\.\ . \ ...\ .#*.....\.\.. .....#.#..........* .#.. .\...##...  ....*.... . ....  ..   ... .* ....#..*...* ...... .*#
#...# *. .... ..#.......*.......* .**....**.  #.* \.#.. ... ......*....\.... \.... ..#  #....  ...... .*#. ... .. ...\.* ..  .....\*..  \\ .#...# .\.#
#...*.# .* *.**..#*.*...*.... ..* #\... *.#. ....* # ..\*..*..# ..#...\...*. ..*#  . \..#\.#...##...\ ..#.\#\#........   . *\... ..*...*#.. *. ... ..#
#* \.#.... *.*..* # \.*..##...#..\ . *.*.\.....#....*..\. . .*.*..#..* .. .\ ...   . ... *..#..... #.\.....*....   .. .. ...#\\. .*.....*.....#...*. #
## ###  # .* .*.# .. #.  *  ...........*. ......  ...*..*..#\... .* \..**.... ... .\ # #.*.** \.. \  ...    . ..*\..\...*.#* .*\..#  .... ..#  ...*..#
#..## . ..... . ....   *.. *... . .. ...* . ..*...\*.#.  .*... .* ..\..# ..  #....... ...  ..  ..* *#*... . ..  *. ...#.*.....#.\..... . .  .\\\*..#.#
#..*.*.*.  ....#... .\..*  .\*#.  .#...*....###..*..*..*.\\...........*  ..#*.\.  ...##... *#..*#  ...\..#*.\\#   ..\ . .*. ...  #. #.\. \ ..#.**..# #
#.\  . .........#... .##. ....#...#. .\ . . . #.. ## .*.*\   #.#*.. ....**...... ..  .\. .....\.. . ..  . *##....... ....#.......  \#.*..# \# *.\.. ##
#.*.*.*  ..#. .\*...#.  .\..  .. .....#.....* . .....\.\#...#.*.....#. .\ .#..#.....* .. ..*..  *... ...*.. #....#*.*..*.*..  .#.\.*.#.....*.. ...\.*#
#.  . .*. . #...... \\##.   *#\. \\..*\#.#.**....\..... #.....*......\# . . .#*.#.. .*# .  .*... **#  .  *... * .....* # .\..##.....\...... .\ ... ..#
#.  \ ...\ *..*.# . *\ ..  ..**.* ........ **.##....*.#.....#. *... .. *\..*...*... . ......****.\.\. ..*..\..........# ..#.  .** *.# # . ... . .*...#
#* ..*\....  .#..*...**.*. #.....*.. ....*   # \. * #. .. .**. \#\..\ .\....\. . ... .#.*.#..*  *. . #.\.* #..#.#.*..*. * ....... #... * ..*..*.*....#
#.. .....** .#*#.*.. . .#\. .\. .\.\ ... .*#*. .\.. ..###*..#......* ..\. ..#####.*#......\.  .\...# .. ...*...##.  .\# *.. \.. ..  ..#..#.\... *. ..#
#* #......*. .. ......*.# *#..#  .. .*#\ #* \. .*. .\\# #** #.#.\... .*....**. .\. # . #.........#\* .. . #...\  .. *.... .*** ...* *.*.\........*. *#
#..#... .#..... . .#.....#....... ....# .** .#* . #...*..#....\#. ..#............\....*...#*.    #\...  ..*..#.#.    ..*........# ...\.*#...  *#..*..#
#*.#.... .. ..*.......** ... *.# *.*...#  \.#.......#.. #.\\.#..\ ....#.\...*.##...*#. .**...*. *.#* ..*# ....* *.#. ..* ..........**.......  #...*#.#
#*... ......#.....\......*  ... .*.. ...#.*..# *#. .*... .#.*.  .*.... .\\ #*. .*..  .. ..#.\ ..##..* .#....#*................#.... ...* .....#.#..# #
#*. . *\  .. ..\. ..  ....\..  .*..*..#.. .*.......... ...#. . ....*. *..#** ..\..#....*  #.*.. \.#*..*.* .....#... #. .... ..... . ..#.....*.\*.* .##
#.* ..\.# ........\ . .............#.\#....\ .*  *. \ .\ #.*\.#..#..*\ ... #.. .. .*.**. \.....#**\..  ...# \#..\#.... # ...    ..** ....*.......#...#
# \.... \..* . .#.. \.. ...  *..\...\..\  ...#..* *  ...*.#.. .  #*...#  #. ......# .#  ...  ...#*\ .#.....#.**..*.. *. .#.. *\... \ . ... **.. ..*.\#
######################################################################################################################################################