############################################################################################################L#########################################
#.. .. . ....*...*. .# ...##......*......*....*....# .\.. .#. .. .#..*.... ... ...*#.. *...# .... .    .#.....  ..\ # ... . *#.....\........ *.##  .##
####.* . ... *....... .#. ... .. *    #  ..   . *.. ..# #.  \# * ........ #.* *.......... #***# *..#.. ...... \ \..*...* #... .  *.*....*..... .. .*.#
#*.. . ...\. ##*..*.**... * .....   .\*. .. ##.*.....   *.. .....#.. .. .\.. #.....#\.*. . . \\ *. ..#. .. ...#..*#.*.   *...\..\#.*...#... . ......*#
#*..#.# . ...  .#..##  #.*. \\.\.. .  .. .*.... #* ....*\* .#.*..\..... ....  ....*.. ... .#...... ..*#\*.   . #..## .. ....... *  . .... .. ..... ..#
# #*.# ...*  ..* .. ... *.......#. .. ..#. #*\. ..\...... #... #\.......*. ..*#*. .. \. ......*\..##... #*...*#... \ \..*..#..*...#.**. . * ....*.. .#
#.# ..*.. *.#. ..# # .*\#...\\. *\. \ ..\. #\.# ....... .*#... ..# \#.*..  #. ...* .\#\.*.. *.. #.. .*\... *.. .*.... \.# ...  #..\.## ..... #.. \.#.#
#\*# .*.. .....* #*..##...  . ...\......*..\#*. #. .* *#....\. ... . .*# . .. ..  . #.\*  ..#..#. . .. .\ ##  *.**.. ..#....\..# #*. .\\...#. . * ..##
# .. #.#. . .. ...*.... ........# #...\. ..#* *.*#  . ......*..*. #.#. .#.. .##......\#.#...#.##\ .\..#\..#.# ...*#.  *.*..*.  *.*# .* ...\..... .\. #
#.##... . * . # .... #. * \#.#*. ...*. .#.*...** **#....*#.##*  *.#.... \* #.\  \. \ . . # .*..... #. .*.... #. .#.. \.. ...  .... ..*.. *.. ..\..#..#
#...#.#  #\ **. \.. .*....##\. ..#.\*...**.* .   ........  *. *#*... . . ...*.  #. * ...#...#.#.\..* *.** .. .*....*##.. .#. ...* *.*.....*....... .\#
# . *  . ....  . ..... .##...* ... .*\ \... . .\. ....... ...**....... ..#\.#.#...#..#....*\*.* ...\\\.*.  . . #*..#. ..... .\*#.. *.... #*.... ....\#
##* .. \.#.\....*.\..  .. ..* ##. ..# .....#. . ..*....# . .. *#..#.. *. .*. .. .*.. ..\... .*.*#..#\   .   *. ..#.*.##..##..  #... .. #\ \\..*......#
#..# ..#.. .# .* *  .##\. ..*\ .*\ ......... #\ * .. ...#...\#... ..   ..*. .\. #....  ...##.   ..#.......  #.. ........*.* .#.. .*.. ..*.#... .*.#.\#
#.. ....... #\....* # .***.#.  .\ .. ..*.##...... .... . .. #....  ......#...*. #.... ..**. . *...**.... .  *.\.......... .#.... . #.\  .# . #. . .. #
##* *#\.*.#. .\\**.#. .. ..# .**.\.....## . .. .#..* ..#...#...\. ... ...\. *. #..* .. . ...*****. ..#.....**.. #. . .. .\\...#.*    #****..\.. ....##
#.* ...#.*... *. . ...... *#. ..#.  ..  ..*##.#. .#. ..# \*. ..*..... #...\.......#.*  .*... ... ...# . . .*.. .......\#..* ... ..*.. *..#\*...... .*#
#.**.\ .. .. *#. #.....*.*...\ .\.#..\.#..*. .  .*..... \*.#...... .... \\.....***##..*#*#..*\..... .#..   #.*..  ..*.#\..\... ..\.. ..  *#..** . ...#
#*.\. ....*#........ *..# ##.#.#  \. *.... #...*..  .. *..#... \.\#    . ........ \#..*... .\.... ...#..*.\ *. ...*.... .##\.. \*# . ... .*. .*.\# .##
#.*..... ..... . \ ....  ...*#....*..#...... .. .... .\ ..#.*#..# \\ *.# #..\. .* .*\# . \.#....\#...\ #... ..#\ ..*. ..*.....#..\.#.#...*.*....#.**##
#.\..\ ....  .* .. ..*..  ..*.. \. ..##*....  .# ...   .. .#. ....\.*.*\...*#.... ........ \\\*.. ..\....#\....#*\.. .*  *...... ...#*...#***.. ...#*#
#..#**#...* ##..#. .\ #..*. *  \\...#.\ ... ##.........*. *.  .\ ......#. .. .**.. .     ... ..*.......#.# . .. .*..........*.....* #........ #. #..\#
# ..  \.# .#\.... ..##.#...*.  *#. . ..#.*\ .  \..#.\*#.  .#.# ......   . #.......*\ \.* #..*.  #\......*# . .*.. ..*# *... ... #   . *. .\..  * ##..#
#...*... ..#..*....*.. .. . . *...\.*  .... *#.. .* .*.. \...\#..\. .... \  \... \  ...# ..... *.  .  *.....*..  . . \ .*.#*.#. . ...*..* \#*. . ... #
#. .\*#..#.#..#\...* \  ...  #..\..#.  \.*\.# .\....\...*.. *...#...##. \.  .\.... .* . . ..*....* .. .*#\..#.  ......\#*. . .. ...*..*... \.#.#.. *\#
#..  . ...* .... .......  ..*. ..\...    *.*\..*.... \.**#..  .#.\..... ## .....##....*# ...\....*....\ *.*... ....\. .....  \* . .. ##.  ..# *#.\..\#
##. .. .....* *# .*...#.. #  .  ..*.# .. # .. .\.. ..  ....\..\*...#**#. ..*\#..... . ..*.*. *..... .   . ....*....#. ...  . #. *.. ..* .* ...\.. .*.#
#*..*..#.#*...... #**. .  ..*  . #..#......#.#.. .... ....  #.. \.#\# .#......*.....#\...#.. *.. .. .. . ##. *. . \..# .#....#. .. .* ..*...#.*..*...#
#....... ..###.*..#\.. ..# ..  . #.....**..*...*.. ... #....#\.. .**.... .. .*.. ..* .....\.#      ....*... ... .. ....*  .#\#...**..# ..\#.....*..  #
##*\. *\.........\ #. *.#.......## ..#* *. * ..... ..#..  ...#.....*.*#\*.*..\*...#....\# *#\. .... .#  *..  # .* .*.*#...*#..... ##....  .....  * . #
# .......#..#..\ .. .#.*......*.#.*#\. ..\ . ...*.\#..# ..  .\...... . . .. . .. \.*.*#..#.*....#..  . **.#\.. .... #.*#..\.*.. ..... . .#.  \.. .. .#
#.*...#*...*.*.#....#..... #..... ..*.#. . ..#...# .#.\# .*..  *#... .\.. #..*..#.\  . .. .###......##.*..# . .*..*    .\#....#***#\.#....**\.\.. ...#
# * ..#...  .*#..# \# ..*  \... . .\... * . #.#...#..#....##. ...  ##.   **.....#\. ...\. ....#.*. *   .... #.  \ ...  ..  ..\.. ..#......  ...... #.#
#. .. .*  ... . .*\.# .**.. ........ .... #.....\.*. . .*..# .\ .*....  .*.. #....#*# \... .*. \...*.#  ... ...........\.##  #..#....*  . .....* \...#
# ....**....\* .*..   #..  \... ..*\\. .. .... #*..# . . ..*...  ###   .. .........* . .#*..* . .. .  ...#. #.*#.. .. ....* . . .\\* .\#. *.....* .#.#
# ....*.  ... ..##\#..\ ... ..#.#... .*..#\..*\....* ...\ ... ..#....*.   .... #.#.*..# .. *### . .#    #*  #.......##...#....*.\ . \*.# ... .*. #.*.#
#.*   .#  #.*.. ....#.......##..*..\..... ..  .... ...  ..... ...#**......#. ... \ .***   ..**.*  .*.. .. ...#\..... \#... ..** .. .#.**. ....... ...#
#.*..  ..\.  ..\..*#.*...\. \.\.....* ... ..\.#.\..... .*..#  ..*.*.. ..\ *\.**  ..\. \*. .#. .. ..*. .. . .  #..*\. .\ *   ..##..#.#.....  .....#...#
## *.  #...*......\.... *.... ....*... ...*   .. ....*  .........*..*.#.*. ...*.*  .*.#.. ......*#.\#. \.... #.##. .... *\...##***\  . .\.... . # .*.#
#*.. ....* #... #.*.# *.  .#...#.#......   .#* ..*. .... #. .*.\*. ..... . . ...\.* ........... #.. * .. *.\..*#...\.    * # .*. *... ...*\. .#...  .#
#.*.#. * #....*# .. ..  ..###.*.  ....*#.. * ##*.. **  ..\*.....*.* . ...... .# .. #.. . ..... .. *. * ..#. \.....*#. . .*.. .\.*..*.*  .*\..\#......#
# \......*...*.* ..... . .  ....*... ..*#.** .##. ..... .   .....##\.....*#..*#..* ...* . ....#.#..\. ..#........ .\. . ... ...# . \*.... *.. #.*....#
#.*......*.  .* .**.*.# #\.... ** ..#\.#. .........  ...#. *..#.*...*\*..\.  * ...#.*\..#\.#...*. ..#. ** .. #.\ ....\\.*. . .  .* \*.*..  \..#.. #*.#
#.  .\.. ..  ..*. ** ..*.#.. #.....#. .....  ..#..* ##.\.* .\.. * *... .. . ..... .** ....... ....* .\..\*\..#..# #    \. . ....... .#. .  .\\\\##.. #
#.#.# ....#  *# ....**... \\......* ..*# *.* . .#..\*...\... .. ..  *.# ..#\. #* .#*   .# .\.\ #. ..*.. #. *....*.\#...#* .. .#..*\ ... *\ .* .... ..#
#...#*.......#. .#.#..*..** ..* .....\\....... .. .*. .*......#.. .#\... *...#***. * .*.#  .....**.*....... .#\. #..# *.*\ . .....*....#.   #.....*. #
##\.#... . ... .  ..#.....  *.. *...#.\*\......#.#*...  #\. .....\.. .. .. .... ..\.  ....*#*.... .**. *. .# .*. . #.. ....*...*#..*#.....*.... ... .#
#. ....... #*. ##.*. \... .\ . ....*##... ....## .    # .#\ ... .. .*#.... .. . .*#* .#*..\....... .#........  . ....\\\..*...\..#.. #*..#...\#... ..#
# #..# . ..#***** ..\. .. .\#..  .#..*.\..#*..... . .#...\#.\.  ........#..   *...........  ##... \....* ..#  ..*.#  #.... * ## #* ...*  . ....\.. .*#
#* . . \... .**. ...\.\.*. . .*... ... . .. *#\ .....  .. . #*..#*...##.##.##.*#.*.. . **  \#..*... ...\.....  ..\  ..*. ##. ..#*... .* .... ..#*..*.#
#. ....#...# \ \* .. ...*.. ..*..*  .  .  .#*.. .\..* .\..*. .*#*... *..* * ....#..*#....\. # ..*...#.#... . *.*\..# *. *.. .. .#..\#\\#... .. .*.**.#
##.  #..# . \.* ..*. ..# .#..**  *# .**. *.....#.*.*... .. ...  .#.. ...#.*.... *#.*.*.... .#..*....*..*..#...\...... ..*.** ....* \...... *..#*.*...#
#.#... *. ...*.##.. ..#..#.\.#.# .. ...\... .. .... .   .*#.*.#* .\* ..   .. .. *... ..*\... ..\ ....\... .* ..#\.  ..#..* \ *.........*#.#### # ...\#
#. ...#...#\ #. * ..  ...*##.#.#  ..... .*....#. .\..*.#.. . ..*\.\..#....* .*...  ..*.  ...   . . #.....*........ *...##\. .*...#.#.#..\..\...... ..#
#........\#.... . .. . .*.*. ...... ... * ....* . . #..\..*..*\* . *....#   *\ ..#**\\.....*#. ..*..#.  .. ..*..#* .\*.. . ....#..*..*.. . .... ** *.#
#*# .....  .... .....#.**.*.\...#..*...#\ .....#..\\.#. ..\   ...\.*.\...  .#.... .\. .*..#*...*...... .#  .* ....\# . ....... . ... ...#.. ....#..*.#
#.*#..... \ .....##....\ . .. ....# .*.... . .. .*.\.....  .*#.. # .*.  .. #.*.....**.. *... . \...#* . .. .....\*..\*   *.*  # .. . .....*... .... ##
# .\ **\#... ..*.*......#.....##......#\.#...\*....*. # *....# .*#....*. *.#. .*#. *  ..\..*....... .#*.#... .. #.. ...  .*. .##...#*..# ....\. ..*. #
#.. ..##.. *....\.. ...\*..*#.....\## . ...*\.#.\...*...\.*\#* ...# . ...   .* ..#....  .\......#\.. .*..*.#. .#.#. ...\. .#  .*..*..... \* ....#..*.#
##...  ...  ......\........*.***  . ..*...*# * *.... .#.... *. #.. .#\\*\.*.... ** ......  ...*. ..** .. .*\. **.\.\..**..... ....\. ..  *.. ..#.   .#
#.#. ..  #  . #  #..\..  .\#\....#.\.*.  ##.. .......*. ....#* .  . .. *  .. #.#.\....*..*...\#..*.. .\. .. #.......*.  ..* ...    #. .... .... #... #
#..*....# .\.  .....*...# .. . .\...  .*...... .  .* .#.... *...**....*.#\ #. .............. \.. ..\\. ....#.*** .\.#  ..#.... . . **..#*. .*# . . * #
#....   #.#... ...... ..*..... . .   ... ... ....#..... ....* \\ #\........ ##...  . ...*#*#...\. .....#.\..#.* #.*. ...*....... .. . . .*.. . .. . .#
##..... .#....#. .*... ......#.#.*...\.. #. .*. * ....#.....#...\* ....... .  .#. .. .*\....\...\....#\*  . .. .. . *#...#. ..... .*..  ..  \....#...#
#.....*..    ...#  #.*... #.. # .. . .*..*..\....... ...#. .*.  #*.#*   .*.\#. .... ..\..  *..#.*.....  ..#\#.  .* ..\ # .* .. . . #*..#*... \..#* ..#
# . \..#  ....# \*.* ..#* . . \.#.....*. ..#.\ ......  .#........#\. ...* ...*......*. .. .  .. .#.\# .. #.#...** ...*  .# . * ....*...# .* ... ##..\#
#.. .**#**.*......#.#.#..#.*........#.. ..\.. #...\ .. #. * #.. .**.*.. *.*.#*. . ..*.#. #* ..#....#.........   .*.#  ....#.# *  \.. #.....#.. ....  #
#.# .###..  ...#.  . ... ....##. **\*.*...  #...##\ * ..#. . .#.. ##...*...\ ...... ...#....*  .##.#. \#..... ..  *...... *.#.\*.*#*.*. .#.... ..\.#.#
#..**... ...*.*    ..#\. ......*..\ ..  .\ ..  ..    ..#\.#.\..#.*...*. .. #....*.\* . .... ... #. . ... ....*.   ..... .#  # ..*. .* *..\ ....... \.#
#.#\....\.*#*.* ..*# ..\*.... .  ..... . ....\*##*.. .*.\ ..  . .*# .....*... ....\.\..*#..  ..... ......#.  .... #.# ....*....   .\...*..**.*# ..*..#
#.. . #.. ##* . ....... ..#*..  . . ..... ...... #.  \...*.**.....#.  ... #* ..#.#.  . *#*.# . * .... ..**.....* ..##..  ....  .*#. ..*.  *.... ... .#
#.... **\..*....   ..#...\ ..... ...\ ...# \ .....#.*.... .....\. ... *...*....**.. ........ . *....*\#...... .. .#.\..  ***  #...#....#..#.* .*.. . #
#. # #. #..#.\.* ..  # .. .  .#.... \** ..#*\ . .. ... .#  ..*.  ..  . .**......*.*...#..\..#...  ....# .... ...#.\\... #....   . . .* ..\*.\#... *..#
#.#. .*. #.\*. ..# ..  ..*. ..*.. .. .. . ..* .#  ##... . . ........*\#.. .\#..... .........#..#*#.* \. .## .... .#  .  ..*  \#...*......##.*. ...  .#
#.......\ .*. #. ...*#.#..\\ ....*  ..*...#. *. ..\* #.#..#......*.# . ...... .**#*.....\....*. ......... .\. .*.\#.... ...#........*........*... .. #
#.*.#    ..  #*   ..  .  .. .. .#\.\ .*.*\.. ..##.*  .  \*.... .... ..... .... .. ...\ .. ... #.#.*#..*.. .. .  # \ #* . .. **..  * .... ##..# .*.#..#
#. .#.. *\*\..*.#.... ....  ..*....... ...  ###. ..#..#.##.**\..# *.. .*.. .  *.**#\.. .. .*..##   ....# * ..  ... .# ... .**#**\....  .\ #.# . .... #
#.*#*\..... ...... ..\.  . .#. .  .. #\  . ...# . ...#...#..#*** ..\.. ...  .. .##... .*.*. .\ ..# .## ..# ..*\....*..*.# ..#..\#.... .*.** .*\   #..#
# ...... .  . ...\.\ \..  \  ##..#.....\.......*..##....#*.###..\ ....... #.......*. #.. .#\.. ..#.#..... .. * ...\.. .. ........*.\\.  ...........*.#
#... # .#\*# ..\ *  #. #.....*. #. ..#..*  ....#.#..\.\\... ...#.....# ..#...#.  *#*  ...*. ..   . **..# . ... ..... #* #\ .*.. \.*...#. .*#. ..*.#* #
# *.. .**. . . ..\......  . ..\.*.. ..   ..#  . . .*..\..*. *\.## .\..  . .*#..#.*#...\...\..** ##.**...*. . #...  #.*...   . *..... .#..*... ..  *.*#
#*#.*#. ...* .   #... . .  #... #*.\#\...... \ #.. \#...**\#.. .\..#\#..\ \*#...#.\........ .* ... ... ..#  ...\ .\... ..\*. #...# \.. *...*....*#...#
#..... .. ..\*  .....*# .. ....*..#***...*** ... .....*.*##. ... .. ......* ..*...  ... .#.  .*. *... *... . ..\.\. *.  ... .*\** . ....... ..... .###
#..*.#...\..*#... .#* .*.*..*.... **.  .......#.*.* .#. ...* ..#*........\..* * \ ... *....*....*.\ *.\..*.* ...... #. ....*. # . .. ... . . *..* . .#
##  . # . #.....   . \. .. *#... \...\ .#.  #*..#.......#...\.... ..\ ...# .... ..*\..#.\.. .  \*.. \ #...#*. #...... #*.*... ...... *..*# .\. \.....#
#. #*  .* .. ...*. .. . *.*..... *..# *....*.##.\ *..* ...#.. ......*...\ \\.\.....#.*....  ....\ ....... .* #..*.#.. #. ..*.. ..\.......... ..#... .#
#*#.. . #. .. ............  . #*..\*. .... . *.#.. ...\ #......\#. .#* ..  . .# ...#.... ...#..  . .* .*#.#*#*......\..  #.*.#.*..  \...... ..  .... #
#*  .. ... *\  .# * ......... .  .*. ........\. # ......  ....\...  . \#**.\.  *.  ..*...*. ...*  .*.## \## .  ..#.. *.. .\. .\..#..##...\... ##*#. .#
##....##.*.**..#. .. .... . \ .#... .#\...# .   \..#.###..  #.**. # .....*... ...*... ..\......  ......\...# ... #....  \.\....#\* ...#\.#... . *..*.#
#...\..*..*..#*.#.. ##.....****..#.# . .#...*#..\ .*#.   *.... .. ..* * . .*...  ....#...* ... .. . ... ....#..*.  .. #.*  *.  #.*.*.#.... .* ### ..*#
##.#.. \.\.. ...\  .#\.#....# ......*.........  ..... ##. .. .........   . #.....*.*.  \ ..... ...*..... ..**.# .\#.\#.\.\......\. ...\*#*#... #...#.#
#*#....# ..\.  ... .. . ** #.. . *......*#*.*..#..... ....* . ...* ...  . *..   . ##.#   ..#* ..\# ## .... \.\...  . \  \.......**..**.* .* #  *.*.*.#
## #**. .* ..\....##... * . . *#**...#...*.# .**... ...* #.... .#....*..*.#. \ ..\\.. \. ... .  #. ..   # . ..... ..#..#*   .. .....#...\...*.#  .#..#
#*. #..*.... *.#\.... .#..  .... . ...#.. .\# . #.#*.. #..*.....  ... *......*.#. ... .. \  .  # .# .\. ............#    . .*.. ..  . .#  .##.... .*##
#.... ...#*.\. .*#* .....\..\. #.. .......#..\.........**......\...*##. ..# *....#.#.. ..*#. .*. ....#*.*.\..#.....   .. .... #....  ... .#.\..*.\ # #
#..*  ..\.. ...* . .... .. ....... ... . . .. .. ... ...*...# .#...   . \ .**..\*## .. #. ......\\*.* .*. # .......... ##\ \*##  *.. ..#........... .#
#...*....  ....... * ..\#.... # ....#... .#...  #\... # .. #*.*...  .*...\.\# * ...  \ ..*..*  ###. .#.# *.#  ....#....*.  . ......#.. #*...#...#\ # #
#..\ #..*....#...*.# .#......*..#....\.  ... ....   . ..#*...\#...\* *..#.*... . * .. .  .#*. ...# .*  .# ...\*. ..##.#......... ..**....**.#. \ .*..#
#.#... *..*..... .. . .**  ...... .*.#.##..\  ..#.*.#.......  .#* ...#...#.  # .##.\..* ..#  .....*.. . *..*.#* .#   .......* ... ...*.  ..\. ..#.   #
#..*.#.\ ..##. . \#.....  .. ..#. .*.... ...\... ......#...**.......\*..* ####..#. **..... . ...# .........\.\.. . ..*. #*.*...*.. ..#. ..*\...... ..#
# ....*\**.#. * .  *... .......\...*. .# ## ..**. ... ..#..*...# .#..#\.#..#...#.##. . ..**.. . ...#..  ....*... \.....#.. .*. .\*. .*.#...*\*..#*...#
#*\..# .#.. .* ...... *..\.. . .... *#.....#. * * . ....#.# .# #*   #..#.\...**#... ..\..#. ....#\.\.....#*. .* #.\#\. .  . .. ..  #\# ....# *.*... .#
#.*..#. * #.*.\.. ..#  ..**.#.*. ...... #..*#  ..\ .... ... ##. .\... *.... .#...*. .....#\.\## #..*. *#\.........\. . # \# \   .\.*#.\.#..... *  ..*#
#...#... ...# ....\.. . ..* .#.*.. ..#.... .# . .....#.#.. .#.\ .#\*.....* ...# \..   * * ..  #...#.* .# #...* .. ... . ...*...#...\...\......*..*##.#
#.. .. .#.##*... ....  \...\. # ..  . . \# .......... *.. ..#..... .\...  ..#.#...**. .. ...   . #\*.....  #..**R .###.  .*. ...  *#.\...*\..........#
##  #..#..* *  ...#..#.*#. ...*. ..*.  . . .. .. #.. . \.. # .. ..\.#..* ##**  .## \  *#\* ... *.*..#..#.* #. ....\......  #. .* ...#* #\...\.*.** . #
#.....\.   .*...\..##\.# . ..#...*#.#..**#.**.  *# . ... *  *#...#*..*.    .....  ...*#. ... ..#. ..*.#.**...#*\##. #.#.. *\..#.*\#...  ... ....# **##
#..#...*... #.  .. .\........ .#*  .*. *...* .. .....  .###*  ...#..  .. #......#.*....*.#...#. ..*.. ..*.....\. . .*.\#. ....\.#.. \. **\.* .**  ...#
#*. ..* *.\*....\ *.*.\...\......*.\* ...* ..#. . ... ..*. .. \ .# . ..\*#..\.....*. ..*......*. * .\.. ..#. .. . *. . . .* .\#....## \.*....*.. . .*#
#.#. #\ *..#.##  . .* .# *# ....*#\.\ .....*...* . *...... .. **..  #...# . ...*.. .* ##.. ....*..*...\..*..* . .##.#..#\ .* *#.#\. ... .# .#  .\.\..#
#.. .. ...#*.*....# *.....   #.. .\....#..*......#.\..* \...*.......##. .. . ........\. *..# .#...  *....... #...\.  *.* . ....#   ....#... ..... # *#
#..*#.. .... .\.*..\..\.. .\#.. .* #..\......#.#.....\.*.#.... .#  \#  . #*.#*. .    ..#  *.# ..\.#.. ...\  ....  #.# .. .. .\..*\..# .*.......*.*.#*#
#.....\..  ...*#* # ...#. ..#...* .*.....#.. *#.*... \.....##........\  .....* ..# ..*... .\.* *...#... *. ...*... .*..##..  .*.*#*.#.... .\#. ...#. #
# # .. #. ... .#*#.. #..#.# ...#.. .  #.  . .  .  *.. #. *....\.   *.. . ... .  .. .* .... *. ........#. #\ *. ..\.*...\\. # .... ... ..  *  . .#....#
##.#...\. \. ... #. ..#\......*. .  .*#. .\..  *. .. .#. \ ##  .#. **\##.....#..#*  *.#.*....  .*. . *... \*......# .... #..##... . .. ..  . ..  .. \#
#....\..... .. ..#\*.  . .#..\..  ... ..  . *\.#\.. * *.   *  ... ... #...*.. # . ..*.*...# . \......*... \ * . . \.#.. #...#..*....*#*.#..*...##....#
# ..#.. ... . .###. *  . .  ...\#.. ..... ... .\ * ......#  .. * ... . *...#.  ...  . ..##. .*\. .  .\ #...  *....* \. .#. .. . ..#..\. ##.. .*.*#.  #
#...#... #. . ...#.\.*.. ... ....... .#.*.*\**.. .#*..  . *. ..#.. .*. ..#. .\. ..... #*#* .*..*.#\.#*... . \ *.... \#   . ..*.* *. ......*#*.  . *..#
#*..  ..*# .......\..  . ... . .*. #  . #. .. #.. ..# .. #\ .\*..  #.\ .. ....  ..*#* * *... . .... ..*..##.  *.*  \.. .\.. ...*... . ...*.  ##*.#...#
##.# ...* .\.....\..# ..  .*#\\. *.....# .*. ...#....#.... . # .*\..  . .\..#.* .#.#..*..#* .#.#. .*.\ #.##. *. .# .\#..\..#........  .*#.*...... .. #
#.\ . . \...*..\.\....#........*.. \..*..*..\....*# ..\..  ...#......*..\**#* ..\*...  \.*.*..*. ... .....* . .#*.\..*..... ..**. ....#... .. .#.....#
## #.. ..#.#.... .*\. .....* .... ..*. * \ . #.* .. ...  .#.*. # *..# .... \.*..*#. . .  #. .*.. ..  #* .  . . ....   ...*.  .* . . ..#....*\..... # #
##...#...\..... .. .#.... .........##..##.#..   *.# ..\  .  . #  *#*..* .#... *##*.*. ... \..*\.#....*..**.. * ..... .#......#. ...#\.. ..... *....#.#
#..*.. .  ... .. .*.. . * .\.\.....*. .... ..... \.....*.#....#  *#.\*. . .##**..#\........  #..#  *.  ..*  \*.... #.\ *..  .. .. #  ... ..*.#\... ..#
#. .....\\.....#.* ...  ........ .##.....\..**.*#\.#  ...\# #*.\....\.....*.#\#. .#*...\ #  .* . ....*#..#.#. . . #** #\...#.*........... .....*.#. *#
#. *..*  . ..*.\ # ......\. .* #.  .* .  ...# .* .. *..  .###. #..*....\..*..# ............* * ...\.*...#... #.*. .*..... * .. .. ..* .*# *.#.  . .* #
#\.. ..*.*.. #*\.\....\.\ ....... ........ ... ..####*....\ *..* .. *.#*. ...  ..* .*.\... .. * ..#..... ..#.* ....##*........  ..... .... .# ..# ...#
#... *. . ..    .*.....*#.*# .# # ..... .*.. .\.#.  ..*.#...... . . . .......\.*. ..* .. #* #*.\  \ .. .    #* *# .. ..#.... .  ..\.* . *..##.. # # .#
##*  \#. .   *. ... ..  . .** \. ..... .*. .* . ... #.... ... #\\#. .\.\. *.*... .\#... ...  . .. #... *. ..*.. .. ..\....*.  ..#.#\.*..... . .#..* .#
#.#.#. #.. #*.....*..#*....  #... ..... ... ...#\ .#.......\*. ... .......\##...... .*.\.#......*#.*..\.......#.\.\.#.. .  #.\.\.  #....**  . ...... #
# .   ...*. ..  ...*.#. ... ..#*....  .#.\.\*\..**.*..##..*...\*.......  .#..*....*.... .  .* #.. ...# ..*. ...........**....* .......#*.....*. \.#..#
# ..**.... ##.. ..*\\ #. ... #.#.#\ \# ... .*# .\  . . .. *#...  .. .*.. .. .........#..........#.   ..*\* .\\\..   ..*.. ..*....*..*. .# .. .#.  #.##
#.##\.#\....... . . # #..\.*... ......\#.....  #\.#....#...\   ..*.*.*.* \.#...*...*..\ . . .# *...#...*\ .. .#.#.# #..... \ .*....  .* \. ##.... .*.#
### \...\.*. *. . ..#. . .\#\.*.* ...\ *.. ...# ...* .. #.\.*.....*.*..*# .....# .#.....*.*..*.... ....# ..## . #..  #\ \...*##*#...  \ .*.*##* ...*##
#\\#. ...\...* #....*.* .### .. .#..... .#....##.#. ...... ........#..#...... . .#*  #.....  ...#..*..*.\..**.  #  .\...#.*.*.#.*.\...  .  ...#.#** ##
#.. .. ...*. ..###........\*...... .#.....# . .#.**. *    *..* ........ .... ..  .#. \.##*#. .*\... ..\#. ..  *.*.*.*.. .....\  #  .   *..#..#.. ....#
#. .#..#*.. #..   .\#.\ ..#.#.\.  *.\.... . \ .....  ..... ... .# ....* .###... ..#... ....*. .#\\..#  ....\..*..##..*.*\. ..*. # ...........# ..  . #
#*\#* .\.... .*.#......*. ...    *# .....*.   ....*. **.. ..#  *...#*   ... ... ...\.... #...* .... ...\....\#. .. #. * ...*.........# ...#.*# ..*...#
# .*\...**..#\..#.. .#.... .  .. ..........##.#... \\. . .# \ #... .##..*.... ...  .. # .#........**.#.*. .# #...\ . .#.. .. .........#   .....#..**.#
#.*.#.... ..#.#.   .*. # . \ . *.*.*.*. ...#  .**.. ..#. *# #......*.  ... .   * .#..* ... .. \.*....\..#..#..# ....\ ##.. ... . #. ... ..##.\  .... #
#.......#.... ...*...... .\  #..*..*.  . ..  \#.. .....**. **.#..*...*.**.#.#   .*  .. .\.......*.. ....  *......  #.# .. *.#.. . .  .. ..*..\..#....#
# .. ###.*.*..\.. . ..... .... .#*\*...  ...*.#. .  ..  ... # *. ..* . ## ...#.. ...*#**.\..** \..*\ ...... .**..\#. #  ..**... ..  \ #... .. .*..#. #
#.. ... #.. *.. *....*.\....*##...*.# .. . .. .. .... ##.. .#... .#\ #.....**. ..# ......* #..# . .... #... .. .#.*...  .#..##....  ....... #.**.#...#
#......*  .. .......*#.....*..*##. *....#..* ....# . ..#. #*.... ..#.......*.*.#.#...   . ... .. ...  .# .*.#.#..#.*#. .*.... ...*  *..... .\. #.*.. #
#...#  .# .*#.\.. ... #\..#\ #*.\*...\. . #.\#**.* .\.* . ..... . .\#. \ .# ..#.# ....#..........**#. * .. ..  ...\. * # .. *..*....\*...  #   . .# .#
#\\  . #..*  #*..... ...    #*. ...... ...* .#.#\. # ... **#. .#*........#.... .\\*  * ....*. ..  .*..#..##..#*.... ..* .##.. \... ..#.. .#*.* .. ...#
#..*...#.#*..*   #.*...*.  #..  \..#.##..  ..#...*...........#..#\..  #... .  **.\\.........#...  ... \  ..... .#... *.... *..* ...*.\.  ...\ .#\.   #
## .... . .. .. .*.  ..#..#......**...#.. . ...... ........*.*. *  ...\.*#\ .*..#...... #. ##*# .\..*...\.*.... .#........# .... .....*##.*.. .*\..#\#
##.\\.*...*# *#.\ ...*. \. .*##*..... ..#..\ . #  .#..##..# ...  .  .#....\#. .. .*..* ..........# \.. . .#.  ..#.. #.......*\* . ..*. .*.  . ..*.#*.#
######################################################################################################################################################