##L###
#. .R#
#.*#*#
#\\* #
#.#  #
######