#L####
#*#. #
#....#
#R.  #
#*.. #
######