####L#
#..R.#
# #..#
#*...#
##..##
######