######
##...L
#...R#
#..#.#
##* .#
######