####L#
# #.\#
##  ##
#...*#
#..R\#
######