#L####
#* ..#
#.R..#
#*. .#
#... #
######