###L##
##. .#
#.####
#..*##
#R\..#
######