###L##
#..**#
#R...#
#   .#
#.*..#
######