######
#.  ##
#..R*#
#....#
#\.#.#
####L#