######
#..#.#
#....#
#..R #
#....#
####L#