######
#...*#
#.. .#
#R.\\#
#... #
###L##