######
#.*#.#
#...*#
#.R*##
#.*..#
####L#