######
#.R. #
#* #.#
#..  #
#.*..#
####L#