######
#R##*#
#..* #
#.\. #
#.. ##
####L#