######
#. # #
# ..*#
####.L
#. R\#
######