######
##\.##
#*#*.#
LR*..#
#*.L.#
######