######
# ...#
L  R.#
# .  #
##* .#
######