######
L #. #
#\.R##
#...##
# *..#
######