######
#.. .#
#.*. #
#. ..#
LR.#.#
######