######
#L...#
#.##.#
#..*.L
#R.. #
######