######
##.. #
#\..R#
# ##.#
# .. L
######