######
# ..*#
#  .R#
#....#
# .#*#
####L#