######
#.R.##
#.#*\#
#.*..#
#\...#
####L#