#L####
#.* ##
# R\.#
##..\#
# ...#
######