######
#....L
#..#.#
#.R*.#
#..\.#
######