######
#*...#
#. ..#
#\\.R#
# ...#
##L###