######
#. R*#
L..*.#
#*..*#
#*.. #
######