#L####
# ..\#
#* R##
#....#
#.*..#
######