######
#R#..#
#.* *#
##..##
#.. .#
#L####