##L###
#*...#
##.#.#
#..#R#
#. * #
######