######
L....#
#....#
#... #
#\..R#
######