######
#* **#
LR...#
#....#
#*. .#
######