######
#*#..#
#...*#
###..#
L. .R#
######