######
#.. .#
#.*R #
##.* #
#...*#
###L##