######
#. ..#
# R.##
#..* L
#.. .#
######