######
#..#\#
#..R.#
#*. .#
#..* L
######