######
#.. .#
#*\#.#
#R*\.L
#... #
######