######
#*  .#
##...#
#\  .#
L R..#
######