######
#..#.#
# . .L
#* *.#
#R.. #
######