######
L..R #
#.#..#
#  # #
#  ..#
######