######
#..R.L
#. .\#
#.# *#
##..*#
######