######
##..*#
#.# *#
#. .\#
#..R.L
######