######
#**..#
LR...#
#....#
#*.###
######