######
#. .*#
##.* #
#.R *L
#.* .#
######