##L###
#*R..#
#  #.#
# .\.#
#...##
######