######
# ...#
#L...#
#.R..#
#**..#
###L##