######
#  R.#
#..#.#
#.\.##
# #\.L
######