#L####
# *# #
#.*.R#
##.\##
# ...#
######