######
#\#..#
#.R..#
#. .*#
L *..#
######