##L###
## ..#
#*...#
#\#. #
# ..R#
######