######
#R. .L
#..###
#*...#
#..#*#
######