###L##
#.R. #
#.  \#
# ...#
#.\* #
######