######
##...#
#*##.#
#\..*#
##R.##
#L####