######
L.. .#
##R#\#
# # .#
#.*..#
######