######
##...#
#.. .#
# .# #
#*.R.L
######