######
L*#\.#
#  .R#
#....#
#...*#
######