######
###\.#
## .*#
##.*.#
# ..RL
######