######
#.#..#
#.**##
#*#..#
# R..#
####L#