######
#* ..#
LR.#*#
#.#..#
#\...#
######