######
# ..R#
#.#..#
#.. .#
#.#\.#
##L###