######
#. ..#
# R..#
#..* #
#.# .#
###L##