###L##
#\...#
#.R*.#
#  #.#
##  .#
######