####L#
#  ..#
#  #.#
#.#.R#
#. . #
######