######
#\#.*L
#*.R.#
# ...#
#.. ##
######