####L#
# .\ #
#*..##
#..R.#
#.## #
######