######
# \.*#
L.\ .#
#....#
#.R..#
######