###L##
#. .R#
##...#
#. #.#
# ..*#
######