###L##
#.R\.#
#. **#
#.*.##
#..\.#
######