######
#R..*#
L..#.#
# . .#
#.#. #
######