######
#.#*.#
#\.*\L
#.* R#
#....#
######