###L##
#. .##
#\*..#
#R...#
#....#
######