######
#... #
L \..#
##.R #
#...*#
######