####L#
#..R.#
#*...#
#... #
#.#..#
######