######
#.#.RL
#.. .#
# .*.#
#. ..#
######