######
#..#.#
# ...#
#...*#
#.R..#
#L####