######
#*  .#
LR ..#
#.#\.#
#...##
######