######
#. .##
#...*#
# . .#
#R*..#
###L##