###L##
#*. .#
#... #
#....#
#.*R.#
######