##L###
#. .*#
# ...#
#....#
#.R*.#
######