######
#R.. #
# .#\#
#...*#
#.. ##
###L##