######
#.. R#
#....#
#....#
#...\#
#L####