######
# ..R#
L*...#
# \..#
# *.##
######