######
#..R\#
# ...#
#.. .#
L.#..#
######