####L#
#* .\#
#...##
#....#
# R .#
######