######
#... #
#.. ##
#\  .L
#*R* #
######