######
##...#
#.**##
#R...#
#*...#
#L####