######
# ..R#
#....#
L.\ .#
#.. .#
######