######
#. ..#
#. #.#
# #.*#
#.R..#
####L#