######
#* \L#
#.*###
LR*.##
#...\#
######