######
# \. #
#...\#
#R...L
#.\ .#
######