######
#...*#
#.R#.#
L ...#
# .#.#
######