           ######  ######    
          ##t\! T##t !\T##   
           ######  ######    
               .....         
              ##L####        
           ####WR..W####     
         ###...........##    
       ###..............##   
       #*****************##  
     ###       ***        ## 
    ##          *          ##
    #..     \\\ * \\\      ##
    ###.....\\\...\\\.....###
     ###                  ## 
      ##                 ##  
      ###..  tTTTTTT...###   
        ####..******####     
           ##########        