##########
#\\\\  **#
#    ..R.#
#\*..  \ #
#!*..   !#
# #   ####
L # ...\\#
# ...W.\\#
#     .\\#
##########