                  
                  
                  
                  
          ###     
         ##.##    
         # .####  
       ###  .###  
       #*   .  ## 
      ##*   .  .# 
 #    #.*   .  .# 
###  ##.*   .   ##
#t#  #..*  \\   .#
#\#  #..*  \\  t.#
#!# ##..*  \\  T*#
# #.#W..**  .  T*#
#T#.LR..****.  T*#
 # .#...**  .  T*#
 # .#...*  \\  T*#
#t#.#W..*  \\  T*#
# # ##..*  \\  .##
#!#  #..*   .  .# 
#\#  #..*   .  .# 
#T#  ##.*   .  ## 
###   ##*   .  #  
 #     ##   . ##  
        ##  ###   
         #####    
          ###     