#######
#***..#
#\\\..#
#**...#
#\*.*.#
#....RL
#######