             ########################
             #\.....................#
             #...........   \*......#
             #... *...... ...*......#
             #... .....*. ...\\   ..#
             #... ....... ....... ..#
    ######   #... ....\\. ....... ..#
    #\\\\#   #...\.....      ....  .#
    #....#   #......... .........\\\#
#####*########      R     ###########
#\\\***........ ..........#          
#**............ ..........#          
#\*.* ......... ..........#          
L.. .....\\.... ....\\....#          
#****.....................#          
#...............*\........#          
#.........     ...........#          
#.........................#          
###########################          