#############################
#\..........................#
#.###        ....#...###\\..#
#.#\..\\##.. ....# ..\\\*\..#
#.#....#\#.. ....# ....\*\..#
#.#....#.... ....# ..###\...#
#......####. ..... ..... ...#
#.......           ....# .\\#
#.......## \*..... .#..# ...#
######....  ..#... .......#.#
# *..#....  \.#... ...#... .#
#\\#.#....# ..#... ........##
#.*.....\\#\*..... ...*.....#
#.#.....****\*....... *.***.#
#.   ................ ..\\\.#
# #####    ######.    #####.#
# ....................\\....#
#\..\\\\.....##.#...****....#
#\....*.........#...\\\\....#
#\.###\#    .\\.#...\\\\....#
# .\\\\#... ....#..     ....#
# .....#... ....#.. ........#
#R#........         ........#
#L###########################