         
         
         
#        
##     ##
###   ###
#\## ## #
#\ ###R #
#\..#\  #
 # ..\  #
  L\.\**#
 #  .\## 
#\...##  
#\  ##   
#\ ##    
#\##     
###      
##       
#        