##########L########## 
#........*R..\\\   .# 
#..\\\\\ # ####.....# 
#......... ....***..# 
#......... .........# 
########.. ..###*#### 
#\\.#..... ....#\   # 
###.#..... ....#   ## 
#\#.#..... ....# \ #  
#\\.#.     ...## \ #  
#*\\#.###. ####\\\ #  
#.#\#..... ..\\\*. #  
#. .#..... **#######  
### #.   \ ..#        
  #.#. ... ..#        
###.#. ...*..#        
#\\... ......#        
##############        