  ####
  #Tt#
  #\\#
  #\\#
  #\\#
######
#....#
#...*#
#*T  L
#...*#
#....#
#R.t.#
#....#
#*T..#
#....#
#....#
######