time         ,iter.    ,bestScore,live    ,dead    ,lambdaLeft,liftReachable,mapName
1342360225008,        0,        0,       0,       0,         3,            1,map1
1342360225208,     1107,      212,     121,     212,         0,            1,map1
1342360225427,     3182,      212,     107,     733,         0,            1,map1
1342360225627,     6228,      212,     103,    1065,         0,            1,map1
1342360225827,     9456,      212,      16,    1447,         0,            1,map1
1342360226027,     9771,      212,       0,    1483,         0,            1,map1
