####################
#.... ..\.##.#... \#
#.*#.. *..# . # ...#
##. ..*#.#  .\... .#
# * #.    ...#..* .#
#.  .  .#. \##..#. #
#....# ...  *..*.# #
#....#.#\... ....*.#
#.. #.  #.\R##.. ..#
# *.  .# ... .*\ . #
#*. . . \..  ....# #
#**...*...#.*. #...#
# * ......*.# .. ..#
#...... .*. .....#.#
#.......*.\. ...*..#
L ..* ..*..#..  *  #
#..\.....*  .**#..*#
# ...... ..*\ . *..#
#.. ..... .........#
####################