#L##################
#L.*. #*. #.#...**L#
#\.\..##....\* ....#
#...*\... ..*.##...#
#\#.#.*... #. ...  #
#... *L.\**  . .\..#
#* *.***.......  .\#
#..*#.... #...*.#.*#
##.# # .\. *##.\ #*#
#......##... L#*.#.#
# ...##.*.*#.\..#\.#
#...*\*.#.*.##..##.#
# .#.. #*\.....\..*#
#...**.\\..*.......#
# R.*#\#..  ..\ \.\#
#*#..*.**......##.##
#*. ...##*. .##.. ##
# .#*. . ... . ....#
##....*#.....**. ..#
####################