####################
#.... .. .  ...# ..#
#.**.  ........R...#
#\...#..*.\.......##
# . *...#. .... . .#
#...*....\.. .\.* .#
## .. .... ....  *.#
##* ... .# ...* . .#
##  ... .. * #.*...#
#..\**.#***.\  ..#.#
## . \. .*...... #.#
#  .\#   #.. ......#
#..#* ..... ....  .#
#.. .  ..#.... .\. #
#.#. # .*.#.#*.\#..#
#*.  .#........#...#
#.#..\.. ...\.#\\# #
#..... # *..*.   ..#
#* ...........# \.*#
##L#################