####################
#*#.. ..*.*#...   \#
#.*\#.*.*# #..*##*.#
#..#.#**#....#*..#*#
#\*..#\.#.*#R*.... L
#*   .#*L.*. .*.. .#
#..#.......\ ..#\**#
#.....*\.*\#...#...#
#**..**** ..\# .#.##
#..*\ .#.  #*. #.###
##.. ...#**.....\.##
#...#......*#*...#.#
##*.#.....*#..*.* \#
#\..#**..# \..*....#
##\# ..#..###. .*. #
## *##..#*.\*.*...*#
##\.... . #.....#. #
#  \*....*.\..  ...#
# \\.##. # #*\...#.#
####################