####################
#..#.*.# ..**.\ ...#
#. #R***..\*.*.\#. #
#*..#.#..#\..* .* .#
# \.#....\ #\.* .*##
#.*...\ # .**#.#*. #
# .*.#*.*\#.#* ....#
#*.*..*#.....**..#\#
#*.\*#. *.. .#*. **#
#..*........ .*#..*#
L\....\.*\.**. ..#*#
#\. .# *. #*.......#
#....#*.#... \\...##
#.*.\. ..#....*#.*.#
#.. *.**.\L*...#..##
# ...*#.....\#.#  .#
#...#....##*.....#*#
#*#. ...##.*\ ...  #
#.#... #..*** ..**##
####################