####################
#..*. ...... .. .*##
#.. .***.... . ..*.#
#.*...*.....\.  .* #
#\#...#.. *..## ...#
#....\.*.*..  .R*..#
L*......... .. ...##
#***....* #*.... .\#
# . .....*..\..* ..#
##...#.. \.. .. .. #
# **##\#** .....*. #
#...# ...\. .......#
#...#...*.#....***.#
# *\..*. ..# *.#.\ #
#. .. \.. \*..#.# .#
#*. *.... ..\...*..#
## ......   .#**..\#
# \..*    ......##.#
#*.  . ...#..*.*. .#
####################