##########L#########
#.\    ..*##... .. #
## .... #..  .. *. #
# ... \. *.#\\*.. .#
# # * .... .\\###*.#
#.*.\ ...*. #R.    #
#. ..# #.. \*.....*#
#.#*.*\  .*.*#....##
#.*..* ...   . ...\#
#. ... #....... #. #
#..**......* .#. .##
#....*.#. \ * .#\**#
#\..    .#. . .  .*#
#.#.##.#.. . ...* .#
#... .*. ..**... #.#
#..... #.\. ... . .#
#  ......#. ..*..\.#
#..*.*  .\#  . #  ##
##.* #........ ... #
####################