####################
#..#.*.. *#\.R.*#* #
#.* * ...#..#.#....L
#.....  .. *....\..#
# ..#..#.* ..\*.  .#
#..#  *. #.#.\ # .*#
#..*..\.... *. ...##
# . * .\\#....  . .#
#* ...*.\ . .. ..\*#
# . ... #.....#...\#
#.**.#..# . . *\.  #
##..... .#. ..#..**#
#....  .  .. #   *.#
#.........*....*...#
# .*.... . .#.#.#..#
#..#.....#..#.\..*.#
#  .#.....## .  .. #
# *.#..\*.#.**  #\##
#...**#....#\ .  ..#
####################