####################
#..*....#.. .#*. .##
##.\## ...* ##..\#.#
##.....# ...\.... #L
#\\\. #.*#...\..**.#
#\.. ......\#..# .*#
#..#. ..\.  *...\..#
#..R.#.. #. *.*.#..#
#*....#. .*.#..\  .#
#. .*\.. .#.#......#
#... .... .....#*\*#
#.##*.... *.#\....*#
#...#.  ..*  *#. # #
#...*.#.*. .*..#. \#
#...*. ...*.  .#..##
#........ .....##*.#
#.#.....#.#.\......#
#...#.*#.......#.. #
#...*##.*#  .. . # #
####################