####################
# *..#...  . #.. .\#
#..   #*....*#. R .#
L.. .##.. #.\#  # .#
#  .. ...*..*.*.*. #
#*..... .#    ...\##
#. ..#* ..# .... . #
#.. #. .....* .....#
# **... ...\#*..\#.#
#.. .*  ..#*.*#..#.#
#.#*\..  ..** . ...#
# *..  ...#.#...#..#
#. . ... ## .*.*#..#
#..*.......#*#..*..#
#. .. .. *... #... #
#*. #.... .. ...*..#
# \..** ....#...*..#
# ..*. .. ......*. #
##.* .... ....##.*.#
####################