####################
#...##..*. .....# .#
# .# #R#.\*.\ .....L
#... ....*.. . .. .#
#*\.. . ..*#....* .#
#...#*.  ..* .... .#
#\..#* \..  ....\..#
#. .. *......#.. ..#
#.##.. ..*#..... .*#
#*.**..  # *.....*.#
#.# .\.... .*.*#* .#
#*.. .\...#.. . ...#
# . ...#.##.  #....#
# .. #....#....#...#
#..\ .. .#*.*.\\..*#
#.* .\.*#*.#.....#.#
# . ..*.# #...*. . #
# ... . .#\ #... *.#
#. ...\... *......*#
####################