####################
#..... .. # **#...*L
# ....*. *...#.\...#
##*....*\.. .. .\.*#
# ..*. ...  . ..\.##
# \.  \**.. *.  .. #
#...  #*.#\*#. *...#
#... .. .\..*.. . .#
#.......#........*.#
#*...# ... .......*#
#..* *#.. #  *.##..#
##. ..#  ...#..*...#
#.......   ...* .#.#
#  \ ... . ...#*\ .#
#*.*. . * **.\#.. ##
#.......  . R* .*. #
# *.*\#.#. .#..\.* #
#... .. ......#*...#
#....*...* .... ...#
####################