####################
#\ .....#.#*.  ...##
#\..R* . ..* ....* #
###. ... .......# .#
##....*... * #  *.*#
#......* *.# . \*. #
# .#..#*.. ...#. . #
#. # *.\\......#**.#
# ##...\.  #\   .\.L
#.#\.... . *.....* #
#..#... . ..\... . #
#. **.........#*.\*#
# .*...#.. .. ..#. #
#  ###* . ..#..*\*\#
#*.....*.  #.. ... #
#..#. ... #..#.. \ #
#*..##.\.#\ ..   ..#
#*.#. . .... \# ...#
# \#*\..**..   .#..#
####################