####################
# .\..R.. .* * ....#
# ...*.  *.*.. ...##
##...*** .\..#...*.#
#.*......*.\....#..#
# . ** .*..**#.##.*#
# .*.......\.#....##
L..*..\ ..#.. ..#. #
#  ....*... #....*.#
#. .. ..\. ...*.. .#
#..   .#....   .. ##
##...\.#.  *\*....##
#......#... .. \. .#
##....  .......*  .#
#*.##\ .. .\ ...*.*#
# ...#*.*...... # .#
#......\ ...#.....##
#. *.#\.. ....#.**.#
#.#\..   ..# .*.#..#
####################