##################L#
#. #.#.*..... \ ..##
##*..\...\.. .*..**#
#.##.# #\.#. ##   .#
# ... # ..\ .. \...#
#...* ..... .. ....#
#.\   * . ... .... #
#*....*....  *.*.\.#
#.\.*....  #..*.. *#
#.*. ..#.*##. .  \.#
#.... . .#.. .*....#
#  ....#..  ..*....#
#.#.#..... .R #....#
#. \...#.#**. .    #
#..#......#.. .....#
#...*.#...#..*.# .*#
#*\*.....* *.... \.#
##.##.#.\* ..\ ...##
#\.* .#......*...#.#
####################