####################
#.. * .\. *.. *....#
# .....   ...# ....#
#. #*.#*  .\..*.\.*#
#..**..#... * * ...L
###..\ \*. \..#..*.#
#.*#.... *.. ..... #
#.......#*.\. .#. .#
#...  ..*... * . ..#
##. .. ...#   .#..*#
# ...*.. .   . .\.##
#.. .#.. ..*..*.*. #
#..#R... ....  #.  #
###*.\ ....  .# .# #
#...... .  #\.#. *##
#.. \. ..\* ...* ..#
##  ..#..*.\.....  #
#*. #. .#  .*  .*.\#
#*.\. ....\. #...#.#
####################