####################
#.##\*.#. ...\ ... #
#. .#\ \*.#.. .. # #
# .  #**.   ... .. #
#* ........ .. ... #
#.\ ........*.##.#.#
#.#**.....  .*.....#
#\..#..### .\.....*#
# ... \.*.#\#....# #
##  *..*\.#...  ...#
#.# .. #\...*..*#.##
#. *    .\...* # ###
##... *.  *R#..*\..#
#*.   *  .... .##..#
#...\. .. ..*** *# #
#.\. .. # . ..#. #\#
#*#* *#.  #*#. *...#
#\..  # .*# .. ..*.L
#.....##*.. *#\#. ##
####################