###############L####
#.*.  .*.*.*. #...##
#..#. #\. .\..... .#
#..*#.*. #* * ...*.#
#....#.*. # . #.. .#
#.* .\.*.*.*.##.*..#
#.... ..... .....# #
#. \. . .... ...  .#
#*\.R#.. \...# #. .#
#.\ #..##....#.....#
#... .. ...# .*\#..#
#.. ... ..#** \. ..#
#** *  .. .....  ###
#.*#... .\.. . .\*.#
#*...\..*.. #......#
#.*  .\ *...  .....#
##. *...*.....#. .##
#  .. \ *.\.*\.*...#
# #.# *...##*.. .. #
####################