####################
#...#.*.*#... . \**#
#.   .#   ...#.....#
#....#.. ...#\.# .##
##. ..*.#\ . * ...*#
#*#..\ \... #...**##
# \.#..*... #*.. #.#
#.. ........R \... #
#..... ...\.   ....#
#. . *. *.....*...\#
# #...\#**.......\.#
# .. #..*..#.. ....#
#.***.. .........#.#
L..... .\##.#   #..#
#.\#\..* . . ... .\#
#.*. *..  .. .. . ##
#*.#.....#..*....#.#
##*..###*#*.....*..#
#...\*. .... ...*.##
####################