####################
# \....#.*#. *  ## #
#. .... . ...*.. ..#
#.....*. *** ... . #
#..#   #.#  .**.#.*#
#. .  ..*.... *.*..#
# ..... # .#..*...##
#\ .#. *  . #.# * .#
#.#.#.### #.. ...* #
#......#. .#  .#*..#
#..#...\#* .. * ..\#
#...#*.#.......##..#
#\..#.......\*#*...#
#*....##.. ........#
#.. .. ..# .#. . #.#
#* .  .*......#.\. #
L.. *.*... # .# #  #
#.....*. ..#.#...###
# . ........R. .\.*#
####################