####################
#..  ...*\..... .. #
##.. .....#.\#.... #
# \..#....#* .  . *#
#.#. .# ##...... ..#
#*.*.*# ..#... ...\#
# . . .. . ...#*#. #
##\.. ..... .......#
#*.......  ..  .  *#
#.#*.#... .*. . *\ #
#...*\*. .#. .R#.\##
#. #* .\........ ..#
#*#.\.... ....#. . #
#  #.......\...*.. #
#..# ..#..  #*.. ..#
#.. .............. #
# ..*.  ..  * .\ . #
#*#.\ #. .. .......#
#.*..*.#.\..#**..\.#
####L###############