####################
#.*.......#.\ .  # #
#.... .. \.....*.. #
##....#*..  .** . .#
#.......##*. ... \ #
#..#..#......\ ..#.#
#.*.#.*...\ .\.....#
#.*.\ ... \.  *\ .*#
#  ..* ..*......* .#
#*..#....#\.... * .#
# #.\.....#.. .*...#
#..* *....# .. .# .#
# ...#..*. .. . #. #
#*. .....R\*.... **#
#.*.........*  . ..#
#.....*#.. \. \ ..\#
#......\..  *\ .*.*#
#.*.....* ...#*... #
#..... #..# ...\\..#
################L###