######L#############
#\ . ........#.* ..#
#.\.#. .. .. .*..#.#
#..\.. ....#...*...#
#*...*... *.##....*#
#.#...#*#...#.##\..#
#...** \\...*.*...##
#.   # . .  ... *..#
#....*\ \ .\  .#. .#
#...# .#*\ ....#...#
#.#.....*... .. **##
# ..#.. .. .* #.#  #
##...#. * .# ......#
##...#.#R.  .# \*.*#
#*.\\. ... ...\.. .#
##. .  ..## . .....#
#  ... \.  .\  . ..#
# #...*#...#  *....#
#.*.*#...###.*  .. #
####################