####################
#*.*.#*.*.\..**.. ##
# . #. .. ....*  ..#
#. *\..\. ..\.#.. .#
# .# .. .***..\. #.#
#*.* ....... *\* \.#
#  .#.....\.* .....#
# ...#*..#.. .# ...#
# .. .#.. .#. ... .#
L. .*#*.. . #.  .###
# .  ..\\#.... \.. #
#. . ..*......\#.. #
# #.* . #  #. ... ##
#\  #\....#.*.\. *.#
#..R.#**.. # .# . ##
##*.. .... .\.#  . #
# . *  . .#.. .... #
#  .* #. #*.** ... #
#\.. ..#*......  ..#
####################