##################L#
# *#....R*.........#
##* .....\..... *. #
#.* ..#*.*.  .#...*#
# ..#. ..\#....** .#
#. \.... ..* #. #.\#
#..#.#... .#...  ..#
#. . ...* .. ...\#*#
#. \ ##*.  \..   #*#
# ....*.  ..#.*.#..#
#* .. .#.\.**\. .#.#
#.*.  ...*.#.*.....#
#...\...#. .* *.*.##
#.#\..  .#..*. .  *#
#.... ... . ..... .#
#..\.#*.. .*.#. ...#
#**. \. ...#*#\..#.#
#..\** \.  *#.... *#
#...#..*.#*..*\.**.#
####################