####################
#.. .  *\..... *\.##
#* .. .**..*... ..\#
# .  . ........ .**#
# R..* .....*..*...#
##\...\..#..*.* \###
L. ...\  *. .#. *..#
##...... .... .## .#
# * *  ...# ..#..**#
#*.#.  \.#.... ....#
#.\.. .\..... . ...#
# .##.. ...\.*.. ..#
#* .#.. ..## ... *.#
# .#...#..\.......*#
#.#..* ...*\..*.. .#
#.# .... \.   # *. #
##....##   **.*....#
#.*..... ...\#.... #
#.\* ..#\....#.. ..#
####################