####################
#..\ .###.# ...*..*#
#.*... * .  ..#.#. L
#.*. ..  \..# . ...#
#...**...* \*.  ...#
#  #.. ..*\#  #.\..#
#. ........ .  #. .#
#......  #  .....#.#
# .*#....*. ..*.  .#
#....\.#.**#.#...*.#
# .\ .   *....#....#
# ......*... ......#
#.... .. \. ..#.\*.#
#.......# ....*....#
#....\.*. ... ..# ##
##R. .  *.....\#\  #
# ...* ... . \#.\ \#
#...  * .##. ...#..#
#..#......... .. .*#
####################