####################
##. .*..   ...*\  .#
#. .....## ....#*..#
#..*#..\.*......#..#
##.# *. ... .  *...#
#.*.....#..# .. ...#
#.#.... .*.#.#..*# #
#*.*. .. ...#.# \. #
# #. \.\#.. *.# .#.#
#..*..... *.#*.. ..#
# .... .**# . .. .*#
#.. *...#. *... .\.#
#. \ #**.\......  .L
##. \.\#* .... ** ##
#.#...* ..* ...*.\.#
#*...* ........# #.#
#.# .*....R .*#.* .#
#*. .*..#.*# . ..# #
#**..#\\...#.. *.. #
####################