#############L######
#.\ .# .# .#\*.#*. #
#*.#.. \...#.. ...##
#* #    . ..R.. ..##
#...*....#L. *... .#
##.*..*#...##  \.\*#
#\..LL**........  *#
# . #.*.*... \*.*###
#*.*\ ...#  \.. . ##
#... ..*..... #.*. #
#.*.... .*.###*.**.#
#.*# .#\ ..... ....#
##..# .#\ **...   .#
#.#***..#.\* #..*..#
#.* #L..#..#*.#...*#
# .....\\.....\ \.\#
##...#*.. ..*.#. \*#
#\....#......##..*##
#....***.  . .*##. #
####################