################L###
#*\. . #. ...*.#...#
#.*\ ..#\# .#.*... #
##.# . \\ .... ..# #
#...*.  #.# #..#...#
#*  *\ *..#..*.. .*#
#.*.     . ##..  *##
#** *...  .*..###. #
# # .#. .*.  \\.#**#
#. ... #.. .#..*..*#
#. .*... *.* #.. \ #
# #..*##.\..#.. . .#
#. ...**.*.*# # ...#
#*  ... .#...\. .\.#
# *..\* ....... *..#
#.*. .#. .#.. .# ..#
#...* *.. ##.  .*#.#
#.* .... .....*..  #
# \..#.#... R.. .  #
####################