####################
#..*#. ....#. .#. .#
# . .*\....  . ...##
#  .*\\*#.#.*..  . #
#.. .\# .....*. * .#
#... *#   ....*..\R#
# .. ..#**..# ....*#
#\.# *  \.\.  .. ..#
##..\...#...#......#
#.*#.. .\*.# \.... L
#\** .*.# . ..#..\.#
#.#.. *..#.#.  *...#
#........   ...\.  #
#......*....... *\.#
##..#.*.*.# *...*..#
#\.# \..#...  #..\.#
##...*. . .\\* .*..#
#.......*.# .......#
# . *...##..  .#.*.#
####################