####################
##.  #. . #..#....##
##*.*... . .#..*...#
#....\..  . \ ..#.*#
##.... .*........ \#
# .. *  .*. .* \\ .#
# ...\\.. ....*#*. #
#\  *. ...**##.** .#
#*. . #.. .*.   .*##
#*..*.....#.* ..#.#L
#... *.........***##
#.# #.#.........*#.#
## .....*#.....#...#
#..#... *..*.. ....#
#.#...... #..#.  ..#
#.*... .. ....*... #
#... ...##R*#*... .#
#.*... .... ...* . #
#. \.. #*...* ..* .#
####################