####################
#.#...*......#. *.\#
##... \.. *\.#.##.##
#.\ ....* *.....*\*#
#*. #.*..#...#.*...#
#..... ..#......#..#
#    . .**#.#...\ .#
#....# R. .....#.#.#
#....*..  ..#....  #
#....*. ..#. . ....#
#.\  . .##*.#.. .*.#
#* ..*..#  ....*.\.#
#.\.*.*  ....*....*#
# .... ... . *   \.#
#.... .. ..... *...#
#...\ .. \.. # ... #
#.   ## .#.\# #.##.#
#**..*. ..\...\..*##
##.. \ .....*.#.# .#
#L##################