####################
# ..*.   ...\*.# . #
#\..#....\ . ......#
##..#....#  .* . ..#
#\*............#*#.#
#......* .#...  . .#
#.. *.\ **.. .  *#.#
#..*.##... .#...**.#
#........#.#.\#...\#
L#........*.*...* \#
#. .....\ . #.*..\.#
#..*. .. .. .*...  #
#  *.*.*..  #... . #
# .. #.#. .*#.. *..#
#. #*  #......\#...#
#. \....#...#... #.#
#..*# ....\. # #.*.#
#R .....  #. . #...#
#...#* .. . #..**#\#
####################