####################
#..*... .\.. .\# #.#
#...#....  ...#. \ #
# . .......*.*.\.. #
## **...... \.##...#
# ***.....#..* ...\#
#*.. .. .. . *.* . #
#.# .R .....* .....#
#**..#..*.....*...*#
##.*...\.##** *# ..#
#   ..\ ........  *#
##\\*# .. *....\...#
#  *. .##.# *. ....#
# . ...*\..  ..\\. #
#.   ...#.* ..**...#
# ..#. .......\....L
##.# ..*\.......*..#
#. . # ..... .. .#.#
#......\.. ...# ...#
####################