####################
#\..... ... .# . #.#
# .  #......\.  .# #
#.....\  . ...*... #
#. #.\ . #. ....*. #
#. . \... . ...*#..#
#*......*.#. * ....#
#.# .... #.*..*..\##
#  .*.  .... *#. #.#
#*.. ....* .* *.#..#
#....*R.. ....# ...#
#.*.\#..*...  #*...#
#.. **#.# . .* .   #
#..#.#.. ** .\  *.##
##\\ .*#....\. #\.\#
# #. .. .* ..... .*#
##.##..# .........##
#.**.........**##.##
#..*..... #*.##\\.\#
#########L##########