#L##################
#.. ..##* #   ##.\.#
#*..\\#.*.**...#** #
#L...*#...*.# #..*.#
#.*  ...#...*#*## .#
#*..*..#*....# #...#
#* .*.....**..##.# #
##.*..#\ ....#.*...#
#.... * \*.##..*##.#
#..##  . .*... .. ##
#..*.# .*\..#.*. .##
#...\.#\.*  ..R..\.#
##.#*\*..*.*. .....#
#.\.\. . . ..*...#*#
#...*\...*\#..**#.*#
#...\.L..*. ..\.*#.#
#*\   .*.. .*#.#...#
#...#..... #\** . ##
## #..#.*... .*....#
####################