####################
##.  .. ** *\#\  .*#
#....*.#..* ...  *.#
##.#...#....#*...\.#
#....\.#. .\#.. . .#
#\.#...  ..*   #. .#
#.\....#...... #...#
#..*. .  .. #.  .*.#
#..*...# .## \ #.*.#
#..\ \\.......*.#..#
#..*..\** ....* .###
#.\# *..\...  ..#.#L
# \... ....*  .. \.#
#.*..\.. #......  *#
#. ..*#.#... ......#
#. \ .. ..\\.. *#*.#
#.#.* \\R......#*# #
#... .. ..#..\...#.#
#. ..**. ...#... . #
####################