###L################
#\..  *.*..*... * *#
#.#.** *... #.#...*#
#L. ...#.. ..... #.#
#.\*.  *.##.#  ....#
# .#..\*.. *#R..\*.#
# *. .*.. #.*  .   #
#.#\.  .###. *.#.*\#
# ..\ ..#...#\#* *.#
# #......... .#\...#
#* \.# .L\..... ...#
#....###..##   \. .#
#...*.##.. ...   ..#
#..\   **# .#\ .. .#
#..# ....L#.\**.**##
##*\.\ . ..#.\..** #
#.....* ****.##*.* #
#...# ......**...L.#
#  *.#...*.# ** \..#
####################