####################
#. ..**. ...#... . #
#... .. ..#..\...#.#
#.#.* \\R......#*# #
#. \ .. ..\\.. *#*.#
#. ..*#.#... ......#
#.*..\.. #......  *#
# \... ....*  .. \.#
#.\# *..\...  ..#.#L
#..*..\** ....* .###
#..\ \\.......*.#..#
#..*...# .## \ #.*.#
#..*. .  .. #.  .*.#
#.\....#...... #...#
#\.#...  ..*   #. .#
#....\.#. .\#.. . .#
##.#...#....#*...\.#
#....*.#..* ...  *.#
##.  .. ** *\#\  .*#
####################