####################
#** ..\.#\*....*..##
#.#... . *\ ##*. . #
# *.*...***....\...#
#*...#.........#..*#
#. # .\ #.#*..... *#
#*# .. #.. #.#.*#.L#
#*\\.#..  *L.#.# ..#
#..  . .. ##... ..##
##.  \.R  *#.\. ##.#
#..\ ##.  *.*##.#..#
#..*. **#. *..\.# \#
##.. .. .. .*... .*#
# #*....#\.. .. * *#
#L.. ..*.# *#. **..#
#.*.*#\..#*#... \#*#
#.......#..*#..*.. #
##.*#*# . ....\...\#
#. .##..   ..*..#  #
#####L##############