####################
##. .*#. ..#....*..#
#.#\..## *... ##\.##
L# ....\... #.....##
#.**..\...#*.# .\\\#
#*. #..#\...... ..\#
#..\...*  .\.. .#..#
#..#.*.* .# ..#.R..#
#.  \..#.*. .#....*#
#......#.#. ..\*. .#
#*\*#..... .... ...#
#*....\#.* ....*##.#
# # .#*  *..  .#...#
#\ .#..*. .*.#.*...#
##..#.  .*... .*...#
#.*##..... ........#
#......\.#.#.....#.#
# ..#.......#*.#...#
# # . ..  #*.##*...#
####################