####################
#.**    *.....* \.*L
#.. . * \  . .** \.#
# ..*.*.. .... ....#
##\......  ... ...\#
#.\ ...  *...  #. .#
#   * .#.#...*.. . #
## *# . .  ... .* \#
#.#.*..***. .. *.. #
# ..*..#.. \#. .*..#
# ..\... .*..\#.. ##
#.  \.*..#.# .....##
#.# . . ... .\....*#
##.*..#..    .*#.*.#
#\*..\#**....#*.. .#
#\.**.##..**.....#\#
#*. ..... \.#\....##
##\* \..#...* . .#R#
#.\#* . ...#.* ....#
####################