####################
#  * #. .....  .##.#
#.  .  . *#.#......#
# \##*.. . ..#.  * #
# ..*  * .....  #.\#
#...# ......  ...*.#
##... .... ..# ....#
#......*..*#....# .#
# # .#*.  *#*.# ..\#
#...*#. #*.... .  .#
#..  .. .*\...*.#.\#
#. .*..*..#.#.. .  #
#...... .#.. .. . \#
#.# *. ... #.#.#..*#
#.... ##.*  R#. \. #
#. #*#......\.* .\.#
#....... ...\..*...#
##..#....*... . #*##
#..*.#*  ..... *..*#
##################L#