################L###
# * \.#. .# ....#\ #
####*.\.... ..*..  #
#.*.*. #*... .*#..*#
# ... .*. ........##
#.#....*..**.#  ..*#
#.. .. *...**.  .\.#
# ..\. .**...\.\...#
#*   #.  .. *.\ .. #
#*..\#.....*..#.. .#
##.R.  \.*..*  *.#*#
#.......... .... . #
#. # ...*.. # ....*#
##..*#*.*.*.... * .#
#\ .... ...*...# #.#
#\ *..  * *#. .. ..#
#....# ... #.. ..#.#
#.*#.. .#.. ..* . .#
#.. ...........\.  #
####################