####################
#*..##. #.. # #....#
#.#    #.. .#\. ...#
##. #\.#...##.*\. ##
#. ..\.*.# ##.. .*.#
#*.. #\..#\.# .*...#
#.*.....*R#* .#....#
#\#. ...........  .#
#\..# #*\ . ..L...*#
L#..#*.\. #*###...##
#*\\......\#.*... .#
#.#..#....###*. #*\#
#*..\.#.. ..\\#..**#
# .*.# . ...##.. .*#
#..*#. .##*\#.#*.*.#
#..#*#.# .*.#..\#..#
##..#............*.#
#   #  .  .\. .*.###
#**.*..\\..*\*..#..#
####################