####################
#.. .. .. ...\. . .#
#. *\ ...  #*.\....#
#*..#...*...* ...*.#
#*.  \ R. .........#
# .#. .* .... . *.##
##....... .#.# #...#
#.. \* ...* .... . #
#***.#  .*.#. .. .*#
#. .#.#...   *#.#.\#
#...# #. # . .\..#.#
#.....# # *.*..... #
#. ....... *. ... .#
#*......*\   #. . ##
#....#.#..\..*\...\#
#. .. .. \ .*.. ..*#
#.. ..*.. ..*. *...#
#.\#  .\..##...** .#
##. .\.*\. .#    . #
############L#######