####################
#...##*. #.. . . ..#
#....*. # *#*.... .#
#.*.. ..... ... \\.#
##..#.* ..#*. #...*#
# #.*#..........## #
#  . #.. *#. . #...#
#*..* ..\...*. *.#*#
#..* .......#.*.#. #
#* ....  ..*. .....#
#..#\# .*.... ...# #
#..\....*.*.##  ..*#
#  .R\*.... ..# ...#
#....*  ...#.......#
#*. ..#.\* .  .*.*##
#*.#.. ...*..#.. .*#
# * .. . ...*#*....#
#...\....#. *..#.. #
##..#.*.....*..#*..#
#####L##############