######L#############
#...\.** # .. .*# *#
#..*#..*..*..* . \.#
#* ....* .*..\. .. #
#.........###..*.. #
# *..\...## .. ..*.#
#.**#.....\..*\..  #
#.*..*....#...... .#
#......*. *.* ... .#
#... *. *\*\..    .#
#...*..#.. .#.\. .##
#..... *... .#*. ..#
#  \. ..\ ... .\...#
#...# .......*..#.*#
#.  #. .......#.*..#
# .  R..* ..*#..*.*#
#....*.  .*.*.#*.#.#
#***........*\ ..# #
##. ..#\.  .. ..\..#
####################