####################
# .... .#*.... .#\.#
#\...*..\*.. ... .*L
##*#.   \\\..\.*...#
#.. . .\.... ..\   #
#. . *.......   ...#
#...........**..  ##
#  ......## \... .##
#..\#\..*. .# .\.* #
#... .#  .. .*##..##
#. #.*.#.. .*R..*.\#
#..#.....## * . . ##
##..*....*.*..*..\.#
#..\ . ....*.* ... #
#...#*#..  ..*#....#
#  .....*...*. ...*#
##.*#...#* ..#. #.##
#. ..... .. ..#....#
#* ...##....\..#..*#
####################