#########L##########
#.# .R*.. .. ......#
# .. \....\. \.\..*#
#.. *.. .....**.*..#
##.  ......*\ ....##
#. ..*....# ...# ..#
# ..*.  .\. ... *. #
#. *..# # ....* \. #
## ......# # . .\ .#
#..#...\.... .#..#.#
#.... *..* # ... .##
#..#. *\#\#...*#.*##
#..*  # .....*.. ..#
# \\##. . **..*....#
#.*\\*.*... ...\*..#
##.*.   \. ...# ..*#
#* . ..#.#*....#.. #
#.. .....**#.......#
#.  .. \#.\...#\#. #
####################