####################
##. ..*\##. .... ..#
#   ........\*.*#  #
#*..\*. ..**..  #.\#
#. .  *...*#.***...#
# .##. .\**.# . . .#
#* # .  \.#..*... .#
##. .\* \.# \. #.#.#
#. *..# ...*. #  ..#
##.**#... .. ...*#.#
#. *R..#  .\  . .\.#
# ...*... .*. .. ..#
#*.*#...  .........#
#..#.#....#.*. *.* #
#.*\ . *....*  ..# #
#...#...\  # ..\ ..#
#*..\#......*.. \ .#
#.#.#*..*..#.\*  ..#
#.* . *...... ..#..#
################L###