#############L######
#. *.....*#.\. **..#
#..  *#\* .  ...**.#
##..\.\#\ . ..\#\..#
#\..*.*##.*..*.....#
##\..\\.#   *.*#.. #
#. #..##..#..\  \L##
##.#\*......*#.**..#
#. *#*..... ..#*.###
#.*\..\......#.....#
#. #*.. #*.#..*. #.#
#..**\\ *.. .**..#.#
##.**  #..* .. .#  #
#L..#*.  ..*..# \..#
###.R.....*###\....#
#.  *..\#...*.   . #
#*....*.**#  .#*.*.#
#.*# # .* *L\#\...##
## ****.\.\.*..\...#
####################