####################
#.  .. \#.\...#\#. #
#.. .....**#.......#
#* . ..#.#*....#.. #
##.*.   \. ...# ..*#
#.*\\*.*... ...\*..#
# \\##. . **..*....#
#..*  # .....*.. ..#
#..#. *\#\#...*#.*##
#.... *..* # ... .##
#..#...\.... .#..#.#
## ......# # . .\ .#
#. *..# # ....* \. #
# ..*.  .\. ... *. #
#. ..*....# ...# ..#
##.  ......*\ ....##
#.. *.. .....**.*..#
# .. \....\. \.\..*#
#.# .R*.. .. ......#
#########L##########