####################
#.....\R ......#.\.#
##.##  . .#*..\.# .#
##  . .#.*..*.*. ..#
#....\ . **.#\*  #*#
# **....\.\..*   ..#
#.  *. . .....#..*.#
#.#\.. *......... #L
# . *\ #  .#  .....#
#... .# #..\..... .#
#.....*  ..*.\.. **#
# ...###\...*..... #
#......  .\.  . . .#
#.*.....**# ...   .#
#  ...#....#. ... .#
#...#\*.\... ..  \ #
#.*\ . .  #.#......#
#...\* #.*. .. .#..#
# #..*.#...*.*. ...#
####################