################L###
#..... #..# ...\\..#
#.*.....* ...#*... #
#......\..  *\ .*.*#
#.....*#.. \. \ ..\#
#.*.........*  . ..#
#*. .....R\*.... **#
# ...#..*. .. . #. #
#..* *....# .. .# .#
# #.\.....#.. .*...#
#*..#....#\.... * .#
#  ..* ..*......* .#
#.*.\ ... \.  *\ .*#
#.*.#.*...\ .\.....#
#..#..#......\ ..#.#
#.......##*. ... \ #
##....#*..  .** . .#
#.... .. \.....*.. #
#.*.......#.\ .  # #
####################