##L#################
# ... .\..\* . \..*#
#*.*..  .........# #
#   .... .\**# .\# #
#....\.*.*...\...R##
#......*#.. .. #.# #
##. .#.....# ##... #
# ... .. ..... #. .#
#\*.....\.# *#*...\#
#. \.**...*** .# # #
#.  *.*. . .... .. #
# *.... *  .... ...#
#  ...#\.##...  ...#
#.   .*..   ..# \*.#
#.....#.*... . ....#
#*..... ...#....#*.#
#....... ...# .*\..#
#......#.. . .   .##
#... ..***##.*#..\ #
####################