##########L#########
#\  #.\ . .   * . *#
#. .*. # . .. .. ..#
#.. .R .. ....*#* *#
# **..#*  * .#  \#.#
#.   #\ ..#.#.....##
#.# .*....*#*.... *#
##...*. *\..... \..#
#*  ...#.\........*#
#.#.... .#  #..*  .#
#.*#  # .....\.*..\#
#....#.#.. #...*...#
#.*.\ *...#. * .\..#
#.* ... ... . *...*#
#. .##\.\  .#.\\#**#
# ..  ..#\ . .*.. .#
# .. . .......  . .#
#.... * ..# ..\# . #
#.   #.#  #.......##
####################