####################
#   ..... . .*... \L
#*... .  . . #.\ ..#
#..# *....#*.  ..*.#
##*# .. ....***#..*#
#...#......  . *#..#
# .#.#.#....# . *..#
#.*... *..\.*.*... #
#..\.#...\*#.......#
##... .*. . . ...\ #
#** ..*.  .\ #.# ..#
#...\... .#\ * # ..#
#.. .#.  .*. ... *.#
# .  .* *.... *  *.#
#\ #. * ....  .**..#
#.*....  ...#... ..#
#\.#... .. ....*..\#
#. .  .. \  * .#...#
#.* *....\..#.#R.. #
####################