##########L#########
##.# ..*...*R. ....#
#. #*..\\ *.*.#..#.#
#. ..#...... *.#..\#
# .... #. ........ #
#...#.. .... ..... #
# ..#.. .... ....**#
#.# *#.*. \ .....\ #
#\.#.*.#. .*......##
#..*.....*.... ..\ #
##.#...#..#.# \ ...#
#. #. .# . ...##...#
#*...#..*....*   ..#
#.. \.. *.*#....*###
## \. ..#.\... #.*##
#. .... *..  ......#
#.\. ...  ... .  ..#
#...\*..#. ......*.#
#..#.* ........  .##
####################