####################
# **#.....*.R** # \#
#...#* ....*#.....##
#..#\* .  ...*.*# .#
#.#....#. *.. #***.#
#\#.  .\ ..\ \.. *.#
#*.*. #..*#\.....###
L\....*...* .* ..*##
#.... \*.*.. . .#.##
#.*..\   . ....... #
#.*.\. ..*. . ...* #
#.. ......# . .*...#
# . .#.. ..  ......#
# #.#.....\. . . . #
#..*#...# .. ..#  .#
##..*..\..*#...\\. #
#.\.. ...*.#..*#*.*#
#\. . * .  ....*.. #
#  . . . ....# ..# #
####################