######L#############
#.#*....  ... *#...#
#.*.*\.*.# ..\#.. .#
#..#.#.*.... .. . .#
#\.. \.* . ..#... ##
#*#.*...#.*...\.#..#
#.#... ..\. .. *.#*#
# #..*. .# ..*\.. .#
#.*.  \.***....#  *#
#.## .#..*.....\. ##
#.*.. #....\... ...#
#.......#....  ....#
# .*  #.... R## #..#
#..... ....  *.*\# #
#..... . .* \.. ...#
#... . .........#. #
#**.. #...... *. .\#
#..# ..#.\...#*...*#
##..#\....\. .#*#.*#
####################