####################
##. ...\.......  #.#
#.. ..#... *# *#. \#
#**......*..*.. .. #
# ... # .*....\*.. #
##*...# *..**#   . #
#. . *. ..  \ ..\. #
#. .#.# #.#. #... .#
#.... ...... ... #.#
#.\#\..# .....*.*.*#
#.#... .\.. * . ..#L
#.   *.  *. .\ .# ##
#. ..* .* . **#\\ .#
#......  ...#.R\\..#
#  *.....#. ...#*..#
#.#. .. #. ... #.  #
#. .. * \ #... #.*.#
#. \ # .*..... * ..#
# #....**# \#* ..  #
####################