##########L#########
#  . ...\ ........ #
#* . .\ .  . ....#\#
# .. .. ..* *##. #.#
#\## **#.# .....*..#
#..\*..\#.*.**....*#
##\ #. ...#.###.#.*#
#.... #  *.R.*#.*..#
#. ..... .....* *.##
#.\.* \..**.... \..#
# \. ....#....#. . #
# **#..*#..........#
#.   \.. # ..#.. #.#
##..**......#......#
## #. .#.\  ...... #
#. ....*..#   ..* .#
#..   .*....... .. #
#.... *...#.\#...*.#
#.... \.....  ....##
####################