####################
##. ..*...*...#....#
#....* ..#.. . \ ..#
#.. \. #. *#. *.#..#
# .* R.#**... ..#..#
#....   .........**#
#.....\*\.... .....#
#...#.....*.......*#
#* .   ...  ..**...#
#. ......#.... # ..#
#. .......#\\ * #..#
L....*...#....#  .*#
#.**#..*..... .....#
#*.\........ .*....#
#.*...\** *#..*....#
#.   *..#..#......##
#.   .  ..**.......#
#...... \.. . ..\#*#
#.**. #*. ..##* ...#
####################