####################
#.. ..#..**...  ..*#
# .*.  ..*... . .*\#
#.* ...\.... .#.#..#
#*\# ..*.#*.  .#..##
#*...###  #..#.. ..#
#..#..  \.*.*. ....#
## *\.....*.*.  *.*#
#..*..#* *  \#..#..#
#........\... * . *#
#.. ........# \ #..#
#.* .  .*.*. *.  ..#
#*##........\ # . .#
#...*\R..  ..#*.*..#
#.\........*. \*...#
#.. .. #*.#....*...L
#...#..\ #...  **. #
#  .. .... .\..  . #
#.\\ *... .#* ..#.##
####################