##########L#########
##L#.....*.*..*. ..#
# * *##\ *.# #..\.##
#...# ....\#*.* *#*#
#. .....*..#.###..*#
###\.... ... *.*...#
#.**\...# *##...\.*#
#\....*.*.\ .#.*...#
#..*.#**. .*. .#.#.#
#*..*.. ...*...#*..#
#..*.\#... \.. #* .#
#  ..*..# \.. \\.#*#
# . \#......... ...#
#*... *##.. ...\.###
# *.\#.#..#...#....#
#**.*#*##* . .\##*.#
#. .\.# \ \#..\\.\##
#R** ..#\. . \ ###.#
#.# ... *.*.*..*.. #
####################