#L##################
#...  ..*\. . .#. *#
##..\...#.....#*.#.#
# ... ..  ..*..  ..#
#.#....\  #..*.* ..#
##..\. .. *   #...*#
#..# ... *...\..*..#
##.. ...\......##..#
##*.*..#.*..#. ... #
#  ..#. R.. *..**#.#
# .##.#. *.*#..\ .*#
#\.. *..*..... #. ##
#.*\* \..#* *..\..*#
# .. .. ... #  #..\#
#.  . #..*.. .. #..#
#.......  *..*#*#..#
#.#. .  .. .. .....#
##  . .#*..**\.\...#
##....*. .  .# .  ##
####################