####################
# .. ..*##...* #.# #
#...*.\*.\.* \ ..  #
##. .#.....*...* .##
#.....  ...* \.  *.#
#......# ..*..\...*#
#.*\. . ..\. ...#*.#
###  ..... ..  * **#
#.. .\ **#.. ... ..#
#..#\*. #... .. ...#
#.....#....##..# \.#
#. .# #...\ ..#R.\*#
#.  ... .... . .\ .#
# #..... ..... ....#
#..*.##.*.*.*.\. *.#
#. ..# . # .*.#....#
#.*... * *# .*.#*..#
#. .....\. .\# .#..#
##...# .*.*.*.  .*.#
####L###############