####################
#\...  ..  .... *..#
# .  .#*..#..#. ...#
#...*#..  .. .**.*.#
#. ...*..\.#... # .#
#.#......*. ... *..#
## \##..#... ...* .#
#....#* #  *#. ..\.#
##  .\ .R. .. .# *.#
### .  .\..#*.\. ..#
#..# ........*..*. #
#\.. #.\# \...**. .#
#.*# ..# # .. .....#
#. *   . ..*.......#
# ... ##.  .... ...#
#...#...# .....*...#
#.#   .. . . ...\. #
#.*.* ...*.**......#
#..# .... ** .. . .#
###############L####