####################
## . #.#..#.\.\.\ .#
#... . L** **.*.*.##
#\.*.#.\*#.. ...#\*#
### ##..... #\..**.#
#.R.*..#..#.. ..#\*#
### \* ...**\.... *#
L .#*.\..##.\...#. #
# #.#...#..*#\.  * #
#..*\.*. ##.*.  *###
#...#.....#*.*..# .#
#......*. . .#  .#.#
#...\.*.*.#*\#... .#
##  ..\. \...*.\ *##
#.#..*.\....#. .. *#
#*  # #\.*#... #\#.#
#*.. # .#...#.*L..*#
# ....** . . .#. *.#
#\*#...  \# .   ...#
####################