####################
#...... ......\.#.##
# .#  *\\....\.....#
#...\...#*\**.#.#. #
#. * ... . ....... #
#*. .*\.*.\. ..\.*.#
#*.\.#. .\\........#
#. \ ....*.# # ### #
# .R.# .\*.  . ...*#
#.....#.. ..... ..*#
#.#.\......#.....* #
#...\..*...# .*\. *#
##... .  .. #. ##.\#
#.\....  ..\.. .*.##
#... ....**    ...\#
#..#*.... .# ## .  #
# .*#.  #.#......  #
#.##*. \.#.**.  \*.#
# . ..*.##........*#
########L###########