####################
#..# .  # #*.* # ..#
#. .. . \ .*#.* ...#
#..#.  *\ *. .** .*#
#.  # ..*.... **.#.#
#.#.... #..#R......#
#. . ... \.. ......#
#\.*..*#. \.. .... #
#..\.#\#...*.......#
#....... .#...... \#
# ...*.#*.#.. #.. .#
#....   ..*.... *..#
#. ... *..*.* .\.. #
#......... . **.*..#
##..\*. ..**.. #.#\#
#  ..*\.\.#..*.#\.##
#..*..\..  .. ...  #
#.#...... .......\##
#..... ..*.*. \.  .#
####L###############