####################
#....#..\*.  #..# .#
#....*.*#.#. .*.*..#
# R\.#...*.......  #
# \ . ...#. ....# \#
# #.... ... ... ..*#
##.... .........** #
#.#**.\..\*. ....*.#
#... *#*..*....#**.#
#.#*.....# *.#. . ##
#. .##.*.   . .  ..#
#..* ..# \. #..# .##
#.*# .. .# ...\ \. #
#...\# .  #...*.. \#
#..**#.....#... . .#
#. .\. .  #...***..#
# **..#.. ...... \##
#..  #. . * *. ....#
#..#. # .#. .. ....#
#####L##############