####################
#...**#....#\ .  ..#
# *.#..\*.#.**  #\##
#  .#.....## .  .. #
#..#.....#..#.\..*.#
# .*.... . .#.#.#..#
#.........*....*...#
#....  .  .. #   *.#
##..... .#. ..#..**#
#.**.#..# . . *\.  #
# . ... #.....#...\#
#* ...*.\ . .. ..\*#
# . * .\\#....  . .#
#..*..\.... *. ...##
#..#  *. #.#.\ # .*#
# ..#..#.* ..\*.  .#
#.....  .. *....\..#
#.* * ...#..#.#....L
#..#.*.. *#\.R.*#* #
####################