########L###########
#**..*#.........##.#
#*\.#.\ #...\... #.#
# #*.#.#*#.*##\... #
# #.# . #* .\.##*#.#
#... ..#.... \#.#..#
#.*..... .......*..#
#. *... ..#.* #*#..#
#.. \.. ..*\ *. #..#
# ..\.#..\***. ##  #
##*.*..*..*#.#*   .#
#.\.#. .#.. #..*####
#.# .\*.#...*\*.\*.#
#* .. ..#\ ....#.\\#
#..\\#... .R...L...#
#. *##...\ .* \....#
#.##..#\ *## . \...#
#**.# #. ##\.*. ..*#
# *.#..**#L.. .# ..#
####################