####################
#.........#...... .#
#....* #.## #.. .*.#
#...*. .#....*. ...#
#.. # .\*# ..#..#. #
##......\ .  ..... #
#*#*.. .*.. .......#
#..\ ....*....# #\.#
#..  ...\....#* . *#
## .#....#.... . ..#
#...* ...#.**.#....#
#..\ *.*.\  .# *.#.#
#  .##..# # \. .. .#
#. . \.##...*. ..#.#
#....##\..*.\...* .L
#.....*.. ...*...*R#
## . ..  .....*  . #
##...... # . # .#.##
#. .*\ ... ....#\..#
####################