###############L####
#*.... .......* .#*#
#*   *\*.##.*.....R#
# ..#.. .... #  .* #
#.*\..#.. ...#.*..##
#........#. #.#....#
#\.\.*.. ..*\ # \ .#
#  ... ..*#*...*.. #
##. ..*....## \. ..#
#..* .  .*........\#
# * ....*... .* .#.#
#......*...*....* .#
#..  *..... .......#
#. #  .. .  .. ..**#
##.*\*... .#..  .. #
#..#* . .#.*..\\...#
#  #  .  ...  .....#
#*#.... *.....*. ..#
##..*#.\.#.#.\ ## .#
####################