#################L##
#*. .*.....*.......#
#.*.#.... *...   . #
#.  .....*.  \.*..##
#....\#. #.........#
#..*.\.#.*...... ..#
#......  ...#.... .#
#.#..*. .*.... . \.#
#* .#.....*.. *#...#
# \#.*###  #. .*.* #
#.# *#.#..#*....*\.#
#..##..... ... ...*#
#. .* .#.. ..\  .#.#
#\.*....\.. * ...R.#
#. .\.#..\.. ** .###
#....  . .*..##.  ##
#..  \. . *#.....#.#
# ..*....#.# ..\...#
#.  ..  *.*..\.*. .#
####################