####################
#..#.... * . *.....#
#*....** .#...*..*.#
#....#.....*. .....#
#.....#\.#\ .......#
#. .... *..*#......#
#..#.#*. ......*.. #
#..*...........#\.##
#. .#.......*....*.#
#.\.#.. *#...R... .#
##. *.\\.\## \.  .##
#.. .. .... .*.\ . #
#\.. .. ......*.*..#
# .*.\\ .. . .  \#.#
#..*. .*... .. \ *.#
# * ...\. *. .. ..\#
# .. .. **.##  .*.\L
##. \#..  . .*.....#
#  . ..*.... *.\* .#
####################