####################
#*......* ...\... .#
#.* ...# \#. . ... #
# . .*...# #.*.. . #
#.#.....#.*#*.\. *.#
#*..\\.*.*#. .. \..#
#...#....#....# .. #
#....#  .##.#... . #
#... . ..#...\. ..*#
#. *#*.*. ....\. #.#
#.*.....* #  ..**.*#
#*. .....#*.. ..##.#
#.. ..#......* .. .#
#..\....  ..\ *#..\#
#. .... *..  .*#...#
#. *....#*.. . ..\*#
#. .. . ..*.... ...#
L..... \.*\.#R# #. #
#. #..... .*..##...#
####################