####################
#..... ..* \...**#.#
#...#.#R ....\....\#
## .  *.*#.  .....##
#** . ....#......\*#
#*.........\ . *.. #
#. .* * ..  .. ....#
#..  .#*.\**.\..**.#
#.......* .\#. .. .#
#*. .....*.#\ .... #
#..\...#..*...### .#
# \ .  *. .... \...#
#.. ...\.. . .. #..#
# .#.\*##.  .#.....#
##..... .* .  .  . #
#...**.\#...#*\.*..#
#*. . .....   ...*.#
#......# .\.. . .. #
# .  .. ..* # *....#
##############L#####