####################
#.. .........#   ..#
#..* ..*. #.#.#\R..#
## *.*.#*.*.*.. \..#
#. .\*\  #. *......#
L #..##..#.*... #*##
##.# . ....#\ .....#
#  .... #*.*.. ..*.#
#... . . ........#\#
##   . #\ #.\..#*.*#
#.*.#.# .  **....#.#
#  ..#..  *...  .. #
#.*.....#... ....  #
#........ #.......##
#  .*.*\.........*.#
#...* . #  #.. ....#
#.. *..\  .*.*.#.*##
#..\.  ... ***.  . #
#..#..\ #.#.. *\ ..#
####################