##########
# ....   #
#. ..  *.#
L... \R..#
##.... .##
#....##\ #
#. .#.#..#
#..... ..#
# ...... #
##########