##########
# \#  .\.#
# .. . ..#
#.*. ....#
# *#*. ..#
#...R... #
##..*\*. #
#..... *.#
#..*..\.\#
#######L##