######L###
#.. *.  .#
#*. .\ ..#
#..# .*.##
#..*. ...#
#..... *##
#*...R*  #
#.#.\. ..#
#  *#...##
##########