##########
##......*#
#..*... .#
#..#R..*.#
#..** .. #
#. .. .*##
#.. . .#.#
#.#.#....#
##..*\.#.#
###L######