##########
#..*.**..#
L. ..*..*#
#.... .. #
# .R.**.##
#.... . .#
##....#. #
#.**.  .##
#.\ ..   #
##########