##########
#....... #
#   . *#.#
#..R.#.#.#
#..  . **#
#...#  ..#
L. .#.*. #
##   **.*#
#. \\# ..#
##########