##########
#....**#\#
# ...#.. #
#.....*#.#
L##*  ...#
#*. .....#
###\#*.#.#
#...* . .#
#*.##   R#
##########