########L#
#. ...*#.#
# ..\# ..#
#*.   * .#
#. ...R..#
# . .*...#
#\. ##.# #
# \.#.#..#
#...*. **#
##########