##########
#* *... .#
#.....*..#
# .**#.#.#
L..*  ..##
#..#... .#
##..\R.#.#
#.......*#
#..# .#..#
##########