#L########
#... .* .#
#.\ .*.R.#
#. #\  #.#
#. # ..# #
# ...  . #
#..*.... #
#. .\...##
#**....\ #
##########