##########
#. .#*.#.#
#.. .*\..#
#.#.*. .*#
#.* # ...#
#. ..#.#.L
#\..#\*..#
#.\# ...##
#R\ *..* #
##########