##########
#..  # *##
#.#.  ...#
##...*...#
# ... * .#
#*.......#
#.#*#.*R #
# *...#..#
#.##. \..#
###L######