#L########
# .#....##
# . . ...#
#.... \ .#
#\.#.##..#
##R..\ \ #
#\*#.#. .#
#. ..**\ #
# #.*#\. #
##########