##########
#*..*.R. #
#**#.*#..#
#*\# #.. #
#.. .*.. L
#.#*..#L #
#...*\.# #
#.* #  ..#
#.....# .#
##########