##########
#.. ... ##
##.#.*####
#. .  ...#
#*... .*.#
#R * ...*#
#  .. .\.#
#. \. *..#
#..#..\\ #
###L######