##########
#\..#  ..#
#.*.   . #
#.* ..#..#
# ... . .L
#.. . .  #
##* ..#*.#
#\.  .#.##
# . ..R.*#
##########