##########
#.#. .##.#
# ..\...\#
# * . ...#
#...*.**##
#..  R...#
#... *.. #
#. .. ..##
#.... *..#
###L######