##########
#..**.R .#
L.\\\*...#
#\..#..#.#
#...#...*#
#.\......#
#.... ..##
##   ....#
#.#.. ##.#
##########