####L#####
#. . .\###
# .#.....#
#.*.R. ..#
#  .....##
#*...#...#
#.... ##.#
#.....#..#
##.**.* .#
##########