##########
#.#   ...#
#..\*. ..#
#####.  .#
#.#.\...*#
##... ...#
#..   .#.#
#.R....# #
# .**.. .#
##L#######