##########
#.#R . #.#
#*#.. .*.#
#. . ..* #
#.*.*.#..#
#.*....\ #
#.  .* ..#
#. *.#*.##
#..# *.**#
#L########