##########
#.##. .#.#
#\...\.. #
#... . * #
##**.*...#
#...R  ..#
# ..* ...#
##.. .. .#
#..* ....#
######L###