##########
## #\#***#
#*.#R#...#
#.#...  ##
#.. . \ .#
L  .#*..*#
#\.#*..* #
##.....*L#
# . * ...#
##########