##########
# R......#
# *L.L # #
#.#.\.* ##
#.. **.*\#
## #...#.#
##*. .#*##
#..#.###.#
L......**#
##########