###L######
#..#..#. #
#R. ...  #
##\. \.. #
#. ...* .#
#*.*.\. .#
#....*..\#
##.   \* #
#.\. .*  #
##########