##########
#..*.* .\#
#.#..  ..#
L L*....##
#...R..  #
#\.*.#...#
##.*.# ..#
#.#*....##
#* #.**..#
##########