##########
#.*...*. #
#......# #
#  #*...*#
#*. ...\##
#.\. .R..#
L  *. * .#
# ...* ..#
#..#.# .##
##########