#L########
#.. .#.\.#
# ...   .#
#\...#   #
#.#..*...#
# ... #..#
#.. . .# #
# ..R# \.#
#..\ ..#.#
##########