###L######
#*.*... .#
#...#..*.#
#*. .R*#.#
# * ..##.#
#.. .**..#
##\*### .#
# .\.#.\.#
#.*..*\  #
##########