##########
#  #..*..#
##.R*. ..#
#... .. .#
## #... .L
# \.... .#
#...*.**.#
#.. ...# #
#\* * .\ #
##########