##########
#.....R* #
#.  *.*. #
# .  .\# #
#........#
#.....  ##
# ...  .*#
L . . . .#
#.. .* #.#
##########