##########
# .. ..#.L
# . \ #. #
#.   ...R#
#   #.#..#
#..\ \# .#
#..*..#.*#
#..#*#   #
#..\ \. .#
##########