##########
#R*. ###.#
#...#.*\.#
#..\.\*\\#
#.... .* #
## .*.####
#.*...*\.#
#*##*.####
#\ ..\#\.#
###L######