##########
#*.. ....L
#* ..  \.#
#..*.## .#
#.\.. \. #
#... . *.#
#... . .*#
#\...##R #
# #   ...#
##########