########L#
#*... .# #
#.* . . *#
#...* R.##
#  .*.#..#
#.**  \#.#
#... ..#.#
#*.. #.#*#
#..#**..*#
##########