##########
#.\**. #\#
#..... .##
##..#.#.R#
#.# #*L.##
# .  .. *#
#  #\##* #
#. .*..#.#
#.**\#*#.L
##########