##########
# \#. ..\#
#..*..**.#
#    . ..#
#. .... ##
#...  .  #
#R##..#  #
#..*  ...#
#*#. .. .#
#####L####