##########
#*...#..##
# ...*#.##
## *.\* .#
#..\L..*.#
#..\..\*##
#..#.#. ##
#.*.  ..*L
#.\. #..R#
##########