##########
#. *. \ .#
# .. ..\.#
#.. .  ..#
#.\ ..##*#
#.# .*#..#
#* *R..# #
##. ..#.*#
L..... .*#
##########