##########
#.#..... #
# *.# ...#
#. \.....#
L R...#\.#
# ..#.*.*#
# .  .. .#
# . ...\ #
# .. ..*.#
##########