##########
#.... ...#
#\.#.... #
#  . .R\.#
##.**....#
#...#...#L
#. .#. #*#
#. .\    #
#....  \.#
##########