##########
#. ..#.* #
#.... . .#
#.# *#.#.#
#.  ....R#
# *... # #
#.*\*. #*#
# ...#...#
#**.\. ..#
####L#####