##########
#....**#.#
#. ...\*.#
# ..*. . L
# R*.  ..#
#.*  ....#
#...*....#
#..  ....#
#.#.#.#*.#
##########