##########
##.......#
##.# .R .#
#......*.#
# #..\. *#
#..##. .*#
#.*\ ....#
# #*\.*\\#
#....... #
##L#######