##########
##...#*  #
#.. .\.#.#
#  *R...*#
##* .....#
#... .*..#
##.*. #..#
#.. \. .*#
#.  .* ..#
###L######