##########
#.. *.. .#
#. *#. .*#
#....\..\#
#.#.#.#..L
#\\...\* #
#....##..#
#.....  .#
#..*..R. #
##########