##########
#.. .#...#
#.#.... .#
#*  .\..##
##..*R...#
#.##\..\.L
#. .  *. #
#  .*... #
#.  .#.. #
##########