##########
#  \..   #
# *.  . .#
#*\..*..##
#. *\.\..#
#  ... ..#
#. .*.. #L
#\... \..#
#.#.*.#R.#
##########