##########
L . ..*. #
# .#* # .#
##..\*.#.#
#* \#*#..#
#.#\.. . #
#.*. ....#
#.\...*\ #
#.R...#\##
##########