##L#######
# .**.. .#
#.R....# #
#..   .#.#
##... ...#
#.#.\...*#
#####.  .#
#..\*. ..#
#.#   ...#
##########