##########
#  .## .\#
#..\#*\ .#
# #....*.#
# .\R...##
#*... \..#
#.#... ###
##. ..#..#
#.. #..#.#
########L#