##########
#.# *. ..#
#. . . . L
#*.  ... #
##  .....#
#........#
# #\.  . #
# .*.*  .#
# *R.....#
##########