##L#######
#....\ #.#
#... ..\##
#..\#\.#.#
#..##.*..#
#..\*.#.##
# ..* #\ #
#.... *R##
##...*...#
##########