##L#######
# ... #*.#
#. ....*.#
#.. *# ..#
#. ... .*#
# ..*.*.*#
# .....#R#
#.\.. ..##
#..#.# \\#
##########