##########
#..#. *..#
#. *.**..#
#*\    .##
#\.*.*. .#
#*\ R**. #
# *.#...*#
#......*.#
#..*... *L
##########