#######L##
#.# ... *#
#. ..R..##
#.* ...###
#. ..  ###
#.....**.#
# ...\#..#
#.. ... .#
##.... ..#
##########