###L######
# #......#
#. ..*#.*#
#*  R# ..#
##...#.  #
# ..*...*#
#.*...#*##
#... ..\.#
#*.#..\#.#
##########