##########
#.. .. ..#
#\  ..#\##
#.  .#. .#
## #*  #.#
#......R #
# .... .\#
#...#....#
L. \. . .#
##########