##########
#.\ * #..#
# . .\..##
#... .\*.#
#..  ...##
#. .\  *.#
#\R #.*..#
#...*...*#
#.  .....#
####L#####