##########
#*....\.\#
#*#...\.\#
#. . *...#
#.*.#.. .#
#.... ..##
#....#\#.#
#.....\\R#
#..#....*#
#####L####