##########
#.\  ....#
#    \. .#
#*# .#. .#
L#...#...#
#....**.##
#.\R. .  #
# ....#.\#
#... ....#
##########