##L#######
#.# ..#.\#
#.#...R\.#
#*.* * ..#
##*  #. .#
#.  . *. #
##.*  .. #
#..# ..# #
## .. .. #
##########