##########
#   ..\  #
#. .  .* #
##..*..\*#
#..\.\* .#
#.. ...  #
L# ..*. .#
#..\ ...\#
#.R#.*.#.#
##########