##########
# ..*....#
#\#*#...*#
#. .#.* .#
#....\#* #
# ....R..#
#. * #...#
#.*......#
#. *...*.#
##L#######