##########
# .\#*.# #
# \**.. .#
#. .#.#*\#
# \ \..R##
#..##.#.\#
#. \ ....#
#... . . #
##....#. #
########L#