##########
#.... ..\#
#. \#*...#
L\....* .#
#..\#.*###
#.#.R ##.#
# ..  \. #
#.  .....#
## .. .\.#
##########