##########
#....#.  #
#.*  #  .#
#...#..*.L
#..*.#...#
# R..\...#
# ....*.*#
#....... #
#.#.**.#\#
##########