##########
##. #.#..#
#.. *... #
#. * .*  L
#..R. .\.#
##\... .*#
#*...*#  #
# #......#
# .*...*.#
##########