##########
# . ..*..#
# #.R* ..#
#...# .#*L
#. .. *..#
#....* . #
#.# ..  .#
#. .   ..#
#.... * .#
##########