##########
#..*.. .*#
#.  *.# .#
##...#.. #
##R#*.* ##
#* ..  ..#
## . . #.#
#. ... \\#
#.... # .#
#####L####