#####L####
#.. .\.**#
#...#... #
#*# .*\*.#
# # ...* #
#R....  .#
#.#.#* #.#
#. . ....#
# *.#.. .#
##########