##########
#***...  #
#   ....\#
##.. ... #
#\*.##*.##
#.....#. #
L...R....#
#*.  ..* #
# ....#.*#
##########