##########
#...#  ..#
# ..# *..#
#.*. ....#
#....\*. #
##.##..  #
# ....** #
# .. #**.#
# .....R.#
#####L####