##L#######
#... \ #.#
#.*\ #. *#
#  #. .  #
##... .. #
#..* ...##
# .* . . #
#.. .*..*#
#. . .R.\#
##########