##########
#.*  * #.#
#*#.\#R.*#
#.*.. ...#
#.......##
#. .*.  .#
#.......*#
L*\....  #
#.**.##.##
##########