##########
#  .#....#
#.  #  *.#
L.*..#...#
#...#.*..#
#...\..R #
#*.*.... #
# .......#
#\#.**.#.#
##########