##L#######
#..R. ...#
#..#.\.#.#
##.\.... #
#\ ## .*.#
#.....*. #
#\..#.. .#
# ...\ *.#
#\.......#
##########