##########
#..# *.* #
#..#.\\..#
#.. . ...#
#...#.#..#
#.. .. ..#
#..R ...*#
#..*.... #
#.***.**.#
######L###