##########
#\\ #.#..#
##.. ..\.#
#R#..... #
#*.*.*.. #
#*. ... .#
#.. #* ..#
#.*.... .#
#.*# ... #
#######L##