##########
#. . ... #
#.  .....#
#. ..*...#
##.... . #
#..R.....#
#* ..#..##
#..... ..#
##      .#
#######L##