##########
# . \....L
#..#.** .#
#. .#.#.*#
# . #.#..#
# * #.# .#
# *.. .. #
# *R *  .#
##..   ..#
##########