#########
##..#R .#
#  . . .#
#.......#
#..*\*..#
##... .*#
#*..  ..#
#. .....#
##L######