#########
#.*.. *.#
#.. ....#
#. .....#
#. ...  #
##......#
L .*..R.#
#.*#...##
#########