#########
#.*...\.L
#\* . ..#
#*....R*#
#.*. #*##
#..*...##
# .. #.\#
#.## *..#
#########