#########
#.*...\.#
#*..*...#
#*\..*#.#
# #.   .#
#.*...*.#
#..R.# .#
# .*#...L
#########