#########
##..*.* #
#\..... #
#..* ..\#
##.R . .#
# .#.. .#
#...\.##L
# .\#.#.#
#########