#########
#.. ...*#
#R... ..#
#\*.*...#
#...*...#
#.##..\##
#... . ##
#.*##. .#
######L##