#########
#.R.. #.#
#..#. ..#
L #.... #
# *...#.#
##.# . .#
#.***  \#
#.......#
#########