#########
#...#.#\#
#.##....#
#..# *..#
#**.\...L
#. .....#
##.*\.  #
#..#\R .#
#########