#########
# #...  #
#*.*#* .#
# ..*#.R#
#\.*.  .#
#\...  .#
#.\. . .#
#.#*...\L
#########