#########
#. *....#
## .##L\#
#\#..* .#
###.* \ #
# #\###.#
L\. #R..#
#. #\.*.#
#########