######L##
##..* #.#
#. \ #*\#
#  ..*..#
#.. . .R#
#.*.. ..#
#....*. #
#.#...\.#
#########