#########
#. R\#..#
#  .\*.##
#..... .#
L...\.**#
#..* #..#
#....##.#
#\#.#...#
#########