#########
#.....*#L
#*.\##\.#
#  .*.\##
#..#.  R#
#.... ..#
# \#.. *#
#.. \.. #
#########