#########
#.. . **#
#. . .. #
#..*. *.L
# ...*.\#
#...#.\\#
#R\ ...\#
#*.. ...#
#########