#########
#. ..R*.#
#... *..#
#. .*. .#
#.**...*#
#.. #.# #
#.*...#.#
#...*..##
##L######