#########
#. ##...#
#....*.R#
# ..#...#
#...\   #
#. ....##
#.\.  **#
#.*.... #
#L#######