#########
#. .... #
#...*..*#
#...  .\#
#...R...#
#\.#\...#
#... . .#
# * .. *#
######L##