#########
# .... .#
#*..*...#
#\.  ...#
#...R...#
#...\#.\#
#. . ...#
#* .. * #
##L######