#########
##* ....#
#**#.*R##
#.... ..#
#.#...\##
# .. .. #
# * #.. #
#.#.* ..#
######L##