#L#######
#..... ##
#.\R. ..#
#.  .#.##
#.*\..#.#
#.....*.#
# .. #.\#
#.*. .. #
#########