#########
## *....#
#...\...#
# .*.. ##
#\.*..###
# .#.\# L
#. R*...#
# ......#
#########