#######L#
# *.R#.##
#. . \\*#
#..  .#.#
#\...*#.#
# #.#.\.#
#.\.. ..#
#. .. *.#
#########