###L#####
#..  #..#
#R.#*.*.#
#.#..#*.#
#.... *.#
#  ... .#
##..#  .#
#.. ..\.#
#########