#########
## *. .##
##...\\.#
#...* #.#
#..#.R*.#
#*.\. *.#
#..\.*..#
#. ..#..#
###L#####