#####L###
#. .**. #
#. ..R..#
#\. . .##
###\.. .#
#.### *.#
#..*..  #
#\.... .#
#########