#########
## . ...#
#.*. ...#
#*. ..*.#
##R... *#
###..*..#
#..*... #
#*......#
######L##