#########
#...R\* #
#.. ...*#
#.  . .##
# ..#\ .L
#\.  #\##
# .. \..#
#. \ \..#
#########