##L######
#. #....#
#*..  .*#
##*... .#
#.......#
#...... #
#.R. ..*#
##.. ...#
#########