#########
##.. ##.#
#....#. #
# ...* .#
#..... .#
#..*.\..L
#R. # ..#
#. . .###
#########