#######L#
#*#.# . #
#.......#
#.R . ..#
#..*....#
#.  #...#
#.  #*..#
#...\.#*#
#########