#######L#
#.. ....#
#. . ...#
#.   ...#
#.\.. #.#
#.#R#*. #
#.\ ..#*#
#*. #..##
#########