#########
###.\..\#
#.  .. *#
#.#.#.*##
#   .#\.#
#*..  #.#
#..\..#.#
##.#.R *#
######L##