#########
# . #..*#
#....*.*#
#... \..L
#. .. ..#
#..#..#R#
#.\....*#
#......\#
#########