#########
# . * ..#
# .  *.##
#. *.  .#
#...*#. L
#.. .#R*#
#.....*.#
# * *...#
#########