#########
#....\. #
#*...#R.#
##\ . .\#
#..*....#
#.  .#*.#
# ..*.\ #
#...* ..#
######L##