#########
L..#... #
# .R... #
# .  ...#
# # .##.#
##.....##
#.#.\.*.#
## .\ .##
#########