##L######
#..R....#
#*  .#..#
#... .*.#
#** ..*.#
##. ... #
##.# .#.#
#. .\.. #
#########