#######L#
#. .*.#.#
#..**  ##
#. .R.. #
## .... #
#..#. ..#
#.*# ...#
#..*.*..#
#########