###L#####
#.L....\#
#*.*.####
#.....*.#
###. R#*#
#.#..#.*#
#*..*.# #
#..*#. ##
#########