#########
##..R.. #
#\#.  ..#
#\*.#...#
#. ..# .#
#.*..#*.#
# #.. .*L
#.\\* ..#
#########