#########
#.#... .#
#...R..##
#.....#.#
#.......#
L . \.*.#
#\..* . #
#.. ..#*#
#########