#########
###.\**.#
#.....R.#
#.# * . #
#... . *L
#.#*.**.#
#..#**..#
#. .\ ..#
#########