#########
# .  ...#
#  ...  #
#.#...R.#
#.......#
# ... ..#
L*#.#.#*#
# .# #\\#
#########