#######L#
#R..\...#
#..*.#.*#
#*#...  #
# *. .*.#
##\..*..#
# #\\.*.#
#*..\.* #
#########