#########
#.. ..#L#
#*.#.. *#
#... #..#
#. . .. #
#.*..#.##
#.\.. *##
#R.#....#
#L#######