#########
##*..  .#
#**.#.*##
# #... .#
#.... #*#
#.* ... #
#.R.\...L
#.#.#  .#
#########