#########
#..#. * #
#..... .#
# *  ...#
LR.#..\.#
###. *..#
#.**.   #
#.\..  .#
#########