######L##
#\......#
##*.. *.#
#.*..*  #
#.......#
# .. .#R#
#. . ...#
#   .** #
#########