#########
#*\L*.#.#
# #\....#
#.......#
# \...#*L
##.*##.R#
#. . .*##
#\.#\.**#
#########