#########
#.*#\...#
# ......#
#.#R... #
##....*.#
#  ..#.##
#..*.*..#
#*.\.\ .#
#L#######