#########
#*...##.#
#....\  L
#. .....#
#..**. ##
# ...#.##
#..*.#.*#
#.R\....#
#########