#L#######
#..*. #.#
# . ..\.#
#* *. .##
#.... . #
#.*. #. #
##. *.. #
#.# . .R#
#########