#########
#...#*..#
#.......#
# #\ .\ #
#.* . .##
##\#R\L##
#.* ..*\L
#...*.*.#
#########