#########
####...*#
#..... #L
#..* . .#
#**..##.#
#R.#..#.#
# ..*. .#
#*\.....#
#########