######L##
#R.  ..*#
#..... ##
#....*# #
#... ...#
#.. #\. #
##...  .#
#*.*.* .#
#########