#########
###..* .#
#*#\\R*.#
#..*  ..#
#..#..*##
#....L.##
#.....\.#
#  .....#
#####L###