#########
# .#..R.#
#.#.....#
#\.\#.\ #
#...\ *.#
#..#.#..#
#.*..#.##
#. ###..#
##L######