#########
#..#.  ##
#\\..*.##
#....\ .#
#.\. ...#
#\.# . .#
#* . ..*#
#... R*.#
####L####