######L##
#* .  . #
# #. R..#
#. ...  #
## . . .#
#...\ . #
#.......#
#..*....#
#########