#########
#.*.. # #
#*..*\#.#
# .\ .*\#
#.  ... #
#.. #..R#
#*..  ..#
##...#..#
#######L#