#####L###
#..#..###
#.#. *..#
#\...#.##
#. * .\\#
#.*.\#*.#
# **.*.##
#R\\. \.#
#########