#########
#. ....*#
L. .. #.#
##  ....#
#  ..#\\#
#...... #
#..#*. *#
#.R.#.**#
#########