#########
#.. . . #
#...  ..L
#.. ..R #
#..\ .  #
#*......#
#...  # #
#...#. *#
#########