#########
#\#.#...#
#....##.#
#..* #..#
L...\.**#
#..... .#
#  .\*.##
#. R\#..#
#########