#########
#\*. R.\#
#\#.*. .L
#..\.. .#
##.*....#
#....*  #
#.##....#
#...#*..#
#########