#########
#...... #
# . \.R##
#..*..  #
#.. ...*#
#... *#.#
##..*.*.#
#...\#. #
##L######