#########
#...*.. #
#\.. .. #
#\ .*.. #
##...R..#
# *....*#
L......\#
#**..*#\#
#########