#########
# . #.\##
#.......#
#\.#R*..#
##\.  .*#
#.......#
###  ..*#
#.#..\  #
##L######