######L##
#....R..#
#..#.  *#
#.*. ...#
#.*.. **#
# ... .##
#.#. #.##
# ..\. .#
#########