#########
#..\..###
# # ... #
##. .. .#
#* #*\ .#
#. .*...#
L..#\...#
##.*...R#
#########