#########
#  *  ..#
# * ....L
#.... ..#
## \\.. #
#  . . .#
#. ..*\ #
# .... R#
#########