#########
##   .\*#
#.. #\. #
#.##.**.#
#..*. # #
##**. .##
#. .**\*#
#\.#.R .#
######L##