#########
#....#*.#
# ** R.*#
##*..#. #
#*.# .* #
#..*.*#*#
#......*#
#***....#
#######L#