##L######
#.#..\  #
###  ..*#
#.......#
##\.  .*#
#\.#R*..#
#.......#
# . #.\##
#########