###L#####
#.#...#.#
##.... ##
# .R... #
#.#\...*#
#**....*#
#.. . .*#
#. ##...#
#########