#########
L..... .#
#.\ *..*#
#.R \...#
#.....  #
#. #..#.#
# ..#*..#
##.#..\ #
#########