#########
L**.* .R#
#. #..#.#
#.\...  #
#.....**#
#*.#..#.#
##....*.#
# . ....#
#########