#########
#.R# ...#
# .\ .#.#
#....*. #
#...\\*.#
#\#...**#
#*.. . .#
L##*#..*#
#########