#########
# . .*. #
# ...**.#
# *#.\*R#
# *.....#
#..  ...#
##. *  .#
L ..\#..#
#########