#########
#\#R*  .#
#. .*.. #
L#.#.#. #
#.### ..#
#.# .*..#
#\ .# ..#
##..*...#
#########