#########
L.. .#*.#
##. R#..#
#..*\.# #
#.*#.*. #
# \ ...##
#*...\.##
#.* .#. #
#########