#########
##..#.#\#
#*...\. #
#.....*##
#..* * .#
#.\.#.R\#
#. ....*#
#*#...#.#
######L##