#########
# .....*#
#..R...*#
# . *..##
#.... ..#
#... *.*#
#..* ..#L
#\.  .. #
#########