#########
L ..\#..#
##. *  .#
#..  ...#
# *.....#
# *#.\*R#
# ...**.#
# . .*. #
#########