#########
# .... .#
#.. ... #
##. \.  #
#\#.*..*#
#...#*.##
L#..#...#
#.. ..R.#
#########