#########
#....#  L
#*. ..*.#
#  *...##
#\*R....#
#..#. **#
#. ....##
#..*...\#
#########