######L##
# .#\...#
#.*.*..##
#.#* ...#
#*... ..#
#  ..*..#
##R.\ . #
# ......#
#########