####L####
#... R*.#
#* . ..*#
#\.# . .#
#.\. ...#
#....\ .#
#\\..*.##
#..#.  ##
#########