#####L###
#. ....##
##.  ..##
###*.\ .#
# ....# #
#....* .#
#...... #
##. ..R.#
#########