#########
# .    *#
#..*.*. #
# \ *.. #
##* R...#
#. *. ..#
#..  .#.#
##.#..  #
#####L###