#########
#    .###
# ..* . L
#.... *.#
#..* . *#
#\. \*.##
# . .#.##
#.*..R .#
#########