#########
# .\.. .#
#.R..*\.L
#\# .#. #
#.....**#
#.. * ..#
#..\. ..#
#.*#.. .#
#########