#########
#. #. R.#
#...*..\#
#.....  #
# .. *.*#
#.......#
#*. ..\.#
#. #\# \#
###L#####