##L######
#.. *.#.#
# ..# * #
# .. .. #
##\...#.#
#.. ....#
##R*.#**#
#.... *##
#########