#########
##.. ...#
#.R. ..*#
#...... #
#.......#
##*... .#
#*..  .*#
#. #....#
##L######