#########
#...\*.R#
L... ...#
##.*.. .#
##*  ...#
#.#. .**#
#. ....*#
#.......#
#########