####L####
#*. ....#
#. R#*.##
#.*..\*.#
##.. ##.#
#\.\*#\.#
#.#\.##.#
#*  #.**#
#########