######L###
#\ \!    #
#\ **##. #
#\ ..  . #
#\ .. .. #
# .   .W #
# .  #...#
#*R\ #\\\#
#*. !#\\\#
##########