####################
#W... #.........##W#
#\\.. *..........\\#
############\###\###
#\\\\\\\\\.........#
#W*######.######.#.#
####\\...\\\...#.#.#
#\W#####.....###.W.#
#\##\.###.####.#.#.#
#\\##\###\#\\#...#.L
#.......#.#\####.###
#####.###.#.......##
#.......\.R ###...\#
##*######..###..\\\#
#W\\!#\\\**.\#W\\\W#
####################