#################         
#R ..........!\##         
#...#  **  **\  #         
### #       \   #     ##L#
#\  # ###  \    #     #W #
#\  # *.. \     #######  #
#\  # .. \   #   ..      #
#\  # ..\    #   ..      #
#\  # .\     #  #.########
#\\   \ ...........#      
#*     ...####.....#      
#  ##   !!#.. . ####      
# \\\\#   *  *  #         
#################         