         #################
         #  *  *   #\\\\ #
      #### . ..#!!   ##  #
      #.....####...     *#
      #........... \   \\#
########.#  #     \. #  \#
#      ..   #    \.. #  \#
#      ..   #   \ .. #  \#
#  #######     \ ..* #  \#
# W#     #    \  ### #  \#
#L##     #   \       # ###
         #  \**  **  #...#
         ##\!.......... R#
         #################