######
#R* .#
#.\  #
# * \#
#\.  L
######