###############
#R.#\.........#
##.##########.#
#\..........#.#
###########.#.#
#\...... L#.#.#
#\##. ..  *...#
#\.#. *...##.##
#\.######* #.\#
#\......####* #
#\#####\...## #
#\\#.....*##. #
#\\#.#####...##
#\\\.......** #
###############