                  
          ########
     ###### #....#
     #      #... #
     #.\\\  #.*. #
     #*\   \*.*. #
     #\\#####.*.\#
     #\##...#..#\#
######\#....#..#\#
#....*.#.......#.#
#....*.#.......#.#
#.*             RL
#...\... ......#*#
#... ..# ...... .#
#... ..# ...#..\.#
#    ..# ...#..\.#
#...........#..\.#
#.###########..\.#
#... .\\....#..\.#
#\### #\\##\#....#
#\# #..*\\#\#....#
### ##############