   ######   #####
   #..*.#   #\\\#
   #   \#   #\#\#
   # \.##   #\#\#
   # \. #   #\\\#
   #*#. #   #\\\#
   #... #   #   #
   #... #   #\#.#
   #... #   #*..#
####...######.*\#
#   .###  #.*.*\#
#\. ....  #.\*..#
#\. ..... #.\ . #
#   ..*\. *.\ . #
#*\#..*\. #.\ . #
#*\#..... #.  . #
L*\. ..   #.    #
####\\. ######*.#
   #.*\\#   #**.#
   #.*\\#   #**.#
   #.*\*#   # \.#
   #.*.*#   # *.#
   #.*\*#   #\*.#
   #.*#*#   #\\R#
   #.*#*#   #*.\#
   ######   #####