###############
##.. ....\..#*#
#*# ...... .. #
#\# ## .* *#..#
#.. ... ..#.#.#
##.... #\.*#. #
#.....#\...  .#
#..R..**..#.#.#
#. #. . ...# *#
#....\...\# . #
#**..   # #\. #
# ......\.....#
#.... ....... #
##.*.#.. ....#L
###############