############L##
# * ...* ...#.#
#. .*..  .. ..#
##. . #.*.... #
#.\..\....#...#
#. ... .#\#..\#
# ....#......R#
#. .#.#.....  #
#. * \.....#. #
#. ... .\. ...#
#  ..*#..* ..##
#. ...\ *... .#
#.#.....*#\#..#
#. . . . * #..#
###############