###############
#.\ . ... .   #
#.*.\.... . ..#
#* .R#........#
##. ...#.*. \.#
# . ..#.  *...#
##.  .... .*#.#
##  ..#  .... #
# ##.#..#.. ..#
#. *..\#*.... #
#.. *.#. .*  .#
# .*.*\.# . ..#
#. ... ....*..#
#..   ...***..#
###########L###