###############
##\..#..\..\..#
#. ....#. .##\#
#\....  .... .#
#\.#.#.... .#.#
#\. #**..R*.  #
##*## ...*#.# #
#........*..#.#
##. ..\#....#.#
# #*#. ...*  .#
#..*#*. .. #..#
# .  .**.*\.\ #
#..\ *.  .  ..#
#.* ..##. *\#*#
#############L#