###############
#* ......... .#
# .##...# .. .#
#.  ...#.*.*..#
## *.  .......#
#. *.......\*.#
#.# .  . ... ##
## \  \..#R..##
#. .**....\. ##
# ...# .. ..**#
#......\..*.. #
# #\. ......###
#....\  #*##..#
#...# .#..... #
############L##