###############
#.#  ....#.*..#
# ..*.*.##....#
#.*#... ......#
#.#. ..... .**#
#.. ...* #   *L
# .   ... .*.\#
#....*. ..#*# #
#.....*...... #
#..  #.  .....#
# ..\*\ . .## #
# *R\*... ....#
# \. ...\ \...#
#..#..\...#...#
###############