###############
#..\.#.....#\.#
# ..#..#.*R..##
# . \ . . ..#.#
#.\  . *.*.. .L
# .#. ..#.....#
#**.. ...\  . #
#...**.\#...\.#
# ... ...*## .#
#..  . .......#
#..#*\ .....#.#
#..\.. .......#
### ...*.. ...#
#..*##.*.. #..#
###############