###############
#\...#..\. ...L
#..#. .# *. . #
# ....*..*...\#
#..  # *.# .#.#
#...#.. .. ...#
#... *..# ## .#
#  ..#  * ....#
#..#. *. ..\*.#
#*.#.**.\ ..\.#
#... # ..\....#
#* . .. .... .#
##\*\....#R#\.#
#.* *... .....#
###############