###############
#. ......... *#
#. .. #...##. #
#..*.*.#...  .#
#.......  .* ##
#.*\.......* .#
## ... .  . #.#
##..R#..\  \ ##
## .\....**. .#
#**.. .. #... #
# ..*..\......#
###...... .\# #
#..##*#  \....#
# .....#. #...#
##L############