###############
#.*.....*.....#
# ... .#..... #
# . .  ....#.*#
#  .# .* ...* #
# .\ .....  \.#
#......*. .. .#
#.*.. ....R.#.#
L. #.*..*. #..#
##.*.# .*.*.. #
#  \.. #\...#.#
#....#. #..#..#
#..\ ..*.... \#
#. ...**....#.#
###############