###############
#........R...*#
#.. ...* *..  #
#.#......#.\* #
#.. *  \#...#.#
#*#. .** .   .#
#. . #.. #....#
#.\*#. * ..#. #
#* . * * .*.. #
#.\..  \***...#
#........ **#.#
## ...  ..#. ##
L. ...   . .*.#
#..#\..# ..#.##
###############