#####L#########
#..*.#.##..  ##
#\.*....#.... #
# ..\......  .#
#.##.....#  *.#
#\.\#*.###\..*#
#. . .\.*... .#
#......*.  ...#
#*.. . . ...#*#
##.. #. ..*...#
#......*.. ...#
#.  .  #...R..#
#.##. ....... #
#.##\.   . .* #
###############