###############
#....\..**.\. #
#..**#... .#..#
#.. .  ...**..#
#*. ....* ....#
#.\# ...###. *#
#*  *. * *#.. #
#...\ .. .....#
#  ..  ..**\.\#
#*R..*..# ....#
#.. # . #....\#
# .*... .  #..#
##.  ** ..\.. #
L.#\ ..... .*.#
###############