###############
#*.  .*  .....#
#*.*...  . *. #
#.#.\* .\..#  #
#... . ...* #.#
#.. ....*  # .#
##..##. #. .*.#
##...R*. .. *.#
#. *. ...* * .#
#...*..*  .##.#
#. . #.**..#.*#
#.. * ..*..#..#
#.   ... ....##
#..*..... ..###
#######L#######