#####L#########
# #.\.....  . #
#**.. \ .  *..#
# ...\....#\\.#
# .\.. .   .R.#
#.. \... . ...#
#* #.*. ... ..#
#\. #.  . ....#
#. ..#.*...* .#
#....\...*..  #
#  ..#*. *#.#.#
# . .. * . . .#
#..*.  . * ...#
###  #.. . .. #
###############