###############
#.......*. \..#
#*.#....#...\*#
#. ... .#... .L
#*.*#.. . #.* #
#. ...... ...*#
#........ # \.#
# ....\  R.  .#
#  .*.*.  #...#
#.#.# ..* .*.\#
#. ..    #. *\#
# #..  .. #.*.#
#.#.. .. . *..#
#\.... .##.#.##
###############