###############
#.#.#.*. .. ..#
#...\..R...  .#
#...#*. . .# .#
#. ..#.\.#.**.#
#.* ...#...*# #
#..#.... \ \..L
#... ...  . ..#
#...#.. *.....#
#.....\# ...\##
# *. *. .* . ##
##**..#. .#*.*#
#..#.*....##..#
##.. ...... .##
###############