###############
## \  . . . \*#
##...*. ... ..#
#..R. ...*.. .#
# # #. \...* .#
L ..\... .. . #
#.. . .  ..*#.#
#**.   .....*.#
#..#.. \##. ..#
#..#..#.\ ..\ #
# \*# *#.... .#
#...\#*..*... #
##. # #...* ..#
## ..... . ...#
###############