###############
#.#......*....#
#. .#..*. ....#
#* \. .....#*.#
##*..* .... ..#
#*..* ..#. * .#
#. #.* #** **.#
# *.... .#.#R #
#..#*.*\..#*..#
#*.*..# ......#
#.* ..#..#....#
#.....\ .  .  #
#..*\..# ...###
##.*\.#.# #.# #
###L###########