###############
# #*R .*.. ** #
#.\...\...   .#
# .*... . ..#*#
# .\.*..## . ##
#...*.. .*..*\#
#.*. #..##...*#
#....\..  .#.*#
#...*..  . #  #
#.....*# ..#.\#
#.....**.  #..#
#.* #..  .\...#
L..#.#. #.\..*#
#.#\\#....#\#.#
###############