###############
#*\ . . .  \ ##
#.. ... .*...##
#. ..*... .R..#
#. *...\ .# # #
# . .. ...\.. L
#.#*..  . . ..#
#.*.....   .**#
#.. .##\ ..#..#
# \.. \.#..#..#
#. ....#* #*\ #
# ...*..*#\...#
#.. *...# # .##
#... . ..... ##
###############