##########L####
#*# . ....*..*#
#........*. ..#
#..... .#.....#
#   .  ..*#*###
#.. .*..\...  #
#....*...... *#
#.*.\.#  .*.#.#
#.. .  # .# ..#
#.#R. # ..#...#
#.. ...* . #..#
#..  . .#\.. .#
#..  ..**. .*##
##.*.....*#. .#
###############