###############
#... ....\. ..#
#*.*...*..# #*#
##*.\....#.. .#
#. ## . .  . .#
#...... *.*..##
#.##..  ....* #
#*. *\..*....#L
#..#.#. .*# .##
#*#.   ..\  \.#
#\.#...#*..\..#
##.\.R **....##
#.**..  ....*.#
#* ##.......*.#
###############