###############
# .....\. \.# #
##. \#.. ...*.#
# ...  ..  *# #
#.#..... R  # #
#...\...*.\...#
#..  .##.*#.. #
# *. ... \ .\##
#... . #.## . #
#.. ..#.. ..#.#
#...... .\.*#.#
#  ..#.**.# ..#
#...... .#* .\#
# .#..#. * * .#
##########L####