###L###########
#  .... ..*.#.#
#.....  ...*. #
#.. .#.#. #. .#
#.\*.. . .\**\#
#...#...*..*#.#
#.......  ... #
#.#\\ ##.*    #
#.....  ..**..#
#.# ...*..\#..#
#..  ...*.\#..#
#...#.\ #.\.\.#
#. *.*.*.   ..#
##..#R. ..#...#
###############