###############
#..# ..*.##*..#
#... ..*... ###
#....... ..\..#
#.#..... \*#..#
#....... .  ..#
#. ##*... ... #
#.\...#\.**...#
# .  \... ..**#
#.....#.. .#. #
L. ..*.* .  \.#
#.#.. . . \ . #
##..R*.#..#.. #
#.\#.....#.\..#
###############