###############
#*#  ..#... ..#
#.# .*.#*.# ..#
L\.... .#\...*#
#. ....*... ..#
#.\*.... .*#..#
#.. .... .... #
#.*.#.#*...  .#
# .* ...\#*...#
#*. #......*. #
#... #**\.\#. #
#.....#    ..##
#.*.  ..#...###
# .R... ..#*. #
###############