###############
#..**.  \ # ..#
#\.. .* .. .. #
#.  ..\#.  ...#
#.. *#....\. .#
#.*...... ....L
#  ....  .....#
#*.. .... ..\.#
#.. ..* ..R.#.#
#.*\.....#....#
##...*...... .#
#  #...... ...#
#..\..#.......#
# ## \ .....*.#
###############