###############
#*.\. # . *.*.#
#......*.... .#
#.\. #.... #  #
# . #R*.\.... #
# ...*  .....##
#. ........*.##
#.......\ *\.*#
#...** *  ..#.#
L ...... #   .#
#. .* #.  #.\##
##.*..* #... .#
#.  ......#.  #
#..#. ..# *   #
###############