###############
#......*\\.*..#
#. .. . .  .#\#
#. .#..\ #\..R#
#..   ..\ . ..#
#* .....*..*# #
#. #.  .* ..  #
#.. .... .....#
#.. .. #.. *..#
#*.\.  .....*.#
#....****.....#
##.*. ..*.\ .*#
L..  .\#.#... #
#. ...#..* .\ #
###############