###############
# *. .   .\##.#
# ....... .##.#
#..R...#  .  .#
#... ..*......#
#...*.. .# ..##
#*#... . . ..*#
#...  .*......#
#. ...*.\. . .#
#*..\###.*#\.\#
#.*  #.....##.#
#.  ......\.. #
# ....#....*.\#
##  ..##.#.*..#
#########L#####