###############
#*.#\*.*...#*.#
# *..#..#. *..#
##*\#.# #.#.*.#
##... .*..#\. #
#..R. #\.. ...#
#.  . .. .....#
#. *#. .   .*.#
#..**..*.*....#
#....\*... #.\#
#.... #..* .#.#
#...\  .....  #
#**..\..*.  #.#
#..#..## #..*.#
#######L#######