######L########
#. .#*. R..## #
#...#.   ..  ##
#.\.*. .*..\ .#
#*........ . .#
# ... .*...# *#
# \....*  ....#
#.*.*###  ...*#
#*..........#.#
#* ..# .*...\.#
#...## # #....#
# . \...\.... #
#.# ...* #.#..#
#.  .\.  .*\.*#
###############