####L##########
# *.. \... ...#
#  ##*\. R ..*#
# ....\*. \* .#
#.  \# * .....#
##.\...#.... *#
#.. ..........#
#.. ...#.. . \#
# ...*..#.....#
#.#  ..\ #. .*#
#. .  . ...\..#
#\#..#.#.. *#.#
# *..*\..#*. .#
# #..*  . .#..#
###############