###########L###
#.\.\*#\.*\**.#
##....\....#..#
##. ... .. \ ##
# .........\..#
# .*.. \.#....#
#..  *... ..*.#
#* \  *.#. ...#
# ....#..* #. #
#.*#.....\#. .#
#..R. ........#
#\.*#..##....*#
#  . ..# .*# \#
#. ##..... ...#
###############