###############
#.. .... \.* ##
#\...#.. .  * #
##. ... ..*# .#
#..... *......#
#\. *....#.#..#
#..#. ..#.*...#
## .\..*.. # *#
# ..  ... ...\#
# ..\......\..#
#\\ .*\.R..#..#
# . # .... *. #
#\#....# .....#
#. .... .\*...#
#############L#