###############
#*.##....... .#
#..... # .. ..#
#.. ... #...*.#
# * #. ....#.##
#.*#R . .. ..##
#*.. .. \ ...*#
#.**....*....##
#.  #...# ....#
#..#..... .. .#
#....#.\ * *#*#
#*....\....#.##
#*\ *.# .*.. .#
#...# #  .*.\.#
###L###########