########L######
#.# #....#. .##
#\. .\#* .*** #
#.**..#\.\* #*#
#........#. .##
#..R*..\ #. ..#
#..# ... #*. ##
#....**.# .*..#
#.. *\* #.. ..#
#..**.....* .##
##**\....# .. #
#\  . ...... \#
#...#...*.. #.#
# . .....*# .##
###############