####L##########
#*\.\ .. ..*.##
#...#........\#
#.#.* ...  *..#
#.##. ........#
# * .. .#. ...#
##..\  \#.....#
#..*.#. .. ...#
#.. ...\ .#.\.#
#... .....\.*.#
# ...*#R.*...##
#*. ...* . ...#
#..  .. *# .**#
#.**...#* ...*#
###############