##########L####
# #* .#...*...#
#*#..*#.. * ..#
#. *..\ .....##
#. #.#......\.#
#........*.*\R#
#.. ..\\  *. .#
# ..  \\..\.\.#
# . . #..# ...#
#. #...\ .. \##
#*......*...# #
##.*  ...\#. *#
#.... *.#.#***#
#.. .. ...#..\#
###############