###############
#.# \. #.....##
#*.*\*....*  .#
#...... #.....#
#*\....*. ...*L
###*. *...  * #
#.*#    *.\...#
# .......*#.*.#
#.  \..***....#
#  ...\*..... #
#*#... ...*...#
#. .#.**....R #
#* .. ##... ..#
#.#\ ### ..*. #
###############