###############
#...... ... # #
#..*. *R... ###
#..# **#*.....#
#....  .#.. .##
#* ...*#..# . #
#....#*..... ##
#.*...# \ . #.#
#... . .*##\.##
#.. * *.......#
#.#..*..*...\\#
#..\..#.#* .**L
##  *. *..*...#
#..*#*. .*...##
###############