###############
#.\ .\..*#....#
#...#. .... ###
#**.#\..... ###
#..\.# .  ...\#
L#...*...#.  .#
#.....\. .. . #
##...#.*. *#. #
###..#*. .... #
#...##. ......#
#... \. .* .. #
# .  ......R..#
# . *. .#....*#
## ..*..*...  #
###############