###############
#... ....  ...#
#.*......#...##
#.*  .  ##  .*#
#\*..*..# ... #
#. ...* ..... #
# *#.** #\ #..#
##.R ..# . .. #
#...  ..#\ ...#
#*.. .........#
#*... ...* ..*#
#\...#.....* *#
#. ........*. #
#* \.. \..\.*.#
#########L#####