###############
# #..#. .. *..#
# . ......  ..#
#\ ... .\..\..#
#\.\.* * ...*.#
#. ... ..#..#.#
#\\\.#\. . ...L
## *  . ......#
#*\ ** .......#
#..R.. ..* .* #
#    .  ..\#..#
# ..... .. .. #
#.. \\*\#.#.\##
# ..... .\. ..#
###############