###############
#.R.....# .\. #
#\#...*  . ...#
#  *.\ \. * ..#
# ..\ .## ...##
#...* .# \ . *#
#\..*.. .*.#* #
#. #. ###.#.*.#
##*...#*.  \. #
#. .... #  .#.L
#. \.... .\.###
#* .\\..##. . #
#..*.. #..#.#.#
#*..........  #
###############