###############
#.. ... ....#.#
# .. ....\...*#
# .#.    .....#
#.*.#*.. . ...#
## ..\* .....*#
#R..*.* #*... #
#....# #.. ##.#
#.*\........ .#
#...*\ . *.. .#
#...# ...\..# #
##. ....*#....#
#..# . #.. .#.#
#.*..*** .**..#
##L############