####L##########
#...**\  .* ..#
## .\  .. .  .#
#.*..\ **.#\..#
#* .. *....#..#
#.. *.  ...  .#
#  \ \.* .  ..#
# \* ##\ **  *#
#*.... * ... .#
#. ..... . #..#
##.#....\ ..#.#
#......... ##.#
## .#*.*.*.#.##
#... R.....\#.#
###############