###############
#. # #..#...* #
#..#  .# .\  .L
#.*. . # \\...#
#... ......*..#
#.#....**... .#
#. .   **.R #.#
##.*..# * .\ .#
#.  *#.\*. \..#
#\ *  .. #\ #.#
#. *.# # .# * #
#\...*#.......#
# ..*..#.. ...#
## ....*....*.#
###############