###############
#...  .... ...#
##...#......*.#
#*.  ##  .  *.#
# ... #..*..*\#
# ..... *... .#
#..# \# **.#* #
# .. . #.. R.##
#... \#..  ...#
#......... ..*#
#*.. *... ...*#
#* *.....#...\#
# .*........ .#
#.*.\..\ ..\ *#
#####L#########