###############
##... #   *.#.#
#\# ....#.\...#
## .\.*..\....#
#.#.\  .\.  ..#
## \..*.#.   .#
#.  *. R.  .*.#
#....\.. . *  L
#   .*  *# #..#
#.... . .*   .#
#...*.....\..##
#... *........#
#\\*...\ .....#
#... ...# ....#
###############