###############
# # ... ... . #
#...#..*... ..#
#. ... .. ...##
#.\..\   .....#
#.# .......#..#
#.. ..#. #...##
#\....#.#. * .#
#. . *. ...*. #
# . R.*\# \.#*#
#\.  \# #..#* L
#..* ... .*  *#
##*##..\.##.. #
# .  . # ...\.#
###############