###############
#*..........  #
#..*.. #..#.#.#
#* .\\..##. . #
#. \.... .\.###
#. .... #  .#.L
##*...#*.  \. #
#. #. ###.#.*.#
#\..*.. .*.#* #
#...* .# \ . *#
# ..\ .## ...##
#  *.\ \. * ..#
#\#...*  . ...#
#.R.....# .\. #
###############