##########L####
#....... ...#.#
#...#. \.. #.\#
##....#. ....##
#  ...#. ...R.#
#.....*.\.* *.#
#......#.#....#
#**....\..* #.#
#..   .... ...#
##..\. *  . .##
##..* .*.. \#.#
#* \# ...#  .\#
#.#.....*.\...#
#.#... .* .  .#
###############