###############
# . #..* ...\.#
##. .*.. *. ..#
##\#.\ ...  .*#
# ..... ..*. *#
#\..*.....#...#
# #...*....\* #
#..... . ..#  #
#....... ....\#
#....#. . . . #
#.. ..R...\  ##
#............ #
#*.. .#\.. ...#
#........... .#
#########L#####