###############
#.  .\.  .*\.*#
#.# ...* #.#..#
# . \...\.... #
#...## # #....#
#* ..# .*...\.#
#*..........#.#
#.*.*###  ...*#
# \....*  ....#
# ... .*...# *#
#*........ . .#
#.\.*. .*..\ .#
#...#.   ..  ##
#. .#*. R..## #
######L########