###############
##\#.#.. ...\.#
#.# #  . ...\.#
#. ..\ . ...*.#
#..\\.*...* . #
# .. ..\* .*..#
##.* * . .....#
# ....R.  ..\.#
# #.\#. *... ##
# .\.. .#*... #
#*\.      \...#
#...  .*# ....#
##... * . ....#
#...... ..#...#
#######L#######