###############
##... ... *.#.#
#  ... .......#
#.... *. . ...#
##......*... .#
#.*# .....#.**#
#*.. ..\...#.##
#  . ....... ##
# ..  .... ...#
#.*.*\... ....#
#\*..* .......#
#..**.#..#...R#
# ...*..*..  .#
#*#.......* *.#
########L######