###############
L... .\..#...\#
# . .* #. .#..#
#\...*..*.... #
#.#. #.* #  ..#
#... .. ..#...#
#. ## #..* ...#
#.... *  #..  #
#.*\.. .* .#..#
#.\.. \.**.#.*#
#....\.. # ...#
#. .... .. . *#
#.\#R#....\*\##
#..... ...* *.#
###############