###############
#\.. ..  ..*\*#
#.*.\# ..R...#L
#. .....##..\.#
##....*....#.##
# ....*.... ..#
#..*.*....    #
#.......\. . \#
#. **. *.. ...#
#.... *.* \# .#
# ... #.**\ *.#
#....*..#..*..#
#..*...#...#.*#
#..#.. . .### #
###############