##L############
# .....#. #...#
#..##*#  \....#
###...... .\# #
# ..*..\......#
#**.. .. #... #
## .\....**. .#
##..R#..\  \ ##
## ... .  . #.#
#.*\.......* .#
#.......  .* ##
#..*.*.#...  .#
#. .. #...##. #
#. ......... *#
###############