###############
#* .#\.  .. .##
#... ......#.\#
# \*##.... ..*#
### .. ..#....#
#....*# ...##.#
#.....# *.#..*#
###\.##\ .#...#
#\..... .R.*#.#
#. .... ...*. #
#. *.#.**#....#
#.. \. .  ....#
##  ..*..*..#.#
#..*.. .\. .#.#
##########L####