###############
L*....*....* .#
#..*.*. ....#.#
# # ..*##.#  ##
#. ...#... * .#
#.\... . .\.* #
# .*   #*.#...#
#.#\.\..\.* . #
#.*.. ...  .*.#
#\ #.#..*.. ..#
#..# . ....R..#
#..... #. . \ #
#.   ....... .#
#*....#. #.. ##
###############