###############
# ##  .. ..*..#
#.#.... ......#
#*..#*. .# .  #
##. \.*..*..#.#
#.. ..#....\..#
#.# \.\.  .#*.#
# . *..*..*.###
#..#*..#... ..#
#. .#.......*.#
#. . # #..... #
#R... *. *..  #
#.*....*.\ .###
# ...* ....\.*#
###########L###