###############
#.##  .* ..\ .#
#\..... .*..  #
#.. .* \.#R*.##
#\....  ...# ##
#*....* .. ...#
##\.. .*#.....#
#\. .\.....##.#
#......#...# .#
#*...# .*\....#
#\. ...  #..* #
L*#\\...#...#.#
#*. ..*.. .. .#
#..#.... ..*\.#
###############