###############
#. .* .\.*. *.#
# .. *..... .##
#..  #...#.  .#
#* .. *#....#.#
##... #. . *.##
#... \..*.....#
#.#.#***  ..\.#
#\..*... ....##
#...... ...\ .#
#...  *.* ... #
# ..*. *##...#L
#R#...*\ ...###
#. *.. ..#.  ##
###############