########L######
##. .#*.*.#...#
#....  *.**..##
#.. ..*\....###
#*#.*. .#. .*.#
##  *..#..*.* #
#.. #.#.R #...#
#.*.##....    #
#....*..*  *. #
# \.. ...\...*#
# \.   ..\ .*.#
#*. ... \*\*#.#
#.. . . #.  .*#
#....\. .. ...#
###############