####L##########
#\ .... . ... #
#...  .....  .#
#.....*.#.*...#
#...#..#......#
#.*......#... #
#.. ...**.... #
#.#  ....... \#
# .. .\..*....#
##...*... R\.##
#*.#..........#
#. . ...**.*.##
#.*.  #\...   #
# .#.  \.#. \.#
###############