###############
#.#**\ #.*#  *#
#..#*.#....#.##
# ..... .#*#  #
#.......*.*  .#
# .* ..  ...#\#
#.. *.... .*# #
# *.\#\.*.. ..#
# ..*..*..... #
#\#  . ...R#.*#
L. ..  *......#
#.*....#...*..#
#.\.\. *.#. *.#
##..*\ . *....#
###############