###############
# .. . ..#  ###
#... * .  .*..#
#. . . * .. . #
#.#.#* .*#..  #
#  ..*...\....#
#. *...*.#.. .#
#.... .  .# .\#
#.. ... .*.# *#
#... . ...\ ..#
#.R.   . ..\. #
#.\\#....\... #
#..*  . \ ..**#
# .  .....\.# #
#########L#####