#######L#######
#...\ .\. .*  #
#..*.....#...\#
#......*......#
#. .\  # .# *.#
#.# . \*  .*###
#...#..*\*. ..#
# ... *R  ....#
#\..#..#...*.*#
#### #*# ....\#
#.  #  . . .#.#
#. .# ......#.#
#..\... * ..  #
#.* .... . ...#
###############