###############
# . .....#.. .#
# .... ..#\..*#
# ..... .....*#
#.*........ .\#
#.. #.#\.\#.\ #
## .. ....#...#
#..*.*.*..* . #
#\\..##.......#
#*.... .  . . #
#R......*.....#
# #..\.** .# #L
#*.# .....\ ..#
#  . ....... .#
###############