###############
#...#.*. ...#.#
#.....  #\.#..#
# .. \ .. ....#
#R.*.#.. .*.*\#
# .*..*... . .#
# .... #. ...##
#..... ..*#. \#
#. #  .*##...##
# .. #.. ....*#
###. .#.. .   #
#.#.. .. ... .#
L # *...#..*..#
#* .\*.*..... #
###############