######L########
#... #*...... #
#....*.*.#...*#
#*   ..\##.. .#
#..\*# ##..#..#
#..\ .\... .. #
#.  #.\.* ... #
#.... .# ..# .#
#. .*...\. .\ #
#. . ..#...*\##
#.....\\.*R..*#
#.* . #..#. ..#
#.. .* \ ....\#
#\*.* .. \*  ##
###############