#L#############
#*.  #.  . ...#
# .#. .   .. .#
#\#........ *.#
#.. ....# . # #
##  . .*...  .#
#*.... .  ...*#
#  \ \*. .#...#
#  *....*  .# #
#* ......*..  #
## .. .\*...#.#
# ..#.\... ...#
#...R#...\.# .#
#.*.*..... * .#
###############