###############
#* .\.  *.#. ##
##..**. .*.. .#
#..*.....#....#
#..*.*    ....#
#.*.*\ .... . #
#..# ......* .#
#.......\.....#
L.*.......* ..#
#..#. ....... #
#*.... ..#. .*#
#  .....#.....#
#* .... .* ..##
#..R...##*....#
###############