#########L#####
# ..#* . .# . #
#.... **.##.# #
#\. ..#.\.. ..#
#. *. .#  \.#.#
# .  \*.  .#..#
## .# .#.# #..#
#. \## #* ..#.#
#.* ...##... .#
#..\  . ...\..#
#...\**....\..#
#..*...#..\.*.#
#R# ... *   ..#
#.\  .\.#..*.*#
###############