###############
#.*.*.#..*R.  L
#. #....#.*...#
##... *.  #.. #
# .\**....\..##
#..  .........#
##.#..##..\\ \#
#.........#. ##
#...*.#.**.*. #
#*..\.. *.#* .#
#..\  .\...\.##
# #.. .... #* #
##... *.....# #
#. .  . . \* ##
###############