###############
# #.#.* ...\ .#
#... .\ .**\..#
#.#.... ..*# .#
#...# .  .....#
#....*.. ...\*#
#..  #*.. ..\ #
#*. R ...\. ..#
L#...# .... ..#
##.# . .\..  .#
#.....*.......#
#....*  # ....#
#.#  .. .   .*#
# #...#.   ...#
###############