###L###########
# *. .. .*....#
#.#*..   .*\..#
#... .* * * . #
## .*..*.\# ..#
#.... *\......#
#.. #..#. ....#
#*\. ..#...   #
#. .#..*.\..\.#
#*.* \.... # .#
#.R.#...#.. #.#
#\.*.  * .....#
#*.#...\*. .*.#
# ...*  ..*.#.#
###############