##################################################
#..\#..#.  ........#*...  # .* .. .    *....*.#..#
#... ..* .......\#.. ....... . .. .# . . .\*.....#
#..#..#*..*..#..#.\#.. ..  .#.#. .. . .*...*#.. .#
##\......  ..\..*......  .......... .**.. ..#..# #
#. #.#. \..*#..*#.\**.R.#. ..*...#.*....#....... #
#.  . ....*#*  ..  .##..\. ......#\.\##  ..##... #
#.#...#.. ..#......  ......*...\ .\ ..#.*.. ....##
#... \#.\..#** ..*. ..* ..\.#. . # \... ..*..**  #
#\.*.... .*  .###.*\..#. \..*\*\ *.......*####.. #
#..  . ....#.. . .....#...#.  . ... ..#*.# #*.. .#
#........ .. .....  .. ..\... . . ........# ...# #
#....*.  ..\...\.....   ...#\...\..*...*   \. ..##
#\  **...**..*.#.#.*...*..# ..  ..... ..#.\*.....#
#..* .  ..*...\. ..*.\. \ ..\....... \#\...\.....#
#. ......... *\...... .  .. .\ \#.. **#.##......*#
#*.. .....#..\. *..\  **..#*.*.  .......*#..#....#
# ... . *.#  .. . *. ... #..#...* .  ..**.. .. ..#
# #.  #. ... . \*.. .*#**.# .*.. .   #.*..#.#. . #
#.* .\.#\ ....  .. .#.*. ...*# .**..\# .#*...* ..#
#..#\* #....  ...  . #.   ... ... .#\. ...#**..*.#
#.. ......#\...... .#..*#....#. *.#.  * .*#.\##..#
#.. # .*.#..#*. ...*#........*..# #. *#...#\.* \.#
#..#*. ...#.#.... ...* *. ...*.. .\.\..*.. * ... #
#..#.# *........\.#*#*. ..# .*...#*. ..#.. .. #.\#
#. ... ..... ..# *\#.\*#. .*#\ .\....\... .#..* .#
#..*#.    . ......# ...  #..# \  ...\.* #. \.. ..#
#...*\.# .*.*. ..*.. * .*##.... ##.*..#...**.\\..#
#..*#...\\...  ... .* ..*.....#*#. ....... . .. .#
#\.........\ #... ..   .#... \ #.....#..  *\\\...#
#..*. ..*...#\..#*.. *#.. .\. . ..... .. ... # ..#
#..\.\..*. ...*####*.  .... #... .*. . . .#.*.. .#
#.*. \. #*. .#.. ..*...#...* \..*..... #.....    #
# . .#  .*##.*.#..*. #* . .*..#..... ## ..\*...#.#
##.#*.  ....\.\ \.*... ...* ..   * .*\.#..#..#*.*#
#...#.#  ##.. ....\ .. #..#. \  \**.*  ........# #
# *. ...\.\..\.. .. **...# .\#*.........# #... ..#
#.\..  ..*.*.. . ....# #...... #..*#*.\.*.* . .\ #
#  *. .. . ...\.  #....#. .#  .\.#. ... .* ... . #
#..  \ .#.... *.. \#.. ...*.. \...#.# #..# ......#
#.#*..#.  . . **. ..#..* .. .\ ... .... ......**##
# .. #.*..*. ..*# ##..\... .. #\#.\.....*. ......#
#. ..*.** . . .# *.*... . .#.*. . ..#*. .....**. #
#  *. \\..... \...#*...## \... * ..*.#.. ....*.#*#
#...*..#*\.\.\#.#*......#. #\....#. . .#*.\.  . ##
#   . .....*. #..# .\*..#.#..\# .  ..... # . **..#
# #.\...*  .........***\#...*....  . ...#\.......#
#.##.. .  ..*.  .#.#...*... . .. .........*..*# .#
#.... .#...* ........ ......\ .#... .# ..*... . ##
########################################L#########