##################################################
#............. \.#. . .*.... .**.\... # \#.......#
#....# .   .#. .. ...#. ... ........ #.#.... \##.#
## # #. \.. ... ...**.. *.\...... ..\ . #\# .#.\##
# \..*. ##\.\..  ..  *.* . #...\  ... ..*...  ..##
#..*#..*.* *.* *. .. *.\.. ..\. \.*..#* .#..*....#
#.. ...*....  ## ..#....#.\..*...   *...  .*..#  #
# ...   .* ..\#.   ..#*. ...*. ...\.. *..  ......#
#........# .#.#.*.*. ...#....#.#*.  ..  #* . .\###
##*. ... . *... \.. .\.. ..... .# ..*. #.  #\.\..#
#*\ ... # . ...# .#  .*.... \#  .....\ .#..  *...#
#. ..*\ . ###.. #.... .. ......#.. .   #. . ..   #
#..# .#...\\  ...#*.\#.   #..# .#.. . *..*.*.....#
#*. ......... ..*.#.#..*#...*. .. .. ... .... ..\#
#. .#.. .. ..... ...  . \.*... ..\.\.....\  .. ..#
#.#..#... *..\.........# *.. ..... **  *.\... ...#
#..#. ..\.. ..*.\.#..   \* ... ....#.  .  .  .. .#
#\... ....**..\\...*.  ..#.#**... *..#\ .#..#...##
#*.   #..**#.*..*.\#.... ..... ..#  .. ..... ....#
#.. .   .#. . ... ... .*.#.*.......  \**\.#.. #..#
#* ..*...#\. ...*.  .*.#.#\...#. *.  ....*.. ..\.#
#.... .## ..... . ##*.#. .  . \*.  .#..... * ...##
#  ##......... ..*. *#. # . ........\..##.......##
#  #......*..\.  .# . .\ ..##...#*... \...# .*...#
#.*.. .... * \ ... .....#.\.... ...*.....# .*. . #
# *....  .   ... . ...*#.. . .*..*.*..#*.#\.*..#*#
#..*.......#.#..\.\. \*...*# #.. .. .*..#. *. . .#
#\.# .. #*...*.. ..... #.  .... ..*....*. .\.\\ ##
# . *....\ #. .....*.   * ..#\.#.. ..#...#.##.\.*#
##*.....\ .\  #*....#..#.. .*. ....#*..#  .\....##
#   ... . *  .* .....*.*\*....*.*. \*...  .  .. ##
#..*#.....\ .*..\\. * ..  .*# .#.......#* *...  .#
# ..#*.. .\ \ .....  ...*.\..#.*\  *..#...#.. ...#
#... .....  .... .. . ...##....*....  #.#. ....*\#
# .. ** .   . #....***.# * .* *..*.#...  ..  .. .#
#.. ..*. *.. .#*..... . *** # .##.........\.. ...#
#.. ..#\*#*... ...... .#  .......#  ..#... ..*...#
#. .. .*.. ...\ .#. .............#.. ..* .. . .  #
#...\.....\...... .*.. .. .*.... .*.# .#. ...#...#
#.. .......  ...#.\. *. .*..#*.#.*.  .\\#.#.. #*##
#.#. .. . \\#... ......  .*..*.\.#\*. .\ #.. \ .\#
#.  .   .*.... \#. *.... .# *.#.. .*.. ...# #   .#
L..#.  .#.....*. .....  \#\.......\..#.*...#. *\.#
#.. ... .#....* .##....#* .#....\....... ##R\...##
# ....\*#*#*.#..  . .*. ...*......  .\. ...\.# .*#
#.. ....##...* .. * .. .\.... #.* .##. .. .*. .*.#
#.....\ #..#.*.. ...  .##....... *...\..... . ...#
#.....\..*..\ ..* . ...\..#  ......#.. ....\....*#
#. ##..#.. ..*...  ...#......##\.\ ......#*.  \.*#
##################################################