##################################################
#.... *# .#.  \.. . . ..*#*.*. .* .#..  ...#.#...#
#*...*.*....*..#.#....# .   .. *.*......# *#.#...#
#.. * .#.##......*. ..*.   .**#..#..**.... #.....#
#\ ..#. .#* ..\ ..*  ...#...**#. .....#  ..**....#
# ....# .#... R*. .* ......#.*.*.. \ .#.#. ....*.#
#..#.... .#........*.  ....* \* ###. .#* .... #..#
#   . ....... . .# .#.# ..*.. ......*...*\*.*... #
#...#...# ..  .. *...*.\...#.#..*.##.  # .. .#...#
#. #.. \#.\*.#....*.*\#. .... #...... ...\.#. .*.#
#. .. #.\.. .*.*.. . ..*# #.  ... ... . .. #\..###
# *. #. #.#  .  .. . .*..*.\. # #. #. ... . \#.\.#
#. ..#...#...... *. .. .... #..*\..*.*.. .. \.*..#
#.#.##..**# .. .###. *... *.#...\*.\ *. #... .#..#
#\.#. ... .. .*..... .......  *  *#.#.#... ... ..#
#. \..#..... ... .#.....*...*....# ... * ....*. .#
#...#.#. # ..   ..**  ..*##*#. .#.#. ##*..*....\.#
# #*#  . . . \#.. .. \...... . .....*....#...** .#
#.*\.\....*.\..* ..........\.. . .#.#..\..\ \. ..#
# *... ..#.... .#  .#...#.**.... .....#  ...*  ..#
# ....*..#....\* . .*.# \...# . . #...#....\. *..#
#...*... .\...#.. ..*...... . ..  ....\#  .#.....#
##.. . ..#..# ..\.*. *.................#. . . #..#
# *#... ...*. .#... ..#.....*\...# .... ..* ...*.#
# .*.*#  \#.*. ..#.\...*#*.\ .\ .........\.*.\..##
#... ..*...*... # . .. . \  . .......\ ..... #. .#
#........ .. . #* *\ ....#.....\..#.. ... .  ....#
#....*. ..# .*... .*...... *.....*... ...........#
#.*... #.....#..*...#.. .   . ... ...#. *..\#..*.#
#..* *..#..# .#. .. .. .#.*.\.  ..*.*.#. ... .. .#
# *\ \.. \. . ... .#. #. . .    *##..*..\...*   *#
##...##.\ .....#... .*\. ...* ... .. *. .\ . #..*#
#  .. *... ....\. .*...*.#..##............. ....*#
# . .#. ...*..* ...#*  .. ..\  . *. #...*....#. .#
#...**# \.... ..  ...\#.#..# .. ..**..*\.#.. ..#.#
#.#.. .... .\...*. .\....  #*..*..*..*.#.... #. .#
#*. .#..  \. .. ..*.. .#..*\....*...#. .. .. . #.#
#.. .. ....#..# .*....#\ .# * .. .* ..\# ..\..  .#
# *# .. . .....#.......  .  \... ... \..#.. .#...#
# . ....#. ...\ ##. . \    . #..\#*.#. .\..#. \. #
#. .\\ * .. \* .... ... \ *.... .... . ..#\.\.#.\#
#.\#.\ .\ ...\..*\...\.**  .  . #. *....* . ...###
#*.*...##.. .#.*..#.. .. . ..#..  . . *. .. .\...#
#......  * ..  .#. . *........ * .#. .*.#...#....#
#. .  ..#..... #.#... * .\ .. .*   #. #**... ....#
#...#..#\. .....\.**... ...*... .# .*# ...#.. .  #
#...\.#. .....\.# . ......   ..## . ..  #..*...  L
# .\. .. *....  #.....# .*  . .. .#.. *  .*..#.* #
#..... .  ...\*..#. ...*. .#  * *.# ..*.*. . .. .#
##################################################