##################################################
##\* ..* *.  ... .  .  .# ..\ .*... *.. . .. ....#
#.... *.. **#..  ..* *.*\\..*#   ... . .  .\.* ..#
#..#....#.......\. .*...\#*. .....*.#.. \. *.  ..#
#\# ### .#  ..  .*... ......  . .\ \.*.\.. \.*.*.#
#\#.*. .*.\  ..*#* .#\...\.# ...*....*.*#.#*.* . #
#....... \.*...*.#..##.  .....\... ..#\....\..#. #
# .....*.. .*....*..*#..#..*...*....# #*#.... .\ #
#.. *... ... ..*##.*.*#.   *.*....\.... .. .   .##
#. #.\ . .. \.......*...  . .##*#  .... ..\... ..#
#.#..# .......** ..#.... . ... . .... ##R.\#...#.#
#..  .#..*. .... .#...\.\#.. ...#. * ..***..*.* .#
# .... .#.#.\#. .#.\* .\.. ....*....#.... .....#.#
#.. .. \...  ...#*....#**... ....#  ...\...... * #
#. ...#..*.  * .*.#* ..*\.#.\...* .... ...... .#.#
# ...**##.#. .#......*#.*...*. ... \. ..*.  .....#
#.* . \. \. * ..*..*....*.... .##*..   .......\..#
#\.  .*....*....*.. #.........*..*# ........ # ..#
#....*......*...\.....*......... ...#.\.* ..*.. .#
#.*#  # .* *.......*... . .... .*#.\ .##........ #
# .* # ##.....\*....... ..#...  .. ... . #...*.. #
#. ..*.... ..\ # ...* *   .......#.... ..#..... .#
#.#.. *....# \..\ .** . #.#. ..\.#. ....# ... . *#
# . .\#*. ..\.\.  ..# . *..... #*..#.. ..\.. \# *#
#....  ...#  ##.  \**  ...... *#. \* #.##  .  ...#
#... *...... .**..... ...#\. ...*.... ....#...##.#
#.\##.#\ .#   ...... .\*#.#......*. ..\ ...   . .#
#.*...#.. .*. *.* #*    ....#....* . . .\*...## *#
#  . .*. ..\.. ....#. .. ....*\.*....\. ... .... #
#.\....#.*.*..# \.... . .. ....*.#. **## . ..*. #L
#.#.... . .  ....*# .#.#... ..  ...... *... .....#
#\  .. ..   # ..... . .#.#*...\ ............. ..##
##.....*\......* . ..# \.....** . ... .....*#. .*#
#... ..\.#..#..*. ..\..\\.....##\ . .# ..... #...#
#.. ...**. ....*... **\.\.....*....##.*. . ..#. .#
#. .*.....#*..# #.\.   ..*#....*..# .. . *.... ..#
#.  \. *.#. ..##..#.   *\*...#. ..  .* #.*..  # .#
#.*... . *... ..... .\\.##\#. *\.. ... .....#.\..#
#*\.\..*.. ......\\#....#. .. ...*.....**.#..**.*#
# .....*.* \....*...\ .#*#. ..... .... *..*. *...#
#...#......\.. \... *...#*#  *.... .#..*.*...  . #
#....*# ....\ . .... # .# ..*....#. \.# \.....#..#
#* ...#\.  .. .#.#. #.*.\\.*\..*.  ...*... . \.  #
#.........# ..... .  ..\....#.. #..#.  .. .... . #
#\.\ ..** ...#*........ ..#...\.#.... *..# . .#.*#
#.. ...\....\*..... ...\ ..* .... . \. ..#\...* .#
#. .*...#. .  ..... ....#. .#..#.*...\.. ..#.\*..#
#  . .#.. .  ... .. #\ ..# ...  ...\.*.#\.. # .# #
#. ... *.. # \..# ** .. .*.... .*.# .*.#. .. . # #
##################################################