##################################################
#*\. ..#... .**.* . .# ..*  . #.## #.. ... .... .#
# .\.....# ..#..... * #\. .....**\..#  ... #.*...#
#.#..\. .. .....\#.# .**#.*.\..#.*........*...\ .#
#..#..*  ... ...* .\. #.  .*...#* ..#\* .*.\. .#\#
#.......#.. .. ....#..  ##\ *** .. ....*  #..... #
##..*.. ....#...*. .... * .. .#  . ..#. .. .* .\ #
#*.*.*..... ..*.* \...* #. . ...\......\ ...... .#
##*.##.  *. # .. *.. ....... * . ...# ..*   ....*#
#.#...  #.* ..#.....#... .\. *..\.\* *.\...*.. . #
# ... ... # .*. .......*# ..*#....\.*..##\...\#..#
#.   ... .#. .....  #... ..*... .#.. ...\.. \... #
#...  .\# .  ...  \.#.\* ...*.#.#... #.. *.......#
# ..*.. . .. ..#*#  ..\.\  ##...#. #.. . .## . #*#
#......# ..*...*..*#  #.# #..#.  \ #.#.\\......#.#
# ... ...... \.*. .... .. . .*#**... ..... ...\..#
#...***......  *...*#..##.# ......*.. *. ...#..  #
# ..... ... ..........   . .....  .\.## ..\..#...#
#\ .\.\...*.....\....  ......*... .*.. ....\.\ ..#
# ..#.... . .##.*\ \ ..*......##  .*........**.#.#
#... ... .....\.*  ...#..... .#... .#. *\.*R* \\.#
L . .... # ...*.........* ............#.#*.... .\#
#.#....*.... .\*#*.. . ....\. #.#. **...*#\..\...#
#.... .# . .#.*...# ...\...#*  . ..... ...  ...\.#
#.  #. . .**#...##..... \\... .\.  .. .....# #*. #
#.#..   ..*..... ....#**.. .**. .. #....*...*\.. #
# #*. *.. .....* . #\.. ..*... . # \#.. *..... ..#
#.. ...*.........*..*..   ...#. *......#*\#......#
#\.. ..  .  ...## #.\ ... #.**#\.\.. .*.... .. *\#
## #  . ...\*..**..*.*..*\...###.*.. #. .. ..  ..#
#*...**.#\*.. #  ...*...... . # ##. ..........#\ #
##... *. .. .* .  ..##....\....  .... .....#*.  .#
#.. * ..# #.* .#  ..  **.#..#...\ .....# #.##..*.#
#. *..  .* #...\# . ... ....#.  \.... ...*.#.... #
#. #.#.  ...#.#* . .*...\..# \.#.*...#........*  #
#.. .#.#**#\* .\*# ..\.....#*  .  ...# ....*.  *.#
#. \. \. \ .. #.  ...... * ...\.. *. ..#.*..*. ..#
#..#..##.# .  . .. ....# .  #.*.* #.**\..*... *. #
#.# #......  .*.*..*. ....  ...#...# .*#. .. .*..#
#.  *###...... ...###.#..*.*.#  . ...\** ....*. .#
#....* *#\\..#. . .*... .. ..\*.. ..... ....#....#
##.*    . ...##.#.  ...  ...*. ..*.# \.. ..#.*. .#
#..  **.#.#.*.....# . ..#.\...*##..\.*#*. ... . ##
###..*...#\.. #.... *.*.....*    #  #....\*#.*  .#
##......... ..\\..\\.\#.. .\......\.. .#.. ....#*#
#..   \. ..\..\ ......*.....* .....#..# \..* #*.*#
#*.   .. .#.... ...#*.*.... .. .........\..#.# . #
#.#\.#. . \ .#..\ .  . .\   . .*..* #... #.. .#..#
#\*.. .. #.#.  .#.#....\ \.. .........*..\.#..*.##
##################################################