##################################################
#.. *#..*.* ##. #*....## .# ##.**. #.***..#.\...\#
#\ \..# ...#..#  *.*..# ..##*.. ... .\\ .*..\#*#.#
#  ....*#...# L .# #....#....L. ..*#.*.#.\ ..* .\#
#..#.  *. .*#.\. *..*.#**\.... .\. *.#.*... .*...#
#..* #.*..#..#* ... .\..... .***\..\.. .*..*\.*###
#..\#..\.   *#\*.L...#.. ***.# ##.*.*\*#..***. *L#
# \. *......#\##.*.. \*.....\.#*..\#....#... *..\#
#  ##*.......  ...*..*. .#*.#* \..# #.. ##.\...#.#
#. L*# .*##\..**..*.# #. . .*\*..#*.. \.#.\#*#..*#
#..#.#*#.#*.. .#*..#\\.**.# *..\..*...#..\....*.##
##...#*# .....  . \#.\\..  .... .**#..   .*.#.\#\#
##..L#..*\..##.......*...# .\ .##. \ #. .#.*..\..#
#.#\#* .# .##..# . * ... .\#... .#..L**.....*.. ##
#.*#....#. ..\..\..#*..\#.##*\\.\..\... ....*. ..#
#### . #...*\.*.\..#\*...**...#**..\\.## . .\.L**#
##*.**.. . #..*..#** #.L\\..#\....## . .....#..  #
#L.#..*. **.. .. #*\*#..# \ . *..#.##.. #....# #.#
#.#**.*. #.#\ ##... ..**..#.**.* \\*##*.##.#*..###
#* .##* ...*\  .*#..*#*\ #\##L***.#..#..\... *##.#
#* ...\ **\.....\..\*..#.. ....**..* **.\#. .. ..#
#*...  *.#\  .....\.*#.*..#.\...\.##.. .\...*..# #
#.* #*.\# ...\..#...*...\##.#.##L ...#.# .....*.##
#.## .\ ...\. . ..*...*.L.*. *.*..#* .*.*\#..**.##
#. .#..\. .# .#.#.. ..# . ..\##....*.. \.\ .  ...#
#L#. .* *. # #L.#......*#. ...\ L .#..#*.\* ... ##
# L. \.. \\....*.#*.#.#..*#*... \#..*.*..**.\#\*\#
##......##*   .* *\#*.. ....#*..*#. .#.#.#.....#.#
# .#.#*..\#.....# .. .*.#.\. ..# \*..*...#\ ..L#.#
#.**......# . \#.#.\#*...L ..  ..\*#..#.#....\#. #
# * ..... .\.#.. .\ ..#..\...... \ . ....... #.\##
#.#.*.....#*..# ...##.#*#.L... ......#..*#.. ....#
#.#* .\ ..##*.*....#.... #\   \..*.. .   ##**...##
##... ##.....#.......##...*.*... *..#..* \.\...\ #
#.  ..\*.#..##...* .#.*# *.#.*\.. .#.. ..#.#  L..#
#*##*#*# .##..#*.*.  .#.#.#....*.#...*..** ..*.# #
# ##. ...\.#..#. ##.L* ..*\.\......\.#*..*L...**.#
##\   .#..# .# .......#.#..* .* *.*...L \.#\ * \.#
#*.#LL\.#....*\.* .\ \..\. .*. ....*.*.#*...#*.# #
##\..# #.\**##.*.*\.#* #.......#\...\...#..#..####
#...\..#....\#*\**#.#.# . #.* .\.\#**\*.\.#......#
##.**#..*  \.#.# .\. ..#.##*..\#*\*.. #.# ..#.*\.#
#..# . #**  . ..... *.....#...... .#*#..*##.*..  #
#.....*... .....*..***.. ...*.*...*#....... **. .#
# ##. .## .....*.#...*..* ..* **... .....   .*...#
#..\....* ##..\#*# # *.\\#.#..#... *. .*#* *#.*..#
#. #...#.* *..* ..# .. \  . ...\#* ....*...#\# . #
#.\.. .#...*...*..#  ..*\\#.## ... ....*... .\.#.#
#.#. *#.R *..#.. ..#***..#.\ . .. #.#\.# ....* *\#
##L###############################################