#############################################L####
##.##*.#...\#.\*. . .......L.*.*..*#.*.*..***.#..#
# .#*.\### ....*#.....#.\*. ...  . #.\.#... . \.##
#*..#. #*..#...   *..*..\.*.# . .\##.\#...  .#\*.#
#*  .. *\.*........#.#.. \.*. ..*.. *.# #.##...#.#
#* ....#...#.# .*..  #*. *\ .##.#**.* ...*..** ..#
#.....\...*..R..#.\  #... ..  #... .......\...* .#
#\   .  . *.. \#*\.**..**\.....*.#.#*.. .#*##*..##
#..\#*..  .#*.....\.**..*#*..**...*.L#. .... . *.#
#..L..... *#.... *#.. .\*.. #.#*.#.. .#..#...#.. #
##\.....*#..#. #\\...*.\..#..#.***...* \ ..**..\*#
#\...*.\\...#. ..#.....#.*....#* ..*#.*#. .\. #*##
#...LL..\.*\##.#..##. L\.. ** . .. ... ... .#..\.#
#.... ..* *.* *  .#..\.*.##.*.\\ #... .#..** **.##
#.. #.L#..**##.....*.\.\**. ##.*\* #..* #..#.  *.#
###.* * ..\#.*....#...#...** #\*##.*.*.##.*\ \.#.#
#..#L*#.#...*.#*\.#.#...#*. #. \*.# ... ... .....#
#......\  *#.*\....#..#*.. .... . ..  ..\.\ ..*.\#
#\.##.# * .#.##..**#.*\. ..** .#*#..#  .**#.# \###
#*..#*..##*...\## .*  ..***  #    \.#.***##*.#.# #
#.\\.**# # ..# *.#..\... ... ............. .....##
#..*\....  ...***.*. \... .... ... .\ *\*. *.....#
#.**..\.*#.*\..# .#*#.#.....  #\ .*. *..... #\..##
#.....*.. .*..  ...#.*.....#..##L#.\#.*.*.#.\.\. #
#.......\   # L#.* ..\ .*.\\...*.\.#.\. ..\# #...#
#..# *..*... **..# ...*.#.......#.*..#.##.* .#\..#
#\....\..#*.**..# ..... \**##.....\\ #.#*.# .\...#
##*... \.*..#.#.#*. L..\*..*##. .*...#. .. ..L. .#
#*\..#.*..\\#  *....#..#.##.# .###....##..\.   ###
#.#*#.*. ##..... \.....\..#.*..#....* *..#..*...*#
#.. .#.#.\\#.#.\.L.* ..#...##.......*. *#* ..#*.*#
# L *... *\#\..\.. *... ..... L.... ...*.#\. #.  #
#.\*.\ .#*# ......*.#*.*  #.**.*\\*....#.\.\.**.*#
#. ..\\.* ..\.*# .#...\* \# .##*.. ..... \ ..*...#
#**.#.L...*L.**.*#* ....*....*..*\..#...# .*.... #
# .. .\.**..*  . .. #\. ..**.#.*.\#. # *\\...*..##
#**\#... **.#..*  * ...*... ..L#.*#.*.\ *.*... .\#
#. .....*. .*# . .*... ..\... . #...    #...\#...#
#### \*. #.\.  \.\#..#......  . #.\........#*\.*##
#*.*.*.*.\*. *.\.... ##.#*.*#. ...*#..# *. ...#..#
# ..**##L....*# ...\\*...* ...\*. .#....#.#. . . #
#.**........ #.#.* \.#.##.\. .#*..L.*.#.\*....\ .#
#.. . ...#  . * ..*.##.#*.#...*.. .*#\ ..\#**....#
#\.#. L ... ..#.#.#.........  . #* \.*#..\**.*..##
#..\..#.. .#*.#\.\#* \..#.*\..*# #**...***\**..\ #
#### \#.#*.****..*..#.#\. #.*\.. ..#.\.\L##.\. \\#
#. .##...#..#*....\#  .#\. **#*#  .#.*....*..# ..#
#... \.*. .L\*\#.*.\. \*... ..# .*.*#..#. .**. **#
#....... .. .. ......*...*  #*..#.  .....***# \L.#
##################################################