##################################################
#.. ...#***.  .*##..#. .*... .\.......*.*#.#*.*.##
#*..## .. .*. .*...*\.. .\*#* ..\..*..\.#........#
#*##.#*  ...*.*  ....  ...  *.#\.\..*....*.*. **.#
#.\.  \..#*\#....*\ ..## .#  ..  . ......  .. ..##
#*\.#..*..........  ..#....#....* .... .....*\.*.#
#....* \.... *.... .. .\.*.........*.    ...\....#
#..  .#...#........ ..# ..\. .# .. ........ ... .#
#. ...#..  #.#.\ ..#.....#.. .....R. .....  #..###
#.#.. ..*..*..# ..\ ...#.*. .\ .*##.. #.. .#.. #.#
#...* .#.. *.*..  ..* .#.#.*..\\. *   .#.. \.# ..#
#.*. *...  . . \*.  ....  ..* .. .. #...*.*.*.*. #
#..\#*.. .#.....#...*. ... .#..*..## * .#.*......#
#.#* .\ .. * .#*.#...  ..........\....#\*.. ... *#
# ........\ \.*.. ... ..... *.*.. .  * .\.# #.. .#
#..#  *.#..\ .#*...#.   ..#..#... *.*  . ..\..\..#
#.. .\*\\*  ........ #..*#.#.#.*.*..\...*..... ..#
#....*...\ . .##  .......# \ **.\.. *........\.*##
#  ...#...  ...... .... ..\ *..*..#*. ... . *...##
#.#. * *.\\. ......\* .#.#  . ..... . ..  .. .#.*#
#* #..*....  . ...#.## ..#....#...*#....\.*.. . .#
#. .*.#*. .. .* *#\ *....*..*   .... . ...# .#.*.#
## .\   .** ....#.. ..\.**.*....\......... #..#.##
#.#.*.#. ..**. .... ... #*. *. ... *#.#.\ #\.** *#
## \.#. ...... ..\.*. . ..#....* . #.#..... \ ...#
#.. ..* ..**..   .. ..#*..#**. ...**..#  .**.. .*#
#.#..*\   ..#.*\. \.   ..  .#*...  *. #... . .#*.#
####*.#. * * ...*#.*. .. . *.. ... .. \.*. . ..#.#
#. .... \.\.* \..\....#\ . \...#.*\# ..  .*#...*\#
#. ...  #...#...\**##.*.....#......\...#\ .\.  ..#
#..  .. ....\ *.#..** \.#.... ... #*... ...#.*. .#
##.**\.  ...\* *.....\... ....\#*##\*  \.*.#.#..*#
#. . ....... *  ...#. ...\.\ . .*. \ *.* #..* *. #
#  *. ....# .. ......#.*  ...*..  #** ..*....*.#.#
#...*.... ...#\.. ... ... .\....\.#*.  .....  ...#
#  \.*.\. ..\....##\.. ** * ..\.##... .\ #.*. \..#
L....* ... ...#.....#.. \..\#*.\## . # ... ...# *#
#... ...*\.**... .  \. ..*...... ..... .*........#
#...#.....#..... *.\**#.. \. .# ..*..  .*..# ..*.#
# ..#..* #.. .  ....#*#..*.*\.. .*...#   \.......#
#....\.*..*\. ..  ..  . \ ..\.......#....*....#..#
##   \# .#..* ... ...**...  .. ...#.*...**.\.*.. #
#.....\...... #\.. ..*...... ...*....\ ...  #.  .#
#..   .  .#..... ..#.***.*#....*\.* ..#....##* ..#
#....##..... .#\ # ..  .....*.# . .#. ...*\** . .#
#*..#..#*# .*.....# . .......#\.*. .*....# * **..#
#..\*...... ** .# . . #.*.. ..  #\\... ..#.*...**#
#.\.....\* .. . .\ .. \..### *...#.#..#  ..\ * #.#
#\. ..\. ........\.. .# *... ...* . # .. ...\..* #
##################################################