##################################################
# ###..#   \.\#...#. #....# ..... ... .*#..\ #. \#
#...*.#.... ... ... .* .....*. ..*.* ..... ...#.##
###..*\.*. .#.......#. ...# ...  *....*........# #
#..\\.*. \ #..... .#...*.\.    ..*..... #... # #.#
# \*... ..... ..\*. \. ....#...  .. . \..**..*...#
#... \ ... .\...*..*\.. ...*#*..* *..... #..#..* #
#..*....... .#. ....# .. .... ...  ....\\#\.\.. ##
#\..  .......*...*. ....  .. \ *... ...\. .....  #
#... *.. .. .# *. ..  #.....#.. \.. *. .#   **.*##
#.* .* #. . .......*. *........#..# \.*...##. *.##
#.... .... *.. *.*. . * .#...... \# ... ..##.. ..#
#. ...  *. \. .. . ...*  .  ...# * ....#**.**....#
#.* . \*.*#. \\ .. ..#.\.**...## ** ... ...*....*#
#.#*  .*. .\ ...#..#....#...*.#**. ..# .#..*\ .# #
#. *.#...# #.....  # . *...\..*..... ...* #.#  \.#
#. *.**   ...*.. ...*......... #  . .. ..*.\*.. .#
#.#. #....*#*\...*.*...#..\.......*.... ...*...**#
#\.#... *. . ....#.*#. #.  #\ *#...*.\....  .#. .#
#......... ...*  *.\....*. *# ..# .#.#.. . .#..\ #
#.**. *.. #\. # . .. . \*.. .  .\##\..  .. ....  #
#*. ..*..**... .# ..#*\*...# .. *\##*...\ #......#
# . . ....\. #.. *. . . ..  *....#\.......*.##*.##
#\. ...* .*. ....* .. .#.#\..#... . *... ........#
#.. *.\*.. ...*..#..**\. ..* ......#..#.. ..*#..##
# *#.. ...... \.#* *   ....\.\.*##.. ...... #*..*#
#..\.*  ..#\#.* .  .....\..#.   ...#.   ..#.*....#
#... ....... .\. ...*. *...  . *... .*#. .*... #.L
##\ .. #...... .*#..#.. ..*.. ..  ....\....*...\##
#\.\*........#*.\.*.\.  .*..*.\ ....  .# .... *. #
#. *..   ...  ... ... ....\ ..*... .. ##.. .. .. #
#... . ##...#.###.  ...\.*.# . ...*.. ........ *\#
#\. #  ....  *..  .\ ..* \\#.*  .\......##.......#
# . #...*#..*#*.* ..#. .\*#.# .... * .*\  .. .#.*#
#... .##.#.\ ..#*.#. ..#... .#   .. .#.... ..\##.#
#.*.#.... . **.#.....*..#.....*  . #...... .#*.* #
#...  .#. ..# .#.  . .*  *.## ... .. ..  *\.# ...#
#...\\#. #.#....# ...*\..\... * .#.. ...  . .* # #
#\ ...*..\....*. ..#  .#....## . \... #  .#. ..*.#
# ..\ .. ....\. ......**......*...... .**.##\..  #
#.......**#.... #\.#*.. ....*.. # . ..* #* .. ...#
#. .  ..\..#.. .. . #..*.....## ... *..#... . .*.#
#* .\\*.#.#* . *....#.  .....  ### .#*.... **....#
# .........**. .  .. ..  ..... .\\.... *#.. *....#
# ..*. .\. ..#.  .\ #..\.. *.***#*. *...#....#.#.#
#\*...# #...........\....#...*..*. *. #.....  *. #
#**.....##. .*.. #..* ..*# \. .... # R *.* ...*#.#
#...# .#*#.#\\...#......*.#.*...... #... *.. .  *#
#... ..**.#..###.  ...*..## .. #*.#*.#.  ...#.*.\#
##################################################