######################################L###########
#*... ..*..#... ......#.#. *. .. ......* .\. #.*.#
#.....  .* ...# .... *\.....\*..*.....  ..\...\..#
#.*... .. .**#.... .  . .* #...*\..... ... ..# .*#
#.#.* \..*. ... .\.* .. ..... # *....\ .#\ .\.. .#
#..... .# ..... . #** *....# ...#*.. .*.... ... .#
#. #.#  .\...*.**\ .*... .... . \..\. ..**#..*...#
##...*\...#.....#.##.   . .* *.\.*.**  *...\...*.#
# \...#.. .. \....*. .\\...***#.*\ ..#.*..\  ..* #
#.... ...#\.... ..   *...#.........# *...... .. .#
#.*.. .#...* ..*......#. .. ....##..* . # .*..#. #
#.##.... * \#.* ..*. . ......\.\.#.#*......#.....#
##.. ..*# ..#*.  ..*..\ .... .#.#R#..**. .. .. ..#
# .. .. .  ##.# ...\*..#*. .#...#.. ..*.. *.#..# #
#. #  .#*.\. .. * . ....*\.. ...  . ..#.......#..#
#.*.....***\**..... .......*.. .#*... ..... ..#..#
#.. ....#\......*.*.  ...\..*..*.. ..#....*.. ...#
#. .. .....#\ * .... \.  \ *  * ...  ....\. *.. *#
#. . . .** .. .#... .#  ......\ . #.. ..#. .*....#
# #.**.......#.. #....... .... *# \..* .#*\.*....#
#.*... .. .... * . * #  .. #.......  .#*..##. \..#
#..#*#.... .#.\......\*... *\.\.\.  .#. ... .\ ..#
#.*##..#........#  #*. #.... .#..  ...\ .  #*.#.##
#.#.. #..#..*.#*. .* ..*....\.. \.. #. ..*#*.....#
# ..*#\.#.....# *  ..\ \.. ...*..#... ..*.*.... .#
#\. .  ........#..\#..*.. \..\ \ . *.*. ...... .*#
#. #  #.*..# ...# .*..   .. .. .. ..# # . ..\.. .#
#.#. . .*#\*.*. . ....*   .## ...... .* ..#. . # #
# .  ..#... *.  *. **##. .#* #. .  *. .   ..**...#
#.# .. ..   ....\  #.. \##..*..#... .#... .....# #
# # .# .. . ...#..#.#.\#*\..... #.... *#. . .....#
#\*#*........#.. .* #**.\ .*# ..*.... .  .#... #.#
#.\. .##. #.. ...##..  .......\... .... ..#*.....#
#*#*..\.\. .#. ....* ..* ..*..  .#...* .. # #\...#
#\.. * .#. .#.......*..*.*.\...#. \. .#. ... .  .#
#\.. .#.\...   .*. *. #.  ..#*. \. \... ..#*... .#
#*.  \..\. \..   \...*..\. *..  \...#\. *...\.*. #
#.#.......# \\.. *.**. ... .. \*#.#. .. .\ ...#..#
#...... .....  .##.. ....*\. .  ... #*#.  .*  .*.#
#..   . #\ . * .\.# .. .......#.*.....#..#. ..\..#
#.....*. ...*... ..#.. .*.  .  \   .# ..# *.*. ..#
#*.\..... .*. ....#..#..\....... . .*.#  .#**.\\\#
#.*.....#* ..*. #. .... *.**.  .......\........ .#
#... \#.\. *.#.*...**#...*..#... *.\ .....#....# #
#  . * ..* *.#..#*.  # .*#*#..\.*. .*..# .* *. . #
# .* .\*   . ... .*# .. .\...\.. .#... .##.....# #
#.*.**#*..* ...*. .#.... ..   **.**\* .# *..*...##
#.#*#  . .. .**..... ..*.* .##.. ...........#.. .#
##.#.*#.*.. .*  ..\..\\. **. ..#.. ... .... *. ..#
##################################################