##################################################
# .... ... .#..  .*.....#. \.... ..#.. .... ...#.#
#..  ...#...... \.\#*. ..*.. ....#*.##*\  . .#..\#
#.*. .... ..*.* #... .#. .#..... ..\ *.. *.... ..#
#. .......*...*# \ ..... *..#* . . .. ..**.. .*..#
#..*... \..\*.#.*#  #* *\...#....  ........    .##
#..\...*...... *#\.......\.....  ..\\.. #. ..\...#
#..... . ..#.#.*..#.....##..*.  ......\#. . .*.. #
#. . *.##*. *.\. \..# # . . .. .#.. ....# ##.. # #
#.*. .\ . ... #** .. ... ....*.#.\# * ...  .*....#
#...#.\. #..*.*....##\ ..\\..*.........#*.*#..*..#
L*..*....\ *.....#\.....#. *... .# #*..*..#\*.* .#
# \.\*  . #.*..\.... ..#..#   .*....* .#.. *.....#
#..#.* .#.*. .*#  ..\......# # ...*# ....\ ..#*..#
#.. \ #..*. .#  .\.........*#.... ..**.. ...\.*  #
#.  .. ..... * \...#*..#*..*.... ##. .... *.*  ..#
#... . ....**#.*\.# \.\..*# *... .  ...*.\.. .##\#
# \.....#*. *. .. #\.*...#...# #..#.* ...*\.#\...#
## . . ..**.#\ .. .\..*\#*  ..#.. .*\ .... \. . .#
##*  ##..\..# ..* *. .*.... #....*....\\#... ..*.#
#*. #...  ...\.*.\.##*..\.. ....*#...\.. ....*...#
## ......*#*  ....#** #.*.... .#..*.   ...\..  \.#
#..*\\..\...#...\ ... . ..*. ...#..*  .. .....** #
#\**.*#.*...* .\*# #* . .... .......#.... . .#.*.#
#. *...#*#\...*..*\...#.#..  .\.  ....##.#.*..\*.#
#* # *.....*......\....**. *..#... .....  .*\ #.*#
# *. *. ..\*... .....   #.....*. # ***.# ... ....#
# . *..*#... ..  ........  #. #. \\..\# .#..#\ *.#
#*.\   .# ... .* ... . ... ..  .. ..\....#   #*. #
#\ .*.* ..... \. .... ...#  \#. **...*# * .... ..#
#.....*.*.#.\..*.#... .....*\#..#  ..\.... .\  ..#
#... .. .... .......\# #. \#* #.  #. .....#. .* .#
#... ..\.  .. ..* .\...**.....*#... .. \.\**.....#
#\ #.\....\.*#.#. ............#. ..*. ..## .  \  #
#.*. .....  .....*..\....* .......# ..*#.........#
#. .. ## ...## #. #......*. ..\.. . ..... *..*..##
#..  \ #...#.*........*.*.#.   **\. ......*.#....#
#.. . .. . \..*.. .*\.#...#..#*.##. .*# *. #. .. #
#.... .... ....\...* .. .#..\#  .##..........##*.#
#... ...#  *.#*..... #...#\..\.  #.#. ... ....*. #
# ... ..\. .*.\..  ....\....# ..*# *.. . .#....###
# . . ...#.#........\##...* .. * ...*..*#... ....#
#. . ..*#  \.#\  *...#.....#..\.\ .# .* .#.#\*.* #
#..\ .#.. \..#.#  .*..  ....#.\ .*.. *..*.....#* #
#*...# . \*.....*.R...\. .. * ..#.. .. .#.\ .. \.#
#..#.. ....*..##.#. . #. *.\...#. .*...*... *#   #
#..#.. . ..#.. **. .*.#.... . *.#*..# ......# ...#
#.#...#*.  \.#. .. .. ..\# .*...*.... *...#  .\. #
#*.*.. ....* #. ... . .\* ... .#*...#..#......#..#
##################################################