##################################################
#... * .. ...\*..#..*..##..*. .##......*.\..\.* .L
##. \...\# .* ..#.*.* .  \\...\.....  ....\*... *#
#.#..... .#.\.. . .....\.##*#  .... #.#. ....#.#.#
#..#. .#  \#. ..\.. ...  #. .. ...\.*..# \ ..*. ##
#........# ...*.#\...  .\..*...#.. . **.*.*......#
# .#..  ........*...* .....\...... ... #. ..#.. .#
#.  \ .# ....#....##..\# .#... #....*  ... ....*.#
# *.. *... ....* \. *........#..##...#..#....  .##
#..*......  #..  *......* **. #.\*.... ..*....#..#
# .\. ..*. #....*.*... *.\. . ....#.. *.# ..#. *.#
#..* .\.... *#.#...\#... ..... .#.#.\.#..#.. . . #
# *.*.  ...#.#....*.... . .. ..#.##...\.. .... ..#
##.... \.#   *#*...\..\  ..##..#... ....*.\... *##
#.*\.#...##. ...#.*\.#...... #....\ ...* .**R   .#
#\......\  .*....*.. ..... #.*.\ *..... ... . .  #
#..*.. *....#.**.#.*## ...  \... ..... *. ..**...#
#.* #.. #* .#.#   #..# ..........*#.\...\.#*.#.  #
##.. \..... .\...#\..\.#  . .....\... ....... *. #
##.#.#.*...   \.. .* #...... #.*..... \ ... #*.###
#  .#.\.# .  ...#..#*......**.....*  .. .* #.....#
#.. .*# ..\. *.......# ...#.*.\...\ .\.*..#.. ...#
# .....#\..*..*. ... ...##.. .\.. ..* ........ ..#
#\..# #.....*....*\...\.#.... . #..\.# ... .*#...#
# *..\#.. ....... ..*. \..... ... ....\\ . #. ...#
#\#. ..*..\.....* .. . ###*#*.#....\ #  . \ * . .#
# ..\....   .#.# ... .*..##*. ... .*..  ..*..... #
#. .  *..\... # #..\ ...# .\..*#....*......##..  #
#.. * ..\.#...#.. \*..\... \.*.\........ ... #.\ #
# # ...... ... ..#  *\.*.... .**  .......... .*..#
###............#.* .. # . ...\.... *.*. ..#.#... #
#.*.. ..\....... \#.# *#. .*........#. ........ *#
# ..\*.. .. #...#.*.....  \.  \  \ .#....... ..  #
#*.# .# #.\.##.. * ... *.. . \ ..# ..\\\... *....#
#.# ...#.........##\.# ... .... .. ...  . .......#
#. .... .......*....#...*.*..#*.  #\. #.* . . **##
# .**..#....*....#..#....  # .**. \\.\ . ..... # #
#   ....#...  .#..#.#..\.*.  .#* # ... ......*.\.#
# .#...... # # .*.*# ..  .... .*  ..#*..#.*  ....#
# .#.\.\...\#  .. . ##*.\.#.....\* #.\#.*..*..## #
#.\*.. * *..... ..**.#**#... . .#.#...  .......#.#
#..... . ...## . ......#*.#..  \.....*...*#**\. ##
#........#.#* ... ..... ..#.... ......\*.##*....##
#.## ..*  ..#..*.. #\\. .. ..... . ...#.*. *  ...#
#.. .*\.  . ...#..#..*.   . ... . .#.*.#..#.#*..\#
# .\ . #. #\  # .\...#. ....*..\.#. \ .#*...*.. .#
#.... *.\. ..... *..#\* .*......#.   . *.  .... *#
#.\..\.##.*  . ... .... *. #*.....# ..#*##.. ....#
#.*...\..# ...\ . *....*...\...\.*. .#.* . .*#*.\#
##################################################