##############################################L###
# ..* *#. ...#... ...# *. ...*. . . #.*.##. .*...#
#  ... .\. #........ #.*... ....\. *....#..#.**..#
## ..\.#...#*#.*.....*...*. .#....... #..*  ... *#
#\.. .#*.#*.. **... ..**..*.#.* ..  #. ..\. .* ..#
#  .....\ ... ...  . .\ ...#.\ .#*.*. .....*   #.#
#.# ..*...\. .. .......*##\*..*. \.. ...**... . .#
##..... #.*..**...*. \    ....   ..\. ...*.*..*..#
#....*......... .\...\*#*.#.\#. ***. .*. ...R....#
#...*\ .. .   #  . #.# #..\. ..#.*.#.......*..\* #
#.....  . #  \*. #.*.** . .....# **......... #.\ #
# . #.....##*... .#\.*  ....\.#..#.. ....\*# .. \#
#.. ..*#.*....* . #* .*...#. .#..... . . .. .... #
#.# ...#.* ...##.#.# #.. .#.* . ....*.#.. .....  #
#..#..\.# ..#..  .. .*.\.... #.**....#.....*... .#
##.. ... .. .*.* # .. .*.\.#.* ..*. ....  .\#  ..#
#..*. * .\..#. *...*   #.*#. .# .....*.*  .#.\# .#
#... .#\ .\* ..\*. .. . . .#..... ...\ .#\  .... #
#\.#..#. .\.. .*\.#*  ... .**. ......*.... ..*...#
#...#  ...\..#..... . .  ...* **.. .. #. .**.. \##
#..\*.... .# ##...## .#...  ..\.. .....#. .# ..\.#
#..* .*  .. ..#.\*..*.*.. # *\ ... .. . .\.* ..*.#
#..#..*....# ..*......#.**... .....  #...*.......#
#. .* ..#.... ..\..#.*.\.. ###...##..*.\... ..* .#
#. # ..# .#\..  ....#.\..# ...\.*  ...*.\..#.....#
#.# .*.  .*...#..#\...* ...... . . ...*........# #
#\......#...# .#. .. *.\ .*##.*..*..... .*  #.*  #
# *..\* .*#  ..\.\..\.# .. \ .......  ..## *.....#
#. ..## ...#.   .. #. .   # .#.. .. ..#. * . ## .#
#\...   .. .. ..## . ....#...  .... ... *.. . ..\#
#. .. . #.#.\.# ... .#*.. . *. \\. \.*.. . *#....#
#..*.. .. ..#.# \.# ..... ##\ ..#.  ....  ..... .#
#.. .. .. ..#*.#...# #\.. *. ..*.. .##.\ .. . #..#
#..##..#.*.##...*  ..#.. ..#........\... .. #.*. #
#. .##.......... ..#..#.    .##.  .#..\  .\**# *.#
# *... .#....#. ..... .#. ..# ...*... .#*#...... #
#....*.....#.. \ ..##.\......*.. *. #..*#... . ..#
#..\. . .#... .*\.. \..\...*.. ..*. .. .#  ... ..#
## .....   ##.  . .... .\ ...   ......#\...**....#
#...#\ .*..*.# ..# .# ..  .#.#...\.. *...... ....#
#...#.\..**.* ..* *.\#.#. .#.*.. .*..*. . **. .. #
# .#\ #.. ....# ** ...\ . ....#.# .#.\**.  . ..  #
# ..#.#.**\... **.. .##\  *. *#........ *##...*.*#
#.  #... .. #.\..    . #..  \.###.**..# \.*  .. .#
#....*.... \. *.. ........#* ......*. ..* *.....*#
#.. .......#....... ..#......... *..*..... ..** ##
# . #.. .#..*.#\#.  .#.\ \.. ... # * ..#...#... *#
#....#\.........\. *.\#* ... ..#....\....*  ....\#
# .# . ...... ... .*  ...**#....# *# .*.#..#*  \.#
##################################################