##################################################
#....  ..  .#....\.  ..* ..#*...* ..# .... *.*.  #
#\..*..*# * .* *.#.\ .....#  ....  ##*. #.*\*...\#
#..##\.*\..*. .\... .**\...*......\   ..* #. ....#
###....\...... .#..*\.  .. .#. . . . .. ..\*\ *.\#
#.*  \*.\* ....# *.... * . .* ..#* ... .# *\. .*.#
#.#....  .# . ... #*.....* .......##..*... *. #..#
#.#. .  #*...*.  ..*.#.\\.**... .......  \.. ...##
#.# .   .\**#...*..* .# .*. \#... \.*.... *.#.*..#
#.*....*. ..#  #\*#..  ...\.#.  #. .\.*...#. ....#
#..\ .......*.......*#*\.....\\.. #.  \ ...*..*..#
#.  . . . *.... .*.*# *#. .*.*. .*..... . . .. ..#
#.##.... ...  . .......\..\*.#*...\...#.. ...***.#
#.. .\. *#.....###...#...*..#........ ... .*.*.. #
#*. .*.  #.. *...*... .. .* ....*.. . .....*.*.*.#
#...*...#.. .#. *.  .#\#*\.. \.... .##..*.. . ..\#
#....\. ..##.. .##*. .. .\ ##*... .....#..\...#. #
#..#... ...*....\.*..#....#\.# \.*....#\.*....# *#
#. \\..  . ..* *.*.#. ... #* .*.# # . **.. ..\.. #
#.\. .. . . .. #..... #*\. . *#.* . .#. *.  ...#.#
# * .* #.#........ #\#  . *..*#*.**#.#....*..\*.##
#..     .#..#.# .........\.. * .\.. . #. *.*.. ..#
#*.*\. *.. \\ ... . ....#...#.*#.#.\..... ...  ..#
#. #.*. .. .# \. . *.... .#. . . * .. ...\.*##.\ #
#..*..\\#..#  .*.. #..#*......*.... #*........ .*#
#\ ..... \. ....# .. \ .#...# ...# .##.*....#. ..#
#.*#  .#.\\#.# **..*.   *## . ..#.... . #.\ . ...#
#   .*..#..# .  ..*.  .# ....*\.#..... ...#... *.#
#\..##.. *. ...*. .# ...  #. #. #.  .... ..* .\.##
#....* #.  .... . R *.  .*. # **.#......#**. . ..#
#........ \   ...   *...##.  #...  ..###.#..#* #\#
#....\.**.#. . ..\...\#* .* *..* .....#...  .....#
##.. \..*..... ..##.... . .*  ... .*...... ...**.#
#*.# ...*.   * .....     ... #. \.*  .# .#  .\...#
# *...#. ..*.#\.# \#...#......  .....# *. **...  #
#.# . .# \*.\.  #\# .  ..\...  .. .. . . *..* .**#
#..#  .*  .  . \*. ..* *.##  .. * .  *.. * ...# .#
##........*...*.\ *....#.*.. ..\.  .#* . *.   ...#
#.........  **\# *. ..... . ...#... . .. .\#*.#..#
#.*. *.#.*...... \*... ...*.*...\ .##......\   ..#
#.. * *# ...*\ * #.#*\ .\. #..#.# ....*.. . .....#
L...... ..*....*......*.*. .#.. .....# \...*. ...#
# .. ...\ . .*... .  *. .... .*.  .......\.. ....#
##.  . . # \ .. #..*. .**.\. ....... ..\*#...  ..#
# ..\. ...\...* .* # \ #.*....#.... .... * * . *.#
####*.#........\..# ...*....#.# *.**.*.\.. . . #.#
#.\..* #*. .#. **.. \.... .. .*...*. ... ......###
#\. *.# \..  *. ..##.#......\\.*..*....  #..  ...#
#.... ..#. ...*..*# ... . ##.*\ ..# .*...#.. .**.#
##################################################