##################################################
#.#*  .......\.#.... \ ..#.* # .......**....\ .#.#
#..\ #  ..#. ..  ....#.. ...*.#......*** . ...#..#
#.#\* . \#..*..*.\....\...#.....*. . ...  ....* .#
# #*.....*...#. .... .\...\..\#. * .\.* .#.#.. .*#
#** *#.\#.#\##\....#\........ ....   .. \*\*...*.#
#....\..#.#.*.*  ...#.#.#.. ..\*....  ......#.. .#
#\#.....#*.\*#.. ..#*\.*. .*..#..\...#*# \..*###.#
##......#. #.*#  #\.... *...* .....\.........*. .#
#.*.....*.\**..*\ .. .*## . ....#.....*.......#.*#
##.....\\.* #.. #.#.  .#.......  . \..#  .   .*#.#
L...*.* .#..#\....#....#..... . .. . ...... .....#
##.\ . ..... #  .#.# .. .... .*.. .*....#**  ..#.#
#... *..*.. ..........#...\.#...... .#...#.#.    #
#.. . .\ . .. .. . .. #. ... ...*#.*...*.* ......#
#.. .....#.\.* ...*#.#. . #. .**#..  . .#...  * .#
#.. \ .  \ * #.... #....#....*#.#...* #.. .\ #.*.#
#....\  * .. *.**#. ..\..* ... .R#..#.#  #. .....#
#. . .*..*. \.#..\..*#...\..\*.....\..... \. . * #
#.#.\ ....... . ## . \ ..... \. #.....#... ..#.. #
#..#**.#. .* *. .. .\  .  .#..#..*.\... .#.... .##
#* *#. .. ....\... *#...*.#.\..** ...*##.#.*.. ..#
#.*. #.\*..... .. .. .. ##....  ....# \ #..  ... #
#.#.... .......\..  .\ ....*\.   ..*#*.. ...*#...#
#.\..... ....*# #\...*\*. *... .#*##. .**.  .##.*#
#.... . ....... **... . ... ....#*#\.  .#. \.*#.*#
##*. ..**#*.  *. \.... .* # \. ..  .. #......... #
##.**. .#..*.*.....\.. . .... .*  #..*.\*....*  .#
##**.*  .....#......*# *\. ......   .. ..\..\ ...#
# ... *.#.*  *.  .\ .*.. .#. *\#.# .\.*. .....*#.#
#\.#\ .. ..  #*.## *...*......*..*. .. *....... .#
#  . . #. .#..*. .....  .*.\ ..#      #... ......#
#\.....\*.. ..##...*#.## *.#.#...*#...\  ......#.#
#\#*.#. . .... . .#* .* * \.  ......#*.#  *..\...#
# *#.... . *. . ....*.. .. ....  ..\.\  .*\\....*#
# .* .. ....#.**..  ....* \. ... . *.. .#*...*.\.#
#... *## ..\.\ ...* #.  . ..*.*. ...\....... #. .#
# .. .....*.. *..  * .#..* .....\# ....  \#.* *..#
#.. # .##..*.#.. ...*.....*.. \... # ....*. *.*.\#
#.#....#\ ###*. \ \... .#.*.*\....#* .  .*..*.#. #
#........#\..... ...##\..#.#* *.#..* .. #*. .*.**#
#... #.# *.... #..#.... .. ..*.*.#*. # . ..**. ..#
#.#...... . . #.***.#.......#........*.#. ..*.. *#
#*\..\ ....*...# ...\. .. ..#. . ..\...... #.*...#
#. \.. \..  .\. .#. ...*. .\...#.... ** .# .. . .#
#.#.... ....# .. ..... .  .. ...*.\...#*. ...\.#.#
#.###.*#.\.#.....* *... *#..  .. ...... ..# ...*.#
# *....\*...  ..*. ..# \.... ... *..#. ... .  . .#
#. .*. ..#* *#...*#\..... #..# #.\ . . ##......#.#
##################################################