##################################################
# ..* ....\.\.#.. ..\.\#..#.#......... .#\ ... . #
#.** \ #........*.. .*....*.*\* #.\\.  *.... ....#
# . ... .*. ...*.....**.# ... .**.. .... *.#. .*##
# ...*.  ...*.# #. #.\.*\ .\*.. .. #..*.*## .*#..#
#.  . .\....*  .*. .*.*#**.  #\    \#....*  . \ .#
#*..\# .**.*... ....\\. *.....#....  .....* ...# #
# ...*.. . .... ....*...\....#..#\ .. *#\....#...#
#.... .\ ...* .. * ...#*. #.  .***. .#. #...#....#
# .*#..#. .#.... ..\.*.  ... . .*. ..\\.. .. .. *#
#.*.....*  ...#*...  *.#.*    ..*.#.# . . # #.*..#
#.* *..*....#.*...#*.....\ .   .... *#*..# #....\#
#*#..#.#. .*.* . .\ *.. . . #.......#\.*... .....#
#. ..#.#**... ....#*.*.#... ........ \ \ . ..# . #
#*.. .*.# ..... .  *... . ..*  # . ...* .*.....###
#.*.*. ##\ .. .. ..\. *\. .. ..* .......  \**.  .#
#.... .. .. ...#.*. ..# #.. .* .\..#  .. *. ..# ##
# ##..*..*....* \*#.  ..#.. \..*.#.....#   .#   ##
# ..*.* .#...#*..*... .... . . * . ... . *...  ..#
#. # *..*....*. #.. .. ..#..* ..... .. . #.... \.#
# *... ...*...  ...* ... ..\.. ..\ ..\. #   ....*#
# ...*.*.. . . *#...\.........  \....\..##.. . # #
#*# .\ .# .. . ......# .  #..#... ..*.*. * .*....#
# ........#    ..#*.#.#. ... #.*. *...#.*..**. .\#
#.. #...#.*.  . .. ...*..#*#....##.  ...*.. *.**.#
#..  .   *..##.....#..\.**.#. .......#....\\...  #
## .**..  #.*. *.    # ....\.#.....\.* . .*.. ...#
#....... .#.\ *.#.## ......# #.# #....#...#..#..*#
# ##...*.\. ..\.. \\..##.. .\....# #\#. ..*.* .. #
##.......*.. . ... . #\***. .\##...##.. .#..\..#.#
#   ...    .\.. ..*. . .#\..#.##..\..... ..*\ *#.#
#  ...\.\   *.*.... \.#.  ..... .*... .... ..*#. #
#*...\.\....\ \.. #### ..\.. .###.#.. ..\ ... #..#
#..\#....#.... #.*.\. . # .#.#..#... .*   ...*.\.#
#... .*.* ....* ..*\..*** .\.. ...\ . .  .#....#.#
#....*.*.#.....   .. ........\  . . .   ... ..\ .#
# *.    ...*..**.....* .......*...  .*....\.*... #
#  # .......#.#..  .**.*#. ..  *#..\...*...  #.  #
#*....# .... * ..   *..\*..* .# . #\\#. ##.\.. ..#
#....\*...\ .##. ...#.#.\.. .** .*..*.. ..  .\ . #
# * .... ...#..*...... .. ***.....#...  .. \ ....#
#.*. .\. ..*.... . *.... ...*..  . . ........#.\.#
#..##. #. #.... ...... .#.. \..**...#.# \....\# .#
#*. ....   # .. .*#....  ...  #*.... .... ****...#
#.#... .*..#.. . #.#* ..# *..  .#*....... . ..*  #
#\##*#..#.. .\ ... ...#.# . #........ .. ...*.## #
# ..*. ...#.....*.... ... * .*#. ## .* #......*..#
# .\..R.# *.#...*.#  *......\....  .. \....\.. . #
# \. . #... #.... ... .  \.....**..* .*.. *#.\ * #
###############L##################################