######################################L###########
# ##.... # . *#* .. . .... ....#.#..    \  ..*#. #
#.#.#.#\..#*..#  ..##..  .\.*....#\. ...*#......*#
#\ ....#.*........* .....* # \.\........*. ....\.#
# ..*.#..*#...... .... ....# #.#.*. ... *  .#....#
#.#   .*... .. #*\. .... ##.#.. .. ...... \#.# .*#
#*...#.#....\ . ....*#.\....* ..#.........* .. \.#
#...... #..#. *.**..\. *. ..\\  *... ...  .\... ##
##..#. ##*#. #.*. # .#.\.\.....  * #.*...#..... *#
#...*..# .#...*. .*.*.#..  *\.   ......#..##..  *#
#.#....\ ..... #.....**..\. \.. .#.* .  .# ...   #
#   .. .  #\...#*..*. ...*#.\.... .... .*\.\. ...#
#**#..*...\#.  .#......\..#... ...  .*.. ..##. ..#
#.\*. .*# .. * ....# ....# # \.. * .....\ ..  \ .#
# ....*.... #..\.*#. ... ..*...... ..*.#.#.*. . .#
#.#*   ..#.*. ..*..#*. ......##.#.....*... .*. #.#
#......# .. . . #.....\  .*.**.\#*..#.. *\.*. .  #
#.#.**..#....*......  .* .*.*..*# ..*..*.#*.* ...#
##......*...#.  *# \*...\. . .\... * ....*  .# .*#
#.#.. *  .... .*.*..* .....# .....*.  ..\.##.\..##
#**   # # . ..*..   . ...#     .#*... . \*.#.\.  #
##\.....* .   .. *...**....#*.#*. ..\.. *.#.. .#\#
#...... .... #.  .. .. ..#.# ...*.....*.. ..\...*#
#. ...   #......#.. ..... ....  #.*..  . .....\. #
# .. *..*.. ##.. .##..  *.... ... # .... ....#.###
##  .#. .*. ... .\.*.*..* .. .#...#.# . .#.......#
#*. .. \#...... *.*#*.#....*. ... .. . .#.\.. .\\#
#  .*.. ..\**  ...#  ** .*.*...#..#*.\  .... ....#
#.* *.\..  ##.\.*# .#* ..#...... ..**\.....#....\#
#. .#...\..* ...*.*....  .  ....##.. \\\.*#.* .###
# ...\*\  *#.  ...** ...#..\...\  ..*.. *. **. ..#
#. ... .# .*..... . . .#\..*.......*.*.. ..#\**..#
#. .....   ...   \. .*.. . .  . ..*.#.. ...... \ #
#. ...R#..#**# *   *#. .\.**  . . *... ..*.#\..#*#
## ..  #....##.   .. .\.. .....*..#*.*... ##...\ #
#.\...\..*...*.*** ...#.. ........ ..... . .. . *#
#\ ......*.....*..*#.  .... .. .*...\.#.. #..*..##
#. * \..** ....*..#. .*.....*  #*..*#..#.... .*. #
#*..... \.. # .. .*. .#.#..... . .\ #. ..***#*...#
#... # . . ..#**.. \... .... ..\#.. ..  *.. .... #
##.*. .  \..##..  . . .  ...#.#*... .#. # . .#.. #
#.... ..**........#..#.... *... .......#..... #..#
#.\..\#.# . ...... *.*#.#  .#. #..*....\. ....#..#
#.#*  #. *..... #.\..  ....*. .*  \.....#.. . . .#
#. \....  *....\#...* ..  #.......\..#... #.. # ##
#...#  .\ ..#.....  ... .#..*.\. *#.  .  .\  .   #
#.#..#*....*...*  .. *.....*..  ..\.\..*.........#
# #. ...*. ....#.. ........*  *#. . * ........ ..#
#. .. .## ....  ..#.\...  .*.* .......##.#*\.*.. #
##################################################