##################################################
#.#.... *#*  ..# .*...#.. ....\*.\..    .* \ ....#
#. ..\.....\*.\.#.. ..  \#.. ... .  .# ..  \# #*.#
#.#.\... ...... . \*## ....*..\\  .\.... ..*...  #
#  ...\ .#\...  * ...#*..#.\.* .#....  ..#. . ..##
#..#.. ..*. ....\  .#.. ..*...... #.......#* #. .#
#.....#*. .... .....#.. **. .\.#.....  *...  \...#
#.* *.\..*.  .\.#.. ..*.\#.#*.  . . .\..# . ...  #
#....*...# . ...*#\..*\....#\ ..\.\.*..\  ..*....#
#*...\. ..*#**..*# ... ..\.*.... ...\.##* # .. ..#
#  ... #...  # ....*  #..#.. ..#.*..*.*\#..... .##
#** **.. . ...*.. .... \\.*. .#*... .*..\*.  ...##
# #\\.....*.**....**\..   ...*. ....*  .\.#. #.#.#
#..  .. . #..  .........#*#*...  .***...#..... #.#
#..#...*# \.\...# .*........ .*..###*. .\ * ..  ##
#.*#. .#.#*\.#... ....*.#.. ..*... .#...  .# ..#.#
#.**...* ## # #*...  .*...*.\.\\ . . ..\ ..*..\#.#
#..  .. #.   .*..... . ....\   .  ... \*..*..##..#
###.* **.  # .. .#.....#.*. ......\... . . .##..*#
#*\.#.*..*.    . . *.....* #. ... # ....##\.. ...#
# .#.  ....#.  *. . .. . . ....#. \ #.\#\.. .. *.#
#*....#.... . ..# .\.#*#.....*. ...#*.# ## .. . .#
# . . *\\...  *.\*.   #.....*...  \* .** * ......#
##. # .**## . ...... *..##\....\#..* .... *.# #*.#
#.* . .. .\\...*.*. ......*..* ...  .......*....*#
#..\ ... .#. ..........\ . #.#  .#.\.*..**..# ..*#
#.... .....\  .\\.*. ..\*...*..\\.   . .  #.. ...#
#.*. *\.##......\. .#... .... . \ .##..\*. . .\  #
##  .. *..*#..*.... ....*  ...*..\...  #*. ... .##
#..*#...#*#.#.* .*.  ....... ..* *.#*#. ...*\.#  #
## .# .......  ... . ..*.  ..#. .. ..*....\\#*.*##
#\*. . ....\ *.*....  . .. # # \\. \.#. .#.... # #
#.#.*  # #.#..........#.#. .  ............#* . .##
#..#.  .\.# .* #\* ...  ......#\  . . ..#. .....*#
#...... .*...*. #...# #.#.  ...*..#. . ..*.#*.  .#
#.*.*\.*##.#....  .*.  . .*#*..*..  ..# **  *..\##
## . ...#. .*.......... ..**...\....  ..... . ...#
#.. \... .... ..##.#.#... . \..#..\##..*..*#. ..*#
#.*\ .\.. .. #..#.. .....*  *..*.... . .. ..#....#
# *... *. .#  #.....  . *.  .# ........*#    .#\ #
#..#........ # #.#...........#.....*...#\ .*#.*#.#
# . .... .*...   #.  ..## ....#.#.. *.##  .#*. \.#
## ..... #. .... .*\#.##. .#.*..... .  .. ..## ..#
#.* ....#...*..*.#. #. ##.. *.  .....*...\  . *..#
#..*. . ....  #....*\ .  **..... ............. ..#
#..#..#. . \ .   * #. ..#** . # .\.... \. .\... ##
#.  *.\...* .**.*\*.... *.\ . \.#.**#. *.****.. .#
#......*.. . ..#.#... * .. ... *.     ..*.#  #*..#
#....... ..R . .#*. ... .*  * ......... .. .\#. .#
#########################L########################