##################################################
#.* ...*.#.... *............ .#\\...\ #..... #...#
#....#.#.*.....#.. #.**.*#... .....*\\. #.  .....#
##.*#.#* .##... .* .#\...  . .. ....#.. ..*.#*...#
#\*..*...  #...\#* \. ..#\ ... .***.. ...... .\.*#
# ####..\**.. .#.*. .#*  .. . . ..*...*\#. .#.# \#
# .\*.... .*  .*..*......#. . . ... #.#...*.#....#
#.. .*....#*..... * ..  #  ......\...\\. ... .#..#
#\ .#\..*........... ##.. .\.. .#..***#....*#.*.*#
#\...... .. * #...   ..#. ..*#........ . ... .   #
# . .. ......#*..*...  **....*..**\#. \....#.  ..#
#...  ** .. ......  ..... .. ....\....#.. ..#..###
# .. *.**...#\.\*\. *. \  #*.*#......*#  * . .. *#
#..  *. *\#*........ \.... .  . . .\ .  .*.. ..* #
#* .*.. . #.. ......* \ ........#...*. ... .* .#.#
##*.\..*... *.\*...............#.#*. ..#...\....##
#.  ... .**.. .... ..#  *...*..#..\ \* ..\\\. ..*#
#* .#.....  .#.**...  * *. .... *....... . \ #..##
#......... *.#..# \. ....##..   .....*.*#*  .  ..#
#...#.*..*.#...  .. .\...#\..#.\.. . .*... ...  .#
#  ...\**# .*. .*....*..##...##.*.##\..*.......#*#
# ....  .. ...\*. ..**. .. .#.. .#. ..#.*..* ... #
#*..   *. ..#.   .#...*...#.....*..**...\...... .#
#..\\ ..# \ #..\# \........*\ . ***.... ###..\..\#
#  *  . .*...#.*\ .....\.. * ...  #.......#. .#..#
# ..# ..#..... \.. \#... .#.#.. ..*...*\ # ..   .#
#.#... ... *.#.*  ..*..\...  #.. ..... .\..    *.#
#.... ..*.*....**..## .* .....\ ...*. ..*.. \..#.#
#...*\.#..# #*. . ....*#  .  .....*.*.. . .# ....#
#.. .  .. .#..#. .#\. . .#.\..*\.*.*#.* ..#...* .#
#......\ ...*.. . #..* . *.*.#. ..*.  ..*# .*\..*#
# .... ... ..#\ .. \.......... .*#..\.\.*.*..*\# #
#\* ..**...  .#. ...# ....# ...#....#.\*.*# #.#.*#
#*.. ..*#..  .#...* . # *... \ .  \  ..  .*.\....#
#. .**\*.  * \ *#*. .....*#...#.... **#.* # ***  #
##.#. ..\.**......\. . * ... \....... # * .......#
# # .\.\.*..\##..  ..\*...*.  .* ..#...#..*...## #
#  . * . .#.# *.. #*.\*# .*#...*#......# .. .... #
#\.. *..\.... .*....*#.#*..  .. .. .. . .# .#*...#
#... ...\.. .*..#* ...*#\.# .. .  . ..#.\  \#* .\#
#  ...  . ....#.  . .R...#*........ ... *..#. . .#
#*. . .... . . .*.* \.#...#*....*...#*#. .\#....##
#.**..#... .. .## #.\.*.\. . ..*.#.... ... .\# .##
#*#*.. .... .....*.. ..* . .  .  .##....*#   .#.*#
#  .\*. .*. \ #....*..#. . *# ..* #*.#*......*...#
#. ... #*. #.....*#*. .*.*.#*. . .#  \.#..#*.....#
#\*#*..*#.\....#*\ ** .*.   .##.*...#..*.*\ .* .*#
#.# ..#.  *. .**...#. .#. ....#\* ...#...* \. .. #
##..  ...*.. * .\ ... *.*.#.* .. .*...\\*.  ...#*#
############################################L#####