####L#############################################
# .##.#... *.#.. . . .*.# .* * ..*\\.#.  #*.*..  #
##\*....   .*.*..# * ....... .. #*...... \.# ...##
#.  *..# ...* \.*. ... ......*..  #  . \.*.. . ..#
#...\*.# ...*\#. ..#. .#.*.* .. *.*  .\ ......  .#
#.#*.. . . *.* .. . #.# #... .\.#.#..*..#.. .**..#
# .#. . ..\*.#   *\.\   .\# .* .\.# * .. ..#*....#
#. * ..#.. \*. .  #.#. # .#*.....*...#.* *....#.\#
# ... #.. .#. ...\\ *  #*.  ..#.##. # #  **. .  .#
# .*. #.#..*#  ..* . #.*\.... ...##.... .#*.\.. \#
## ..#  *..#  ##... *...#...    ..  ..##..#..... #
#..\..#. #.#.*.... ... .\.. ..\... #* . .\\. ... #
###.* *. ......\*...# .# ... #.*.##.... . ** . ..#
#*.*#....\ #......#.#.  .. . . *.#.*#..*.*. * ...#
#*.... .. * .\...#. .  .\..\.#.....\...  # \\ ...#
#.    #.#.*.*...#... *. .*\. . ...\.*.*.. .... ..#
#... .#.#... ....*.... #. #.*.. .#.#*.. ** .#.* .#
#.*..*.*.#.....  . .*.*.\.#  . ...*.*\.\\.... ...#
#. \..... . . #.##.#...#.... .. .**..#*..# .#*.\##
#  ##* ......*. ... ....#.....#. ...*.#..  .#*...#
#.## ..  .# #..*. ..#..\. ##.#. .#*...*....#....\#
#... .\.# #*.*.#.... ..  . ..\.\.*. \.*......##..#
#  ..*.. .. .#...... #..\...... .*..#\.. # ... ..#
##\.* ..*... ......... *  .#. ... #.... ..*.. ..##
#..# .*.... .. .** .. ... .*..#.\*. ... .\.......#
#......  .* ..# ##. .   .. .\. .\**. .\..*.. *. .#
# . .**#\. ..#.#  #.... ...... ..#.....#\... ##.*#
#*  .* . .\.#*...# .**..\..# \*. .#. .*.#..# ....#
#. .*......#.....*.. .  ....  ....#*.\..  . .....#
#. * *#..... ...#.\*..##. ...#*.*.....\.#....*. .#
# ..#..*#..* ..**...\.*.* .\* .. ..#.* .\  . ....#
# #....\..  .* . ... \...*.. *.* ...# ... .*. ##.#
#. # .. . .....\*# . ...* . *........# \..*.**# \#
#...*........\. ...#. #..  .. *.#... *..  ....##.#
#*# . .#.##..\.*..*.. . . * #. *.* ...\.\....*.*.#
#\*.  #  #\.* #\....#..... *.. .#.*...... #.. .\.#
#.. . * ##..# . .#.* . .#.\..* #* ....**...   #\ #
#.#....***. ...* .#.........* ..**#\..#\.*.. .. *#
#......**.* ..*..*\..  .* .........  \.. *.##.* .#
# . . * .*#...\ . * ..##\. . ... .. * .#........##
#.*\ ...\..#.. . ......\.#. .  . #... *...*#*  ..#
#.....\. ...*... .#*.# ..... #\..*..\#*.\  ..*. .#
#.....#.*.#  #*.   ..  .#.....#\ ...#.*. ...##.. #
#..#*..#**.*  .. ....* *....## .. \..#\...#.* \\.#
#........*.  \ ..**.. ....\.\* .. *.. ..#... # ..#
# * *...*#.#  *..*#\.*.\.R. ..  *\# ... * *.. . .#
##.... *...  . .*.....*.#..#*.. .  .# ..... .....#
#. # .. ....  *\........ ..\... \ .#..*#* \.#*..##
#. .*.*.. ..*.. #. *. *..*...#..... .*.*. .*.*.*.#
##################################################