##################################################
#... \..# .\.#.**.#..\ \. ...#. .\ .....#**#...* #
# #..   . \. .... .# \. .... . .*.. ........**.. #
##...... .  .**#. .. *#......*........#*\.  ...#.#
#.. .....  .#.**.*....  ....# \#..*. .. .*. #. ..#
# .     ##....#*#.#\...\...#....*...*#......# ..##
#  ..##.\.#... ..# .. ......#...*.#. .  ..#..\\. #
# *..##\....*..*.#.... .*...*..*.*.\*#....... ..##
#... .... .*...*.*.\##   .. ...*..* .  ...*.... .#
#*...\...*. *.. ..**.#. \*.# ... ....#*# *. ...*.#
#... #*..**.. . #. .#\.. .. . \\ ...#...\...#\.* #
#. ... .. .....#..\*..# . .. ..   *.\.\. #.... .*#
##**.. .. #  .......... .\..\..... ** .*.. ......#
# ..  #....#*  . ..*  *...* . *...#...#*.....#.*.#
#.. .*\..#\... *....#..\.\ .. ...# .. *#....  .# #
#\..\\*# ...\...... *.* ....#.*...*.*.... .\*#. ##
#. ..\*. \. ... ... ....#... ..  .......#*.#.*...#
#.* \*..\  .............*..#*..*..# ... .. .....##
#.**... ...#.* .*  . .\... #. ...#.*. ........#..#
#*......  ...... ....  ......*... \ .* ... *#\. .#
#\.\ ..\.\. .  ##.. .*#.... ....#. ..*.*...*...#.#
#.. ..*. .. .*..*\ ...\\... . #*.. .. . \*..\....#
# #...*.#\*. .#.. .#. *..  \. .\..* .....*.#...\##
#*.#..#.... ..#.. ....\#..  .\. ##*....**..   . ##
#. ...*. ......## ..#.   ..#. #...#*.....*....  .#
#*#......* \. #*.*..#*#.. #.#* *...\  ..... #.. *#
# . *......##*#....#..\..*.\ .**.#.... ##.\*.*...#
#..........* ..* #..*.#. **.. .#\*..# .*..#.*.. .#
#* . \ ..... ..* .\.....*.# \*. .*... .  # .....##
#.  .   . .#.* ..*.....\ .#.\..**.  .....**..#.. #
##..*..\..#. ...\\# .. #..#. ...\*. ...#*.\.*.*  #
# . *# #..#.. .#... .#.. *..... ..\#. \. ..**  ..#
#.*...\  *.. .. *.....\. ##..#.. ..## .  #*  .#\ #
#. #..*. ..*.\ ...#\....  ..  ...... ...... ..  .#
#.\.. .....\.# \#*.#.. ....*....#. .#.. #...... .#
#.\ \.. . *. ..\.......#\...... #*........*..# ..#
#\\.*.#.#...#......  .    . *..*# ..#. * .** ....#
#*.\.. *##.*#.\...*.. \ .\.#*.**...#....*#.......#
#  *.........  ........*...\....  ..\ *#. *.**.###
#.\ *.. \ *...*.\.. ... ..R.\ .*. .*...\. ... * \#
#..\* ... .# *.... ...\. *#.. \.#.\ . .. ..*.*...#
# #...  ... \ .*\...#* . *.. . .#...#..\# *..#   #
## .. .*. #..#..*...#......... .  ....  \\*.# .#.#
#....#.... .  .. # **....#.... #*. #. ...#..#. # #
#....#.  ##\ #...#.... .......#..# *........\....#
##. #.*#.....#**...#* . .*\..*..*#*...*..  # .*..#
# .. *   ......#. .  .*. .  ....*..  .*..* *.*\ .#
#  .#.*........#.*.*..*... ..  . ...........*..  #
#\....... *.# ... .#............# ..*... . .. ..##
##############################################L###