##################################################
#..*\. .. .. #.*..#. .......*... \. . .*.*#..#...#
# .##.  . \....... ...  ... . .....* .. * .\### ##
# ....##.\.#*..#..*.#.\.##.#.#...*.*.......*..  ##
#...  #  * ..\..... .\.*....  ...# .*... ..\.....#
#.. .*....**#\.  .   .......\.. \ *\.. #....#. ..#
#\#\. ..#. ....... *#..... ...*.....#*..# .....###
#. .#.\.#...  \*#... .\.  .. ... ..*...**..*#.\..#
##. .. .#.##. ....#\ #.. .\.#.. .....*  ....*# \ #
#. #. *.#*. .**..#***..**. .* .*.*. . .....#*....#
#.. #*\# *.#. \ . ..... .. ....# *\*.*.##*#. ###.#
#.....*   .   ...  ........* . .......  .#.#.....#
#*.*..... .#.#*#.\..#...*#....\.. .... ......\. \#
#..*.....**.# *.#... . *...*. *# ....#*\... .....#
#\.**#...#.#*.#.*..*..  ....  ...  .\...   ...  ##
#..#*. .\......# ..... *#.*.. .. ...........#....#
#.... ... \#...*..*. ..#...*  .*#*...#. \.   .  .#
## .. .. .\ \...# #..*.. *..#...*. ....*.....##..#
#.. ..#* . *.. #... ... ..#...##.\.. .#**.. . ...#
#. .#. ..*. *..*.*........\... ....#. ...#.. #. *#
#  #..#..*.# .#... .\**.##... ..*\ #....#. *...#*#
#... .\.... ...**. .. #  .*. #. \.#**. * ..*..  .#
#.* . .#*R. . .#..#.\...\..#.# ........  #\#.. \ #
##.........* *. . . .\ ...*...    ...\*.*\.  . #.#
# .  #**#*\\.\\....*. . .\\....\.....*\\#..*.. ..#
#.\. .*.. #.. ..  *.*.*. ..\.\ .\..# \ ...  * ..*#
# *\...*.....\#. .*. #**... . #..#*.\ .**.#..* \ #
#...  . *#.# .. .......*.# .#.#....****#*...*.#..#
#.*.*....  ..# *... \ .#\.. . .\. .\..* .*.. \ . #
#. .#..  ..#.#..\ #.\** # ....#....\...* .#.\....#
#*#.*... *.#.#. \.\*.*... \.. ... . ..........*..#
#.. .*.#...#. **.\.*.......# \.*...... #...* ..  #
#.....\##.*# #.  #.*\............... ..#....#* *.#
#..#.*....# ........*.\.... ...*.*.*...#.#*...#. #
#\...#\*.   ..*. . .    ..*#\. \.#..#*..#...* ...#
#  *.\...  ..*. . .*.......*.. .*........*.. ....#
#. ..\.#...#*..*.*..\. ##..*. .# * *.##.. .**. ..#
##...  . . ##.... #   **.##... ... . *......*.. .#
#...*..* .*...\###. ..*\..\ #..*  . .#...... ....#
# ..*\.  ..  #.......#..*.* .  . .#..... ...  .# #
# . .\.... . .*.  ..#... .....#......####.*.  . .#
# . ... ..\.*. \.# .... ....   .  ...... ....** *#
#*.. .. ...#.#..*..#.*.. *  .*.#*..#*..* ..# ... #
#\   . .*.*.\#..#..\\..#.*.. . . .\ #... . *. ...#
#*#.\.  ...#...\ .....#  ..#\  *#. ...*...# ...  #
#.\. ...#\. #.. .....\....  ..*..*....... *.\. ..#
#*....*#\.*.....#.# . *..# .#. \.*...*.\.   ..* .#
#... #.... ..... . .. . .\ .*. .  .* . *.. ...#.\#
#.*..\# # ...\ .\#. ... .*..... #.. . #\* \ #. *.#
#############L####################################