###L##############################################
#...*. .##.*.# . . .*... .* #... ...#... .#* *.. #
#..**.#..#....* .\.... ...*.# ........# .\. ...  #
#* ...  *..# .......#. .*...*.....*.#*#...#.\.. ##
#.. *. .\.. .#  .. *.#.*..**.. ...** ..*#.*#. ..\#
#.#   *..... .*.*#. \.#... \. .  ... ... \.....  #
#. . ...**... ..\ .*..*\##*....... .. .\...*.. #.#
#..*..*.*... .\..   ....    \ .*...**..*.# .....##
#....R... .*. .*** .#\.#.*#*\...\. .........*....#
# *\..*.......#.*.#.. .\..# #.# .  #   . .. \*...#
# \.# .........** #..... . **.*.# .*\  # .  .....#
#\ .. #*\.... ..#..#.\....  *.\#. ...*##.....# . #
# .... .. . . .....#. .#...*. *# . *....*.#*.. ..#
#  ..... ..#.*.... . *.#. ..# #.#.##... *.#... #.#
#. ...*.....#....**.# ....\.*. ..  ..#.. #.\..#..#
#..  #\.  .... .*.. *.#.\.*. .. # *.*. .. ... ..##
#. #\.#.  *.*..... #. .#*.#   *...* .#..\. * .*..#
# ....  \#. \... .....#. . . .. .*\.. *\. \#. ...#
#...*.. ....*...... .**. ...  *#.\*. ..\. .#..#.\#
##\ ..**. .# .. ..** *...  . . .....#..\...  #...#
#.\.. #. .#..... ..\..  ...#. ##...## #. ....*\..#
#.*.. *.\. . .. ... \* # ..*.*..*\.#.. ..  *. *..#
#.......*...#  ..... ...**.#......*.. #....*..#..#
#. *.. ...\.*..##...### ..\.*.#..\.. ....#.. *. .#
#.....#..\.*...  *.\... #..\.#....  ..\#. #.. # .#
# #........*... . . ...... *...\#..#...*.  .*. #.#
#  *.#  *. .....*..*.##*. \.* .. .#. #...#......\#
#.....* ##..  ....... \ .. #.\..\.\..  #*. *\..* #
#. ## . * .#.. .. ..#. #   . .# ..   .#... ##.. .#
#\.. . ..* ... ....  ...#.... . ##.. .. ..   ...\#
#....#* . ..*.\ .\\ .* . ..*#. ... #.\.#.# . .. .#
#. .....  ....  .#.. \## ..... #.\ #.#.. .. ..*..#
#..# . .. \.##. ..*.. .* ..\# #...#.*#.. .. .. ..#
# .*.# .. ...\........#.. ..#..  *...##.*.#..##..#
#.* #**\.  \..#.  .##.    .#..#.. ..........##. .#
# ......#*#. ...*... #.. .#. ..... .#....#. ...* #
#.. . ...#*..# .* ..*......\.##.. \ ..#.....*....#
#.. ...  #. .. .*.. ..*...\..\ ..\*. ...#. . .\..#
#....**...\#......   ... \. .... .  .##   ..... ##
#.... ......* ..\...#.#.  .. #. #.. #.*..*. \#...#
# .. .** . .*..*. ..*.#. .#.#\.* *.. *.**..\.#...#
#  .. .  .**\.#. #.#.... . \... ** #.... ..# \#. #
#*.*...##* ........#* .*  \##. ..** ...\**.#.#.. #
#. ..  *.\ #..**.###.\  ..# .    ..\.# .. ...#  .#
#*.....* *.. .*...... *#........ ..* .\ ....*....#
## **.. .....*..* .........#.. .......#....... ..#
#* ...#...#.. * # ... ..\ \.#.  .#\#.*..#. ..# . #
#\....  *....\....#.. ... *#\.* .\.........\#....#
#.\  *#..#.*. #* #....#**...  *. ... ...... . #. #
##################################################