##########L#######################################
#\  ..*#.*.\ ..... .. ...#....  .#....#**.  .. ..#
#. #  \  ...   #.\...............##*  .. . *#.##.#
#  *.. .. \#.. **\... *. .... .*#..#..\#. .. .##.#
#..# .. . .  .... \ .\*  #*\*.  .#...\.*   ..\.*.#
#....................#..#... *#...\..# *.#.# .#*.#
##.. .\*...*.#...#.. ...* ........#.. ..#\.\...*##
#.# \#...# .* .. .   *...* *#. . \*#.#*. . *.\.\.#
#.#..* ..  .#.\... ..##..#.\ ... . \..* ... . ..\#
#.. .#..  ....# .. .* *#. ..\.. .. .#. * #...#. .#
#.  \. .###.*. .*..R.#.. ....#...#. . #..... #  ##
#*. ..\**..\# .. *. ...*............ ** .. # #...#
# ........... .....#.   #....# ... .. ...*\*..   #
#.....#*.# ..**\\.*..*..#\.   ....#.*...   #*....#
#..#.*.  **. .... \.*.#*......*#. #. .... ...... #
#* *.#  ..\..* ..#........ #.*. ..* . \ .#..*....#
##..*.. ..* # ..\*.  ... ....* .......#.. # # * .#
#.#. .#. *..*..#..* .*\. #.... .  ...#  #........#
#.**...  * ....**\. ....* .#...#..... ...  .#.**##
#.\....  .#. .*#*.. *...##. .\....#.. *..\ .. #..#
# ..#. ...#\ ..#....\.\.. *.... . ..\..   ...#...#
# \.... #. .#...#... \. *........*  .**. # \... *#
##.#..#.*#\ ....*.. *....#.. ***..#. \....#.*#..##
#.    .. ...  .#... ..*#\ ....  * #..*#.#..#.....#
#.#.. . .#.. ........ .\..#..#.*...*. . * . .# ..#
#\.....\**.....*... ...*#\.#...*... .*## .... \..#
# .#** \ .*#..#\....#... \ . . \.# ...  ...##. ..#
#. .... * ..*.*.. # #.*....\#....#..\. . ...#.##.#
#....# ....... .... ...# #. . *. ...*...#......  #
#\ #..#.. . ....**.. ........*..* .#   \ .#*.. #.#
#.# .....#..##....... . ...*#...  # ...* ..*  . .#
#*.. #*.\...\*...#.#*.##.##.#.. .# *. ..... \ *. #
# # ..*# .........\*. . ..\..  ..*... \...... .  #
#.#.*...   ..\ . *   .\.  . * .*..##......*... .##
##.. ...*.\ .###. .# *.* *...*.. * ... . .. .....#
# .*.*. ..* *#..#......\*.\... ......#. *.#.... ##
#.# ...#*..#...*......#  .*.. *.##.*..* .*#*..#. #
#... .**# .### .  **#.    ...#..#..#.. ....*.... #
# .  .. . #... \### *.. ....*  ..* *. ..... ... .#
## . .. #..........* .. .*..*..  . ..*...##*#. ..#
#.. *#..#. .  #..   .. .* .*...... . .. . *. .   #
#..#... #.  ...*.*#......   .. ........*. .* ....#
#.#   .#.*.# *  ... * . #* ........ ...# .   #.*.#
#. ....\\ *.*........ .  .** ... ####. .#..  . ..#
#... #...#. \.\...*..\\##..\..\ .* ..*##..* ..#.*#
#.#. .......##..* ..#.. #\.  .  .. ..*.\.... ..# #
#*  # ##.  .... .\**  ...#...#... .*...*.\ ...  .#
## ..*.. .*..  .\..#... . .. *.   .... . \..\ #..#
#.. **.... . .\ #*.#.\..... .#. .\.#.\...*. .#. .#
##################################################