##################################################
# .. . ...* *. *......# .*..\.**.. . \....#..\.*.#
# .......#....\ ...*....#. ....\ \.\    # ..... .#
#.# ... #... ..# ..*# *. ....*. * #.. ... # .*. .#
#. ..\.. ....*.*#............*\. .*  .....*#...#\#
#..**.  *...#..*.....*#..\......***\*. . .\.#. #.#
#. .*.#  ...\.\#.\. .#.#.* .\...#.. . .. .## \##.#
#*.* ...#.#. .#.. ..*..# \ #.\ .\ ....... . *....#
#. #* ..*..  \#...... #...... ... .  . ... #.. .##
#..#..#.... .......\**. \... ...\.#.#..*. \. .\ *#
#..  #. .. .....*  .....  ..  ... ..#....#**.. ..#
#..#....* .  .*.*. *..\ ..#.\..\..#..  \.# ..* ..#
##. ...*..*..#. ....*\. ... .#. ... ..## ..**.. .#
#. *.#*#..#.  . .  .*\. #....\.#  \.#.*.#.... ..*#
# . .  .    .\. .. #.... .\ # ....... . ....*..\.#
#*.\ \ \..* .. # \*#.*.#. .\ .*.....##.*... ... .#
##  .. #..\..* ..*.*  .... .## ....... .\.R ....*#
##.....#.#. . *. .....  ..*# .*.*\*\#.. . . ..*.*#
#.\... ....*.**... . . #.. #....... .... \...\..*#
#  *.  #.....* ..... ... ..##.....**. .\...# *..*#
#*.*... .. .... .. ... #*..*...#.. ... .*\...\..*#
#...*... .\..##....*.*  ..#....* .....\...... .*.#
#..#.#\.\\.# ..\ .#. .... .#... ...  ..#.. .* . .#
#\....*#..\# .. *.*..#..*\*  *\. #*....**.*.\#..*#
#*\**# ##.\ ..... *.\# # *.. #.#... . .# ..  . \*#
#...** # *#..*.*. ....\..##*.#.*.....  .#\# .#* .#
#**. . .* ...*....*... ..#\* .*..#......#...# . .#
#.\... . #.*#..  .. #* ....#...#\. **..  *#\# ..*#
#* .......*..* #..#....#** .. .. ......#*.#\..  *#
#*.#.. .. ....#. .# .#..... ......  .... ........#
##.... .. ...\  . #....**# .#..#\... \* . .**.#..#
#...* *. . ..*.#.. ..#... ..#.\...# *#  .. .....\#
#\  .# . . # *. #..\#... .*..*........#....#...\ #
#...\.. .#. .....*. ..*....\\. #. ## . ...  ..* .#
#.*. ... .*...# \ * #....#..*.#   *... .\    \...#
#.# . * . ...##.*\ ..*.. .*.#. *.#*## #... #..  .#
# ....*....\#..* #.\#.... .# *... .....*..*.... .#
#..* .. ......*.#.*## ..\ .\ .# #.* ..****. .#*..#
L.....#... ## . \*.. *..* #. **  . .##.....#.....#
#..*. ..... ..\.**......... .. *.*...*....\\ *.\.#
#.*.. ....\.... . #\#...\ *.*  ..\.... ..... ....#
#...*.#...* ........ ...  ..\... ......*... ...  #
#... . .. \.....#.*. #   . .#.. #..*.*... #.*.#. #
#*. .\.*.*.. ....#  ....##.# .\ . \ ..# **\...  .#
#....*. ..#..\#\#..*# .  .#...*  . .*# ... ...\# #
#.. . ......* . .. ..* .#..   .*.#*.....#...#..#.#
#..*#*.\.#  ........#.# .*. ..  .#...\ .  ... ..##
#...\#.*..\.#. \ *   . ..\...\#..  .\*.*. ...\ . #
##....#... .* .*...... *... ...\ .  .. *  #.* ...#
##################################################