##################################################
#.*.\..#....\ . ..**.\..*. #......* .* *... . .. #
#. ..... #    \.\ \.... .#....*... \....#....... #
#. .*. # ... ..# * .*.... .* #*.. #.. ...# ... #.#
#\#...#*.....  *. .\*............#*.*.... ..\.. .#
#.# .#.\. . .*\***......\..#*.....*..#...*  .**..#
#.##\ ##. .. . ..#...\. *.#.#. .\.#\.\...  #.*. .#
#....* . ....... \. \.# \ #..*.. ..#. .#.#... *.*#
##. ..# ... .  . ... ......# ......#\  ..*.. *# .#
#* \. .\ .*..#.#.\... ...\ .**\....... ....#..#..#
#.. ..**#....#.. ...  ..  .....  *..... .. .#  ..#
#.. *.. #.\  ..#..\..\.#.. \..* .*.*.  . *....#..#
#. ..**.. ##.. ... .#. ... .\*.... .#..*..*... .##
#*.. ....#.*.#.\  #.\....# .\*.  . .  .#..#*#.* .#
#.\..*.... . ....... # \. ....# .. .\.    .  . . #
#. ... ...*.##.....*. \. .#.*.#*\ # .. *..\ \ \.*#
#*.... R.\. ....... ##. ....  *.*.. *..\..# ..  ##
#*.*.. . . ..#\*\*.*. #*..  ..... .* . .#.#.....##
#*..\...\ .... .......# ..# . . ...**.*.... ...\.#
#*..* #...\. .**.....##.. ... ..... *.....#  .*  #
#*..\...\*. ... ..#...*..*# ... .. .... .. ...*.*#
#.*. ......\..... *....#..  *.*....##..\. ...*...#
#. . *. ..#..  ... ...#. .... .#. \.. #.\\.\#.#..#
#*..#\.*.**....*# .\*  *\*..#..*.* .. #\..#*....\#
#*\ .  .. #. . ...#.# ..* # #\.* ..... \.## #**\*#
#. *#. #\#.  .....*.#.*##..\.... .*.*..#* # **...#
#. . #...#......#..*. *\#.. ...*....*... *. . .**#
#*.. #\#*  ..** .\#...#.... *# ..  ..#*.# . ...\.#
#*  ..\#.*#...... .. .. **#....#..# *..*....... *#
#........ ....  ...... .....#. #. .#.... .. ..#.*#
#..#.**. . *\ ...\#..#. #**....# .  \... .. ....##
#\..... ..  #* #...\.#.. ...#.. ..#.*.. . .* *...#
# \...#....#........*..*. ...#\..# .* # . . #.  \#
#. *..  ... . ## .# .\\....*.. .*..... .#. ..\...#
#...\    \. ...*   #.*..#....# * \ #...*. ... .*.#
#.  ..# ...# ##*#.* .#.*. ..*.. \*.##... . * . #.#
#. ....*..*..... ...* #. ....#\.# *..#\....*.... #
#..*#. .****.. *.# #. \. \.. ##*.#.*...... .. *..#
#.....#.....##. .  ** .# *..* ..*\ . ## ...#.....L
#.\.* \\....*...*.* .. .........**.\.. ..... .*..#
#.... ..... ....\..  *.* \...#\# . ....\.... ..*.#
#  ... ...*...... ...\..  ... ........ *...#.*...#
# .#.*.# ...*.*..# ..#. .   # .*.#.....\ .. . ...#
#.  ...\** #.. \ . \. #.##....  #.... ..*.*.\. .*#
# #\... ... #*. .  *...#.  . #*..#\#\..#.. .*....#
#.#..#...#.....*#.*.   ..#. *.. .. . *...... . ..#
##.. ...  . \...#.  .. .*. #.#........  #.\.*#*..#
# . \... .*.*\.  ..#\...\.. .   * \ .#.\..*.#\...#
#... *.#  * ..  . \... ...* ......*. *. ...#....##
##################################################