##############L###################################
#*  ....\.**  *#....#\\.\......\.#..*. .\.#.* #.*#
# ##. ..\#....#.# ..#..# ....... .##...#. .. . ..#
#..# #. ..#..\....   ..... .. .*.#. *...#.  ..*..#
##...#........##. . ...... **. *.*.#..* #*....***#
#* #. ....*. ....*....  ..\. ..  .**.. ..#. .. ..#
#..*#* #.... #.\# \.   ..**......##.....*.....*. #
#.. .. * ... *.... .\.#. .#...*#..\ ...\\#.\*# ..#
# . \.*..  *.#...\....* .....#.#.# .\\. #..*...*.#
#\# .. .  .\ ..#* .*\. .# \.\  .\\.... ...*#..\\*#
#*  ......#. *.#. .... ..#...\ *#  **....  #. ...#
#. *...*#.#.....#*.#*..  #....\** .*\.. #. .\..# #
#..*#.*.*.... ...*.......#....#.  .....#..#**##..#
#.. ...*...*..... #..#. \....#** *. ..*.#....#. \#
# ..  ..  \ ......*..#. ...# **...R   ...*. \... #
#* .*..##*...#\*...     *. .*. ..\ .  *..*.... *##
#.. ..#*#.#* .. ..\....*\..# .....* *.##.*.#...#.#
#...#*  . ...## #. \...  . #.. .**.*.*...#. *. . #
#*#.. .**........ ..*#.. .*...*.   ...... .*...* #
#.. .#.\..#* . ...# .*\#. .*.. . \.....  *.\# .. #
# # .\#*..*.#*#* .###..*#... ......#.\.* #...#* \#
#.##. . . .*..#*....\.*.  *...# ..*.#..*.#..**# .#
# ***..\...*\*\. ......#\#\..\#..#  ... \   ..*..#
# ..**. ...\*. ...........\#.\*. . #.* ..  *#..\\#
#\....#*#...# **.#*#*...*##.*....\  #...\*.... . #
#... .. .*#* ... .**....# \\. ...... .#...\ ... .#
#..*..*.\...\.# .. #.\.#...*....  ..* ..***..#...#
#.\....#\  . .#... .#...* .#..#.... .\..#\..\ ...#
#....\*...#*  ...# ...\. .* ...* ......\ . *...  #
#....#\.. ...... .....* *.#  ... .*... .*#*.*\. .#
#...*. .....*#..\.# .. .... .... ..# ##. ..* ..#\#
#*.**.*.....**... .. . ***#.. \..#. \..#..*..\ . #
#.# ..*.# ...* ..#.#..#.... .... #..\\...**. ...*#
# . #. ... . *..*....* .... #..... .# .... .. *..#
#.*...*...**# .# ..*\ . ..*.....#...  #\*.. .*\#.#
#..*  ...... ........*. . ...##.# *#..* .***.....#
# .   ....##..*.\ ..#..* . ..*... ....* .*#. .. .#
# . ##  ..#...#. *.#.........#.#..##.*..#..\.*#..#
#*#*.* .\*. *. .  #..*..#.\#.* \.*....\ .... # ..#
#. ###.**.. ....#......#..\. ..*.#.\*.*.*..# ....#
#\  ..\  ...*..\  .. .*#\. #.. #.\*..\ .# .# .#*.#
#.  ...#..*.###..\ . #.*\.#....... ...........*. #
#.*..#.... \####...#....#.. ......**....#. ......#
#. #.. #.*.\... ... .#...**..*. ##.#.\.  # ..*. .#
#.#...   .. ..#  .. .. ...#.....#......#... ..\..#
#..**.* ..*...# \.. .*#. .# .........*. \* .  . .#
# *.. . *. .#..*..#.\..... .\. *......*.# .. .. .#
#. .  .#.#*..#..#. ..  #   *..*.###..#... *# ....#
## ###* \. .*..\..... .. *.* ..#  ............#. #
##################################################