##################################L###############
# ..... .*....\. .\.. *...... *  *#. .*...*.. \*.#
#.....#..*..\...*...#. .*\ ...*#. *...*#... .\.#*#
#.\.   *  ......#...  . ..\#\...## .. .##..##..  #
#*#\ .. # ..#..\....#..* ..*.#...**.. . #....#.. #
# ...* ......*.\....\...**.#.... .. ....... . .. #
#.. . #\...#.. .*...# # ..   .. . . . . ........ #
## * .. ......*..#..*.#\ .#\..\.*#  .\* *\.\ . #.#
#*..*.* .. #. .\ .  #..\. ... ..... *#. ..#......#
#.....\...  .  ..  *...... * ... *. .*\  ........#
# .# .\.#.*.....  ... . . ##* ...   *#.......* ..#
#.#.....*\ .....  # # ...... . #*..# *\...#.....##
#* ..#\ ... ..* ...*.. .. .#* **....* ....*.....\#
#. ..#.   . .*\*  . #*.\.. *... \. . ... ..  ...##
#.**... ..... . . ......#.* # ......**#..*#.# ...#
#.*.*. ....\...\. ........* ...    *........*  *.#
##*#.##. . #.#.#*.....* . #....*\\....... ..#. ..#
#.#..#*# .\..*# ... . #.* .#...*. ..... .....**#\#
#.#. . .#\*.*\ ......#..* .. ....#. * .*.  *..\#.#
#*... .#.. .... #.. ...\.. ..**#... .##.#...*.# .#
#.\..##...\.. .**.  #......#  ..#..#...#*\.....#.#
#\#..#\.*#* ... * .... .\ \........   ...... . . #
#..*# .* #... * ......... . .........\.* .. ...* #
#\#.. ...  \...#.# ..\ ....#.. .*.#*.....#*.#.. .#
#\*. . ...**. .*.... .* .*# ..*.. \\...... .... .#
# \..###.. \\\\.\..  \  ... #..*\.  ..\. .##.....#
#  .. ... .#. . .. . #  ..#....**.*.... ....###..#
#*. *..#\.# . .#..*  ..... *..  .\# \..*..#. .   #
#* .....#.*. ....#.\..* . ..*. ..#  . *...#.#  ..#
##.*. #... .**\#.    * *.*...... .. **........ . #
##...#*... \#.....#. ..*..... #..*...\\ ..#......#
#. . ...#.... \  ........\..*.. . .#..... *  ....#
#...** *  ..#  ...*.   .*..*##..*. .\#*#. .....* #
# .\*.\ .. ..   . ......*.\...* #** # . . ..*\ ..#
#*.. ..\..... #...*.. ...... ..\... * ... .. *.* #
#.*.*#......\ #. ...#... .\*# ......* *....*.  .*#
# ..\#  ..\. ..  .*..*.  . *.. ***\... ..* .  .\ #
#...#**.    . ...\ .# .. .##.. . . ..##.... \# .*#
#. .. ...*.....*..#. .\.*.... .*. ...# .#.  #... #
##.**.#  .\ ..\.\.\... #.. # .\. .* .##. ...... *#
#..*. *. ....#.\.\.*\##..#  . ..#*\#.  .#.* .#.\.#
# ....  #. .. .. . ..#..\   .**#. #\....*. #.*.*.#
#**.#.. \.**.* ....* ...*  .\.* ....*...* .#. \. #
#* .# . .  .. ...###\.... \ ... .* *.*.. .\  . ..#
#.....**.#..  ......\. ..  ......\#.  ....# .*...#
#. ......... .... .....##.#..*..** .\. ..... ....#
# ... .##\. *.   **....#\*...\.#.. . ...\... ....#
#... .# \..\..# ... . ..\..#..*.   ...#.#. \.*..##
#*.  R....## ....*. ....#........*..  #....... #\#
##################################################