##################################################
# .#**  .....# ...#. #.#.\.    ... . .*#\ #.\ #.\#
#.\\.*...** . .\...   .# .*..# ..#.*\......* . \.#
#. ***. *........  ..  *..** \..\....#.\\#..#.# *#
#..\.* .  .... . . \..*..###. . . .  . \ ....*.*.#
#*. # *\ .. ...#.  . ...#*.*   #....*.#..#..*# .##
#. ...*. \# ...#..... ..**.# *.. \\... ..\.  ....#
#..**.. .*.*...#  *.. *...\ ...  ..*..#..*.....*##
#\.*   .. ....*...# .. . .*..... ..*..*. #.......#
# #.\.. *#.# ..  .. .. *.... *.... ..*  ..*. .*..#
#. *. ..\. ..\. ..*.#*.#.... .... \..* .\... #*#.#
#  \ #..**........*.\. .. . ..*.. .*  #.\.* *..*.#
#..# ...*..\. ..#.......\.#....#.#. \\..  .##.. .#
#\.*...#*\.  \*.. ..* ..... *. *...*.# ...#......#
##...... .R\. .#.... * ..**.  .....  ##.. . .....#
# #..*.#..*\# #....  . #*..... #........** .###.\#
##.....*.\*\*. *. ..*# .. ..  ..*.. . \ **. . *..#
#. .. ..\.  . ...... .##..... ..#*\# .\*. #..#*..#
# *\.. ...\ *.#...# ...##...*..*. .#*. .. .......#
#.\*. ......*.#.*.*.\* #*.#. .. .#....*#.....*\..#
#. . . . *.... * *#... .#*#... * ......#* .*..  .#
#.*...#......##..........*#**.#..#....\*..\ . .  #
# \..##.  ..*\ .. .. ##..  ..#.  *. *.* *.. .    #
# .* .....#...#\.*..\\ ....*.#  .*....*\.......*.#
#... \... .....*.... .#*.   *.##*............... #
#\**..\...*... .  ..#..  .* ......  \. * \.  .*..#
#* ..#.... ...*\ ...  *..** .. *. .\ .....#*..\..#
#  .   #.#....## \.#.. .  \ #.*.. # ....\ . . .. #
#**#   \#  #....\.  . * ...**. \..*.....**. *.   #
##.... .#. * **\*#..\.* * . .. \.. . ....#*.\ ...#
#......* ....* ..*...#  .**...#. .....  ..  \\#..#
#.*...\ .#.  .. . ... . . . ..\*....  ....... *..L
# .....##.. **.#.*.\.\ ..#..#... .\.*.#.\...* \..#
##.*  \\.#  .....** . . .# .\.. \.*# .#..* .\\\  #
# . ... .#...# .#  ...# .#.\*..  . . \..*..#*.\. #
#.. ..#*..#..*.**..... . .. .\.\.** ..#. *\.. #.##
#.##.#.*.....##.. #..... ..* ..  *#. *...#.#.. # #
#...\..#..\...*.\...#..... ..*....* ..#....\  .  #
#. ..* #.# #..*...#..  #..**.## .. .#  ......***.#
#\..#.# ..**... . .*....*  .  . *\.#.#....*\.. .\#
#***....\.... .\  .... . *. ..\. ..\..*...... ...#
#....*..#   .** \. . *.... #.  ..\#........ .#.. #
##.## .# .#.....\ .# ..*....**.*.##.. *.....  ...#
#..#.##... . ..* ..\..\.#.. ..\.....##.\#.#....*##
#.#. \....  ...*#.  ***. .  .\\ #* #.*....#....  #
#. .*  ..#\.\  . *.. .... . ...#. .#.. ..\#.*##..#
#.*..*..  *.*\...*. .*. .\.. . *#\.#..\.##..#*#. #
#...\.... . . ##.... \. . .\.#..\# *# . .# .. .. #
##*#* ...* ..\\ ......####. .. ..\....#..**. ..#.#
##################################################