##################################################
##...##.. . .*R ....**#...#*\. .* . .#*#.#.\\....#
#....#.. #.*#..#.#*  .    ..* .. .. #...*..*.. ..#
#....# ..*.# ... . ..# ...#..* ...\.*..  ... . .##
#.  .....  .*.  ..  ..... ..*#*.** ..#..*. ..*\. #
#. .*\\**.....#  ...#....\.....  .... ..*.. ....##
#..*... .*.*\....  ...#.....##..*. *....*... . ..#
#*... ...... ...#. #.*  #.. \#.\.*\ ...\# ... .\.#
#. #. **#..#..  ... \* .##.#.#*... ....#.#*..#\. #
#.* .....#\.. # ..#.. *.\. ....\ ....  #.....\..\#
##.   ...\*. #..#....  ... .... \ ....\...\*...###
#.#....# . *. ..\.... .....#..#.  .* \ * .#. .. .#
#.#.. \....\\. #.*.. .. . ....... .*  ....... * .#
L**......... .*..... \ \..\ #\......... \.  *...##
#..* .#.. *.....##.* .... .....\...#... .   .##*.#
#*....#. ..\#\.. . ..   .#   ....*\.. \.......*.*#
#*.*... .\. ....#.#........##. #..* .#.   .*..# .#
#\..* ..\.*##......*.#.#.  #..*##...# . ..\..*#.##
# ..#. .  \. ...#.\. .##*\  \**.##..*.#......\..##
#... ...  .... ..\\.#*#..**..# ......#..# ...#.. #
#..\ \\  \.#...#.#..\*.**#.......\...# *   . .#*.#
# .. .*..# .\*... .*...... ..#. *.. ..  * ... ...#
# . .. ... *.. *....... \*# . . #.*......#  ..\ .#
# *.#...\. #*..  . ..**...\*  .........# .*..\.\.#
##*.**.*. *  ...\.*......#. # . .#\.\..... \* ...#
#\  .. . ...*#\.... ....*. ....... .\*..*....*#. #
#..* . . **\\....*. .\...* #....... .*.....*## ..#
#  \.##...  .......#*.# .. #.  .. ..*.# .\#.\**..#
#\\. . ... . .\..... ..**# #* ....*#..\. .*.   ..#
# ...*.  ..*.*. *.. **.*...* #\......  .#  .#....#
#...  # ..*.. .\#.#......* ............*.#\.\. #.#
#.*..\ .*.. ..\. ...... ##  .... .. #*. ... * **.#
#.. #.. ...  ...*..#  ..\#......*.#*.\....*.\....#
##.....   .#... .. #. . #  . #.. .#.\.*#\**# .**.#
#*\\#....   #.\.... ..#.* .... .. ..#..*#. *. .\ #
#....**....\*.*.#...*. ..#... *.. ..#** ... *#. .#
#. *...##\...*....*.#. ##  . ..*....*#....*.. *###
#.*.*   ... .. *.... .. ...... .....* . . ..... .#
#.. \**.# \*. . .\.#....\....  ... .. ##*..#.....#
#..... .........\  ... .#.... .....# .  .. \ *  ##
#.... .**..*.\.*.. .. ..#..\ .  .. .*. ...** \.*.#
#*. * ...# . ... \.#.*#\...   . .# .. .* ......#.#
#*. # #*...... .*....  .....*..#. ....*. .... ..\#
#.... *.  #. ..#  ..#.. * #. .#*..*#. ... ...  ..#
#.#... ..  ..#...#... .#*. ..  . .....   ....... #
# #..*\ .....#..  *......*.*...*..\.\..#. *  . . #
#. . .\.*.. . .. .  #  ..\**.#\....#......*.....*#
##....  .. .\... .... ....#.. * ..**. .....*. ...#
##.\. \. ........*\.. #.. . .  *.....#.#*.*. ..#.#
##################################################