####################################L#############
#\ ...*... ..#..#.  . ..\.....  .   .. #*.....*..#
#. \...\. ..**...#... * ##..* ....  .   .  .# .*##
##.. .... *. .. . \ #.#...... *  .*. ........\*\.#
# * .* .#....\... ..... .##.# ..*..* .*.... .. .\#
# #... ..*\.....*. ..*.... .#..  ...#.\ .\.....\.#
#* ## ...# .* ..* ............* \# .*\....\.**.*.#
#..#...*.\\.*#\....*.. ..# ..*. .. .... ....... ##
# ... #   . ## *.*.* #. ##  .#.. .......\ .....#*#
#\...  ..*. ..... ** .**#...... *# ... ... . # # #
#*.....\ ...*..*#.. ...# ........ * .\*..\.*.#..##
# ... \... ..*.... ..... \..... .# . . ..\.. .   #
#.....*.....*.....#   .. * ....# ...#\.. ... .. .#
# *..# #.** ....*.................*#...* ......#.#
# ... *..... .. *. .. . ... #..* . .   . .. \.*..#
#.\#. ..*.......# . .*.. .*...*# ... .... #..  .*#
#   *........ .......##.......*.*.... ..  *. ..  #
#  . .*..#..  . #.\*.... .#\.*\... ..#. .*. .    #
#\.#.*\.#.*  ...#...*\ **..*##. *. * *...\.*\ .. #
###...   .\.*....*#. .. \.\.\.. ........  \. *.. #
#*.* ###..\.......* . \ *...# ..#  .  ...\#. *...#
#**. .   *.#   . .....#*.#. #.  ....#.*.. .. *.* #
#...\* .# .#*. . .  .* ... ..*....\ \ #..\\ . ...#
#..*... .... .........*...* .  ..#*.. . # #..#..\#
# ......**.#.#.*. ..# *\.#.\... #. ..# .. .....  #
#. ..**..*.\#.*#..   ..  ...#  .#  *   .  *.#... #
#*.*..*.**\# .  #..#.. \.... ..*...*   ....*.#...#
# #  ...#*.... .  ...#.# .\*\.#*...*..#*..*. ....#
#..  .## .*. .. .\....#*.#.#... .. *... ..#...\.*#
# \*....*..* * . ..#.. .*.*.....#. \\. ....#. #..#
# ..#. #....*. #..##.#.#*..#.. .*\ #.#........R..#
# ....##. ..* . .. ..#...... *... .. ...* ..#....#
# *........* .. .. ..  #.#.#...#\ \. ... ... #. \#
#\  .....*.*.\. *. ... ..#.#.  .. ....*#...\. .. #
#\.#.. ..#..# . *#  . .... .. .....*  *.##....## #
#.# \ #\ ...*\  #.**..... ..  . .... #.#.. . ... #
#. . *   ...\... .. ....**  .   .. \##..#... .. *#
# .#.*..#..\ ...\..\.. ... \ .#.#**.\ ..\...  # \#
#..\.. ...\#.*..#.**.*. .... #.*...\.\**. ... . *#
##. .. .*.#...\..... ...#.#..  **  ....#  .....*.#
# .... #... .*.#.#.* ...*.  ..***.#\.  #.... .. .#
#*..#.\* \..\.#.  ...* . *..*\.. ... .....#.*#*..#
#\*....*......  .*  .... ...# .#*.  ..*\..*......#
#... .\#.... .. .....#.. #...... .\. . .......*#.#
#    .#..*.#.*...*.. ..#.. . .*##  .....#..\.*..##
#..... .#.. ...\.# .# .*.... .. ..##..#.. * ..#*##
#.. .   .#....*#*...  \#.#.. .. .  ..\  . .#*..*\#
#  ...*..# .* *.*....#.*  \ ...*..#  .. .#*.#... #
#.  . #..   *  .#...*.# ... \ ..*#... .... *.... #
##################################################