#############################################L####
# *  . . **..#...*.... * ... . ......  *\ .#\ .\##
#*#  ....** .....*.. .*.##..... #...... . .\.. ..#
#...# .....#*  *.#..... . \\. .....*\ .#*...... .#
#.*...#.........* *..*.. . ... . #...#...... .. .#
# .  .\..\ #.... \ . ....**.. ..\**. ... *..*....#
#.. #  *.. *..**\... ....* \.....#...*.#. ....## #
#.\ ...\ .*#*####. .##..   .\.. .........\  .*\. #
#. ..... *. .#.\ ......  ##..#\.##...#.. .\##\ ..#
#....\. ....  ...#..*.. ......\....#.. .... \ . .#
#*#.. ...   ...**..#\#. .\...##....\.... ..\. .#*#
#...   .*.. . \...* ........*.#.#. .  ..  #.** ..#
# .*  \..\.*.*..*...\*..# . .#..   . ..#*#... .. #
# ......\*\#...  ... *# .. . ...* . .....\*.  *.##
##.....*.\*.. #**. ..\#....*## \......\#* .\#. #*#
#.#..#.\.#. *... .*...*.. .#* *\ .. ....\#... *. #
#\*.# .....  . .. #..*...*.....*.#....*#.#.*#. #.#
#. .\ .....*........ ..**. ..*#*.\..# .#.##..**..#
# . .#. #......\##.... * .... *.....#.# .**  *..\#
# # .\...*#\* ...*...\**#....#. ..*#. .. .\.... .#
#...  . .#.. ..\...##..\ .# ..#.#.** .*.   ....#.#
#.*.* . .... . ...#.*\..#. . .#..*..*   . ..# ...#
#..## ...... \. #..#  .... . ..*....\#. . **. *#*#
#.#.......\  * .*#....#. ...\* . #.\....\...* ##.#
#. \....\....*.... ..\.. . .*..\   .    ...  .#. #
# *.#*#.# ..*...\.# .. ......# .....#...*..**.*. #
# .... ...#.....*...  ........# ..  ## *.....  #.#
#\. .\ * .. #.. *....  .......... .#*. .# . ....*#
# . ....... .. \#. *.. *... . .#\..   .*.....\...#
#.....*..* .*... ##... ....#*.*.....# \*..\. *.\.#
#. . ..*.. *..... .. ....#.......\.......# #.\. *#
#. \..#  #.. *.. * .. ....#.\ ...*.. ...\#.*..\..#
#.. # \... *.\.\..#..... .\......\. #... ...*##.*#
# .\..#. ...* .. . . *..  ..... ... .*...........#
#.  ..#  # ..........#.**. *... \ . .* *...##. * #
# #.\..*.  .....\.** ##...*..*\*.#  ..... ..  .*.#
# *...*#.... ....#....** ##......# .#... ..**. ..#
# *#..#.#...*..# *.......\\   * ...\. .. *...#.#*#
# ..* \..# #*... ......#. .\.* ..  ..\#..*.\.. ..#
#...#  *....## \ ....##...#.*  .\.*\. . ..#\....##
##..#.# .... ..\#. ..# ...*.... ##......#.##*. ..#
#.\\*..# .* ..  .. *.. . \# .... *......*  . ##. #
#  ... . #*. ..#.....#....#...\.*.. . *#. * .. . #
#.. #.. #. .\.* *... . .  . .... #*.R.....#.. ..\#
##\.  ...#.......   #.*..#. ...*..# ##.#*  ..#..*#
#..  .#*.#.... #. ..#.*..    .*. .#.\........ ...#
#..#.... ...# . . .*.......\*\\#........##...* ..#
#.# #..  ...*..  ....*.. #...... .#.... .*....*.*#
#. *.. . *.\#....**....\*# .#...# .# .......\...*#
##################################################