##################################################
#.  . .   *.........##. # ..\..*  ..\#..\..*   ..#
#....   #..\\*.  #. .\ ...... \...*..... .##..#..#
#......# .... ..*.#....\.*....*. *.#.\**\.#.\....#
#..*#. ... ..  . .\.*#.. #.#..  .. ........#.. #.#
#.... .#.** ..   ...#.. .# .. .. .   *. \#*  .#*\#
#*.* *..#.** #* #.. . ..\ . *...#.* .......*.... #
#   \.  . . #\*.#...   ...#...**#....  ... .. . .#
#..*\*. #.*.**..... .\  . #.. ##.#.*.#.   .  ...##
#\.\ .. ...... #.. .... ....#.........* .#.#...**#
#.#.*. *..#...*.. \ .... .#.*.*.. ... ...#. ..   #
##. ...#* # .*.....  * .. **..* ..*.  . **  \...##
#.*... .   . . ......\.\ .....  ...#*#.#.*....*.##
##  ....... .\....###.*.*..*#...*\..#. ..*.  . ..#
###.\\*#.*..\..*..#......***#\.*.#.  .*. *.\. ...#
#. .. **  ......*\ **  ..* .*#..* .*#  .. *\..\..#
#\..#.**\.*. ..#. \.#.*...... #  ..\..*..#..*. ..#
#...# .* ..*.. .#.*.... .. .##.*  \  #..  .   *  #
#..\#.\ * ...\#\#. . #. ...#.#. ..  .*..  .....*.#
#.* .    .*\ ....*..  .  .\ .#  ..*.*.# ..*....  #
#.\.. .. *..#.**..\. ... ..* .*. . .\.....*## ..##
# *..  ... #*...*.#...**  .  . . .***.....#..#. .#
#. .. ##....*#.  ....*#.*...  .\. . **#... ...  .#
#\#. .# ...*.... .........\.. #..  . . #.. .**...#
#\ ...\..**  *......\ * . #.... . . ..*#...*. ...#
#.  .\. . . .... .#..*#. * R  ..# .\....... .#.. #
#*#.... ... #.#.#. .. ... #...... ....* . ..#\..##
#.*... ..\. ..  .##.#. ...\.. .#  ..#..#*...   .*#
#. #....#..#... .  *......\..\\.. ...*....... ...#
#.#  ...\#* #.* ....#*....#..#*\*.\#.   #. .*.  .#
#. *....#... . * .......... ...#.*..#*.. .#.**.*.#
#*\.# . *.## . .. #...#.. ..*..#\.## *. \ ..#.. *#
#...\..*.. ...#..#............*..* # ..# ..#..#.\#
#.#..* #...\.. ......#.. *.....*.. *##. ..#.*.*. #
#\#....\...#  ..  * \ .. **.#.\.... *..*#*..   ..#
# #.#.....\ ...#..\.  . #.*\...# .. \...#*.#.  . #
# ..* .*..* . .. ..\*#.. .#*# ......\*. \  .  .. #
#.\.#... ...\* \.  \..*.. .**...... . . \.\**... #
#....# .... #.  \... ........ . ....*  ....* **..#
#..... * #.* ....*\.*...\.. . * #..\. ......#... #
#...#.. ...#. .. .#*\...# \...*. . .. .. ...\\#. #
#*   *...  *.\.. ...*.. .*.\. ....*..#......#*..*#
#.  # .  * .#.*.*...  .#.. ..*.... *..#..*....*..#
#...***.\..... ..#...   ...##. .\ *\#.... .....  #
#..... .... ..... ... ..* .....\.\..##.... .\. *.#
#...*.#.  \.* \   ...\..... \*. .... #  #.. . .#*#
#\.... .* \ ..\......#\\#.  #* * ...# ...#.... #*#
#*\ .* #.....\*#.#.....*.\..##\.* .*.  #... *...\#
# .... ..\.. .\.. #.  .. .*...**....*.*#. .... ..#
#######L##########################################