##################################################
##..\..*\##*..... ....*## ...*.\.. * .....*#. \ .#
# ..#..... ##*..# . #...##..... * .....*..#.\... #
#. #.. *.***.#. ..#. *.*.*.. . ....   ...#. .....#
# ##..*.. ...  ...\.#....#......##. .\...... \*..#
# \.**....#*   ..*..... ....... .#*  ..*.\.\  ...#
#  #  #..  .  .......##.....  * ...**# # . ...* ##
#\.*.\#....#*.... ..*#....\. ...# ..#. \. .. . ..#
#.......#.*..\..\\ *   .#.*\......\ . ..... *    #
#*........#.#...... .. #. *..... ...#   . ....# *#
#......#  .*.. ...*#.. .#.*.# * ..*... #. ... ...#
#\... .. ..#.  ..*#... ...*.#.. ..*......... * #.#
# *#.. ...*.*..# ..... #...*** # *..* ## .*.. .\*#
#\*.* # . ..#.. .#*.. .\..##......\.. ..* . .* ..#
#*. .. \.\.*  .... . #.. ....#.#.*.#..#..**......#
#.   ....\\ .*. . . *# .... \.\...*. .\.. ...... #
# ..\........ .# ..#.....  ..*  #.#. * ..*     ..#
#.*#.* ... #.\.*** ..  #.#*.#. #.....  ...##.#.. #
#..## .....#.# . **#*** *....\.# .... *..\*.. .. #
# #... . ..*.\.. *..#.... #..\#*#.#   .**.  . ...#
#*..#..\. \.*  .#.*..... .*.......**..... . #.  .#
#....###.. ..#* . .........#.. #. .. ..*.*.  ##. #
#......# * *....... .###. ...*. ..#*. .*...#.*#..#
#.#\..\# ..#.\..*.#  .....#  ..\. ..#...*.. ##...#
#.. *...\ *. .#.*..# #* .*\*..#.  ....#..... ..#.#
#** ..#.*.... \.... . .. ...... *.*....  ...#..*.#
#.... .. .......\#.... .... \...##  *.. . ...* #.#
##..     .\. #....*.#......#*. ....   ..** ... ..#
#...  ...... .. . #... #......*.. .#..\.\.#.....*#
#.\#\....*## .#..*. .  .. .#... . .# ...*...#\...#
#...\.##..  .**... .*..\ . .....  .. ..... #. **.#
#... . *.*... .... ..\ ... . ....#.\ #..#.*.*#. .#
#..#...#  ..##..   ..  .#  . .. ..#..  ... *.  .##
#..#...* *\ ...\#.#\.. #...... ..... . .. . # .  #
# . .#......#*.. ...#..  ..**....\ \ # ....*   .*#
# .# *.*.#..***.... *..#\  .##  ..# ..*. .*.#... #
#. .......* . ..  *...##...#.*..##..# \.#\.. ..#.#
#...\*# #..# ..*..*.# #....  *. .*.#..#..*.\\.* .#
#...\.*.... . . ...#.  . .#R*.* ##\... . .\*...\ #
#.\*#.\.......*..\#..#.#..*.#*.*#.##...... .. .#*#
#. ..\. ..\. .**...  ..**....\.\.* .# .*.  #..** #
# ..   ..... .........*........#.## .\  \.\  ..#.#
#  *.... ..#.....# .   \. ... #... *# ..*.......##
# .#.\. \\ .*\*. \\.*#..\ .#.**... .... ..   . ..#
#.* ... .. *#\.......  ...#...#... ...#.#..# ..*.#
#\.#....   \#.*......\....... #....# . .. *.\.*..#
#... .  ......#.*..*.. #..*  *... ..#...\ .*..#..#
#..#.. .. .. *. *....*   #.*.##.. *..*...... ... #
# ..... \*..* .#.#...  ..# #*. .. .*..... . .... #
###########L######################################