##################################################
#...#*\. *#...# ..#.#.... ....#**..\ .#\*\... . .#
#.\..... \....# ..*# \ . . ... . ###.**  . ...#..#
#*...*# ...\*   .*... #*...* ... . *.\ ...#.... ##
# ....  ...  ...#...*.* *....... .#*#.# .........#
#..*... .. ...*.. .#  ..... *...\.* ...* ...* #* #
#.. .#..* .. ...  . \.*........#.*\ . .. .\.  ...#
#...*##*.#. #..\ .#.*.*#.. ....*.. .*. ...# ..  .#
#.#... ..   *.\# #..#*. *#*\* ..*.....* .... #..*#
#...#.....#*....#.... .... .* *...\....*#..*# .#.#
#....#  . .... .. .*.**...*..# .#... .....*.#.. .#
# . \ . ..\.. .\ *.*.*. .  ... .. . . .*.*#......L
#..\....#  ..#... .....\.\. ...   ...#.# ....... #
#...*##..*.#.#.*..\   \.. ...#.. . . ..*.....#   #
#..... ..*.....*.. # #.*....* ..##..\.... ...*...#
#......*. .. ..*.  ...*.\.... *.#.# . *.. \ #*. .#
#. #..*#.... . ...##....    .#.# *..# \.*.#*..*\##
## **.###..##*...\*... ..*.##....*.......#..     #
#.. . .. *.. ..#.#.. ....... .. ... \\ ....#* ..##
#\*#.....\##*.#*.#* .....#.#  #*...#. . .\....#\\#
#.\# ...#. ..*.#.*.**.#\  ..\*.*. .\ ... ##......#
#*#.\.\\ *##.. \\.*...*..#....# # .....*  .\#.#*.#
#  **\..#...#....###. ......*..#.\  .......## \ .#
## .. . . ...*.* #\..*.#**.*........ .#.#. ... ..#
#... ... *..*.* ...*. ** .  .......  *... ...*. .#
#...*. *\..#.... .##.  .*#.\..... .*... \ . .*.. #
#* #*  .\.*  * ... .. .##*.** ... .*.#.#.........#
#....#*............ . .......*.*..*.\.#..#*..\.  #
#*#.*...\#. ***.. #.#. .......\. #\.##..*...##. ##
#  . ...*#*..  *. ...* .. ..  *. #**...#\.*\ # .*#
# #..*.**   .##.....#..* **\##* .  ... ##*.  ....#
#\.* .##*.....  ...\.  *..##...* #..##*\  .\\.. .#
#..*#.  \#..R #\.* . *\...#. ....#...*\.**...# .##
#...* .\..\.. .\.#. \..*...#.#.*. ..#. * # ..#*\ #
##....*#.   #**# .# *.\... #.......  *.....*.....#
#. .\# . .*#...\.*. #*.. ..... ...\..*. *# # .#..#
#...\...#. .. .#...*...* #. . ..*..#\...#.\..#.  #
#....*.#\*#.  * *.   .\.  # *.. .. .#*###..  *# .#
#*#..*.#..#.*.  .###. \... *.. \\ \. . *.* ...  ##
#... .\.  * ..#. ...\ # *..*.##*..# \....# ..  ..#
#.*\.  ....# .... #..* ** .... .....*..\  ..#\ ..#
#. ....  ....   ..# .*....\.#.#  #.##*\..#... *..#
#.*...*.*.*..#......  *.*..##.# ......\. ..*.  ..#
# .*# **.*. .#.*#..*.*..* .....#.\ .......  #...*#
#. #.... . ..... \....## ##*...##. .. . ... ...#.#
#. *  . . ..... .# ...**. .\# ... * ...#.#... .. #
#.\ ...... ..  . *#* \.. #..*\.\.  . .\. .#.. .. #
# .. .. ..*..# . . ..... *. ....#.. ..*...#*.\..##
# . ...#.#. #* ..... *...  .  .........* ..*.*..\#
##################################################