##################################################
##.  *...... .....*.\. . ... .#..#..... .... ..*.#
#\.  ...* .#... *..*.*.#*..*....# .*..\.. ...##*.#
## #. ....\.......\.*. . . .. *..#. . .....\. ...#
#. \.##  #\ .... #\..** . ... *. ..  *.. .*. ....#
#..#.* . \... ..#... * ## . ...*...\..# .  .... ##
#.... .*# ....  #* \#... * ......#\.  .** . . *..#
## ... \.. ...R.\ \..#.*.*#... . .#* ..... ... .\#
#..#..*.  ...*...#*.. ..* ... .*.*...... .. .\.  #
#. ..***#.#**.. .. ......*. ....#.#    .#... ....#
# #...  .. . #.#*\.\.. *## ..*##...#.... .*......#
#*#..\.....#*  ..... . ...\.  .#.*\.....# .. . *.#
#*.#  ..#....#*..* * ....##  ..# .....*...*... . #
# ....*\\.... .#*\# . . * ...# ....# .*\.....*.* #
#.. #.. .*.... ......  .....#..\\ ......#....* .##
#...** .*..# .*.. . #..\..  ..\... .\... #.#  \..#
#.##.*. ....#*.\ . .## \# . #......** #.... . ...#
#.#  .. ..\.... .# ..#.*.\ ..*...*. \.. ....  *  #
#......*..**..  *..  . .. .....*#.  .#... . .# ..#
# ..........*..*. ..*.\.*....# *  .  . . #  ....\#
#.......*. .\..#..*...\.#\ #\.#.\.##....*#.# ...\#
#. #..*  .#........... #  .#*.. \.*.*...**.. ....#
#...* .#. *... ** ..   ...# *\*. .*#....... ..*..#
# #...#*.....##.. \.......  ..*   . ....*.\.*..#*#
#.*.#..... .* ..##.#.##.*#. \## .  ..  *.. .#...##
#*..  .......*.# .##****....##..##.\#..#.. ..#...#
#.*. ..*.\..*# *. . *# ..*.. ..  ...*.*\\...#..*.#
#... .*.. ...... ....##. .  **  ..#.#...*  .   ..#
#.#  .\ .*.  . ..*. ..*##.. .\*.......\.\.*.\.\*.#
#*.#.. ..#....* .#  . #*. ..***.#... ... .  .\# .#
#...*. . *#\.*..#.. .\... ........\#.#\.*#.#.\.\.#
#...\    .**\... .. .  ...  #.**. ...*.# \*\\#.*.#
#... .*...  .........*..* \...... #....\. .#. ..##
#\ . ...*.\.....*... .... .#.... \...... * . ..#.#
# .*..*. #...***.. .. .*..  .. ...#\....  .......#
# #..........\*.. ... ...# .# #.  *. ........ .. #
#....  . #... #... ....... ...... *....* *.*.\   #
#*\.*..*  . .....\##.......... .\#.. #. ..#.* .. #
#* .#  *  . ..  ...... *..\. *...#   \*......\\. #
# .. ..##..  *.*..#... * *. .... \.*#* *#..*.#. \#
#*\...  .*\*.#..#...\*..#.....# \\. . #\#.*... ..#
# #*...  ..#.....\#. #* .#\  ...  ...  .... #.  ##
#.*...#. *..*.#.#...... ..*. *.*.......   ..#**..#
##.# ..*..\...#.... .*#. .  ..... \..*..#** \.#. #
##.. *\\*...#...\........#. .*.*..#.#*.. .. ..*..#
#..#.. .....*  #..\.#.....  ......*. ......\....*#
##.#..*.* .\. .*. . #**.* \.#  ...*.*..*..... ...L
# .*.  #.... ...*#. ..* .#.*..#..\.*... ...\.....#
# ...*....#.*   .. .... #.*....*.**.. ..*#.*\\.. #
##################################################