##################################################
#....#. .\. .\*.##...    ..\.. ...# *#..**.*..\..#
#*.#  *\#..#.  .#  ..##..  .#... ..... #.*.*#*...#
#   ...##......#....\#..#...#*. \.. ...\ ..*...\.#
#\* . ..#......*.\.* . .*..... .  #.....  .\.....#
#. ..... # . . #..\ ......... .#..  .#... .* # ..#
#*.\* . . .. .\.\.... .....*.\#.....\. **.\#*.*.\#
#.. .  ...*... .*.. .  ...  ..#  *....#*.*.. ...*#
#*..*.*. .....#*..\ #..    . .*..#.*# .. * . .#..#
#.. #.*\... ... .........* ## *....#....#*..  ..\#
#.\.....\.. .*.*....#... .*..... *#.............##
#.### ..**#.*. *  ...* ....##....*.*... .*#......#
#.*#.*. #R*.. ..*#.  ... *...*. * ... #.\..#  .#.#
# ..  . .#...* ...*#.#.. .. .* *. ..  **  ..\.*..#
#...\...#.. ..\..\. \.#.....*...#............ # .#
#*....*....#.*..##.. .  .\.\....... .#. #. **..#.#
# \..  .#.#..... *. .* .. ....*... .... \*..... .#
#* \... .* ... ..*......*.........#... ##.  # . .#
#.#.*\..* ..##....# . .. #*.\ #.. .*... #...\\...#
# ....... . *.  ....\. ..# ....*.*.....##*#\##.*.#
#.....** .  .......*....** ..\...*...\.#*.*... . #
#**#...#. ...\ ......#*.#*  .* . *.. #..\ #*#. . #
# .... ... . ..* *..*# \.*.... *\.... .# *..\.*# #
#..# . ...... ..# .*....# .......*. .#*..# .#..#*#
#   . ..#.*..*. **.#. *... *.* .. .. .*.\... ....#
#...#.#. ..*..#**..\ .. .. * *  ..\....*.. * .*..#
#.#..  .... .......*.# *# ..* #  ....## #..  .*.##
#.#.. #...*. *.**.....* .\ *#.....# .  .#....... #
#*  ....* ..***..#..##.#*...*.*#* .. ..#*.    #. #
#...  .*...#.. ..#...#\..#..\*..*.#  \. ..#*.. . #
# . .....#.  ....*. .*....\... ..\..... #...\ *#*#
#  .*.#\... . *##....... #......*....   ..* . ...#
#\. .. \*... \. ...#..#  ..  ##  ...* .**....... #
#  *. #.... \.*#   \*.# ...#\. ..*.... *...*...* #
#  ..*  ..#. .#. .......#\... ...*.......*..*\*.*#
#..# .*.. ...... *.. . ..*\..#.. ..*.... .. .\...#
#.*..... .   *.*...#\.\.... *....#.  #* . #.#....#
###.....# ..# .#  ....* ..... \.#*#...# ....  ...#
## .#... .#.... #\.##.. *. #* .. **...# .\.*. ..*#
#...\.........\*.*. #....# .#..*.*. ...... #..*. #
#......# ** .\  ...*. ...... . *#.. ..# #  .#. . #
###.*.\...  .*.#\ .....#*.* ...#.  .....#.  *. .*#
#.*. ..\ #.  *... *   *.. *..#. . . ....#**...#\*#
#. . ..##. \.# * ##*.. .#.*.........  ..  ....*..#
#..#. ....  ##  # *...... ..\.. \# * . ..... ... #
#.#*.*.\. ..#..#...**. \...\.\..***##...  *......#
#..##.#\..  * . *.\.*# ..*..* * *........ ... .*.#
#*..*.. .# . ......   .#.*\... \.....#. .#**.\*..#
##...*...* .*## . #.  ..* #\ ......#  .#\... .* \#
#############################L####################