##################################################
# .  .* . ..*.*..  .  * ..#. #  *...  *. ..*.\   #
#.*.. ....**# .*.#. *.#... .#.  ....* ..**..##..\#
#.* . ...*. .....#.#.. .  ..#. ..\...#.. .# .#.\.#
#* ...\..#.*.. *..* ....# *......# .  ... #..**. #
# \.* #* ...##.. ..*.*\...*.....\..* ..\.....#...#
#. ... .......* .**. . .. .....\..*. .#*.\ . . R #
#.#  \..\#.*##.#.. ..*... ..*. .\..* . ...#.....##
#... .*  .*..*## ..*..#.#   .. \..*.....  . *#.#.#
#..*..*..  . * \.*#... ..* .\*  .# #......  ... .#
#\..... .. .... ....* .#*.##..  .......\..# ..#*.#
#.. ..*..#..*... ...... .... .. ....*.. .*.## .. #
#\..**..*..#.........    #*\. \*\....# .#.. ...###
#.... .. ...* . ..#*...  #. .... .....*#.....\...#
##..# ....#* ....**.    .. *\ .*\ *.*# #....  ...#
#..* .  ..*... .# .  *.. .*... ..#  *...*.  .....L
#.*.#*..  .. .. .\.#.#.....#....... ... . .. .**.#
# ......*..... .***....#.. . ... *. .  ....*#... #
#...  .. ..#\# ..#.....* . #\ *.#.*..  .. .#. .#.#
#. .#....\ * **\ .. *....# #\.. #\\... ..*..#.. .#
#\...*\*.. .*.... .. \.#..  .  \#.. .**#....*.. .#
#.**\.\..**..*. .  ...#...#..#..# ..**...... . * #
#\.*.*..#......*#.. .. #*\ .#\ # .*. ..# . ..#...#
##..*# .* #. # \ ...........#*... *..*\.... .... #
#..#\**\. ......##.. .  .*...*# .#*..#*\. # ##.. #
#..  *.. .*\ .  ...#.. .#*...*\ \  ..... ...   .\#
##*.....#.  ...... ...#.*... ........ ..*...*.*..#
#...\ .... .  ..  ..\...##\#. ...#\...* *. ..  ..#
##*.* ..    #.* .\ *... ... \.#. ..... .**\ .#.\.#
#.\ .#.# .  .. .*.. ..##. ##.\...#.\. .*...  .*..#
#.*..\#.. . .. . . .  .......##.#.  * #*...# .#..#
#. *  ..*.....#*.**.. .*...#.## #.. .*  . **....*#
#.#*. .#***...  \. ..\..#.. ....##...#... *.#. .*#
#.... .\*........#..\.  #..##..*... .. *....*.# .#
#.\.  . . #... ... . ..*.... .\.#.\. .#.# ....# .#
#.\ #\ . .. ....#.. .... .\.##....   \\....... .*#
#....# ...#*# .. .....*. ...\#... ....\*. # .... #
#. .... #\ #\\.. ...\\...#*.#..  .  *.#...... * .#
#  .*..*.\.*. *...  ..*#.. #.....*. .... .#... \*#
#.*....# . .*\ ..#.. .......  ...   .*   . ...#..#
##. *..\#.... .     ## **. ... .\  ...#...\.. ...#
#\.*#*...  #..* * *# #*......#..  ....#....  ... #
# ..# *...# . .\. .. . ..\*#*.. ..#.\..  ..*....*#
#..#   ... # ..* ... ..* \....*.... . \ \..* ..\##
#. .....# #....*.#... ***...*\\.....* .. ..*.*...#
#.. * .#.....#...  ....... # . * *...#.\.#\*....\#
# ..#\....*.. . #   . . *.....*##..\..  ..#.*#*  #
#..*. #.. ....#   .\.#..* ...##..\# . ...\ . #..*#
# .#.. ..*.\. #.##..* .\. .* .. ....  . ....  .  #
##################################################