##################################################
# ... . ...*.\.. . ..  .\. .  ..#...#........ .\.#
#.#..*.  . .. ... .*  ..\......# .#\.. ..  ..# ..#
#.. ....*. #. .....*#*#* ..  .. ...#*.  ...*. #..#
## .*.......... ..*\\.*\.#..#.....##\... #. .. #.#
## \....# . #. . . ....#....#.\ *.*...... #. #.. #
#....  #.....*... .  *#........  ..# .\....**..\.#
#  *.\ *.......*  #.. ## .##..... ..*..\....... .#
#....# .*#*.....# .#..#  \.*.#.*.*. .... #.. ....#
#*.. .. ...*..#.\..... ...#.**#.*. *..* .# *.*. *#
#.**.. .* .... .*..#...#.. ..... \..*...# *..*\  #
#*.*.#......#.... ...**..\....... ...   #.*#.....#
##  . #*. #..... ... .. .*\ ..##..\..\.. #. ...*.#
#  #. ...* *#..  **. ....#\#... .. ...*#.#.# *.. #
#.#.. .*...## \.*...*.. ..*. ..\# .... .*.*#.*...#
# ..\\.#...*#.#..#*.  .*.* .. .*......*.   . .*..#
# *#...  .*.#. ...*..# #..\...* \..# *..*.*..** .#
#.    * .... ..* ... *. .#.. .#.#.*...*..#. ..#..#
#.\.....  #..\...*  #..  .*... **... . ..* *  .. #
#*#. .#.*  #.. .#...\. *\*..*.#. .#   ...*#. ....#
# *\.#.. .*..... .\.. ..  .*... .....#*  ...#....#
#..# #*.*..\#.  *..# . .#. *  ....#.\ \.# ... .\ #
#.**. \..\ .*  ....*.*. .*#...\.\ ...\. ... .#*..#
#......#..  .* .###.* ...... .\ .....#*#.  ..#..##
#*  ..*#\.. .\. ...\.\#.. *..# #....#......  ....#
#.\.#.....*  *...#.#.\..#\  ..  #.... ..*.##\.* .#
#...*...*.*....*   *\#*.*. .*.\ *.. ... ... .\...#
# #. \*..*.. .*   .....*.*#.  .. .*. .. .. *#..\\#
##   . .**..##* ..#.....*.* #... ...##\.*...#....#
#. ...  * # .. *...#.....# *#..*.* ...... .......#
#. #.\*.#.**..*\.*........\ ..*.. * .. \... ....##
#... ...  #....**.....*#.......# ..... ..* .\ ...#
#..##.#..#  ... .**.. .     ......##*.#.#....# ..#
##*... .*\... *... #..* ...* \#.*.#*.. *.# #*..* #
#.  ..\*..*.*#\ .... .   ... ..\*..#.*.\.. .*...*#
##.# ...... \....*.#...**\##.. ...*... .*.\..\ ..#
# . .......\...#.*\#\ .... . \.*\ .. ..#. ..*#...#
#*#. # #..... .  .# * .#\ .#.\....#..  ....... .*#
#.*.##.\.....#...... ##. ... .*.*..*. .   *.*\ ..#
#. . *.*. .  *....*. ... ... ....#. ***.. ..*.#..#
#...... . .....#.. .. .\.\..#....*... #.* .. .. .#
## \*  ..#.. *. .*\.\..# .   #...\#.# \. ....  . #
#*...** .. ... *....\*. ..*.\...* .....*....*##..#
# * #.** \* *.* . ..... \.. * .. #. *#.#.\.#.# ..#
#.\..#.. ...*.. .. * \...#...  .#. **... . ... ..#
#..**...#....#. *** .# #... .*.. #.#.. ......#.###
# # # .. # *\ ....#......  \.#.... .*.....# #. \\#
#...##*...# # *      .\R\ \.*. ....*......\ ...  #
#*.....  .... . .. ...#. ....** #. ....\......\..#
######################################L###########