##################################################
#... ..**.#..###.  ...*..## .. #*.#*.#.  ...#.*.\#
#...# .#*#.#\\...#......*.#.*...... #... *.. .  *#
#**.....##. .*.. #..* ..*# \. .... # R *.* ...*#.#
#\*...# #...........\....#...*..*. *. #.....  *. #
# ..*. .\. ..#.  .\ #..\.. *.***#*. *...#....#.#.#
# .........**. .  .. ..  ..... .\\.... *#.. *....#
#* .\\*.#.#* . *....#.  .....  ### .#*.... **....#
#. .  ..\..#.. .. . #..*.....## ... *..#... . .*.#
#.......**#.... #\.#*.. ....*.. # . ..* #* .. ...#
# ..\ .. ....\. ......**......*...... .**.##\..  #
#\ ...*..\....*. ..#  .#....## . \... #  .#. ..*.#
#...\\#. #.#....# ...*\..\... * .#.. ...  . .* # #
#...  .#. ..# .#.  . .*  *.## ... .. ..  *\.# ...#
#.*.#.... . **.#.....*..#.....*  . #...... .#*.* #
#... .##.#.\ ..#*.#. ..#... .#   .. .#.... ..\##.#
# . #...*#..*#*.* ..#. .\*#.# .... * .*\  .. .#.*#
#\. #  ....  *..  .\ ..* \\#.*  .\......##.......#
#... . ##...#.###.  ...\.*.# . ...*.. ........ *\#
#. *..   ...  ... ... ....\ ..*... .. ##.. .. .. #
#\.\*........#*.\.*.\.  .*..*.\ ....  .# .... *. #
##\ .. #...... .*#..#.. ..*.. ..  ....\....*...\##
#... ....... .\. ...*. *...  . *... .*#. .*... #.L
#..\.*  ..#\#.* .  .....\..#.   ...#.   ..#.*....#
# *#.. ...... \.#* *   ....\.\.*##.. ...... #*..*#
#.. *.\*.. ...*..#..**\. ..* ......#..#.. ..*#..##
#\. ...* .*. ....* .. .#.#\..#... . *... ........#
# . . ....\. #.. *. . . ..  *....#\.......*.##*.##
#*. ..*..**... .# ..#*\*...# .. *\##*...\ #......#
#.**. *.. #\. # . .. . \*.. .  .\##\..  .. ....  #
#......... ...*  *.\....*. *# ..# .#.#.. . .#..\ #
#\.#... *. . ....#.*#. #.  #\ *#...*.\....  .#. .#
#.#. #....*#*\...*.*...#..\.......*.... ...*...**#
#. *.**   ...*.. ...*......... #  . .. ..*.\*.. .#
#. *.#...# #.....  # . *...\..*..... ...* #.#  \.#
#.#*  .*. .\ ...#..#....#...*.#**. ..# .#..*\ .# #
#.* . \*.*#. \\ .. ..#.\.**...## ** ... ...*....*#
#. ...  *. \. .. . ...*  .  ...# * ....#**.**....#
#.... .... *.. *.*. . * .#...... \# ... ..##.. ..#
#.* .* #. . .......*. *........#..# \.*...##. *.##
#... *.. .. .# *. ..  #.....#.. \.. *. .#   **.*##
#\..  .......*...*. ....  .. \ *... ...\. .....  #
#..*....... .#. ....# .. .... ...  ....\\#\.\.. ##
#... \ ... .\...*..*\.. ...*#*..* *..... #..#..* #
# \*... ..... ..\*. \. ....#...  .. . \..**..*...#
#..\\.*. \ #..... .#...*.\.    ..*..... #... # #.#
###..*\.*. .#.......#. ...# ...  *....*........# #
#...*.#.... ... ... .* .....*. ..*.* ..... ...#.##
# ###..#   \.\#...#. #....# ..... ... .*#..\ #. \#
##################################################