##################################################
#.. .* .... ... ..#.. .** .\\..\..  *. ..*.#*.#.##
#. ..#........... ..##. *.*.. .....**. .. .  #*#.#
##...*..* #. *\**.**   .. ....#. .*... *..*#**.*.#
# #.....##. ...#. ..\...\. .. #*. ... .   *\. *. #
# . .* *. #..*. .*.\..#*#*. #  .*#..#.* *.. * .  #
# #....#..... \.* ...#..*...#**...*.#.* .\.#\ ...#
#. ........\.......  .**.* .... .# .*.. *#.....*.#
#\\\.**#.  #.*. . .......\..#..#.... .*. .....\.*#
#.. .*.* #.. #.   \  .  .*. ..#.. ...*... .*.....#
#..\.. .#..#.....*.#....... .. #.\. * . \# .   ..#
#.*.  *.  .#*# ...  . .\*.... ..##.  ..... ......#
#..#... \. .. .#.#*\ .. ... .**.* ..\\ #.......#.#
# .*.\...* .\#...\  ..* .\..*...\   ..\ .\..\  .*#
#. ...*#.. ...\ .\ .*#..  .# .* .*.   ...\.#. ..\#
#.  . ... .#. .\ .#...\.*.*..*.......#. .#. * ..\#
#...\# # .. *...#.  ..*.. *.. *.... .#. .\.\..*#*#
#.....*#.. .... ...\.......  ..##... ..# .##. .\.#
#.# ...#.  . ....*.. #*. \.**# *. ..#........*#*\#
#..... . .#* ....# .....\*#\.#.#..#... . .. #. # #
# #..... ...#. ...#..*..##\ ..#  \....   .. .. #.#
#...**..   . .*  . .# *#. .##** .*  .* ...#..  . #
# # . .#.. *. ...... ##.   *.... . .*.*\#*. . .#.#
#. ..\.. . # #.. .. .. ..   ..*. #... #..*.#  # .#
#*. ...... .*.* . \ \..\ ..*..#\..#........  . .\#
#. ....*.*.. ...#..*... ..\ \..  * #.....#.\#*.. #
#.....*#*.. .# ..\ ..\....*.. *. .*#.*..#..# ..#.#
##.#.*#  . \...  ..#. ....# .*#  #........#..##*.#
#.. \. ... .#.  .\.\.\* ...*\......\.#. ....#*#..#
#..\ .##..*#.  .......# ..  # * . * .... .. ...*.#
#....*.\*#. *..\ #* .... .......# ..#.......**.# #
#....*. .#.. ..# . \......  #. ...#. .. **. . . .#
#* ..* .\....  ... *  * \  .\ .... * \#..... .. .#
#... ..*....#.. ..*..*..\...  .*.*......\#.... ..#
#..#.. ..... ...*#. ..*....... .....**\***.....*.#
#..#.......#.. .  ... ..\*.... . * .. .\.*#.  # .#
# #..#.* ..*.. ..#...#. .*#..*\... #.##  . .. .. #
#.. .. .. .**..#R#.#. .... \..*..  .*#.. #*.. ..##
#.....#......*#.#.\.\...... . .*.. *.#\ * ....##.#
# .#..*. # . *..##.... .. .#......*.. *...#. ..*.#
#. .. ......* #.........#...*   .. ....\#... ....#
# *..  \..*.#.. \*.#***...\\. .*....\ .. ..#...\ #
#.*...\...*  **.*.\.* *. .   .##.#.....#...\*...##
#...*..#**.. .\..\ . .... ...*. \**.*...\.  #.# .#
#. ... ....*. ..*#... #....* **# . ..... #. .....#
#. ..\. \#. \....* # ..... .. *.\. ... .*..\ *.#.#
#*. #.. ... .....\*...# *. .  . ....#**. .. ...*.#
#..\...\..  .....*..*\.....\* .... #... *.  .....#
#.*.# .\. *...... .. .* .#.#...... ...#..*.. ...*#
###########L######################################