##################################################
# . . *.. ... *. ....\ .*# .. .  .  *.#\ .  \*#..#
#.... \.*.#*...##\  ..#\. *....  ....#. .#.....# #
# ..*...\.. . #    .# ....*.#....*........  # \..#
#*... .#. .... . .*\#.\..#. #.. #.. *...*.**. ..##
#... .... ......  . *..  .*. . . .........# . \..#
#....*.\...#..  .#*.#..* #*..#.... * \..**.# . **#
#.\.\\. ..#..#..#. ...**.**.......*..  \. ....#* #
## .. *... .....#*\ .# # . ..\\..  *..**.*  \.*..#
#.\#. .... ...... .... ... .# .... .....*....*...#
#*.* .......\.  *. . # #    . . . ........##..\*.#
#.    *\.* *.....#..#*... *. ..#*.  ....#.***....#
#..# *.#.\..  .\.##. # .. ..\#...  ..#.*#*....*.*#
#*.*... . .. .*. .##...  #..\... #\*\...*..\. ..\#
#...\.\.. .. .. *..\#. ..\.. #\*.  \...\ *.\....\#
#........* *.. ..... ......#*.*.. *....*.  ..  ..#
# *. .. ..... . ... ..# ..\...\...*#  .\.#.. # ..#
#..... .. .....\.# .. ..* .  # . .  *\.  #.. \  .#
##.*.\.*#\.. *..* . . \ ... ... . #.. *.....\... #
#...*...*..... *...  # *.#....\.... ...  ..\#..#.#
#.........# ..# ....*  .  .#...#..*#..#.*\.......#
#. * ....#.*.... .*\  .......#.#...*#* * .*.#....#
#.*. *.... \.....   ##*.... ...#**...\ . .\.#..\.#
# . ..* ..*. *..*..## .   #.*.#........... . #.  #
#.*..*#*\.. .#.. .. ..... ...  . ..*\ .#.. # *# ##
#.*## * .... .. #..*#*.. .##...# .. ....*.*.\. ..#
#.....*\#...*..#...*.......... ..*. #..*... * ...#
#.. .  *. . .*. *...*.# . . # #...#.. . ....#..\.#
#\.#*\*..*  ... #. .. ###. ...*\...\##.*..**. ...#
#*..\.\*.. .#...#.....\ #.... \..*.   .  *.......#
#..* .**... **\. **...#\..# . .. .... *..* ..  # #
#\.#*.\.....\.... \.**...#. .#.   \...* ..#.**.#.#
#.*#..#. *\*.\..   .*...#.* ..#. #...*.. #*...# .#
#*#.#. *.. .... \.*.  ..#..*.#*...**.*.\..  ..*.##
#*.\.** \. ....... ##...*..\# ...... ...* \. ...*#
#* ...** *.....\. .\ *....* ..... # .#.. ..... ..#
#.    . ...  . ..#.....*.# \# \... .  .\..# *. ..#
## .*.*.*.\ * .*. ##.*.* .  ..... .  *........ \.#
#...*\.. . .... ...*.#...#... ...*..#...... *.#..#
#\\.#*.. ....#*....*.# ....#.#.*. ...#.....\*#...#
#* .#.. \  ..... *.. ..#\.. .  ..**.*.....  . ...#
#.*\ ... *  .. .#*.... \*...  .....*.. .. ...#.*.#
#*...#.. *.#...# ...... .\.....*.*. .\.# . .....*#
L## .#   ...* . ..*   ..\....*.... *#..#..... .#R#
#.....*\..*. ..*.....  ..... .#*.*.. ...\. .#...##
#.. . ..***........#. .#.. **.*....* .. *#.*... .#
##... \..#....* ..#  #.....# .# . ... \ .   \ .#.#
#....#.#.....#.#*.* .* ...*..  * ....#.# .#.*..*\#
##.....\ #.#.  .. ..* .#..#....#*\#*#.*. .**..#.##
##################################################