##################################################
# *.#  *  *.\ ...*.....*..\\.#. \.#. . #.   #.   #
#.. ...\... *..  ..\#. #..... ...*.*.#......*... #
#...#   *..#..*.. *..\. #*. *...........#\#. # #.#
#...**..\\.*. \#....#.....\... ....*#  .. *...  ##
# \*\.*.*...#.#.\\\.*#\\ \#*. .  . . .. . ..*.#*.#
#.#..#**.*. ##....*# ..\....R. \*.##.*\...##. .. #
#.#....  .\..*.. ..  .... .\*.... ..*#.. . ....  #
#*#...#.*. \.##...*.  . .# .#.  .*.... . ....#..\#
#.#.# #.\#..#\# \..# . ...*.#\...  *..** ...#* ..#
#    . ..\..*#. #.... .  ..\....\#..#..\##.#... .#
#**.*..#. ......  ..*\...*.#*......#\# .. .##....#
#.* *...  .\  \..  .*.#\. .. .. . ..*.* ....\#...#
#....*#  .. #. **. ....\**\. .* .  *..#.#. .*.. .#
#*.. *# ...*..*.# ..  .**. .   ...\.  .\ *....*..#
#... ..* .#.   ..#.  *  #..#.. ....*.... .. . ...#
#.. . #...  ... . *..\..#.. ... #.. .#.*. .*\ ...#
#...#.##....*..*  ..#. .## ..#..... ...# .*.....*#
#*..\.... .*....*..#*.. *.. \.. .. #.***..\..#   #
# #....#..*.*  .*.\ ..\\*..*.#.*\.*#....* . \...\L
#*..##.. \...#... .*.. *.  ...  .... *##. .# *\# #
####.. ....#.#* # ...\.*....... .....  ..  .\#.# #
# ...* ..*.. ... #\...  #..# .***.*\.. **\#.#  **#
#......\... .#*.. .. \#...*..#.*#..#......\....*.#
#..* #*#\.##.\* .. ..#.. \#  .*..##\.  ..#.#*.*. #
#...\..... .....#..* . * *....... ...*. . ..#.\ \#
#..#. #. \ .\..#.* ..#........*... ...*.#...#.*..#
# . .\...\ .....\ . .\.*.. # .. #....# ..*##...#\#
#.*.\*#...   ... *\ ...\*...  ..\.##..........#..#
#...... *.#.... ..*#....*..\ ..***..#.   ..*. * .#
#\........ .\ # .. .. #....#.#*\ *#\..*.. .. .\.*#
## .. #* ..  \.  \. .*.. .. .. .*..# . \.* * ... #
#\...*.... *\##... *.....#.\. .....#**\ ..#  #  .#
#.....#.#**.#......   .* ......  .#.\.. ..#..#...#
#.\ ...# ... .# .** ...# ....#..*. ..... *...... #
#... .#.#. ..#*.*.\ .*#.** #.#.**.....*.*..#... .#
# ....#.#.*..   . . ....... ...\... #...*... ....#
##.\.#.... #.#.. ...  .# ... .*....*. \* *  .....#
##* *..#.... .. ..#..*. .*.# * .* . .. ....#  ...#
#\.\ *. .  .  ...#. . *..#. *\ .... ...#\. ..#* .#
#.*.*#.* . ..   ###.\ .. . **.. #.\.. . .....\...#
#. .. ....  ..\.*\.#. . .  # .#... .* #\*. ...  *#
#......*...........#...##  ...\. .  .#..#......#.#
# ...   ..\... ... ..## ... .        ......#.... #
#...\..#.....\. .......... ...**##*.* . #  ....#*#
#.#...\  # ...## #\#\*#.......# ..#.*\.... \\*\..#
#*.\ .. .\ #*.*.#....#.* ....*....#.... ..\...   #
#... #....\#...#.. #.***...#\\... .  .. .#**.... #
#..... #*\.# #. #..#.*##* .. #.... # ...\... **..#
##################################################