##########################################L#######
# .#.#..*..  #.#.**.  \.  ... #...#...*.*\.* . ..#
#.#.. ***..* . # ... .... ..#*#.. #...* . .....\.#
#. ... *. .#....#  .\\   .. #..   .*.  *  #*....*#
#*\....... ..*. ...\ ..***..*.. # ...\\*..  .#...#
#......#  ###. ..#..#.... * *#...*.#  #.*... ..#.#
#*. .# #  \...#. \#.**\#...   ..\#. #.. . ..\*...#
#. ..**\*.  *..##........ .#.#....*. ..#.  ......#
#.....*..#....\....#*. *. ..... . #\ .#..*. ...*##
#... ..#*..  #...#.#...*#* ...#. .. .\..*... ... #
#... *..\...\.\ ...#*.**.\......#   #.*.. .#**...#
#.. .... ... ...#. . \ *...#...\..*  ... ....#. .#
#.........  ... *##*#..  ...*.#...# . **.... .#..#
#..#.*.#.# \ .*..... \ #  \..  ..# ....\\..*.#.#.#
#.*.   .#.*.*   .#. .......#*#...** .# ..   .....#
# * ......\ \. .#..\..\* \##.*..... .*......*..#.#
#...  *. .. . # . .*.  .. .**....*.# .*.\. .##.\.#
#. \ \..  *..*....*... .. .# . . . .. .\ \ #.* ..#
#......#. * .**..#..\..\..\\....#*\# ...#. . * .##
#.#\ *..*. # ..*.. ..*# ...*.....#. . \*..... *.##
# . .....\#.#.... ...... .... ..... ........#.  \#
##..* .. *  # ... ....* \. . . . *.#. . #.#..*...#
# .... \#....... ...  #* .\. *...#. *#.#..\...#. #
#.. ..#**# # .\ \#.*..\. \.\*.... ..#...  .... ..#
#..\....#.\..#....#. .  #.. .. .#*. . *. * .... .#
# ..*  #.*...\*. *.*.  *...\....... . .. .\\. .  #
# #..#...  \# *.#*....\#.. .. ....# *.. ... ..#.##
#.\**..  .\. ...#\...***.*.......*#\. .#..#  ....#
# ....* ..  \#\...#... ....*.\..  .** .#...... * #
# #.. *....\ ...*\.... .**. .. \.\#*#.*. \#*. .  #
##.*  .*.    ..\. # #.#.*#..*. .*\ ......**.. * .#
##........#.. . .# . .**....*..**#..... .....R...#
#. .\# ..*..    **..*.*.\* #.. ...#.\* ....... #*#
#.*.# . *.# ... ...*.\.....#... .... ....*# .#..*#
#.#*#....  ...\#.   ...#. . .\..\. .. .....#...*.#
# .*#...##...*......\..\*........\... .. . #. * .#
#. . .....#\\#.... .#\.#*...*#...\.. ...\.*.*# ..#
#. ... #....* *# .\..*.  . #**. .......#.\.#....*#
#\ ......... .. ..\ .\ .  ###...\.... ... ...... #
#\.....##..*..... .......*. \ ...#.. ..* .\ #...\#
# #  ....*......  . ##.....#.*.#   .*#...#..\.#..#
#.*\..*..#.... ... #.**.... *#. ...#........ *...#
# .  ..**..##  \.#* .# ..  \.##...#.\*#... .#....#
# ..... **. .. .. * #. .. .\#.*...* . #.\. **....#
#.......* .  \#*. #....  ...  ...*.#*...**.. ## *#
#.\. ....* .\##.#* #... \*...*#.. * \*... ......*#
# .*  .#.*. ..* ..#.. *  *........ *... #\..    .#
#....**...#*... ... **#  . ... *** ..#. **.*. #.\#
#\.\# ...* . .*.. *.##......#.....* .* *... .   ##
##################################################