##################################################
# . * \..#.* # ..*.  * #.. ..#... .. ...  .\.* . #
#...*.*\ ......** ..*.. ...# # . ..... \...*#...##
#..   .# ... ....*..*..\..\... ......***# .#...*.#
#. * #.  # . ....\*.....#..... .....*#... ...#.. #
#\. .. #...* ..##.*.\  ......#...*...#.#.\\. \. *#
##......*........* ...*#. .. ....* ...  . .......#
#. .* .....*....\# .*\...#*.. .. . .*..\... ...  #
#.**. #.   \.........*. . . ... . .. ...... .. * #
# \.... ...*..*.  ..*.. .**..# ... **.....#... #.#
#\.. \ ....*#...## \. ....#*\ ## ..\*..# . #. *#.#
#.###. .. \.... . .\ .... . *...#. # .. .. #....*#
# #. .....*.*#.......\.... #  . ....#......*#\..\#
#. . ..*\. *.. .* .. ..*.#...*.. ...\.. .......#.#
#...\\  ......  .\**.\... ** .#.# ..  ..  .##....#
#. ..  .. .  ..  ..#..#. #..\* ...\.*..#....#....#
#...R.. *....#............ ......  .*.#...\ .*..##
#...... ..#...*  #..\ .....#..* ....* .##.#  ....#
#..*..... # ... ###. *...  # #\.... ..  .. \.\...#
# .#.#.... \**..*#. .......\\...#... .....*.* .\##
## *. ...# .\  # ..* ...... # \. *. . .... .*. ..#
# ... ... .  ..#. . .\.\   .##*#... #............#
##..*..#*# ..*##..**.. .  * ....  #..*.... ...  *#
#.. .......##. ..\.#.\.*#. ..*... *. .#..#.. ..#.#
#... ..*.* .. * .#....*.... *...\#....#... .. .#.#
##.*.\... #.\.*#.......#.....##.*\. . .   .......#
##..# ...*.#.. ...#\*... .\.. *#..* .*.....\.....#
#..*..#.. .... .... .....  ..\.*.*#...  .*#...*..#
#**  . *.......*..... .#.*..* .\# .\......*......#
#....* .. \**.  ..# . .*..*... .#   ..# ......\..#
# .# . ..#..#..##\* ...#. *  ......\...\*. ......#
# .* . ..  ..  ... .....*..#. *#   .\.##. .#. #.*#
#.# *... ......#. .....*....  ..*.\.  . *........#
# .  . . ..... ..... .. #.#* . ......#* ..*.# ...#
#. ##.. . . .  #... **.*  .... #.**.#....* *.*. .#
# #*.  .....*.. ...#.  ..# ....\.*\..**..*.. * .*#
#...*.... *.#...  \. ...*. ...\ ....*..* .#... .##
##*.... *#..\.  .  . . . .......#.. .#. .\ .. .#\#
#*.*. ...* ...  .......  .*\  ...  .\..... ..*. .#
### *#.*...#..*.. .......##. ..#....#...#. *#.#..#
#.##. *  .#**....# . ... .  ...\.#..  .. ..  *..*#
#..  .# ....*... *.*.....   \#....... ...#.. \# .#
#.  ..\*..*....* ... .# .. .  .\. *...*.....    .#
#..   . . .*. .\.# ...#.   .......*#.# .*#*...*..#
#.... .... #.............. \. ...   #....\..#..  #
#. ... ...\  *. ..##. ..  .#\..#\...*... ... .* .#
#.* ..*  ....*. \ .#..*..*..*.*#....*#.**..\.  ..#
#. ... *\ . ..#. . \.....\..\. .#.....* #...#... #
#..# ..# #. ..#*..  ......*..#. #* .*....*.** ...#
############L#####################################