##################################################
#..\. *..........# *....*#  .** .* . ......... # #
#..##...........#. #*....... ...#..*   ..***.\*..#
#.###.  .*. *...#.#.#.. .* .. . . .   ...#.*..  .#
#  .#.\.........\#.**. ...# .... * ..... .#*.....#
#.\.*. ....  . .*\#.#.....  . *....* . .#  **.#..#
#..#. *#\\\\ \   .. ..\  ...#.\*.  .***. .#.#.*..#
# ... .. *# .#  . .###. .........#.....     . .. #
#.....*\... #. *..*#  # . . .   .#.. ..* .. ##.#*#
#. *...*... .**....*.\ #...  ....  ..#........*\ #
#...*## ..* *#. \ . # ..#.*.   #.. #.\..*...# ##.#
#.#. .*..\... ..\. #....#**#....*#.#. . *\.  . \.#
#...#. .....\....*.. .....*..*  #. ...** ...#\.**#
#. .* ....* .*.# .  #\ ...\ # #\ \*\*...#\..#.#..#
#..... .... #... . ..\# .....#. ........\.# ..\.##
#. .*  ..  .  ... ...  .. ...........*  .#  .# ..#
#.. #*.\....*  .#  . ..# .......*##..* .#*. #  .##
# ..... .*. .#\.*.... .......*...\.. . ...#....#.#
#*.#.. .# #. .. .*.  ..*###.*.#.... ....#.#... .##
#*.*.. .#*...   ..\*#.\. #...*..\ *.. #. #\.\.## #
# . ..\....#.......###..*..\#\. ...* . .....**. *#
##..*##...*.*. . . # ..#. \.... ... ...\... .\  .#
#\. ...# .##* .* .  ...*. ## . .  #..  ## * ##.\*#
#..  #.. *... #.\*... *. .. # ...# .....*  .. * .#
#  ...*#..#..#*.. ##* # ...\....**... #\ .#.*#. .#
#....  *...\.. #.# .#*. .. #. ...*  ##......##.#\#
#.\   .. .. #* ...##.##........#*..*.....# .# ..##
#.#.#... .* \.......\.##......#.#.. .\ .. ##*. *.#
#. ..  ..#..*.*.. .  # ....#*.. R.. ..*#*.* .#.*##
#.. #.*..\*..   \.#....#. . . *..#**\.. \..\.*#*##
#*...  #...\.. ...  ..  *..*. .# ..\.**.*.\....#.#
#.#.... **. ...* *. .\.#.#.  #. .##..# .#....... #
#.#\ #....#.# \ .... . . .*.\.\.#\....*... .. .* #
#...#.... #...  ......\....\. .#..#*  \. ... #..*#
#.. .  ###...... . \ . .*..* * ....\.#.# .\....\.#
#.\.........*. ..##*....    #..  .# .. .......#. #
# .....*..#..... ....  . . #. .... ...*.. \ .. .*#
##.. ..**.##*. ....*.. .. .  \. ...#... .........#
# ......**. *...#... ..*  .#...\ ...* *..\..\.. .#
#. .  ..*.... .. .. ... .. .\## . ...*#*#*..*.. .#
##.....* ...    .* . ...#...# .  #. .##.*. # #. .#
#. ..........#.......*.\.. .. \..\.*.  .... .*..##
#. .#\...\. *  *#. .## .**#**.#.*...*. # .. . ..##
# .. ......*\.. .##\ #\... ..  . \  ..# *.. #..*.#
L.#*# ...#...  #.....#.  * # * *...#  .# \.... ..#
#. . .* #..#*. .. *..\.....##*\...#. .. ..*.\....#
#*. .\. ...#..#* . . #. ...#\\ .#..*.\\ .#.. . . #
#   .\  ...#*# ...* .. #.  ... *.. . .....# . *. #
##.#\#*#....*....\ ###. *#.\... *.....#\...*.  #*#
##################################################