##################################################
#..#*\  . \#.*  .  . .. #*. \.... .* ... ..* . . #
# #.....#. .#....  ....* .\#..  \##...*#.*.\ ....#
#..\ #  ........*....#.*.... #.    # . ..\...*.. #
##.. .**.*...* ..# ..# .#..\.#\*. . .... .#. ...*#
#..\ . #......... . . .*.  ..* .  ...... .... ...#
#** . #.**..\ * ....#..*# *..#.*#.  ..#...\.*....#
# *#.... .\  ..*.......**.**... .#..#..#.. .\\.\.#
#..*.\  *.**..*  ..\\.. . # #. \*#..... ...* .. ##
#...*....*..... .... #. ... .... ...... .... .#\.#
#.*\..##........ . . .    # # . .*  .\....... *.*#
#....***.#....  .*#.. .* ...*#..#.....* *.\*    .#
#*.*....*#*.#..  ...#\.. .. # .##.\.  ..\.#.* #..#
#\.. .\..*...\*\# ...\..#  ...##. .*. .. . ...*.*#
#\....\.* \...\  .*\# ..\.. .#\..* .. .. ..\.\...#
#..  ..  .*....* ..*.*#...... ..... ..* *........#
#.. # ..#.\.  #*...\...\.. #.. ... . ..... .. .* #
#.  \ ..#  .\*  . . #  . *.. .. #.\..... .. .....#
# ...\.....* ..# . ... ... \ . . *..* ..\#*.\.*.##
#.#..#\..  ... ....\....#.* #  ...* .....*...*...#
#.......\*.#..#*..#...#.  .  *.... #.. #.........#
#....#.*. * *#*...#.#.......  \*. ....*.#.... * .#
#.\..#.\. . \...**#... ....*##   .....\ ....* .*.#
#  .# . ...........#.*.#   . ##..*..* .*.. *.. . #
## #* # ..#. \*.. .  ... ..... .. ..#. ..\*#*..*.#
#.. .\.*.*.... .. #...##. ..*#*..# .. .... * ##*.#
#... * ...*..# .*.. ..........*...#..*...#\*.....#
#.\..#.... . ..#...# # . . #.*...* .*. . .*  . ..#
#... .**..*.##\...\*... .### .. .# ...  *..*\*#.\#
#.......*  .   .*..\ ....# \.....#...#. ..*\.\..*#
# #  .. *..* .... .. . #..\#...** .\** ...**. *..#
#.#.**.#.. *...\   .#. .#...**.\ ....\.....\.*#.\#
#. #...*# ..*...# .#.. *.#...*.   ..\.*\* .#..#*.#
##.*..  ..\.*.**...*#.*..#..  .*.\ .... ..* .#.#*#
#*... .\ *... ...... #\..*...## ....... .\ **.\.*#
#.. ..... ..#. # ..... *....* \. .\.....* **... *#
#.. .* #..\.  . ...\ #\ #.*.....#.. .  ... .    .#
#.\ ........*  . .....  . *.*.## .*. * \.*.*.*. ##
#..#.* ......#..*... ...#...#.*... .... . ..\*...#
#...#*\.....#... .*.#.#.... #.*....*#.... ..*#.\\#
#... .  .....*.**..  . ..\#.. ..* .....  \ ..#. *#
#.*.#... .. ..*.....  ...*\ ....*#. ..  * ... \*.#
#*..... . #.\. .*.*.....\. ...... #...#.* ..#...*#
#R#. .....#..#* ....*....\..   *.. . *...   #. ##L
##...#. .\... ..*.*#. .....  .....*.. .*..\*.....#
#. ...*.#* .. *....*.** ..#. .#........***.. . ..#
#.#. \   . \ ... . #. #.....#  #.. *....#..\ ...##
#\*..*.#. #.#.... *  ..*... *. *.*#.#.....#.#....#
##.#..**. .*.#*#\*#....#..#. *.. ..  .#.# \.....##
##################################################