##################################################
#. #.   .*..# .\...*\. *.* .*.# ....\* .. #..#  \#
#.#... *... *... **...#. #..  ..* \\\. \.# .... .#
#...  ......*. .. *.\ .#.. .. . .#. .\* \.... ...#
# ... .. . .. .\.\.. .....*. .**...\*..**....# #.#
#\ .. ##.\#.. *\\*..........\ .#.. ..... . ##.*..#
#. .. ##..*  #\**....**#*...  . \*..# ... ...* *.#
#. .. .\.......#.. .\........ \# .. .*. . *. # ..#
##. .#\........  \. . #. .......  ..##.\.... . ..#
#  . #.. **  .#.\ . \.\..*... ..*.. .#.  . .#... #
#.\  .#...*.#.\.. ....*.. ....##...*...*..# #...*#
#\. ....* .. #.. .#.  . .\#*.#...*\..*..# ..\....#
#. .#..*.*.. *.\...... ...#  . . .. ##.. \.  ...##
##.*...... .. ....*. *... *..*. .\#... .* # ##.. #
#..**# ......  ... . .##.##.. ...  ..\ *.....*...#
#*.#**.**  #..*. ...#...#*.**..# .\\.....*...*##.#
#*...#....#.. ....* #*..#..  .\.*.#....\.\* .....#
#.  *.##*......... ..\   *.#.*\...*........##. * #
##...# ..* \...... .. ......\.#..#...*.. .. .....#
#.#..\..\*.*.*.  ... .#...#...  .\#. .. ...*.# *##
#.  ....#.#.. #*.. .....##.*........ ....##*.* ..#
#\\*.. .##\.. ..... *. ..*.....#..... ...*... ...#
# .# ..  ..#.*.*..\ #\*\ #\#.. .\. . \..\ .. .**.#
#\ . \..  .  .\ .....\.# ....\#....#  * ..... ...#
#......* \ .....#*...... .. * .   .\ ...  .... ..#
# .......*. \.\....... .. **...*# .. \..**.#.*...#
#............* ... ...  .#.*###.#......R#....\  .#
#....#.. # .. ...##.  \ #.\. .....*. #\....... ..#
#. .#.#*. . \..# *.......# .\\ .. ..**.\. .......#
##.* ..... ..  ... *.  \ *. *...# .....  ....*. .#
#. .\.....\..*.*.....#..# *..........*..\   #.. .#
# ..#..**.\ .... *...*\ .**# *. ... **.*...#.....#
#.*..**..   .... ...#..#...\.*\. .###. .## *.** ##
#\.....*... ..#...# ...#..#**.*....* .  .. .##.. #
# ..*.#.*..* # *.#.\  **#.... .\.. .....\..  *...#
#. ....\ ...*.... * .. .*\...  ##....#.* ..#*. ..#
#... * *..#\*..*......... .#....# #.#.\..#.... .*#
#....#.# #.. . ... ** ... .  ..  ..... . .. .....#
#..#.. . *.\.#*.... ...... ....\.... .*... ..**..#
#..* . ..#..**#.. ..* .*..#* .#. . .*.#\.\ ......#
##.\..... \ ....#....\.*..#. .*  .#. *.. #\..... #
#*..*....*.#... *....**.*...#*..#....#  . \#. *..#
#*. ..#.*... .... . ......\# *\.*..**.*..**..  . #
##.  .... .....\#..**.# . *....*  ..*...*....#*..#
#.*.##....#... *...#.\. .#.*..** ... .*...##\ .*.#
#.*.. \ ..\..# #*..\... ..*..#. ...#..* *# ...*. #
#... .\.... ......#..... .....* # . ...*. . .*\..L
#*.#.... **..*# ... #.\   . .. .\  ...# . ##..  .#
#  ..# #.. *.. #.#....##.*..#  . .....#\. . ... ##
##################################################