##################################################
## .   \.*.\ \*. .. *....*.#......  .....   .\.. #
#.. #\ .....**. .*.#...#.*...\...... ..\ . .*....#
#..##.#*....#.  .##....\  ...#..## #...*..*# #.#.#
#\#..* ......*. \.#.#...*..  \\ ... .\\#. .... ..#
#....* \... . ...* ..#....   .....#*.*..\ .\.....#
#.. *.##.... # .. . .#.\.#. ..# .....#*\. ....  .#
#*.*......#.. \.....\###... ..#*#*.*. .. ..  . . #
#\......#.  ....... ..  \*  ....  ...#.... \. ..\#
##.* . ... .. \\.... .*. ....*.* *.#.......\. . *#
## *.# .*#..*..\. ..\  .*..\.# ..\..*...\..   ...#
#*#*.*.#..*#..* .##*..*#.....# .. .. # ...#.*\...L
#.#..  *.#..*# .....*... ..   ..#.#*. ..  .*##. *#
#.*#   .\.. .. * \#\ #.\. .#..* #.** . ....\\..* #
#...  ....  ...... . *..#\...#*....*...**..*.*#..#
#.. ........# . #*... ...... ....\...* .*...... ##
#.#.....\... ... *  #..**.\..... # . ...... ..**.#
#  ..*. \..*.#. .***. ....#. *.. ... ..\..#\....##
#..#\... .*#.* .. *.*..#...*#.   #..**.#.. \.....#
#. .....* #.... #.#...  # ... ...\. ..#. .....*..#
#.# #..* ..... *..*#...  ..#..*...#*.#.. . *.....#
#..*..## .... ##. *...#.# ... .\ ....  #.. # \.* #
#*....#.     .. . *...#.*. .  .   ..## ..* . .   #
##.*. ...#..#\...# ...#. ...#.\..# ##..#*.\...# .#
###.....#.#... ...*. .... .... .#. \.. .*..\... .#
# #*#.... ...... #. .. .*.... .. .. ......  ...###
#......\****.#.. *.#*..#\.....   .. ..#*....#.*. #
#.......\...*#. .....#. *. #.#....*.# R....#.. *##
#.. ..  ..##*..\.#..... ..\*...  .*#. *#...... .*#
#*.... ... .*.#.*.\\..*............#**.*\. *. *#.#
#.. ..*...*. ..\  .#. ..#.. *.... . ..*...#*##.# #
#\ ..  ...  #.#. ##*.# \. ... .. .. .  *\#.......#
#.*.#..#. .. ...#. #.... *#... .....#.##.........#
#. .##. ....*.*...... .  .#.   #..\.#*#.*#....   #
# ...*..\.**.\.*#..#*.#..* .....#. #..\# #   ..*.#
#*.   *. .....#.... *.*...  ##.\..\ .#.#. *..#..*#
# . . *#.#..*..  .. . .#..* .   .  .#...#.#.. #..#
#.. \.#.  ..  ..*   .. .... ...# .#. ... \ ....*.#
#.....  .  .#.#\  *.....#...\...   *\# .. ..# ...#
#.*..*#\. #.#......*.**..  .............* . .....#
#..... ..... *.....*...*. .*\*.#... #. ..\*.#.\..#
#..#.\. .  .. * *.\. *.... *..... ..\*.. ....  . #
#*#... .....*.*. #* ....... #. * ..*..\  \. .*...#
##. .\.. .... .. #.   # ......#.* *..\*.# . #.*. #
#.\.  . *.. .... ...# .# #...#.*.# # \... .  \. .#
# ..\ .. . * *.. #  .#*#..*..\ #   .... .........#
#\..*.*  #. . .. ... ##...  ..*. . ..*..*.. .*#..#
# .... .  .#\....... ...#*#...* . ..# \#*#..*....#
#. ...#. *..*.. .  .. ......*...# * .. * .#....  #
##################################################