##################################################
#*...\....... #. #...#. #*\....**....#\.* . ..* .#
#*.*....*. ....#. ......# ..*....  ..*...  ..# #.#
#.. *...##........#\\*\.......*. . . #... ....#..#
#... ........\.#. .*.    ..*.#.. .# ....#.*#.  ..#
#*..#..  *#.## #..*... .#..*.#   .......#...  .\##
#\.. ..#.....R.*# .... .  . . ...* *.\. .# ..# ..#
# . .. * .#* . ..*.\...#....#.....#.. .*# . ...  #
# .## .  *......* .... #\ . ..* ..  .. *. #..*\\.#
#.. .*##.#......## ....*... #.. .#\.. .... #.#..##
##....\#.. . .\*.\.  *.#...##.... \ ##....*  #...#
#.. ..\.*..#\..  .. *.\. .#...... ...*# #..\ *.. #
#*#.#...* .. .\... *   \\.......* #..*...#.#..#* #
#.. .**.. ...#. #......## **....#.... ....#*...* #
#.*.  .. .....  #.*\*..*...## **.\.....  .*..\.# #
# * .##...* *. . \ ...* .**.#.......... #  #..  .#
#...........*. ... .....  ..* . . .. *... .#..\. #
#*.##*... ...# .\......\. .....#..\.\.* ...\ # ..#
#..\..*.#\... ..*... \.#.... .. * ..* ..#  #..\ .#
#* .\.# #.......\.......#.... .. .....* ..*.. . .#
#.\.* .\..*\ #.....*.*#.... ...## ...*. *..*.....#
#...\.....*.   ..\#. . ...* ..* .#\ .. ....... . #
#*.... . #. .*#. ..........  ....* ..# .. * \. .\#
#.#  .....* ##  .. #........  ...*.....#... .... #
# .*.**..*...#..... #...... .. #.\...*.. #.#*#.* #
# .#.  ...    .   \..*. . ..\.. ....*....\....\ .#
#.## *...\....\.# . *\... .#....#*. *  \.......#.#
#*#* .** . .#\....*.. . ....  #..# .\ ...... ##..#
#... #.. .   *..*..#. . .#..\*.#... . .... . *.*.#
#.#....   .*. **.#.#.. #. \..##...\.. ..#. .  ...#
#. ....\. .. .#*.. .#....#**\...*... *\#*...\. # #
#\..*  **. #.#.....* .... * ....##\......# .#. . #
#..**..##.#. #..\.*#*.. .**.. ........*..... \. .#
#.# .#*.#.#*....#.*.....*...*..# .. .  ..... #.*\#
# .* ...#\.... .. \* *#. ..*...*. ...* .#.\.#..#.#
#*# .#\. *#\......\ ##*....#\.. .**# ..*\.*.....##
##.*  .*\..... . *... . .. #* ...  ...#\*\...... #
# .. ...#*#.. .   ..#. . #..*\...*..*.*.\..\  *. #
#.. **.#  ..  . .#.#.*........ *...\ . ..*.   ...#
#*#. .\.. ....\....##...\. .#\#..**...   ... ..#*#
#. . \ .... ..#....\...... ..*..#...  .... .\....#
#.. \##\. ..#...##.\#..##  ...... \.#. .* ..... .#
# .\*.  \......... ..\.   ..##. .####*#*. \... \.#
# ##.... .#.*...#.....\ *.... ...\**..* ..*  # ..#
#....*..* ... .**\.. ..**.... . \ ....# \..\.  . #
#. .. ......#...# . ... . ..*..* *.........#...*.#
#. ......*#. \*..... .\\ . .....#.*  *#..... #...#
#.. ..\. . ......# .....##.*. ..*..... **....  #*#
##\. \#. \*  ...... . ... * ....*...#..** . .  * #
####L#############################################