##################################################
#..\..#. . ..\.  ........* .\..  .#.#.*...*....#.#
# ...*....#...#*.#\.#.*  ..* .** .. .*.. * ......#
#*#..\ . .... . ..*. #. ..#. ..#.. .#*  .*..#.. .#
# .. .....#......# .#\ ..*\...\*#... #. \#. ... .#
#.. ...  .*..... ...\..  ..\.*.#. . *...#.... #.\#
#..  ..... ...\\.\....*\..\... ..# ..*. .*.   \\.#
#...  ....*....*.*.*.*.. .... * ..\\..* ....*#...#
#.  ....\.. . ..\..\.* ...\.*.#...#. .*##......#*#
# # ... .** ..... .... .... .....  *. **#*..*. * #
#. *#..R.... .* .   ##.**..   #.*..\.*....... *. #
#.  ...# .#..  ......##..#..... .*. .* ... ..*. ##
#\. ....\...#..* .  ##.\... * ..    ..*.*. .*##..#
#.. .....*...*.. . ....*.*....... . #*.# .# ... ##
#** *#* ..*.. .. \*.**. \ #.\#....  .. ..........#
#....*... . #..\#.*   .\# #. ...#\ #..*#... \\ ..#
# ..# . .   .#...# ......  . . ... .*.#... ..*.#.#
#\*.................... . ......*#... ...***  ## #
#... *.*\  ..*..   . *.#.*..**......#.......#\. .#
#.#...  ...*\ ...#..## .*   .. ...... . *.. . .#*#
# .# #.*.#. ......#.  .\*#.... ....*..#..#..#... #
#..#. .. .*#. ..#..**  # ...  * . .. \#.. .... ..#
#.. .........*... # ..\#.\#..#....#.*. ... ..*...#
#...... ....\* ....\\ \ #*.**. ...\#..  * .**\..*#
#.. *..#.... .\\....\.#*#..** .*. ...#*# #..*. ..#
#...#.*.. \......  .. .*....#. ....**  ..#\ .##..#
#...\...**. .*. ....\.\.....* *\##.# .*.*.. ....\#
# .* .#...*.\#. \.#.. \.......*  \\... ......*...#
#..*..#\.*\* # .#...#..# *.. .**\\...*. .\  .** .#
#**##...  #. .. *#.. .* . #**....\...*...#.\.... #
#. #.*\ .*. .*.* ..* ..\ .. ... *...... . ..#  #.#
#.*....**. .#.# ... ... ... *.. .#.\ . .....*** .#
#.*.. ... ... ...\#..... *#. \.\#*....# . ..*  ..#
#*#.* .. .. .... *# ..#...*#. ....#.*..*  ..#..\*#
#*.# **#\*.# .. *.... #.. ..#      ...#  ....\ ..#
#...# #. ..#  ...*...#\. #\*......\#**..# ...*#.##
#..#.. \.. . .. .# .*...#.#.....#....#.\ #*. .#..#
#\....#...** .  ..###............* #..... **.## .#
#.  .\* ..#*#.  ...#*. .... .....#..*.\ .#.#..* .#
# **...\...###  . #*\*\      ..*#  . .\#\#...* ..#
#.... \.... ....#.. *... ....#.*.\. ...* .\**.. .#
#.... ....\...\.. .. ... ........ #.#\*#.. . ....#
# ... .#.. *..*.  #. #.. ..#...#*.#*.\  *. . ..  #
#...## . .. . ...#.#*....#  .*...\...  ... . \ . #
#. .#\.#.\..\*.#... \ #.. *.........* .\ ...  ..\#
#..#.\.. . ..#.*.*   . .#. *.. ..*... .....#.*. .#
#\.. .....#* #..... #.*.......\\.*#...#.......# .#
# .#.#.....*# .. *#..\  ............ ....  .#...##
#. .. .\....\\.***. .#....*..\..*#.#..\#.........#
########################L#########################