##################################################
#...#..#*.*. . .\ ...*....... .#..*.# .. .. .\*..#
## ###\. * .. *..... . ...  ... .......\ .  .##. #
##  ..*.......*.*...#.#.##.\.#.*..#..*#.\.##.... #
#.....\.. ...*. #...  ....*.\. .....\.. *  #  ...#
#.. .#....# ..\* \ ..\.......   .  .\#**....*. ..#
###..... #..*#.....*... .....#* ....... .#.. .\#\#
#..\.#*..**...*.. ... ..  .\. ...#*\  ...#.\.#. .#
# \ #*....  *..... ..#.\. ..# \#.... .##.#. .. .##
#....*#..... . .*.*. *. .**..***#..**. .*#.* .# .#
#.### .#*##.*.*\* #.... .. ..... . \ .#.* #\*# ..#
#.....#.#.  ....... . *........  ...   .   *.....#
#\ .\...... .... ..\....#*...#..\.#*#.#. .....*.*#
#..... ...\*#.... #* .*...* . ...#.* #.**.....*..#
##  ...   ...\.  ...  ....  ..*..*.#.*#.#...#**.\#
#....#........... .. ..*.#* ..... #......\. .*#..#
#.  .   .\ .#...*#*.  *...#.. .*..*...#\ ... ....#
#..##.....*.... .*...#..* ..*..# #...\ \. .. .. ##
#... . ..**#. ..\.##...#.. ... ...# ..* . *#.. ..#
#* .# ..#... .#.... ...\........*.*..* .*.. .#. .#
#*#...* .#....# \*.. ...##.**\. ...#. #.*..#..#  #
#.  ..*.. * .**#.\ .# .*.  # .. .**... ....\. ...#
# \ ..#\#  ........ #.#..\...\.#..#. . .R*#. . *.#
#.# .  .\*.*\...    ...*... \. . . .* *.........##
#.. ..*..#\\*.....\....\\. . .*....\\.\\*#**#  . #
#*.. *  ... \ #..\. \.\.. .*.*.*  .. ..# ..*. .\.#
# \ *..#.**. \.*#..# . ...**# .*. .#\.....*...\* #
#..#.*...*#****....#.#. #.*....... .. #.#* .  ...#
# . \ ..*. *..\. .\. . ..\#. \ ...* #..  ....*.*.#
#....\.#. *...\....#.... # **\.# \..#.#..  ..#. .#
#..*.......... . ... ..\ ...*.*\.\ .#.#.* ...*.#*#
#  .. *...# ......*.\ #.......*.\.** .#...#.*. ..#
#.* *#....#.. ...............\*.#  .# #*.##\.....#
# .#...*#.#...*.*.*... ....\.*........ #....*.#..#
#... *...#..*#..#.\ .\#*..    . . .*..   .*\#...\#
#.... ..*........*. ..*.......*. . .*..  ...\.*  #
#.. .**. ..##.* * #. .*..## .\..*.*..*#...#.\.. .#
#. ..*......* . ... ...##.**   # ....## . .  ...##
#.... ......#. .  *..# \..\*.. .###\...*. *..*...#
# #.  ... .....#. .  . *.*..#.......#  ..  .\*.. #
#. .  .*.####......#..... ...#..  .*. . ....\. . #
#* **.... ......  .   .... .... #.\ .*.\.. ... . #
# ... #.. *..*#..*#.*.  * ..*.#..*..#.#... .. ..*#
#... .* . ...# \. . . ..*.#..\\..#..#\.*.*. .   \#
#  ... #...*... .#*  \#..  #..... \...#...  .\.#*#
#.. .\.* .......*..*..  ....\..... ..# .\#... .\.#
#. *..   .\.*...*.\ .#. #..* . #.#.....*.\#*....*#
#\.#... ..* . *.  . .*. \. . .. . ..... ....# ...#
#.* .# \ *\# . ..# .....*. ... .#\. \... # #\..*.#
####################################L#############