####L#############################################
#..###* ... .*.#. * .*# .#.*..*..... \. . ... ..\#
#   .#\   #...#.. ..*........*  *.  .*..***..  #.#
# ......#*..  *.*\. .#..... \.. #* **...*.....##.#
#. ......  # ..  #..****.\ ## .#.*... ....  .**.##
#.. *...*...\... . **...*\#......**  .\#.*.... *.#
# *#.. ... .# ..*.#.. ...##\  \...* ..#..**.. ...#
##*\*...*.....*** #.. ...\. *. .#.\ *.#..... ..\ #
#..*.....#.. . ..# .** ........#### . *....**.#.*#
# ...#... ..  #... ....#.. *...   ....\....*\#.*.#
##\. .#\*...# ...# #....  ... *.\ . .#*  ..*..*..#
#\ . .*..##.#.** ..#.... .*..# .. *. ..\ #..\..*.#
#. .... . . .  ....#*....  ...\#..*##..# \..#. . #
# .## .....#..\ .*.#. *#. .\.#*. . .  .#..#...*#.#
#...#...*. #....\.. . .*.\*# .\..*..*...\\.......#
#*#*# .... *. ..*.....\.   #\..\ \.  # .#.*...  ##
#. ....  *\*# ...\. ..\#... .*  #  ...*.  .. \.. #
##** ...# ..... . ..*.. #. ..\...** . .#*...**.. #
#.# .*....* *...*...**..*. \. ..*. . *.#.. ....#.#
#  .\\. #.   .  ..*#. ...* ...#. \  ..#\#..#*.\..#
#.\***#* #\.**. ##...* ... ... .*...# ..\. *.\ #.#
# .... ....  *. .*.....* ##*.* .... .##.#*. \*..*#
#.* *#...... ...*.*.\.*. ..*\...##....  #..\.  ..#
# **....*. . ..##..  ..*\...\....* ##* .*. .\*.#.#
#*\. ...*...\.#....  ## .. . .## *.*...*\**#.* .\#
#....... #\ .\.. ....*.... .  ... ##.. .....\#..##
#.....\. **..* #..#..#..\. ...... . .\ . ...  .  #
#\. *..## \..... ...* . .*...\.\.  ..*.... . .# .#
# .... ......# .# ......* .. .  # ..... ...* .*#.#
#..*. . ... \. .. **#..#...#.#.#  .... \..*   ...#
#..#....#* . *    .. #. *...#. ..# ......*.......#
#................*.\.. #.*.  *.#.#.# *.\#......*.#
#*..*.\............... ...... ..  ..#.#..#..*..#.#
## .  . ... *. .....  .......... **.#  .*..\.*...#
#.\.#.. #.*... .. .*......*\..* ..*..*.. *... \..#
#..#...*.*...#... ...\....*  .  . ....  .#**...#.#
##.. .   *. .. .... ...*........ \.. .*... #\..#.#
#...... .** .#..# ........# #*..#...     .......##
# \## **\#..\..  *\#\. ...    * * .#   ..  ...**.#
#\.. ..*  *.*.  ... . #.. ..... ..*.......*.. .*.#
#.. .#... ..#...**...... . ..\.. .. #. .*.*.#*   #
#.. .   .....  .....\#   *... . #.  .#  ..   ....#
#.#.......# #...# ...**R . .#. .... ..\ ... .*...#
#...*.*.*.  . **. ..## #  .#.#....*..\ * ..*.... #
##.\... ...\...#.*..* .# ..  .. ..*..*..*#.  ..# #
#.* #.. .. *..... ...  . #.* \#......  .... .. .\#
#.. .*.........#*...# *. **..  .. . \.......... ##
#*. .  ....*.#  * . .# # .#.\ \.... . .*. .. \.#*#
#..  .... .  *...*.#... .. ..........\# #.  * .. #
##################################################