#############################L####################
##...*...* .*## . #.  ..* #\ ......#  .#\... .* \#
#*..*.. .# . ......   .#.*\... \.....#. .#**.\*..#
#..##.#\..  * . *.\.*# ..*..* * *........ ... .*.#
#.#*.*.\. ..#..#...**. \...\.\..***##...  *......#
#..#. ....  ##  # *...... ..\.. \# * . ..... ... #
#. . ..##. \.# * ##*.. .#.*.........  ..  ....*..#
#.*. ..\ #.  *... *   *.. *..#. . . ....#**...#\*#
###.*.\...  .*.#\ .....#*.* ...#.  .....#.  *. .*#
#......# ** .\  ...*. ...... . *#.. ..# #  .#. . #
#...\.........\*.*. #....# .#..*.*. ...... #..*. #
## .#... .#.... #\.##.. *. #* .. **...# .\.*. ..*#
###.....# ..# .#  ....* ..... \.#*#...# ....  ...#
#.*..... .   *.*...#\.\.... *....#.  #* . #.#....#
#..# .*.. ...... *.. . ..*\..#.. ..*.... .. .\...#
#  ..*  ..#. .#. .......#\... ...*.......*..*\*.*#
#  *. #.... \.*#   \*.# ...#\. ..*.... *...*...* #
#\. .. \*... \. ...#..#  ..  ##  ...* .**....... #
#  .*.#\... . *##....... #......*....   ..* . ...#
# . .....#.  ....*. .*....\... ..\..... #...\ *#*#
#...  .*...#.. ..#...#\..#..\*..*.#  \. ..#*.. . #
#*  ....* ..***..#..##.#*...*.*#* .. ..#*.    #. #
#.#.. #...*. *.**.....* .\ *#.....# .  .#....... #
#.#..  .... .......*.# *# ..* #  ....## #..  .*.##
#...#.#. ..*..#**..\ .. .. * *  ..\....*.. * .*..#
#   . ..#.*..*. **.#. *... *.* .. .. .*.\... ....#
#..# . ...... ..# .*....# .......*. .#*..# .#..#*#
# .... ... . ..* *..*# \.*.... *\.... .# *..\.*# #
#**#...#. ...\ ......#*.#*  .* . *.. #..\ #*#. . #
#.....** .  .......*....** ..\...*...\.#*.*... . #
# ....... . *.  ....\. ..# ....*.*.....##*#\##.*.#
#.#.*\..* ..##....# . .. #*.\ #.. .*... #...\\...#
#* \... .* ... ..*......*.........#... ##.  # . .#
# \..  .#.#..... *. .* .. ....*... .... \*..... .#
#*....*....#.*..##.. .  .\.\....... .#. #. **..#.#
#...\...#.. ..\..\. \.#.....*...#............ # .#
# ..  . .#...* ...*#.#.. .. .* *. ..  **  ..\.*..#
#.*#.*. #R*.. ..*#.  ... *...*. * ... #.\..#  .#.#
#.### ..**#.*. *  ...* ....##....*.*... .*#......#
#.\.....\.. .*.*....#... .*..... *#.............##
#.. #.*\... ... .........* ## *....#....#*..  ..\#
#*..*.*. .....#*..\ #..    . .*..#.*# .. * . .#..#
#.. .  ...*... .*.. .  ...  ..#  *....#*.*.. ...*#
#*.\* . . .. .\.\.... .....*.\#.....\. **.\#*.*.\#
#. ..... # . . #..\ ......... .#..  .#... .* # ..#
#\* . ..#......*.\.* . .*..... .  #.....  .\.....#
#   ...##......#....\#..#...#*. \.. ...\ ..*...\.#
#*.#  *\#..#.  .#  ..##..  .#... ..... #.*.*#*...#
#....#. .\. .\*.##...    ..\.. ...# *#..**.*..\..#
##################################################