##################################################
#  . * ......\#. *.*  .. \ .....#...#  *..#...##.#
#. **.....*.#...*  ..# . #. ..#..  \. .....*.***.#
#. ##...*##  \..#.... ... .. .. .. *#..  .##.....#
# \\ #..*  \** ..... *# ..\ ..... .#*.\. ..#..  .#
#.#...#...*..\...* .*....*.*..#...... .*. *\  ...#
#*\ ..#*....*.. # .. . *.##.. #..*#*.... .....\  #
#...... . ... ...*.  ..# .... #.......*....*.....#
#.*.....\.* ... *#\..*# .\...*.*.##..#*...# *.* *#
#....  .\ #..#. ...# #... # . #*  ...\... **. .. #
##. . \ *...\...... .*.*......#.. . . . .#..\.\#*#
#. * .\... ....*.* . .#.*.#.#. .*.#    ..\*#  ...#
#  .. .... *.**##  ......#..\.*..\##. * *.\.#   .#
## .#..*\#.#..\#... .#.#..\... \. . .* ...\. ....#
#  ...**. ..#...# .. *\...*\ \... #.*.*..*...*.# #
#....* . \...*....*. . .#.......   .#.. #.*..*...#
#..  . ... ... .. . # .  .##..\.#.  ..  .\.......#
#. ....*. #  . .. .. .*....# #. . *.*...#. *\#...#
#... *  *.*.*..#.. \#*.#....... . #\.#\.\. ...#.##
# ...\.  . .*\*...... ##\.# .......  ...#. .#..#.#
#.\..#....**\....#*.....#..\#...*  . #.*\..*.... #
#*. ... ..... ..**  . . . \.  ...*...*....*\..*..#
#*  * *   .. .  ..#....\...*.. * .#.#..#.# #..\. #
#..*. ......\....  *#.. * .  ..... . .....  *. .*#
# #.#. \......*.....*. ...*#  . *#.  #. *..\  .. #
#*. .\. ...**.  ..\. .*.\ \*.*.....\.  . .....  .#
#*...*. #.\.. .*... ...\*. .. ..#.#.  .*.*.......#
#.#..*..#. ..... ... .. ....** *...... .. .\...**#
#*.*..*. ..\..... \..\.*.  ** ... ......\.  ...\.#
##...***.\#.\. .\ #.... . .\. ..*.. #*. .  .. **\L
#  *.\...\  ...##..#. ..... #...*.  *R . . *.. . #
# .#* #\.# ....\\.*. *  \..#...  ...\ .\ . #\*.. #
##.. .. *..#..#.....\. * . ... *. .  .\...\ .##..#
#.. \#... \.#...\...**...#.\...*.    ... . ..#.#.#
#......**.# ...*** ..   . ...  .#.#... .# **.\ .##
#..#..*..*....\ ....\ ..*.....#   *...*. .. .....#
#*\#. #\#.*..*\#.. .*# ...*..*. *.*.........#..#.#
#....#\##.*.  ....#..  .#..*  .......*...#  ..#..#
#.#..#..  ... . ..*.. ....#..#.#..#..\  . ...\...#
#.\* ..# ..... \ ..*.. \#... .*#  ..# ..*...* **.#
#.*.## . #.......  .. ..#. .... . . *. ......* \ #
#\  ... .. .. .#....*..  . .#..... .#.*  *. .#\ ##
#\..#....#...#..\  ..#  *. . *... ...*..\ * . .. #
#*. *#. ... .* . \...*..##..#...\ .... ..**....\.#
#.*. ... *...#.*..*\. \#...*. .#.....* ..#*... # #
#*.*.. . .\. .#.*..  .... .#... #...#*..... . .###
##*.#.\*. ...# \. .* . ..**..#* #... # \. \.\...##
#.. ..#*#* #.    . ...*. ..    ......* .. ....\..#
#.#.   . **.*.#  \.#...*. . . ....# ..* \#.*..** #
##################################################