###########L######################################
# .........* .... ##*#.\.*  *\...\......  ..*...*#
#..* ... *..\.. .\ *. .*  *.. ... * ...... ....#.#
#. ..*\......#  ...  .***#. \....#..  ... .\.##.*#
#.  ....  #*\.\. .  #.\..  * *.  . . .. ..  .....#
#.......*...** ....#..\*.**. ....\. \  .  ..#....#
# ..... .\\.  #  . #...#.... **....# ......#   # #
#.... *.# .. ...........#. *. . \..##.....*....*.#
#.#..\. #. ..#...#.. .\**..##.*.... . .#\.#. . ..#
#.. ....* #\ .*..**\ *..#... ... ...... .#  \.. .#
# ..*...... #*....*..#..\.\...#. \ ..    . \*.. .#
#....\.# ..*.. .* ...*...**....... .#\.*.#\..*#\*#
##.*.*..*.*.* . **##. #*... ..\ .*.#....*....... #
#......#. ....#*#.\ \ . ....  .. #.#*..#..##...###
#..**# .\#*..*  .  .....*....\..... .*.*\.\..# ..#
#   #.**.*..\# \*...*..\..  *.*..#.#..\... #.#*  #
# \# *#. *... ..\..*..\*...   ..*.........  *.*..#
#...\#\.\ .#. \..   \. #*.....#.  * . .. .* .#...#
#*\.  .#...\....##.*.#. \\.........#.... ...R.  .#
#.#.. ....#....# \\.#*.#........\....**....*. .. #
#.* .#..# #. \.*\.. #*.*.... ..\..\..\  .\....*..#
#....*.. .\......*..*   .. ..  #.......#.##.. .  #
#. #. ..#. .....\.**.#..#. . .. ....*#...#. \##..#
#....*.. ...#..#..\...  .* ....#*..... .\.. ....\#
##.  \.#. .#...*..#.\*..#*#.....*...*.......  .\*#
#.*.*.\# .\.....*#*........ .#. ..**..##.....*.# #
# .#......\ #...#. ...*.. .   .\.. .##.\.*..... .#
#\...... ..* #** .   ... *.#. *#... ..... #. \ ..#
#. .##.*....  #.*..#..   ....\\*.... .\.#..#*..*.#
#...*....**. #...#... .....  ## .... ##\ ... . . #
#... ..  .... ... #.....\#*# ..#*#.\ * .. \\..*..#
#.....  .#. *....#...#....... ..#...*.  .*. .#..##
# .  . .#......  ...*.#. .  .*# . ..*#. * \.#.#**#
#.#.. ...\.#.. #.. *#... .#\ *  ... \####. *. *..#
#.*.  ...#. .*.# #...*...  \.. #..#...#. ........#
##.\..\.  .#.#.. .*...*...*..... *    .#*.#. *...#
#.# ..\..*.** * .*\..  #..*.\.. .........*  ..#.##
#.#* .... .. .*..  .\  ...*\.*\.. ...*. ...*..  .#
# *....\...........\. ..#..#.#.. .*..#.. .*. ..*.#
#.\... #..#*#...*..\....#.# . ..\.#.. ...* ..*..##
#.  *.#.#.*... ....# . ..  ..*...#...*.. #.*#....#
#. **..   ...\. \*..... # .## ..\#. ... ..#......#
#..... .# *#  .*.\ ..\...... . #* .** ..#...\..#.#
#  .. . #.#\*.....\.... **.. ...*....#....#.  . .#
#...  ...*.*..\* #. .....\ # .\ . ..#.... \..*# .#
#.#.. \*.....#. .\ .* .#. .\#. .. .*. #...*..# ..#
#.. * .. .**.** #.... *.\#. *  *.\....#*...#  .\##
##......#.. .. .#. *.\***..*... . ....*.#.**\ ...#
#.\..#.  ..... .\..... ..*.. .... .#. . #.  . . .#
##################################################