##################################################
# ..* .#*. .*...#..*.\.\\  **##.. *. ..#. **.. .*#
#..\#.. ...#  ***##.\#.#*\ . .. ...*.. ...* . ...#
#...\. *..#...*.#.....*.... .*...\.....**....... #
#..  .. *. ....*.. ...#. ..*... ** *\#.*..##...  #
#.. .* .....##..##. ##  .# .. #.*..##* . .. .. .R#
#.# . #.*\\.\.. #* .#\.. #...#*. \.. *.#* ..*..#.#
# .* .\  ...   ..#.#..*..#.#....* \. .. .   *.# .#
#.. #.....#*. ..  #..* ....\#..# .... .  #\...#\.#
#**  ......\. ....\..## .. ..... .... *.... #.\..#
#.......  * .... \* \*. * .#*  .. ..\ .\. * ....##
#.....#.# ..  .\#.... .\*\# ..\...... . ..*... \##
#.\.#.............*......\.. *#.#..\ .......  *. #
#....*..  ...* .#*\. . . \  .*.     . ..# *  ....#
#\.... *. ..*\...# ...*..\...\.\  ##...\.. ... #.#
#...\\..\... * \# . *  #*. #.#. . .. .*.\.....  .#
# *#..*. .  . ..*..#**...\..... ...  ..\. .... ..#
#......#.   .   ..... .#....# ... ...\..\..#. *.*#
#\......  .#........ .. .. *. #.*.*.* #\. .#..*..#
#....... *. * ... .  .... . \ ..........*.*#...  #
#.# #\#*#..#.#......#...    .  . ..#.# .\. \\....#
# . .. ...  .*... #....\.\#..*.. . .* ..##..... .#
#* ...##.... ...*#... . *  .* .. .....\ #... ....#
#.. *. \\. ..\.. ..\....   . **..... ..#.....##..#
#.*. *. ......#..**..\..........**.   *..\*..#\\##
#.\..*.. . . ...   ..  .*... *.\........#    .*..#
#. \.. #. #.. **#.. .\..#.# .....\.\ #.    \ #...#
#..#*# \.*#.#*  .#..#. #  .*....*..**#.#  . ...#.#
#..\.. .. * *.#... . ....#..*..*#. #... ..\......#
# ..#... . . . ....* ......... .#.. .. . *...*\..#
#**....\... *......*... *..  .#..*..  .\.**....*.#
# #... ....#* . **.#.....** ... . \.*.*..#  ..#..#
# .#. .*. .*.\. \...#..*.\*.. ..*#..* . #....*. .#
#* #*. #.* .... \ #..... ..\#.* .*..*. .* .*\*. *#
L#* *.. .. .. . .......#\ *# ... *..\ .*\#. #   .#
#....      #...*..  # .*\ .   .#.  .... #\.*.....#
# ......*.* * *...*.. .....\.*..\#**......*. \ . #
#..  . \#*#* .*... #. \..... *\.#   .### ..* ... #
#**....*.\.\..#....#.....\..*.\.*..* # # .... .###
#.## .    ....... *.#.*... *.. .# ...............#
#..##..*. ... .....#*. .. ............# #** ..\#.#
#......\......*. . .\..#.......    .*..... ......#
#*......#..#*.#... ....* #.##.#*.... . .* .\#.. .#
#. #. .\..... ....*... ..#..... ...*.  . ##  ..\.#
#..#... ..... #*#..*. .#..# #.. .* . \#.... .  ..#
# \.# ....*...  .*........#. ....\*  #..#* .*..*.#
#\..... .. ....  *\#. ....#   ... . . ....\ .... #
#*# ...#.......*.## #.*  .. ....*.*.\.. \*......##
#.*    ....#\#...\...  .... . .. . * * *.. ....#\#
##################################################