##################################################
#...... .*  .# ... .*...**..*.* .......\#..... . #
#. * #. . .... .#####*.. ...... *.#...#.. *. ..###
#..  .#...#...... #......\.#  .  ..... . .   .\.*#
# .. .\#.. ....# #.. \. *. .  .# . .*.*... .#...*#
#..*.....\ . # .\.. .#.. . \. #.... .#...*.. .*#.#
#.....\.\*... .......***.\..... #. .*.  . #....#.#
##*##. . ...\.. \.##\. #......*...* . *.. *..#\.##
#.  .*. #.#. \ ...... . ** ....  . #.. ..#. . #*.#
#. ... ... . .. ..*... \.. # *.. .**.*  . .*.. ..#
#*.. . *..#. *..**..  *.  ..*...**.#...*.#.#*...*#
#...#.....*..#...... .  ..  .#..  .......\##*.#.*#
#. . *# .. #...... .*.*.\..# .. .*\#. ...#*...  \#
#.#... *...\.#  ..  #..   .**.*............... ..#
#..  ....* . ...*. .....  \.  ...  .... *..  # # #
#.. ..... *..     ..**..\#..  .*  #....... .... .#
#*.....* # ... *.#..\... #.\\ .  ...... *.. ..#. #
#....#. .# ...*..... ... .\..#.*. # .# ... ..*. .#
# #...*\.* .*.#.... ....  #.....*. \\.\....\..#. #
#.... #. .#** *. . \ ..... ..#. . # .\.. ..*  ...#
#.\ ............*.*....   .. #.. .**. .... ....*.#
#.#.. ..*.#\..  *. .\#*..\*. #.#.\.#. \... . ..\##
#...#....# ** *.* *#..#.\*.... * ......*..#* .  .#
#..\\....\...\.... ..... .\. ..   .\.. # ....#.\.#
#*.\#.  #... .....\. .#*...#.\ ..R#  .... ..... .#
#.  . *.\.\#..**.##\........... # . *. \ . \ .#*.L
#   . .#..  .*..#.   ...#..*..*....*... *.... ...#
#.... ...\..# **..  # .... ...#... ...   . . # ..#
# .\.. .* .###........    ..* .   .*.. \\ .. *...#
#...*.....  *   \.*.\\....... . .#\. ..* .... ..##
# .**.#.. .\  ... . .*.. #. . ..#..#\# \*..\#*.. #
#\... .. \*..... .... ....#..\.##.. ...*.. #.. *.#
#. ... ..*.**..*......#...*...#....**....  .*\...#
#. . ...#.  \.*.#..\   # ..... .... *# *.#** ....#
#\# . .  \ ... ...\.\ .#... .....  ..\# *........#
# . .. .*. ....# *.#.\ \#*  .....#. .# * . ..  ..#
#  ..\ *.\ ....# \.*.*.....#.**\*..# .*.... . ...#
####...... .....#.. .\. \. ......# ... .......# ##
# ....#. ... *  ...# .*. #...#.\ \ \. . .##. \#. #
#....\....  ......# .*#..**.\..*..**..* #..#.  ..#
#. *\.#..*....#\.#...*...\*#.*... ..*.#  #... ..##
#.* .#.........#.. .*\ ....## . .  **  ...* *..#.#
#.*.  *.... . ....\ ...##....*.*.. *..*#.. . .#.##
## #..#.#*...#. \.. .....#....#.\#   .#  .. .....#
#\.....  .  .\ .* # .*. ..#.\*  .*..*. .# .\.....#
#.#.. ..* .*...*. # . .\.... \...  #.**\ #. .* #.#
#..*... .....*.*.##\** . . ..* ...\ .\ *.....*...#
##. .\...# . ...*......*.#*.. .. ...\....# ..*...#
#.*.  #...  .  ..*.*#.  \**.**.#*.*. ..........###
##################################################