##################################################
#.\...#.*\ ......*.  \#.. ..\**.#.....*.......\ .#
#  .#... #.*.#*....#.*...*.*. ....\##.**.. ..  #*#
#.... .\..*.....#.. .\ .. ...  ...**...* ....#.* #
#.. .*...*#. ..* . #. .*.*...\#.. \..#\..*.#....*#
#*.#*. .#...\...#*  .#*..* ...*...* .#.#....*# . #
#....*..\..... *.*. ....*.#.*. **..  *. # **#.*. #
#. ...\.*\.\....#\#.... . . #..\*...\... #.\..**.#
#* ....#.*.*.. .#\***. ..\. # .. #..#.. ..\.#* .##
#. *.. .#.. ....\.\.* .   . **..... ##. .........#
# \\. ...   ..#*.*.#.** .   . ......\.*#. #*.. # #
#. .  *\ ...  ...\.*# #*\. ... .. . ... .....\  *#
# ..  *#.#....\.##.*.... ....\ .. .*\.  ..# .. * #
#..... .* #*#.  ... . ....\#..*. *..... .... *\* #
# #...\.#.. . . . . *..#..*.....*..  .*..#. \ . .#
# * ..   #\#..*#.......  *#..**.\*...\. .\**#.*..#
#....*.## .# ..  . ... ... #...\...#*. .  .# ....#
# ..## ...*. ......\..#. #.*. #.... \. .*\\ .. # #
#...#.## ...  .#*.... . .#*.*#.** . \....  ...*..#
# ...##*....  . ....*..   ..* .#.. ...*#*\#.#* ..#
#*. .#.*.*..\.   ** #..\. .  *#...  ...*.  ...\# #
# ##...... . ..#   ... #.. .. #. .. #*#.*  .#  .\#
#  **..... ....#**. .....#....* *.*.. ... *..... #
#**** \\..\ # . *..\. . .#...  .#.#...##.#.......#
#.....*.**... ...\** #.#..*.. .*.# *.. *. ....##.#
# .# . *..#........# ... .....#\.  .   .#*.. #.*.#
##...#.\#\   ...\\..\.... *.\\*.*.*....#.\. ...*.#
#.  .\ *.* #.....*....*R \.. *..... .. ...  ..#..#
#.#...#. \.. ..  *.*...#.*......# *...*.....##. .#
#.* ##....#...  . * . * #.. #...#....*.. ........#
#.......#.. *...\...\.......#.. . #..  .. #..# .##
#\.. #......#. ...** \#....* ......*.... . .. ...#
L....*.\.\ ..# .\..#*. ****.# .....#.* * ..#..\.##
#   ...#..#.# ... *  .\ .... # *#..#.  ..**.....##
#. #.# #**.#  ...*.........\.#\\.\... ...  # ...\#
#.. .*..\*  .. #\ \..#..*. *. .*.. ..#...*...#* .#
###.#  ..#.\ *# *.#.*..#..... # .*.#.*  ##.#.. ..#
#..* * ..## ..##. ..  ..*. ......\ .. .. .  .....#
#.  ... *.\*  .. #*  ...*...#*  ......*.  . *.. *#
#. .*....  # . * .**.**.  *...\..   .. .. .#..\..#
#.  *#\.# ... #....*#   ..**.#***.. ..\#........*#
#..# . . ........ . .* .. \..*#.  ...\..*..  ... #
# **.# * .....#.*#...*. .....#* #*....*#*.**.. .\#
#* ..#.. .....#.\.#  ....#.....\\.\. *....... . .#
#.#.. \##. ........#..  . . .... .*.#\...*. \*...#
#.* ..#..   #*..#.\..*...#...*..# ..*.  ... #....#
###. #..#. . ...#....#.....  ... .\...\ * \*##...#
#.. ... .. .#. # .\.*#.... .#....*. \.*..*. ..*..#
# #*.#... # .\# ...\ ...... ...#..... ..*. ..\#. #
##################################################