##################################################
#..#..........* ...\.#...* ..#. * \. .....#..\.\ #
#*.##*....... * .*.#..*...\...#. ..*.*......*... #
#*..   ... #.#...*.  \ .  .  *..##...* *.*.#.*...#
#. ... . . . . .\..*... ..# .\.\.. ***.....   ..*#
#  .  . .. * .*....#  ..#.#............. # ..\ *.#
#....*..* \# ..* . ..*. ..*.*. ... **. *...*\*.\*#
#...  .....\. .*   .*.#\.....*  .\......#*. *\#* #
###..*#\. ..*** #..#*.....\ *...*...   .. \. . ..#
#.  . *....    .....# .#.... .*...*....... .#.*#.#
#. .\.\.\......* ..#... *..... *\#....  .. .. . .#
#....... *.. .  #.##.. .....#..*#....#.\*..* ....#
#*..*...#.. **.#...#... #* . ## ..#  .. ...... * #
#.. .. ...#.#  . .......##........#.... \*...  ###
# ..* ....# . .. *... ... .\ #  ... .......#.. #.#
##***....... ...*.. . .. . ..*.#.. ..\.# \.#  \ .#
#...... .  .   .. . #...#.*#.*  * ....* . ..*..  #
#...*.. .#\..*..\. ..###.. .\.*#...*....#...# ..*#
# *. ... ..#\ .  .*.* .....#.*..\..... . . ......#
#\.*##.*.#....  ....*.\..* * ##* ....*.\ .... ...#
#*\........... .# .# #*  ...***.#*\..#*\.#.. ....#
#.\ #.  #.*.  ..  * # ..#. # .  .# .#...#\..*#. *#
##.......#. . ...*   .. .......*\#. .**.. *...* ##
##....\.  *..#....*..#.#..#..* ## .*.\..\.*   .#.#
# . .*..... *#\.. .#* .#....\ . .\\.*. ..*.*.....#
#.....*.*\...... . #.  *#. #..\...* ......\. ... #
# ..*#* ....#*.#  *. .# .*... *.. #..\#\. \.* \.*#
#.... ..*  ..  . .#. ..  #... #...\...** #..  *..#
#.#..\ *.\...* . .\...  \....#  #.# #. # .#...*..#
#..\. . .*...... ..**  . ....\... ....#*. ...\.  #
# #  #* .#. .. #...  #.*.#* .#.#.. ...*..***.* \ #
###.# ....*.* #\.#. R.*..  .. ..** .....#..#.....#
#*...*. .#\* .\ .#\   .. .. ...*.#.*#.*.*.. *..#\#
#..*..#..   \*##.......*#. .....\#*.#...\* . #...#
#. *\  .**.#.\ ..... * *.*.. .#*.. .#  .#. .#.\*.#
#*. .*... .\*  \   ...  ..\.#.  . ...... .... . .#
#.*....*.\.*...#*.. ...#.   ...*..#*. .. .* .. *.#
#. #.. ..*.*. \. .  .. .. #\#...... . .*##......##
#. ...\ ... . .* .. . ## #.\.. .*# ......*. ..* .#
# . .\ .*.. *.*. .#\ ..\..  ... .#....*..*.# ..* #
#.....# ..*.. \....  *.\\...## ....##. . \*.*..  #
##\*.. \. ...   ***.. #. #..... ..# * ....# \.\#.#
#. #.... ##..*#...*.#..#.\ * #    .  . .*   .\**.#
#.# #  ..*.....#.... ....\.   ...........  .*... #
# .*..... *..  ..\\.*#* ..*. *...\.*\. .. ..\.\. #
#.*.*\  .* .. ..  ...#. ...\ . \..*.... .. . .#*.#
#. .#. .. ...# .#..... #.*#*  .\#..  # \. .. .#..#
#..\#.....*...#*...... * . ..*\ .....# .*###*#...#
#.\.# # ....#.. *#...\ .\..*. .....*.........#.\.#
########L#########################################