##################################################
##* . .... .. . ....*\.  .. ...#*  *.#.. *.. .#\.#
#...** .*..#.* *...* ... *.##.# .*# .*.#.  ..# ..#
#. .. ......   .... \.  *...*.. ...... \..#..#...#
##. .* .. #..*\...#* ...........\..*..... .#..*\.#
# .........#  ..\..#  \......... .*  ........\.#.#
#### ...  .*.*..... ..\. *\...*.. .#**....*#...#.#
#  .*.#.# \ .. .* .*.*..**.\..... . \. ....#..*#*#
# *#......#.#*..#. #.  ..*....*..* . #    .. ... #
##   *. ... ..... .*#  .#. ....#*.. . ...#.  . #.#
#.  ... . *..  * .. \*..*...  .*#.. **##. *## ...#
#*.#.. ....*#.#*  *.  . ..*... .... ....#....... #
# .#..  .. ..#. * .*#..#. ##..#... ..... #*.....##
#\.\..\.. .#...*.\*... .#.....\.  ...   ....* \. #
#* #...*..* *.  .* .* .. #  * # .##**##. ###..*..#
#*.\.#*.. ..  ... .#.#.  .... ##....\..*.   \.* *#
# \. ....\.....#. #.*. .\ .# . * .*...... ... . .#
##.#..# ....# . ..*.....#.\\#.#.\ ....  #\.#....##
#..  ......#\#*  ..........# ...\.\#.  \#  .#... #
# .. # ..\R...#. *\\.\...... .#. .*  ..#..\...**.#
#.*#*#..... ##.. .....#..#  #*.*.\.\#....* ..#.. #
#. . . \.#\.. # ... ..\*\ . .. #...*.*. ...*. ##.#
##. ....#. .  *#.. . ..*......*. ......#.\..*.   #
##... .... .*  *#.#. .*..* .#.*..\.......\*. ..\.#
##..#.# ...\. . .  #... ....  .....\*....\..#....#
# .#.... \ # .. *. # . ##.*.* .*........... . .\.#
#*** .. ... ..\. ......# \##   ..  .\..\.\* #\ ..#
#*...*.* ..*.**  .\.\#......###...#  .......\.*..#
#    .**.*.... ...**.....\*..\.. . *.. ....#.....#
#...* .##.....*#\*......#*  \........... .*#...\ #
#...##... ...#.. ..*.. .*......#. #*..    .**# ..#
##** \.#...... .  *.. \..  ......... . ..... . ..#
#..*.#...  .. .* ......#  ..#....#.* ...\  ...* .#
#.*......  \ \. *....*  #.#.  .\*#    ....\. ....#
#.  .\...*..* # . #....\*.  #... *.......**.. *.*#
#... .*..*.#... #.  \*.   . .##...  ..#*  #... ..#
#  .#. *.# #.#. .. *#. \*.*.. ......*.  #*......*#
#\## ..    * **..#. .\.\..\\... ...\....  *. .*###
# ..#. *.. . \.*.*...#.. ....#... * *..\.. \#....#
# ... * #  .*#.##.*.\ .\\..*.  . . ...  .*...#*#.#
#.##*.*. .##... .  # *.. *. .  . #.*... .*.  ...\#
#.*.*   .\.#\.*  \ *. .*. . #   #\  ..* .....*  \#
#.. *. .*# ... \..*#\..*#... ...#..#***....*...\ #
#. .. \...\#. . *.*. .\\...* \..*\ . .#  ..*.\. .#
#.*....# .#.\ #..**\. \.. ....\*.* .\..#..# #.  ##
##\... ##... **.#... #\#..\......*#...* *.. * ...#
#......*\..*.# .....* ...*.*..*. \.  ..........  #
# ..*. ... ...*....**... ..#..#....\\. . \.\#....#
#..#...... ..* \.#\*.\.#..# * *.............#**..#
##############################################L###