##################################################
#.#.#........#... ..#.. . \... ... .  ....  #.\.*#
#. .\.\ .  \..... ...#\*..*..## #.#.. .#  . \....#
#. #.... *... . #... ..  *\...... . ....* *...\\.#
# *..# ... ..*...  . . .....* #*.*..*.*.#. ....**#
##....#*.. .... . .....# ... .#....* .#.. * .. . #
#.  ..*.#\.\ .. *. \  .... .....*.... #.\#*..\...#
#.**. ... .. . .... . ...#....\.*.\ ............ #
### .....*... .#\#.. . ...##...#*.. # ..   .\.*\.#
#.. ..#.#......#*..... *#.*.....\..*. ....... .#*#
#. . . .. .. . ....\... .   ** ...# . ...* # \ . #
# . ..\....* ... .\.. . . ...#..\.* ...*..*..\.\.#
#  .#..\ ...... *##..  .....*.*. .#.#. # .. * .\*#
#.......#.. *#.*...*.... .*... \..\.....##...*.. #
#.*\**\.*. ... .#.. \.....#....#** .. ...* ..   .#
#*\..#.. #.. .. ..#*....*.\*..#.*.\#.*....*##*. \#
#*...#.. ........  ..*  #\.#*.  .* .***# #.*..#\.#
#  ..*... ..#*.#*. . .\\. .. .... .#.*\..#..*....#
#.\. ... .#... .*......* ..  #.. .\..#.... .\.  .#
#.\.#..# ....#*..*  # ... \.#*#. ...*.. # .. \ ..#
# ...\.#....\#  .#.   *. ..#..# ##  ...*.*\*#. *.#
#...  *..#.\# ...* \#.. . #. ....*\.*.#.#.#.....*#
#\.  *# .**. ...  .*. #..#.. ##*###...... . *....#
#.  ..\.*#.#...#*. .... .. . . . ..#.... . .. *..#
#...* .    ... #...* ...... *...... ..\ . #. *.  #
#  ...*\ ...*.* #..*..#. ..\*........\.#.#.....#.#
#. . ...\ .  *. ..# \..#. ##. .*. .\. ....##.... #
#..* .. .#.......\** ........\\#.#..*.. #*# .*#*.#
#..*..... . \ .#.# . .. .#.....#. ...#....* .* . #
#.. ..# .\ .. .*.#\.....*#...#...*....#  . # ....#
#..... .\*.# ... .. *#.*....#.. .#  * *.. . . . *#
#... ..\\.  .*.......... # *##*.#...#...  ....   #
#. .#... #.. .. *.#.  #.*....# * ... *.**   . *.*#
#..*...... #...# .#.R.  .#....#.... .*....\\. \ ##
# *.#..  #  .  . ...#.*..*#.  ... .. ... \#..\.\.#
#.*#.* .*. ..#....*.... . .. \...\  * .  .. ..*..#
#..# .*..#..\.##... #*\.\ .... .. . .. *. . ..#.##
##... .# **....* ..... ..*.. ....  ....  ...\. *.#
#.#** ..\.#.. ............ ..   ...*.# ..   ...#.#
#*.... *.....\........#... . ..\  #..#..*..#.....#
#..   #. .. . .....\# . *..*#..\.  . ..* ...#. .##
#..*..... ** ..*#.. .. #.  ..........  *\.    ...#
#  ...#.... .*#.##..*# . . ...*. . ..##.*. **..  #
#.\..*...... \* .*..... .\*#... .......... *#*.. #
##..#.*.. .....#.. ..##.#. \ ...#. .#..\ . *.   .#
#...\.   .\*. ....#.. # ...*.#\... ...... .#.....#
#.#..... .*...# . .. ..#. .. .*.*.* *...*.....*..#
#...*...\....*#*. *.  . #*....*.# . ... .\..#....#
# ..*#. ...\.#*. *\.* .  *...\.*.....\. .......#.#
#############################################L####