###############################################L##
#.*..*. *.*.#*... * ... .##.  \ ... *.. ...*.....#
#..#.**.....\... ..* . .....# ...#.  \# .\ . ....#
#.*.......*. ..* .*. .*\. .*##..   .#......*.. #.#
#.#....*.\.\.* ....**.#.. .... . ..........*... .#
#.. *  .\  .*..# ..*...  .**.#. . . .#.... ..*\ .#
##.. ....*.#....*##...... *#..... * ... *#* *...##
##...*.  .. #.......... ..... ..**#..##..\ .##..\#
#. .*  ..# **..*.#\ *.*...\....\...*. .* \.#.#\..#
#.\...#.*.....  . . ..*....#. .# *....#.. *.*\..*#
#.. .... *....\. ..#.*......# .....* .# #...... \#
#\#\.#\..#... .\# *.*.   ......  .*  ....#.......#
#......#... * ...  #\..#.\#. .***#. .*  *.. .\  .#
#..  \ .. #...  # #*  #...##.*\...*.\...#*\.*....#
#...#* . ..#.. \.###...*.*.\.  .*..\ .. .\.* .\ .#
# ..\ .. #\. . #. .#. #.*## .*...#..  * .*.*.. .##
#....*.*.#.\*.*...  ......#.... #..\. #*... ..*..#
#.* ........#.......*  . ..#.. *. \ #.#... .\ #*.#
# .#**.... #**# #.. #.  .#.  .#. ..\.#.....  . * #
#. #.  ...*...#  #.......  # ..#* .\..#.  . . .*.#
#..  * ..  ..# .......#..#.. ...*  ###. #.#. .  .#
#..... ... ......**..\... .  ...#.**.. * .#. ....#
#.... *........ *.*#.. .\*.# ........#\. .... . .#
#........*.\\..#  ....#.# .R#.**..#..*... #..*.**#
#.##..*.....* ..#*.. .  ..*..##... \ *\..*.\.... #
# ...  ....\# .....  . . ....\ ## .\.. ..\...*...#
#..... ....#.  ..\.  .\.. .....*# *#........ .#..#
#*... . \... *. . ...# # *..  ...  ..\*#.*. .*   #
##..*..*.\.*.....\..#.    ..#\ .*.*...  .*.*\  *.#
#....  ...\... * .... .##.. #.#. *......*  *. ...#
#**... #  .  .. .#.....** #.#.\. .. .# ..   .*.*.#
#.......*. .  .....*  #.. .#...# .  .. .... .....#
#...*.*..\... . .#......*...\....#....  ......** #
#..\.\#.... . .#  \.*\...... * \... .. \*#. .....#
#  # *.\#*.. .......... .#..* ..\..\##..*.* .....#
#* .*..* \. .#.*..\  . \.\. ...#..\.*. * .# ...  #
# ... .*...\ ..#  ......\.. *... .. .#.... ##...##
#......* .. .. .*#.. .\*.. ........#.. .  .#.. ..#
#..#\ ...# ..# ...* ....... #. .. ...... .#.  . .#
#..  *..# ....*.....* ...#...  .#.#.. \ #.*. ..#.#
#.\...*....*.#.\......... .. .*#\.\ \.*.....# # ##
#...#*....* #** . .**... ... ..#. . .## . .... \.#
#..\...#*#. .*.\ ..#*.\.\#. .......#.. ..*... *..#
#.. #.    ..  ..\ .\*. ........##*........... ..\#
##..#\. ... * *...... .\.\\.*\  #........*.#.*\..#
#**....*.*. #.\ ..\.* .....  .#.*  *#.. . . \#.. #
#* . #. ..* .#.#\...#*# .... .......\ .\..* . \. #
#... ...... \ *#\*...* ..\**. .......#.......*##.#
#...... .. ....*..#. .#...*... ..  * ...*.*...#. #
##################################################