##################################################
# ...*....#.*   .. .... #.*....*.**.. ..*#.*\\.. #
# .*.  #.... ...*#. ..* .#.*..#..\.*... ...\.....#
##.#..*.* .\. .*. . #**.* \.#  ...*.*..*..... ...L
#..#.. .....*  #..\.#.....  ......*. ......\....*#
##.. *\\*...#...\........#. .*.*..#.#*.. .. ..*..#
##.# ..*..\...#.... .*#. .  ..... \..*..#** \.#. #
#.*...#. *..*.#.#...... ..*. *.*.......   ..#**..#
# #*...  ..#.....\#. #* .#\  ...  ...  .... #.  ##
#*\...  .*\*.#..#...\*..#.....# \\. . #\#.*... ..#
# .. ..##..  *.*..#... * *. .... \.*#* *#..*.#. \#
#* .#  *  . ..  ...... *..\. *...#   \*......\\. #
#*\.*..*  . .....\##.......... .\#.. #. ..#.* .. #
#....  . #... #... ....... ...... *....* *.*.\   #
# #..........\*.. ... ...# .# #.  *. ........ .. #
# .*..*. #...***.. .. .*..  .. ...#\....  .......#
#\ . ...*.\.....*... .... .#.... \...... * . ..#.#
#... .*...  .........*..* \...... #....\. .#. ..##
#...\    .**\... .. .  ...  #.**. ...*.# \*\\#.*.#
#...*. . *#\.*..#.. .\... ........\#.#\.*#.#.\.\.#
#*.#.. ..#....* .#  . #*. ..***.#... ... .  .\# .#
#.#  .\ .*.  . ..*. ..*##.. .\*.......\.\.*.\.\*.#
#... .*.. ...... ....##. .  **  ..#.#...*  .   ..#
#.*. ..*.\..*# *. . *# ..*.. ..  ...*.*\\...#..*.#
#*..  .......*.# .##****....##..##.\#..#.. ..#...#
#.*.#..... .* ..##.#.##.*#. \## .  ..  *.. .#...##
# #...#*.....##.. \.......  ..*   . ....*.\.*..#*#
#...* .#. *... ** ..   ...# *\*. .*#....... ..*..#
#. #..*  .#........... #  .#*.. \.*.*...**.. ....#
#.......*. .\..#..*...\.#\ #\.#.\.##....*#.# ...\#
# ..........*..*. ..*.\.*....# *  .  . . #  ....\#
#......*..**..  *..  . .. .....*#.  .#... . .# ..#
#.#  .. ..\.... .# ..#.*.\ ..*...*. \.. ....  *  #
#.##.*. ....#*.\ . .## \# . #......** #.... . ...#
#...** .*..# .*.. . #..\..  ..\... .\... #.#  \..#
#.. #.. .*.... ......  .....#..\\ ......#....* .##
# ....*\\.... .#*\# . . * ...# ....# .*\.....*.* #
#*.#  ..#....#*..* * ....##  ..# .....*...*... . #
#*#..\.....#*  ..... . ...\.  .#.*\.....# .. . *.#
# #...  .. . #.#*\.\.. *## ..*##...#.... .*......#
#. ..***#.#**.. .. ......*. ....#.#    .#... ....#
#..#..*.  ...*...#*.. ..* ... .*.*...... .. .\.  #
## ... \.. ...R.\ \..#.*.*#... . .#* ..... ... .\#
#.... .*# ....  #* \#... * ......#\.  .** . . *..#
#..#.* . \... ..#... * ## . ...*...\..# .  .... ##
#. \.##  #\ .... #\..** . ... *. ..  *.. .*. ....#
## #. ....\.......\.*. . . .. *..#. . .....\. ...#
#\.  ...* .#... *..*.*.#*..*....# .*..\.. ...##*.#
##.  *...... .....*.\. . ... .#..#..... .... ..*.#
##################################################