##################################################
# ..*.*........ .... # ..  .  ##... ..\\ .  .. .\#
#.# \.. ......**. .#......#\.#.. *#.   .#*...\...#
##.... .... .#. .\.\ .. \..*..*...**.... \ ...*.\#
#........  ... .  . .*...*.*.. .\### ... . ..  .##
## ...#*..*..* . \.*. ... #..  .# ............ * #
#.* .. **..... .*..... #. ..**.. .... ...*.....*.#
#.**.##\.#...#....#...\*.#.  .*.. ...#.#..* ..#..#
#**..  *.*\ ..#.  .*. #*#.. .....*.#...#..***....#
#.. .  .#....#...  .\*.#.* ... .*. #....*#.* **.*#
#... #\ ....  *\.** # . \. \ . #.# .#........ .# #
# *#.#. . .. \.  . #. .#..\. \ .. ..\..*..#  . *.#
#  ..#.*. \ . *\... ##. ..# \  . ...\* ...#. \.. #
##..*....#.... . **.. ..#\ .#..  ..*# .... .\#...#
#. .. #.\.\..*  #.*....\.**.\... .\..*...   ##*.*#
###. ..#.. . . . ..*... ......\   #..# ...\.*.  .#
#. #.. #...#*..#...... \. ##.*..*.... .. ....#...#
#*. .#\..#..#.#. .#.  .#.**\.\ #*. ....  .#  *.. #
#*. ..#.... #....*. ....#...#.# .. . \\.. **# #.*#
#...\...###.*. \*......*.*.... ..* ... . #  .#. .#
#  \ #*.*.* # ....\... . .....# *..\#...#..#...*##
# .\..*....\.\.. ..*.. .. .*.....\..\*\.#*#... *##
#\. ..\. .* . .\  .#.*#\  \*  #**..... ..*  ..*#.#
#.. *.#.**** #.*..\ . *. *#*...*..#\# ......    .#
# . *....#..  . .... \  #....**.\..**  ..... \  .#
#  .* .  *\.. .\  .....\...*.*#.*. ... *..  .**..#
#....*... ...\.#..\.. \... ..... .... #... .... .#
#.. .  #...#..##*#\*...\ \..* ..## ..## # \\.....#
#.##** .....*.*.* ...  *......**....**#\.*.# ...##
# *..# #..... #*.... .*... .\.....\.#*. *##. *...#
###......#..# ... ... .. ....  . .........#*.#. .#
#..  ... ..\.................\.*. ... ..# .....*.#
#.. #.\.. #...... #.. ..#... .**..\...\. ......*.#
#.   *#. . ..#*.*.*#.*# *..* \\#...\\..# ...* .*.#
###....*#. *# *.. \.......##.# .#. ..... .#*.*  *#
#..*.# .\    .  #.#  # .   \**...........#. # *. #
#.... #  .# .... . ...*#..*.*#..\ .. .. *.\.*\...#
#.. \ ...\.. .#*. . . #.  .  ...*.  .. .#.* .*.#*#
#** \#..#.*.*. .*..\....*....*.. .........##.... #
#. **. #....*\...\.*. #... ##.. .....#.*......  *#
#*. .*...*. .\..\ #..#.   ... ..... \.. ...\*.#*.#
#\  ..  *. ... ..\..... *....\*..*...\ .#...* \*.#
L..# .. ...... .   ..#\. \.#.#*..#. *..\..  .....#
#*.* ... .#..* ..#.......\  .*... ##.#. ...*...* #
# ... \.. *. ..*#. .#...... ........*..#\ #* . ..#
#...#.*...*#.#..#** .*... ...  R.#. #....*..#.   #
# ..........#....  * .# ..#. .*. ..* ...#...#. # #
#.\..#..*.. .#.#\... ...  ..*  .#.* ........ . . #
#..*....# ........##\. .. #.  ..**...* \....**.\##
##################################################