##################################################
# ...*..\ . .\# #. ...  .\* *#.. # ....\*.#.....##
#.\ .. ..#  ...#. *\ *\..*  *..*....#. .*...# *.*#
##\*\ .**.*\#*....\*...*.*..#....*  #...*.##....##
#*.*.#.* \.  ....... ..  ..  .... ...\.#..#. *.\*#
#**** .. . #...*. . ..#.\.#  .... ..#.*..* #\ *. #
# .. **. ......... . ##..\.   .\.\.#.. #...#. ...#
# . .\. . ...#.#*..........#\.* #\ **## ..#......#
#..*   ..*\*** ..\.. . .....## .#.......\# ... ..#
#.*. .\* #.*.\..\...*. . ..# ..#.##...#.. ...#  *#
#.*...#... ...R** \....#.* .  ... .#.\ *. #  \*. #
#. ..  *.#..\ \\\  .........#*.   ....#*. .. .. .#
#........ ... .#*.**..*...... . *.......... .\*..#
## .......\. \  . ...#\......**.*.#*#... *... \ \#
# .. ...*....*.# .## # #. *#.* ... .#**..*... .#\#
#.\..###.  ...#.*...*..\*.\#.\. #..*... \ .**..# #
#... .. . ..#......* ....   \*....#*.\.. \\ # ...#
#.. . . ..... .. ...*. *. .\.#* ** . ..  . ..**..#
##.   .*#.**......#*#....... ....* .#.#.. .. ....#
#. .\...  ..... .. ........# ...\ .....*..#\ . ..#
#  .. ....#\.*  * .\.. \ # ..\.......#...  .* . .#
##  ..  ..*.. *.#..*..#\.. . .# \ .... ..*..*.*\.#
#.. *..*  . ..   #.  .# #.* ** . .# .. . ..\*...##
###*.....*#....#.###....* ..    .  ...#...*...  ##
#. ..#*. ...\..*..#*#.... . .*.....  ..* ..# ...##
#\..#**.... ..*. ...** . .* . * ###.... *.... \ ##
#.**#..\*...#.*....### . **\..*.. ... * . .. ....#
# .*#*# ... . .......*.*    * . ..\ *.*. #.   .\ #
# . .  ..  ..* . .* .*..*..#*...#\*. .. ..*... ..#
# #\  *..*.... .  ....##...........\.*# . *.\..#.#
#  .. .....*. . .... #. #. *  #\......#.\ .\\. . #
#... #. ....#*.#..* *.  #.*.\\.*.  \ .  ..*. #*..#
#..\..   .......*#.. . .*..... . \ . ..* ...#.#\.#
#.#. .\...  #....* #.#**..  .......**..\.\#.* \#\#
# ....\.. \......\....... .#* ..\* *#* ..##. .. .#
#.*. ..**..* * . ##... .. \ .....#. . .#\...###*.#
# \. *..... \. .. *...*..\ .. . *  . .#....#...#.#
#..#.....** \##. .............. ..\.*. #.. #*.. .#
#*.. # #*  #. #.\\ *.\**. .... .##.#.# .*.*.. \.##
##.\\.... ...... *.##* \.*.... ............\... .#
#\.\ ... .\\ ..**...*.*.. .\*...\.* .......#..#..#
# .#.#\*#... . **  . ....\. *#...*.*#........\##*#
##.......*.*.#. .#...\....#..* .. .\...*...###. *#
#.*... .... #. . ...*  .. *  . ...#.#\.\. .......#
#\ #.* ..  *#..#......... ..*\\.*\*.. .... ..*#. #
# ..*#....#....# #.*.  .... . \  \. . *. # ..#* .#
## #. ...**....#**.\ . ..*\. .#*\\\# .* .....##..#
#.\ *..*..#* .......   *.... .... ..# *....* ...##
#\.*.#.#.......\.....  . ..  ....  #  .\. .# .  .#
###############################L##################