#####L############################################
## *.. ..#. # .....*..... .\# ** ......... .. ...#
#. . #.  . ...\..##.. #\. ........ . .#. ...\ #..#
##  .*......... .\.. .. ..  . *#. ......*..#..##\#
#\.. # #.. . ...# ..#.# .. .*....#*.*# *....*###.#
##\\. .\.. .... .#. . .  .#.#....* . ..#..  .... #
#* .*.......... ... * .. *..#\  ..  . *#.*.* \ .*#
##   ....*..**.#.. #....*#.#.... \..... *\.#.. ..#
#...#.... ***..#..*...  ..  ..##.......... \.....#
#....#.\...*...# .*.\#....*...* *. ...\...*\..*..#
#...........##..##..*.*..#.#*..#.. .*..*..#\.....#
#.###.* ... #..... \..  \..#.#.. ..  ..    \ . ..#
#**.*.\*. .**.*..#...*\#...**.. .* #.\.*.#.  .*..#
#.#.. . #  ...... .. ..*.#  .. .#  .*. #*.#\.....#
#. #  . . .. . . \.  *.  *#. . .\ ......*    ....#
#..*.# *. ......  *. ...#..*..  ....#.. .*  .....#
#.. ...#.. #. . .. .\.....\  ...*#.  .\\... *\##.#
#\.. .#..*....#...*.. ..# *....*.  ..*. .. .\#..##
# * *.# . ....# ... #..# #.  .\.. .  . ..*..#.#  #
## ...\... .*.*\..  . .#.#. ##* .... .# *## .*.#*#
##. .. #. . ... . ... \.#*.. ## . ..# .#. #.#*#*.#
##.#\###*.... ....\..#.#*  ..#.. . \\.. \ #......#
#. ...\ ....  . \ . . ##.#*...\... # ... #.\. ...#
# # . ..\. *......# #.#.  .*#..*.#. ....#   .. ..#
#*... .*.#. .  *. .*...... ..* #. ....##... ....*#
## ..*.*...  . ...#. ......  .##.. ...*.. ....*.##
#. ..  # . ..  ..*...... ..#\..#....\***.... # . #
#\.###.*...# # *\. * #..#\ #.\...... .#.  ..  .. #
#..\# .*.#\. .# .\ ..*....# .#.*....#..  ..#... .#
#..\** .  #.\ .* .#  ... . ..\*.*..# *. . .. . .*#
#.  \  #\.#.... .\..*.#.... ...#....# . . .\*...*#
# *..*...  \ . .#. #. .#....  ..... \ .#. .*.. . #
#*.#.. *. . .. ..#. .R#*.*. ..\..*.. #*...... .#.#
#.....\.\# ......\#.#...**# .. .\#..\.#. ## .* .*#
#. .#. ...... #.#.#.*... . #..*..#..* .  .. . .. #
#..*.# .* ..#. \*..\*  * ... *. ....\.##....*. *.#
#. .  .*...*.... ...\...#.... .. ...*.... .* .   #
#..\. .. #* ...# .#*..\.# . .. ..**... \#..*..  .#
##.\..#  ##*.* .\* *.* ..#. . #.   ..*.....* .. .#
#\.  # #..*. ..#.... #...\.#\..... ..* ..* ......#
#.... * .*#....  .#*\*... *#.. #.#.\# **.   # ...#
#..#.\....*\. ........ #..  ..#..*#.\.\... . .#*.#
#.#.*.... ...\.\. .\.*# .# *..\##. #...... # #.*.#
#* ...   #... ......\ #....  ....   .. ..  .****.#
#.. \.#.. *\.... .....*##*.#.*\..#..## #.#.#*....#
#  .... *#......# ..*#. ## #\*... #..\. .# ....\.#
# * . ....... #.....#. ...*. .# .  \#. #*..*#. * #
##....*..   ...\.*.#***.#  \  #.#....*\#\#.... .##
#*  ...##....* .*  .##.#\..*.* #.#.#.*.. * ..... #
##################################################