##################################################
#.. .#  *###* . . . # .. .#. ............ .*....\#
#..\ ..*.*\#.. .. *.....*.. .    .....##.*... . .#
#.......#.* .*  ..*\.. .#....   .....# ... ....*.#
#...... # . ..#. ....*......\.#...*.\.#  *... ...#
# ..\. . . .#. .... ..... .*...... *. ..#.*.*. . #
#. .* ....\..# .##......... .... .\..#* ....# \..#
#..\. *.#. #..#..\. .\..\ ....  ... ..... *.... ##
# #..*...*...#..#*.........\ # \.. ..#....... ...#
#. .. # \*.\..\\..###..# ..**.#.*..*\.# ..\.....*#
# .\.....* . ...# #**..#*  * .#\\. *  ... \.*\. .#
#*   .* * .....*. #..*...# *. .* **.... .#.  #*. #
#...*.#\ .**\........  . .* . .  ....*#. #...\***#
#.\#.....#...... ...  ..# ....\ .*... ***. #. .* #
#..*. # .. .....***# .#   ...*...#. #... .. ... \#
# \##.....* ...\.* ..#. ...\*\.#.#. ..........*  #
### .#. . #...**. # ..R..\.#...\.\...  . .. .* ..#
# \ ..#*  .#..#.#..\..... .  ....*# ....*.#*.  ###
#. .. .......#.  #..  . . .\.... ...#.. #.* .....#
#*.#.*..*..* . ..\#.#.......**.. * # ..#..\\.. .##
#*.. ..\#*.*......#...*  #.. .#.. ..*..*......*..#
#.\ *. ............#....... . .. ..#..\..#...*...#
#.  .... . **.   ..##..*\.......  ......*..  ....#
# ..#..#\.*..*##. .\  .  .* .#\  ..... ...# .* ###
##*...#.........*#..#...*#*. ..#..  * .\   *. . .#
#. . ... #.#.* *...# .\. ...* *\  ...  ...*.....##
#.. ...\.. .  .....*.\..#*.. . ...* .  ... * ...##
#. .. *... .#\.. .#...*#*.#.#. . * .*\ \ . .....\#
# #..#. ..#.**. ...\. ... ..*... #...*. ... ..  ##
#... ... . \ \\.\.*  .....*# .**.\##\...... .. ..#
#*\* ..#.... .. .# #..\*#..\.. .*..... *.#.  *...#
#\.....#...#* .........*..#. ...* .#...*  #.... .#
#*...#.*...#..\. .\... # #....*.*..*\  .. .... . #
## *.. ..##  .....#..*. #..\*  .. ..*#*.. ....## #
#.... .  #.. ... #...........*.##\. ......*..*...#
#..#.*#.  ....*.#......  .#.*. * .*.#.\.......#..#
#...\...#*...*..#.##*... \ . *... ...#*....\.. ..#
#...#.\*.. . *#\.*.....  *\ \.## *  \* \. *.\.#\ #
#...#\\\\*. . .  \*..*..#....*...  ..##\#\..*..#.#
## *#. .#.\. \*  ..#.. ..\.*\...#. .*# #*... ... #
#..... #........**.#. #..#.  .*..#.......#.. ....#
#....#.#. *.... ##.*# *... .* ..#  .** *..*.#*.*.#
# #.*... ...*.#. \*..##... . .  *..   ...#..\.\# #
#*.... .*#  . ..... .....* \# ...**.....  *.#.#..#
#.. ##\.# . ..... . .. **  .\ .#.#*  .  .##.# #..L
#..  .... ..\ ## .*  #. \....#......*. . .. ... .#
#*..  * #.*... ......#\.. .... ......##.*... .. \#
#* .. #...*.\... ..#. . .*.#..*........#.\\...#.##
##.... #*#. ..\ ....#* ..*..*... \..\.. #...\#* .#
##################################################