##################################################
#\.. .*.#.#. . .*.  #...#.#*...... .....\. \ . ..#
#....#   .*\.* ..# . #  .. .#.*......  .*.#......#
#.....## ..*...\#. . .\... .. .*. .\. .....\    *#
# ......... . ....*\*.*.. ..*#.#*.... ***##....#.#
#..*.  . ...*\#*.... .. .. ...\  .. .#\. .   .. ##
# .*.. .........*.*.* .#. #.#. . ..#**.#.. .. .  #
#*  .\*...#. .#.*........\..     . ....\ .. ...\.#
#.#.##....*. \ ........*. ..*....... **....... .*#
#.#  ...##...  . .*  ..*.#..  ..*. ......  **.. .#
#.* #* #..   # \... ... #.... . .. .##. .***.*...#
#**..# .... ... ..*##*. ..*. **..**.#.#*.#.. *..\#
#* .. .\...#**..#.#..* *....*... **  #  ..#.. .#.#
#..*#. #.. ..#. *....#.....**. ..# #*.. .#. ....*#
#..#.\\#\.. . ...  ....\*... .#.... ## . \..#..*.#
#..  #.  .. \ *..  ..\... .*....#.*# ......  ...##
#..*...\.... .   .\. .. * # \...*...####........ #
#. # ..#..... ..\..#. .. .... *. .#...\ ...... . #
#.#.#.*# .. .  ...#\ #..*.# .*.#...\. .. .....\..#
# \ . .   .* .# ..   ... . # #*. . \...#.....\\.*#
#.#.\.. ....  . *  #... .\. ......  ..*.\*\.\. .##
#....#... #...##.*..\.  .  .# .. ##. .........**\#
#.*. . ..# *. .\ . .. *... . ...\....... ...\... #
#.. \.. .  \* .*\\ ..... ....... # . . #... ..  .#
#. .* ..##\** ..  ..  #... ....# ....... \.#...\ #
##*#...\.# #.#..  .....# * .\......#. .\#.*\# *  #
#\#* ...#....#..   \.#\  #.*# * . ..#\......*....#
# .**. ..#..* ....  *.. .\.# ..**##*..\... \*\.*.#
#* ...#.#.  *##*... ... #... .  \\..*\....  .....#
#. \*...   #.\ . ..... ....*#..\.. .\.. ##..... .#
#. ..*.....*.\. . .#.# .#..  *..\ .\. ...... .. ##
#\\......*..... ..\...\.\ ......\*.  #.#.....  ..#
##. .\.\ .*.* ... **... .*...** * #.#.#  .#.*#. ##
#.....#. ....*  . .... \. .*\#  .*.#.#. ##. #\#..#
#\ ..  .. ..#..* .....#.  .... #... ..#..*.*  ...#
#*..#...#...... ...#.*... \# *. .*...\.#..#.*... #
# # \ # ...#..#\...#**..* ..  \.\... #.## .. #...#
#  \*..\.# *#. .#.*## ....##*. ..*#. .. . .. * *.#
#  .. .*........ #..... .. .*. \........# .#.....#
#...  ..#.*.   . *.*.\... ... .* \.. ....  #  ..*#
#.\..#.#. *.....* . .\.**# .*..**.*...*.. .* ....#
#.........   \*.   .... .*\..*   .*.#... ..\....*#
#*...\*.# \*\*..#.*....#. ... #*.*. . *... ...\..#
#.... *.#.  ..... .. *\.. #*.\*. ...# #.. .......L
##\.. . . * . .##. *#...\.*#.... \. .**.* .. .*..#
#. .\.... .\... ..#. .# .*#....... .# *.*....*. ##
#**...\ ##\.R.#..*  .#.......\..#..#. .*.#  . . .#
##*.#...  .\#.. ..*. .. . \.  . ..*...#. .... ...#
#.* *.....#. *...  *. \*#.*..*.  \.....* ..\#...*#
##################################################