##################################################
#..**.*.#..#. .. .#.#. ....#.. #** .. *  . .\... #
#.*. *... ## .*..... *... . .*...\.*....\# # * .*#
#. ... *..# ... . *.#.....*# \#..# .. .#....*. * #
#...... ..\..*. .. .*  **..#..... ...#\.. ... ...#
#......#\ #......** .. . \.#.....#. ** *....... .#
#**.\ .* .... ... #*.. # ... ##. . . .... ..\\#.##
#..#*.*.**. . *.#\ .* #. #....#.*# ... . ...#....#
##. .....  ..*  . ..#. . ...#... ...#**. .   \.  #
#.#.*.. .#*...\. ##*......#..#*#......   .\#*..#*#
#  #..*#.*.  .* . *  ..**.*... ...........\..  ..#
#.\. *... *... **  .#.... #*.#  ..*..... ... **..#
#\ .. *   .* .  ..\*..  ....\.....*...*..*.. *   #
# \\#. \.*....## *.#..  #...  \*..# #...  ... *..#
#\.# .R.. .......  .*    \\... ..*.......*...\ .\#
# # ..* ... .....# # *..#\.##*.*.#. \ \.....##\  #
#. .# *........*  \.*  .....#.....# . ...#.#.*.*.#
#. #.    .# #*  . .##*.. \.  #.. \..* .*... .#..*#
#. .. *..#.# #  ....*...*...... *.\#\. .. ... .*.#
#...\......*#...\.*.#.. ..#.#...*.   .. #..  #.*.#
##\..* .. . .#.....*.* .....#.. .. ..*..#.*  ....#
#..\# .... .\.* #\.**.#*.#.. .# ..# .#. ..\.#. ..#
#...# ....##. ## ..... ....# *. ...\.. ..*.# ....#
#.# . ..\*#*\.....# . #.*. .......... *... .\ *. #
#....# \..*#... . .* ...* ....\.. .  .# .. ..... #
# *....# ..\#.... #..\ #.\\... *...  .  ..*. ..*.#
#.**.....*.... .#.. .. . ..*.  .*.*.. .**\ ... ..#
#. ..... .... * ..... #.. .  .*..#.#.....*..# #  #
#.... \ .\\. ..#....#...#.*...#.....   ..##.# ..##
# . .. .....#. . ..*.#...... .* ...... ..  .\.. .#
#. #*.\.  * .. #*...#.#.\ #.....***...*#.  .**..##
##..  ...#. .*# *.\. #\.......*...... #.#...\.*..#
#..##.. \.*.. # #.*.\ .# . ... . . ..  ... * . #.#
# .........* ... ...#. ..\# # \\..*#.. .#.. . .. #
##.\ \.#\*. ...# *.## ....\..... .....#*# . ... .#
#.....\...#..  ..#.. *.\..   ...*.  ... ..\. . ..#
#.... ....#\*. \. #. .. .*..\. \\.#  *..#.#. . . #
#..#...*.#. ..\#...#..** \*..  .\\ *.  .... ... .#
#..#* .\....*.\*.... .#. .. \ *.#...*.....  .\. .#
#. * .. ..#...*#...#*.#.. ..#\*..\  .## .. .* ...#
#... . .    ....#\ ... ....  ... *  .. .....*\...#
#.. * *#.....#..*..... ....  ..*  ...##.#*.... ..#
#*. .#.....*. ..*.#\.. ........#... . . .... .. ##
#.# ..\\.\... *...*. .*##.. .#..\**..# . ..*.#..\#
#.*.\.....  .*\.. ...... ..**...#\....\.*.\  ##\.#
#*..*..#**......... .. . ....*  .. . \.\*. .....\#
#.\.\..\.. .....*\. * .*.....#*.. .. \..* ....*..#
#*. ...\....# #  # #*.. .. ...#*. #. .#  ..  ..\##
#.*...*....*.. . \.*\..*...*..... # .#*.....*..#*#
####################################L#############