####L#############################################
#.#....... .\.....*.\...*  . *.\* .*#.\... .#*.. #
#....#..\. ... . #.*....*# .  .* .*#*....\...*...#
#..*.....*...* *.*.*. .. .#.. .. . #...*. .....#.#
#.....#. ...... ...\#.*... # ..#.... .*\.   .\...#
#.   .* . \..#. .#... \ .#.##.. ..#..... ..*.#..##
# ..*#* .......... ...#*\. .....*. *\ ......*..\.#
#  ..** .*.##.. . .*... . . #*..##.#*. ....#...  #
#...    .\*  ..........  .# .. ..#*.. ** .....*..#
##. .#... *.. .  .\..#*..* . #\..... . .. .#   ..#
#.....#..*..#..#  \.. . ...#........\.....* ....*#
#.#...   .. #.*...   .. ............ ..#.\.. **#.#
#.* .\...  ....  .... ..*.. ..... *....** #. ...##
##.#.. . .* .. . .. .... \.\*# ...##.\..#..*. #..#
#..*.. ..  . *  \...\ .. . ....*....#.. .*. *.#*.#
#.\.\..#\ ... .. ...  .#*..*.#... .  .  #  ..#.* #
## \ .\\....*. ....#....#.  .R.#. #...# ......*..#
#*.* .   **.* ... * #....*.#  .#.* .. ..# ...#. .#
#   ....  ...#...#.*##* # ..........*.  .\\.. ...#
#* . . . ..* *  #. ..#....*.#* .. ... #.*\. .....#
#.... # .  #....*...#...#*.....\#.*. .. \. #.. ..#
# . *. *....#... .#.....#. .. . #.#. \ . .....*..#
#.*#*. #*# ..*..#.#\\........ **\.......#. .. *..#
# ....##.... .\. .*. .## .#..\ #.. .*  . \... . .#
#.#.....#.#.\........*\.. .#..*..# *.*... \*...  #
#  .* .# . \.. ......* ...... *...# ...    . *...#
#..* .. . ....#.. . . . .. .... .*#...#.#*.\..  .#
#....* . ......###*## ..#..# .*.  ... .**. #*  .\#
#*.....#.#.#.*.\*.... .# . ..#\ *... #\.#..*  ...#
#.* .#*\*.*...  ## #..#.. .*   .#.  #\....#.\... #
#.. \ .. # ..*... .#*#.\ ... #  *..*#.... #..#.\.#
#.  .\. ....#..\. ..#  .. *......*. ...#. ... .\.#
#....*..#..\*.#. .... .. .\\. . .*#.*#.. ...*..  #
#.\#..*.# #***. *.  .*#.\#  *..  ........ ..#...*#
#\ .*##*....*.#\.*.#..*\.*....*#.. .. ..# ..#..\*#
#.   .. *... .. **#....#.....\ ..#. ... .*.\**\*.#
# ..*...##.....\..\ ...*. ....*...*.#* ..#.......#
#*\. * .. # .#.#. .*.*.....  ..##* ...... \..#.  #
#.\.\..*..*... *.\..#... . . ..\. ... *....\.. . #
# . \ # *... . #... **   . ...\.... . .. .. . . .#
#*#. ....... .*..\.....*.#* .....*#......#.#.. ..#
#.\*.\.   .. # ..*#...##... . ..#\#. ...*..... ###
# ............ \.*.\....#... . .... . .. ... .**.#
#...\..*#\.# ....*..... ....  \ .* .. \.\#.*..  .#
# . .. * ..#. *....#. ... #..... . .... ..*#....##
#**.... .#.*.*..*.*# *..... . .  ...*.. ... #..* #
#.\\...* *.... . ......\*  .. ...# . ...* ....# .#
#....\ .  #. ..#.# ##..*..*\#... .....\  . \.\. .#
#*.\.#  ....  . ... ...\ . ..#.. ...#........#.#.#
##################################################