##################################################
# .. *  .# #\.......... .. ...#.*...*  . ....  ..#
#*#.\ .. .*. . ....\ \.#. # #. . *  #.*....  . .*#
## ..........\ . ..  ..** .* #...*#.........*. ..#
#\. .. ....  ......#\ *.# .  ... .....* .. ..# *.#
# #..  .#*..*..*.. ..  .. #. *..*.#...\... ...\.##
# ....*.. * \..*....#.#.  # ##.. .** .  .*.*.*...#
#...*. ... \.. .... .#. . R**... #...# #.......#.#
#....   ..  #.  .# . ...*   #\.....  .....   . ..#
#   *#.*.*. .# .. ..\.. . ......**...#.. ...#. ..#
#.*. ..*.......*.. ..... ..# . ...  .*.*  *.. ..\#
#.**...  ..   #. * *    ... .\#\*  ..\..#\** ##\ #
##.......     ...#..*# #........ #..#. **. ......#
#.#..\# ...*. ..\ ........*... .... .. .*   . ..##
#.#...**#.  .... .  .  *....\... ...#...*.*...#..#
#..\ ...* ..*..*.. *..\*......*. .. ...*.# ..#.\.#
#...*.\..*.  #.** ..........  ..... .* ... .  . ##
#.#..*..#..#.#..  .. ...... ...............\.*..*#
#.*......#\.* #.#.#.*  .*.# ..\.*................#
#.......*...... #.. .#...* .# ..    * . *#....#..#
#...   *..\ ....  #.#.#...#..#** .. .\ ... . .*..#
#.#*. *... ..... #  . .. *...... #. #...... .... #
#. #. . ....*..  .\.\...*. . *... .....\ ##..* .\#
#  .  ... . \. . ...... .\..#..#..# *..** .\.....#
##..#\..... ..## ...  . ....*.... ..\. \# .......#
#\. *.#**\*...*.* ##. . .. ##  ....#.\...*... .\*#
#.#.*\. .*. *## *....\...\*..  ..##.. . .*....** #
#..  .\..#  ....##...\*.. .*.\.*.*... ......#* *.#
#*..*\ .*#.##. .... *.*## *.....*. .*  .... .... #
#.# \.* .\.. #...*. ... ... *...## .**.\# *#***\.#
#..\.*#..#\#..  \ .#... *... .#*..  .   .# .\\.  #
#.#.... ..#.* . .*.. .\ .*..**...*...* *....*. #.#
# ..**...*#. . **...\.. .# ..*.. . ..... #... **##
# ..\ ..  .*...  #  *. ...#\.. .\... #*\*  .... .#
##  ...*.#. #  .\ \..\#   .\.....*.. .* .... #*#*#
#.......\\...*..*..\. #*\.*. . ..\....# .*...#...#
#.#*...#..#.  . . .*#.\. .#* .#.*. \..#..... ##. #
# . .#..\ #..##*..#\...  ....*#....  . . . .... .#
#.*..\..# \.. .* .. #..*. ....#.. **.#.##..*. . \#
#..*..*..  *#. . \.* ...  ....# #... #...*\#. .\##
#.*.#\*....\....   ...* ..#.... ...#  .. ...#... #
#*.#.**....* . ####........ **. #.. . ..#.....*..#
# \.. .....#.* \.#. .* .\... ..# ***.....*...*\*##
#... ..**..#.. *...\  \##... ..#.*.. #. ... ..#* #
#.* ....*.#\.  **......#\*...** . ...\...*...* ..#
##.**.  .... ...*.#. ## \.****..#  .. #  ...... .#
#.##.....*...** *# ..\ .....#. .\*.*  ..*#...... #
#.#  ..***..*.  .*  *........*.. ..#...#   \#.   #
#\.. ... . .\ .....*..*.#. #*. * .#.*. ... *###..#
#############################################L####