#############L####################################
#.... .. .#.# .. ..**...*......\.   * ....*....*.#
#.* . .\\#.# #.. .. .......  *...#.. .  .\.*...#.#
# .#.. .* #.\#..\.....*   ... .*#. * .. *. *.. #*#
#.*... ...#..#.. #.. ......*. . .. . .*...\ ..*..#
#...*#... .*\....\  .. .. . **.*...  ..#.##....#.#
#\..**..  .... .#. .* #.. #.. \*. ......\## #... #
#\... ... ...*...\...#..*#.. *...#. .  #.\#*..* ##
# .##..... .#.... . ..* ...##..## ....*.... .*  ##
##. #. # ..#. .*........#....*.#.......#\* .*.#*.#
#  *#... *#  .\ .... ....#. .*.. .*.#....#...#*..#
#   **.\...#  ..#.... . \*.*  \... .*.*.#.  . .\.#
#...#.. #...#..##. ..\#..\.*.\.....# ....  *  ...#
#.. . *#. \  ..#....\.....\......*..#...  ..#..\*#
#..  ..  **#.#.*....\ # ..#.  .. \..#\ ....*. *. #
#..*. .... . * \.#*.*... ..... *.....*......  ...#
# .* .*\ .#..#..........# ......# ..**....#  ....#
# ..*. . #.*...  *. . .\...*.....*  ..*.*\*# ... #
#..\....*#... #.   #.#*\*...*#.. #.\ ...*. ...## #
# ..... *##.**.. *...*.\   ..*\.* ...*.#. * *....#
#..##....\*.##. *# . . *.. *.....\*..  ..*. .#.. #
#*.. #...  . #.\..* .#.#.  .*. #. *.#...  ..*.  .#
#.# ...*..*.... #.** . ##.#.#* .#.. # .#......\..#
#......## *....*..#*....\*. *...*#.\** .* .... .##
#. .#..#. ..\......*. ....\*.. .........\.* ..#..#
#..... *.#.. ....*##... ........ . *.#...# . . ..#
#\..* .* ..... . . *.*  ...#....# ... .. ..  ....#
#*  ..#. .. .  \\........#.   .#..*. ..  . .. ...#
#.** .**....#.\.\..* .....#..\. *.. \ \..\\*.  * #
#.. ....\..*#  ..##.. . ... .## .\ .  *#..\.#....#
###...#..#... . ... .  .. \... .\* .... ...*.. . #
# . # #.\.\.#.. .. * . .....**. .## \*.###...\#. #
#   #.. .. ..*# ... ... #... .*.. ...*.  . * .* .#
#..#.. . \.  .#..\#. ..#.......... .\. .\.*.# ..##
# *.**..*..***\ .*...\...#*.. # *.#  #   *....  .#
#.\*.  ... # #......#*. . \..\.  ..... .#..\*....#
##*.\#. *..*.#.....*.*... .......*..\.#. **  ..#.#
#..*#* ...\ ..#.....  ...  .*.. .... .#.*#..  .* #
#**. \*.*.. *.... * ....... .....  . #  . ..#\...#
#  \*##. .\.. .  #. .\ .#\.*.\##..**.... .#. *..*#
##.**#*...... ..*.. .#...\ .*#. # ..* ..#*.\*. ..#
#...**.... .*..*#.* ..*....* .......... .. . .*  #
#.\*. . ...#... .#.*\*......## *#.* .*.*. ..\**.##
#.*\..*  *...##...\.. ##. ...#*R. .*.....\.. ..*.#
#  ....*.*\.....\\........\ *.  .\..*#*. #...#...#
#. .#\ *..*\.....*.*. #  .  ..**\..*...  ......*.#
#.##*.. . * .\.\ .. ..\.. #  #........ .*\*. ...##
##... ...*..#..  ...#..*   .. ..#...  ... ....#  #
# .#...... #*.*. .**.**.... .**..*.. ..#.   ... ##
##################################################