#########################################L########
# ..  ...# .....  .....\  . .## .\## #...*...  * #
# ...........*. .  .*** .... ... .*. #  .....*...#
##*..\\.. .. ** *..#.. ...#..\***..## # .#.#.\...#
##.*.#\#.#.*\#.\#.*...\*... . # . ..*##..\#. *.. #
# . .....*...##..# .. ..... *  .\.*\.... .. .  ..#
##   ...  ... #. *.... .. .. ....  *\... #.. . ..#
#. . ..#........\..  .. ...**...... .#...#......##
#.\\*. .#\.*#.#.# ... .*...#..#*...** .......#. .#
#*...* . . ..# . *...  #* ... . # ....   ..... .##
#.. #*.*. . . .*.#..  ...*#..*..*..#  ...\*....###
#....\.. #.*...  *.\  .##\#..#. ..*#...\.#*# ....#
# .**.. * #*. #*.# .*....*#.. ... .  ..*. #*..*.*#
#.*...\.. . .**.\....  *.*\*..#...#. ....... ##.##
#..#..* .....#\.. .*\ . ..*#...#.. #. *.#.\.##*..#
# .*...# .. .**.....*. ... #..   .#.. .. ....... #
#..... *... ...\.*.*.* ..\# ....#.#.... *..#...#.#
#..  #..  . ....#. * *...  ...#.*\#.## * ....*  .#
#..*.... .#* .....#. ..**.*.. . .  .. #.....\**..#
#.* ...#..#...  . .*. ..... ... # . *#... ... ...#
#* # .. . #.*.\..... . ...** ...# .*  .  .. .*\. #
#  ... .*..*.....  .  *...... ... #.# .**.#*.#. .#
#. ..#..  #**..... ..# .*\#... ..* #*\..\#.. ....#
#...\ #.##*...   * ..   .. ..*...\\*.  ...*.#* ..#
#. *.\*...........*.. .##......\......#.....#\*..#
# .....*. \ .\.# * . #. ... . ..*......*#... ...##
#...\.***. .##*..\...*..*.**.. ...  #.\..*..\ ..##
#* .  .. \  .#*. ...  * *..#*. .... \.....* . #  #
#.#**...\....*....... ...* .....\#. .\.. ..##.. *#
#.# ..\... #...*.*.* . \\  \.#* .*.#.* #.. .. * .#
#.....*#\#....*# ..* ....... .*...\... .. .*. ##.#
# ...#....   . .  ....... *.  #  **.* *## #. .*.\#
#. # .\.....*. ...\...... ..\*..... .....*##.*.. #
##*.*... .#.#. .# *. .**. .*.. \#.#*.. .  ......##
#... .  ... ...*.  *..   .. .. .. ##.. .#...*# ..#
# . ....  ..*...... .*  . ... ..\..........#  *.*#
#.. *.*...  ##..*..# . \.. ...*... . .\ . .. #**.#
#. .....#..  \#.... ...#**# ....*. .#.*.#....... #
#.. ......... ... *....#*\.*  *\.*.\\. ...*..*   #
#.**...* ... ... .. * ..# . ..#\ #..#..*. .. #\.##
#..##.*.#.*.# ...#.... #* *.. .......\#*\ .* ..  #
###...#.*\. .**....*.*.. ...# ..#.#.. .....#\.. .#
#.. ........... ...*#.#..#... ..*.***..# ...*..# #
#..\\.....\*. #.. .. \...#..  #**..  .#...... .. #
#..* .. ....\...*.....#..\.  .. ..# #*..\*. .*..*#
#...**...##..*..* . .\.. .\..  \..#. . #....\ *#.#
#..*.  ... * ..*# .*........\.#...\..#  *#....#  #
#  .**..... ...  . ... .. ....*#.\*.... .#  ... R#
#.#....*.....  \.\. . .. ...... ...*.... *.. #\..#
##################################################