##################################################
# ....\..... .#. .*.............#\ .  * .... ....#
# ..*.. # .**..\... . .*.*.. *...*. ... \.#.  #..#
#...  . .#...# \.*#\. ...*. .** ..*..... ... .*.\#
#\..#...  #.. .. ..#. . *.\...\.. *...# .. . .#..#
# \*.**     .. ...*#....#*.# ..*# ..*..\.*.  . #.#
#...   ..#..#..\#  ..#*\#....*............. *.\..#
#.# *\.#  .\.   \.*..   .....  #.. .   .....#\. .#
##..* ..\#..*..* .. ....#..*#..*. ..  ....#...\. #
# .# #..\...... .   ....#.\ #..\. *...# ...#. ..##
#.. ..\  .. ..#.......\..#*..*#..*..*#  . \..... #
## .*#.. ..*....#*........ \.  ***....... .**.\\*#
#....##........*#.\* #.....\.#.#.. ....#.*  .*. *#
##..*.. ....\... * #.. .\.  ..#...\ .#.#...\ #..##
# \ #... .#  .. *. . .....\.# .   .#.. *.##.* .. #
#.....*.... \. .. ##....*.\ #.. ...... . .....*. #
#\..*\.. ... . .... \\#. . .#......*. * ....#  ..#
#..#. ..#... .\...*..*.# ...\ .#. # \. .* .**. ..#
#...# ##..#*... . #.. #*......*..\**........   ..#
#*... #.*..  *.\#.. *.#*  ..........#. \......*..#
##..... .. #.. #.#...... *\ ##.. .  #.. \\ ##. ..#
#.#\\.# .* . .... ..  .... * ....**. .*. .. .#. .#
#..*...\ .  .\.. .*.....\..... #..\....*..*.#    #
#....  #... *. ..*... .* ...*.\.##.*...  * .* ..*#
# ...* . .. ..*  .....\.##.*#.... .# .. ..* ..#. #
#. ...\#.....#*...# ....  .*.... *\ .. *.\#. . ..#
#. .*  ##..#.  #..\#..#.. \ .... .*.......*.. ..##
#. ........#.. ..#.* ..... *... ....\.**#. ......#
#...  .\.#.*#... *...# ...#*..* ... .....#...#...#
# ..... ..\..   ... *... .. ..*...*. ...#* . * \.#
# ..#...*. .... ..\..#..*#.. ..*..* ....... * \*##
# .\#.#* .  . #*..   \*  .*#..... ..*...... .**\ #
# .....#. .. ...*#*#....... .. .... .#.* \.....*.#
#.###.  *. ....... *\ . ..#......*.#..... .\.....#
# ....#.** . . #.... .. ..#. ..# .#.. ...........#
#\.... #....# * ... * ..\...* .##.. *...*....... #
#... ... \....#.......*.*...... .#..*.#\.\.... ..#
#.*#*.... \ .#*\\..*...\..... #......  R...* . *.#
#  .#. .......\.. . ...**#.....*\...#..  ..*.. .*#
#  .# . . .. ...*.##.. .*....... .. ..*#  \\.\...#
#.. .* ..* ...* . .\\.. * . #*...#..\.*.....  .\ #
# *#......*. ..  ... ..... .... . . .\*..#..\*..*#
#...\..\# #... .   .*#.* .#  ...........# .... .*#
#..  ... ....* ...*... *.*...*...\..... ...  ...*#
#........\....\....#.\.... *.....\ ##. . ... .. .#
## *#..\... .*..... *.#...* * .*.*.... ...#.....##
# \ **###\....*\. \...  .* . .. .....# \*#*#.. *.#
#....*.#**....**#..*..\....#.*. . ..  ..  \ *.* .#
#.. .#*  .. ##\*.*. .\. ....\....*. ....*#\.*...*#
###########################################L######