##################################################
#. ...*..*...\.#.. ..  .#...  .#...**.#*.....\..*#
# #..   .. .# ..#.... *.. ...#  #.\**..*. ## ... #
# .. #........*.  .#..  ..**  ..#*..*\..#..#. ** #
#...# .# .. .......*.. #.* *.... .#.# *..**......#
#*..#.#.#..***.*.... ..*. #..*. .\   .. .#*.  ...L
##\. .*#..\ *.\..   .  . . \.. ....\#......\#..#.#
#... .# #. .#.\. **.#.. ...*. .. #.#. * *........#
# . .  ...*.*\ ...\...........**... .. .*....#..\#
#..#*\...#. ..#. *.....# \**.\..\   .*....#..#...#
#..\.#*.  *. *..* .*.#. .......*.**  .*..*#..*.#.#
#......* \   ..*.. .##.* .\#\\\.. *#.. \. .\  *# #
#..#.... .#..* ** ..** ..... \. #\#..........*..*#
#  .*\ # .....*  ..\.\..\ \... ..#. ..#..*.# .*..#
##.*..\*....... ....\.. .. .....\#.....#.........#
#.. ..#. #.... *...#. ....\.....#   # .\...## *..#
# ........ *....#.. .###*#* ....#..*......... ...#
#..** ....*... *. ..#..\.# .  ... ....#*..  .  .##
#...* #...*....\ ..  .#..*#. #. .......*.#.#. .. #
#.*..#*..\   ....#......*\. #..   *.... .# *. .**#
#.. .*#.#**R ... #.*....... ..*##.#.*.. ..\# \. .#
#*...#..\.. .#\..#*..#..\.#.....*.  \\ #. .......#
#.... ..*..  *\... .  ...*....**#....#*. .\.#  **#
#**.\.#. ... ...*...*.. . #..#.*... ..... ...#...#
#\  . * .*.* .... .. ..#...\#*....* ..*...#. .. .#
#.#*\..  ...  .\... #* ........ \ .#.... ..... * #
# .. *  .*# * #..... \. #...#....... *. * .. # ..#
#....\ ..  ...*#*.  . .\. * .\ #  ....  ...##.*\.#
#... .\... .#...###. ....*..  .. *..... .#..... .#
#  \. ..\..\.* **. ....* ..#....#.* *.##*  .\.  ##
# .... #...*.. ... ...*\.*......*.\.  .#.*. .....#
#.##*..   .. .*. ...#..#.#.#  . ..#  \ .....\.*..#
#*.* .*.\ *  \#..\.\. *** #.\\..... .....#..#.#*.#
#..   * *..* #..*.#.... ......*.\ #.....\.*. ....#
# . .. . .**# #.   .#\.....   .**. # #..  *..#  .#
#.\.\...*....... .. .#... * **.. ..*. #....... ..#
#.*. ...*. #.\ .......\ ###. *..*#. .*.* *##.*.*.#
#*.. ..#.\  ....#... .. .\  \.. .. ..#...#.. .# *#
#. ..* ..... .# ...\ ..#.*.\..## * * ..  .*..*.. #
#...#.......... ##.#.*\*\.#.. .......  ..*. .....#
#.\...#..*.#.#*.*#.\. ......# . ..#\. ...... **#*#
#. #....#.#....#..#. #\. ... .\... \ .....\#....\#
#*. .. .. ...#.  *..##. ...#.###. .\*....#.#\..*.#
#....*.. #..\..\. . .#..*..\#.#..*##..\..#. \*...#
# .... . ....\..  **.. ..\.  *.....#.**\... \*. .#
#.. #.. ... ..#*\##* *.\.*. *#\ ... ...... ......#
# #*\  .# #..... #*.*....*.\\. .* *\.\.*..####.#.#
#**...*#\ ..#.#. ...#..\.. ...*.. ... ..*.......*#
#.#.#.\.*....*...*\ ** ...*   ......#\......  .\\#
##################################################