##################################################
##..\\. .... .. .\.. .. .... ..\#.....* ..*.\.. .#
#\..##... #... .*..*. #...\* \# ...  *\... ...   #
#*.# ... #. . ..  .#*.. ..#.... .. . .......\ ...#
# ..#*..*.. ..... .  .... #. .... .*\.\.#... .* .#
#. .#....\#....* .* #* \ *...............*.......#
#.*.# ...  #  #*\*.# .*# .##*.. ....  ...##....# #
#*.. ..*.....\.#... #..*..\..# .*\*.*.**. \.*\..*#
# .#.* .  ..#..# ...#..... . ...\.*.. ......*.#..#
#* .#.\....*..*.\..*... ... .*  .#..#*.*.. . .. .#
#.*. \. ....#..#... . ..#.#.... .. #..  .. #.. . #
# *.  *.. . .  . *.*..#. . *\*  ...* ..\\.. ... ##
# #.. .* \..\   *.*... \   ... #.#.......\...\   #
#...........#.*. ....\\.#.  ... ..... ...  .#* .\#
#... .....*... #....\ .\#*.* #.....##... ...*....#
#. . **.*.*. .......*#...*... ..*** #...\ #......#
#  \.#..#.  .#*.**\.. \  ..*.\.. ..#...*....... ##
#...**#*#...#*........   .. ..*.. ....\...# .... #
# . . .....#..#.........\..#..#. ..\#.\.........*#
# *.....*.#.\.*.* .*..*.*..*#.  .. .. #. .  .   *#
#. *.##*.*..*. ..#...**#*.  .....\*  ..\* # ...# #
# *. \##*... ..*.....     .   # #.*  \. .#.....\.#
# ......#..\.#.#..*..*.. .\ .... .\  \... *.... .#
#.*... .....\**....     ..* . ##\\..*..#...\ \.. #
##\\.. #   \.*\**.... #*..#. ....\\.\##*##\.. #..#
# \#.\..  .#....... . ...#.....#...**#.#* \....#*#
#..*.... . . .#.....#.#..\#.. .*...#.\ .#...#.  .#
#....#.** .................... ......#.  .*..*...#
#\*   ..... . \*...... .. .#............ *\#. #..#
# #. ...*#...... ....... ...*...*...#  .*........#
#. ...\..# .... .*.  .. *...\. \*#*..*......\..  #
#* . ..*.*..*...#... .\##....*   #.* \....* ..# .#
#. ..*...# #..*.#. *...*.*..*....\.........##...*#
#...\.... ...# .**.#.##. .**.#..  ....* .# .. *..#
#..* . .\ . . . .#.. ...\.. .......#  .. . .....##
# ..\......*. .\. .\.. #*. .. ... #  .... .#. .\ #
#* #...#... #... .# .... .. .*....#.....#\...\...#
#...**# .. ....  .......# ..\*.. #..*......  .\**#
#. ...\#..#... . .\#  . ..\ .# .. *   . .#* * ...#
# . \*.*  #*.\.....#....#. . #*.....#.*** .....###
#. \.#.#..R*...*..*. .#.#..\. ....  ..*..\.... \.#
#  ........* ..... .## \ ..*.......**...*.. ##.. #
#..  #.. \\.... ........ #... .... ...#*.. . \...#
#.\*\*\...#.... .......... . . .*.............# .#
# ...... ..*..... *....  . .....# .. #. .. . ..# #
#.* **.  ..... ..#..*. \ . #.*. .##. .** .\...\ .#
#.  . #.  .*. ..\ .....#.#.#.... .. #\*. #. #**. #
#...*..\..# #*#... ..   .#  . .... . ..... .. .###
#....   #.... .....  .**...* #.#*.....*. .  *..  #
#############################L####################