##################################################
#.. ..\\ #  ....  . .*....\*..#  . .#.* #... ..# #
#.*.*.....  ..........#. .. *.#. .*\*.* ..\*  #..#
#. #....# * .  **.\.#. .... * .  #.*.*.\*.*\..#.##
#....**.###*#. . *..# ..#.*. ..##.*.\# ***...#*..#
#  ..#* ...*. . .....#.... .... ..* #*\##* ..\. .#
#..  .... ...*..* ....... .#*.##. . . *#*..*. ...#
#.\......#.\ # .\.. ..*##**.*... ... .....  ** ..#
# \*.. ..  .#. .  **...#..  .\.\. *.*.* ... .....#
#.# .   ..*.. *..###\ .  #....#..\.........**. *.#
##.##... .#..\* #..#* **.......\ .. .\.\. ..\**. #
#.#..*...# #. #..*......... .*... *#*  ...#..\ .##
## \.\..#.  # . ...*# ..\ ..##.#. * ..*..*.....#*#
L ###..*. . ..#*#. *##..... .  .*.*##..  ..#..\..#
#..... ...\.... ..#.......  \ ..##\..#.....#....*#
#........* .##*\. .. \ *...\..   . .... .* ...\ .#
#  \ .#....##....   *.#... \\.......... *#..\.   #
#...#\.\ ......#.* *#....*...#...\*... #..#.\*...#
#....  ..... ..*.. . **#.# ..#. .#....*..*.\....*#
#* .. .. ........ #.. ***#*.*. * ...*.    *..* .*#
#*.. .*... ..\\*.... . ..... .. . .#. ....\....#.#
#..... #... \. .. #*.#.. .*..  ...\** .\#.* . ..*#
#..*. #.*...#.#...*. . ... ...  ....... .*.#.#\.*#
#.. .... .. .. ..\\\*##..  .. .. #. .......#. .*.#
#*. ...*.#.\... #.* ..#\........#......#..... . .#
#.. .  #..#*\... .. . .*...#.. ...#   .\\.. ..  .#
#.....#......\#....   #.\...#.\...*\. .. ...\ # .#
#. .* ..#. **....*..*.. *.# . ........ *.*..   . #
#. ..*. #.. .. ...*..*#*... ...* ....*..* #.*. ..#
#.*  * *.** \. ...#*..*.... \#.*.. \...\#.##..# *#
#.....\....\... ...\.  . ....# .*.#....#.. * *..*#
#\.* **.##.....*.....#.....#  . ..  . .# .*R *...#
#..#....#. ... .#. *..#*. #.*.\...* ....#.#..\.#.#
# #... # ....*\. *# \ .#.. ..\*# ...*. . .. \...*#
# .  .....* ..... ..**... .*.  #. #... *..*......#
# .*. . ....#.... \... \.*.. .. .. ....*.. *.*...#
#*    ....#* ##.*. ..##*... \ .\.\ .\  .*...*..  #
# ..... ......\**..* . *.# .  .**.#...#. .*.#.. .#
#. .*.. *..*.. ..*.. .. ....\*...   ## .....*. ..#
#.  .#.#.#.........#..#.... .# # . ... .. *.. ..##
#..*..\..\.#. ...**.. .*\.  ...# \ # *. #...  *..#
#.\..##\.*#.  ...\. * . .#..\..#..*.*# .*. \#.\  #
#*. \###. .  ...#* *....* . \\.. *..*..#. ....*. #
#.** . * .. *.*. #.  ... . .*.*.*..\ ...\....... #
#.....#..*.. #.   .*.*...  ..#.. #.*  # * \ .. ..#
#.......*.#  .  ....#......  ..\. ... \*..*.#....#
#.. *..* #*...*...#.. \ # .. . #*. ..... **....#.#
#*##.#.  *.\.\....#.. ......*... . .#*... .*.*.  #
#..*.. ##....* ..  . ..#.... .  .#... .*. #...# ##
##################################################