##################################################
# *..\... .. # . *... ...* #. ..\........ .\.. .\#
#.# * \..  #..#.#...* ###..\ .. \. . .. *\.....\.#
#**...*.#.. ...\\#  .. ..*.# . . #. ** ......*\..#
#..** * #....*. .*.\#....... . #.....*. #*#..#..*#
#. . **\*... .#. . #.*.....  .. # \#. .....##....#
#.. *##....#.. *.\*....#*.***.#.. .....#.  .   ..#
#.  .#  ... \....*... ......*.. ..\# ......\.....#
# ..*.\.**...*.#... ..  ...**... ... *..#. #\   ##
#..#....*....#.......\.. \ .  ..  .. .\*..*.\....#
#.......\   #...*. ..\*.*..#*#....  . ..# *..#.. #
#.*.. #..*.  ..*.. #. .\ ..#**\.* .....#.....#...#
#........*. ..... ......*.. .\  . ...**.\*... ...#
#* #... ... # . ##\.*#\..\ ..#.....#... ... *....L
#..\ .*.# \. ...##.\.. * ** ..\##....\.. .\.*.\  #
#...  .....  .*#.\....\. ... ... ..\#... ....*...#
#.#.*....*.. **#  ..*...  *.#...... .. #.... .*  #
# .* *..# *.* \ .*. . \.\... .#...  * ....... . .#
#*..#.#.*.\  *\##*#\.... ...\.....* *\...  .\**.##
#. .*.#... ...*# ... ....#.\ **..#.* \.... ..  ..#
#..  .\. \#...\......#.....*.##**\...#...#  ... .#
#\*...#*.  .. #\*.#...\ . \#....\..\ *.\.\ .... .#
#.#.. . .*.\ .. ... ..* . .. .*.#*... * * .#.*####
#.*#. . ...# .*  ...*#.  ..   .\ .\*.#..   \*..#.#
#*. ..**.  #..**... .**#..*#.. ..   ..**.. *.. ..#
#... \ .....#.# . *....#.. . .*.\.. ...... .#.\ ##
#* **.\# \.#.#* ... .* .*# ... .... .**.. .#.*.#.#
##.#..# .........\....*.**.\.. ..#.... **.   \. ##
#.*.#. #... . ....   *..*....* \#* *. .. .*#.*. .#
#. . ..*.\....#*...#....#.. ##.#... .  ....*..# *#
#*.#. ..  .. . ..... .  #.#. *\...... .\\.* * .#.#
##...* . ... .*#..*..* \.. .... ......  ...#...  #
##*.\........* ..\.** \ #.......  ##. . \...*....#
#.. .....*...\..*.*.#.#.#*..# ........  *\\*\. ..#
#..\..\.. .  *.* ...#..#..   .#...*#. \..#.*  #..#
#. ..# #.\. *  . ..*.* ..... ... ..*.\ \........ #
#* ... ..*\#....\..........  ...#.*#. * .. \. *#.#
#......*.#. * ##..*..#. ... .*...#.....#. ..*#\..#
# .*.*.*.*...# .. .. *..  ....  .*\ . .  ...* .*.#
#.. #.\ ..#.   * .\\..*.#.#. *..  ..*.* ..#. *...#
#.# ..#. ..# ..##*. \. .*.#... \.. #..*..*.. ..#.#
###..#  ..... .R..... ..#.....#.. \.#.#  ..#... .#
#. ... ........ .. #. .\.. #.. ........#...#.  ..#
#....\...    .*.........*.\. .. ....* ....\ *....#
#.*.\*..... .... *....#....#..  ..........*..#.\*#
##.. ..  ...... .  ..  #. ##.. \*....#\*#..\  .\.#
#.** .*.*....*..\.\#.*  ...  ....  *.*...  *#.##*#
#........#.\..*..\.. *#*\. ..\*...*. .*. .. ##..*#
##.*.*#.#*.*.......\. ...*. .#..##*.  .***#... ..#
##################################################