##################################################
#*..*. ..*. .\ #.   \..\ ... .\ *........ ...... #
#...*...*\.#. .*#.*.  .\. ..  #...#. ...*.. .  ..#
## ** * .\..#.. . ..*#*. ...... .*\..# .#*..\...##
# .....#.. .##..... #*....# .\.\. *..*#....*. ...#
#* ....*...\*.\..*.#.*.#...\.* . ... .   ....   .#
#.. . .\*##.*. .# *\.. *. ..*.*... *.\.##... ..#.#
##. .....*  #.........  .\*. *.** .*#.....  . .*.#
#. .*#.#.. ...***# *##  *.*\.#..*..**... ..#.*  .#
#\.##.*\#..#.#.....  .\.\.*# * ...*..#.*#.# .\#..#
#.#. ..\ .. #...#.. ** .....\..#..\  . .... # ...#
# ..* ... ...*.*#...... .#... #...#**.\* .....*..#
#.......\.....  .*..\..*.. \..#.\  ..*..\..\.*.#.#
#*.*....\.*\..  *....#..# *... \\# ....*.........#
#.# #*. ..**.  . *..#. # .. ..# ...#.#.\..*#.....#
#.#..*#\ . ...R *. ..*   ....*... .*.#..* *....#.#
##.#*.#.#\   *.\.* \..#.\. ....##..  .*#\..#...# #
#. .. ...\#*  ...*  ... .. .   . .##.......##..# #
#\.** .##.**.*....... ......*........#\*#.. ..*.##
#... ..*.  \#** . * .##*...#...\...#.. . ..... *.#
#.. ....# \..#*.......\\. ..... ...#*#*....*.....#
#...* ...\.... * ... ...*.... ...#..... ......\. #
#...*.........#.##.*...#.\*#   .  ....#.#. .. .**#
#..  \*#.\..... . *..*\\#\..*#.#..*. .\\ #.*##  .#
#.....*.. ###...... . #.# . ...*... .......*... *#
#\ .... .#. .\.*\  .# \.*#.* *.*.... .#.\\#.. .  #
#.#.. .. .. .   * .#*.#...#.. .*..  *..##*.....#.#
#\...  #*  .... ...\.*......\*  # ......*... #. .#
#\.... ......## ..#*......\......* *..*..#.#.*.  #
### .. \.\.*... ..*.#\..*..#... ..\.#...  ....\..#
#..  ....*.#... .\. #...#*#... .#.*..#....#   ...#
#.. ..\ .....#*.\ .##...**   .#.......#.. ....# .#
#. . * .\  ** .... .....#...#.. #... * . \.......#
#.#...#..*.#.....#.. . .. ... \..* .\  # ... \.#.#
##..#.\..##....*  ..**..*. .......#.....\.#   *.\#
L*#.#..........\.#. ##\ *.##.... ...*# ..##.##...#
# .\..#*#.*. ..#.#..*.*. ... .#*** ......##....#.#
# ...   .  ..... .. #.\*# \  .**. # ..*.*##...#.*#
#*......*\...* .*..*.**\.*..*.....*.#.  ..\\ ....#
#*.#.*.. .##..\.#..#*....#. #.... *.##...* ..* * #
#.#.....  .... *. ... ...*. . .. .....*....*...#.#
#\\.... . .#*. ##.*.....#.\\....#.....\* ... .*.\#
#.. ..#*...*.*.#* *\* \ * .#......... .* #.#   # #
#.....  * ..*...# ..#...#.*.*\ ** *..  .\..  *..*#
#. ## *....... ..* #\ .*....\#.....  #*#..#...  ##
#.. ..#.\...#. *.#....**. ....**.#.  #.#.....*. ##
# ##.#*    ** .. ..  #*...*....*  .*  *#  .#.*..##
# #.. ...#  ... ..#.##*....\....#.*...#   * #.*  #
#* .#*.. \*... *..*. .  \......*. ..  *.\..... .##
##################################################