##################################################
#\.\# ...* . .*.. *.##......#.....* .* *... .   ##
#....**...#*... ... **#  . ... *** ..#. **.*. #.\#
# .*  .#.*. ..* ..#.. *  *........ *... #\..    .#
#.\. ....* .\##.#* #... \*...*#.. * \*... ......*#
#.......* .  \#*. #....  ...  ...*.#*...**.. ## *#
# ..... **. .. .. * #. .. .\#.*...* . #.\. **....#
# .  ..**..##  \.#* .# ..  \.##...#.\*#... .#....#
#.*\..*..#.... ... #.**.... *#. ...#........ *...#
# #  ....*......  . ##.....#.*.#   .*#...#..\.#..#
#\.....##..*..... .......*. \ ...#.. ..* .\ #...\#
#\ ......... .. ..\ .\ .  ###...\.... ... ...... #
#. ... #....* *# .\..*.  . #**. .......#.\.#....*#
#. . .....#\\#.... .#\.#*...*#...\.. ...\.*.*# ..#
# .*#...##...*......\..\*........\... .. . #. * .#
#.#*#....  ...\#.   ...#. . .\..\. .. .....#...*.#
#.*.# . *.# ... ...*.\.....#... .... ....*# .#..*#
#. .\# ..*..    **..*.*.\* #.. ...#.\* ....... #*#
##........#.. . .# . .**....*..**#..... .....R...#
##.*  .*.    ..\. # #.#.*#..*. .*\ ......**.. * .#
# #.. *....\ ...*\.... .**. .. \.\#*#.*. \#*. .  #
# ....* ..  \#\...#... ....*.\..  .** .#...... * #
#.\**..  .\. ...#\...***.*.......*#\. .#..#  ....#
# #..#...  \# *.#*....\#.. .. ....# *.. ... ..#.##
# ..*  #.*...\*. *.*.  *...\....... . .. .\\. .  #
#..\....#.\..#....#. .  #.. .. .#*. . *. * .... .#
#.. ..#**# # .\ \#.*..\. \.\*.... ..#...  .... ..#
# .... \#....... ...  #* .\. *...#. *#.#..\...#. #
##..* .. *  # ... ....* \. . . . *.#. . #.#..*...#
# . .....\#.#.... ...... .... ..... ........#.  \#
#.#\ *..*. # ..*.. ..*# ...*.....#. . \*..... *.##
#......#. * .**..#..\..\..\\....#*\# ...#. . * .##
#. \ \..  *..*....*... .. .# . . . .. .\ \ #.* ..#
#...  *. .. . # . .*.  .. .**....*.# .*.\. .##.\.#
# * ......\ \. .#..\..\* \##.*..... .*......*..#.#
#.*.   .#.*.*   .#. .......#*#...** .# ..   .....#
#..#.*.#.# \ .*..... \ #  \..  ..# ....\\..*.#.#.#
#.........  ... *##*#..  ...*.#...# . **.... .#..#
#.. .... ... ...#. . \ *...#...\..*  ... ....#. .#
#... *..\...\.\ ...#*.**.\......#   #.*.. .#**...#
#... ..#*..  #...#.#...*#* ...#. .. .\..*... ... #
#.....*..#....\....#*. *. ..... . #\ .#..*. ...*##
#. ..**\*.  *..##........ .#.#....*. ..#.  ......#
#*. .# #  \...#. \#.**\#...   ..\#. #.. . ..\*...#
#......#  ###. ..#..#.... * *#...*.#  #.*... ..#.#
#*\....... ..*. ...\ ..***..*.. # ...\\*..  .#...#
#. ... *. .#....#  .\\   .. #..   .*.  *  #*....*#
#.#.. ***..* . # ... .... ..#*#.. #...* . .....\.#
# .#.#..*..  #.#.**.  \.  ... #...#...*.*\.* . ..#
##########################################L#######