##################################################
#.#.. .*.*#.#.....*  . . ..# ..\*........ .\ .\.##
#... .*..... .**.. * ..#.... .... ...\. ..  ....##
#*.....*......#....\#.**\..  #  . .. . ..*.\. . .#
# . .  * .#..\.\..*...*.*......*  ..#..... \*..# #
# .......   ..... .  .. .*#. ...#...#..  .. ...#.#
#..  ... ... .#*..*#. .# * ..#..  #.. .#  .* ....#
#\.. .... .*.... .#..*.....  ....*. ......*# # .*#
#.#...... *. .. #. .   ...\#*.#.\ ... . #... * .*#
#.*.\ **... .*. ..  . \..#.. .. ..*.\.*..**. ....#
##  * \ ..  . #..... ....#. ...  \......... .....#
#.....#..*## .. ...  ....\....#.\. . .*\ #.**\ ..#
#. ..... . . *..... ...... .. ....* .. ...   *.*.#
###* ..*....#*....*.. .  ## .#.*....*...\##...* .#
#. .#* ... **#.. ..* ...#.. .*...#.*.*\....**....#
# \. .* .#*..#.. .. .... *.#.. ....\.#   ....#\\*#
#.**. #**\#*.\.#. ..# .  # . .# .. ...#.   .....##
#....\.*....\.*#.*......#\..  #..*...  ... ..# ..#
#.** * ... .*# .. ....  ## ...... .\.. ..*. \..*.#
#.# .\.\#.*............ *......#.#\. ..*.. #  ...#
#....#.  #.  ......\# *...*.** ..* .*.*..  .*... #
#..   .*. .\..#*.... *# #**.. .....\. . ... . .\\#
#..**\.#\. #.*.. ..  .# .. #.*#.......  ...##.\  #
#.. ##*.....*. .......# *...\. .*....\\** . . *..#
# .#*....*..*\. ....... .*.... ....\#*... . ..  \#
#... *\ .....\.\#. . # .#......*.\...  * .*.**.*##
#.\.\..*. #.........  *\...**.. .  ..*# .\...#.* #
#. \..  #......*.# . . #*\ .......* ..* ... .. . #
#... ... *  .. ..* .#.. ......*. ...*\. #..*. .. #
#.*#. .   * #...\.......#**.*\..#.#...#.\  \\ \..#
# ..#... #..#...... #..**..#*#.\\.. ....  ... ...#
##..\......#.*..##.**\  \*##. .\.#... .\  . .#.. #
##.#*..\.. . #...##*..#  .#.#.*......##*.\.. *..\#
#. #..*.   .#. *..# .##........#.#.... .\. ...*.*#
#*.*.......\ ..\*....   #.   .. . ..\#\.. .#....*#
#.*##.   . ...#...\..... .... *.##.....* ..#. *..#
##...*  .\ .........\# \..\ \ .....*. .........**L
#. * .......  *. ....... . .. ..*.# .\\....\ ..#.#
#. .. .#. * \ *.  .#..#..... ....\.. .* . #....#.#
###...*\...\.... \ .... ...  ....#..# .*\...   .##
#\..\.....#  .... \.... .\.* ..#.. # ..\#..... *.#
# .\#..*#.#.... ...*#.#.##. *\ ...  ..#..#** .# .#
#.\. ... #\... \*.\.#\ ..#  *.# .#... ...... ...*#
#.. . ...*....* .*..##.....#...  ....\*.*. ...*..#
##.... ..*.. ....  .....\....#...  #.....**\\*. .#
# .\*.. .*..#.. **.*#*.. .....  ..  .*.  .....  .#
##. . ...  ..*.\... *..#... #.. . ... #.*.. #....#
#.. ..*..*...# .. .. *..    .  *#.#..#*.# ..#....#
#....\\.#.#*#. . *. .\*#...#**.... R*. . ..##...##
##################################################