##################################################
#\  ..*#..* *...# .\ #... .#\*. .*.\.\  *..... ###
#*....# ..#....\ *.#.*.\##..\.. ..#... \..* .   .#
#.\.\.*.*.\.##.  .. . ..**...#*#.\ .... ...\ ....#
##...#... .*.* #..#.. .#... \*.. .*  . ..... . .##
#*\ *. * #...**.###. #.. . .\.#  ..   . ....\. #\#
#.. .... .  . .. .....#.....*#.........#..  \* . #
#\..\\...  ........ # .#* ......#. #*....#. ...**#
#.# * . .. * .#.*..  ..\. ... ..*# .. ......*..*.#
#..#*\*.. .. ..#.. ...#.#. ..\*. .. . # ..#. ###.#
#.. .\#*......*..**............*.#.#..  .  .#..\.#
# \. .....*##..... .\.#.#.#. . #... ..*.....*. ..#
#\. #.. ..... ...*. * .*\....  .. *#.#.. *..\... #
#... ....\*..... ..* ...... .... .#.. ..#..#  ...#
#*.... ...*\.\*. .\ . *. .\. . *..... . *## . ...#
#\.*\.  # #.\*.. #..\**.*..... .... **#. . ....  #
# . .. ##.. #..\#.. *  .##. \ ....# .  ... ... ..#
#\#.#.*.#...#\...#*... ...#.*\.  ..** *  . .... *#
#.#. ... ...  ...*. ... *..*.\. . \.#.\..... #..##
#R..*... *#...... *....#..#... ....... .*..  .*.\#
##..*.# #.**.* *\# .. \. #\.. .   .. ....*..#\. .#
#..... . . *.*. #.#. .\##. .....\...*..\#*.... . #
#*#.*#. . ...... ........ # ..... ..*..#....\.\ .#
#.\  .   .  #.  . .#.*# # #..\  . ** .. ........ #
#. ..  *.* . .... ..#..*\*.*.  \....# *.. ...#.  #
#\#..* *. *.. .*..#   *.#....#...*... .# #.*.. *.#
#...#. .. .#  . .......\.....#....*... . .*..\##.#
# .#.....*\..*.....\* ###*# .*.#.* .. .*.. .\. \.#
#. ...*.... ...#**.#.. .*..# \.. \ ....* ...#. ..#
#... . *.*... .*.\...\   ...#....#.. ..*..\#*....#
#...  .*.. . * #. .#..   \.* #*.*...  #. .. #\ #\#
# . .*.\ ..#...*.#. ..\...*. ..  ....#..*.. \.\..#
# #.. #..... .\#\.*#*..#..#. # # *.# \.*......##.#
#\  ... ..#..*...#.. ...#.\*.....* .. \...*......#
#  *\ #.*# *...#. .**..*  .#. .*  .. ..  #..# .# #
#..#.#.*.\\..#.. *.. **... .#....... *.#..# . .  #
#.#\.......#.  . ...\...*...#.. ......#....*.....#
#.*.  ....#. * \..#*...\. .\\.... .... #.\..... ##
#. ..*.... ....#.  **.* .# . . ...  .*... .*.# . #
#\..\ ... ...*\ .. .#*.. . #.  * .. *#... .\  ..##
#* .. .  ##...*.#..  . \....**....*......##.....##
#. .*\ #.*..* #.\..... . .......*** ...... \*....#
#*##....  .  .. \..## .*...\# ....#. #.. ...*#..\#
# #..*...* . .\ .\..#..#..##*.....#*..# ..\\.. #.#
#. ... .#*   ...*.. * * . # ...   ...#.. .  ...**#
## . *..\..  ....#*.# #..\..## ##.. \ #... .*....#
#...* ..  #... ....##.\ ..\. ..** ...**.*. .*.\ .#
#*...*. #**.. * **... . ... ..# .\ ..... #...#...#
#. ..*.... #... . \ . *... .. .*\*.*. ... **..\..#
#######################################L##########