##L####
#.... #
#.. ..#
#..#..#
## .R #
# .. .#
#######