#######
#... R#
#...  #
#... .#
#..#.*#
#...\.#
###L###