#######
#   .\#
#R #..#
#.  *.#
#..**.#
L**\.##
#######