#######
#...  #
#*.#.R#
L .*#.#
#. ...#
#..   #
#######