#L#####
#  ..R#
#\..*##
#.\ #.#
#\.*..#
#.*.#*#
#######