#######
#... .#
# .R*\#
L. ...#
#.....#
#.....#
#######