####L##
#.   .#
#....##
#*....#
# .#..#
#R. * #
#######