#######
#*..R #
#....##
# \.#.#
# *.#.#
#..\*\#
##L####