#######
#.. ..#
## *.\#
#.#.###
#*....L
#R#...#
#######