#######
# * .R#
#..#. #
#....*#
##....#
#.   .#
##L####