#######
#..#R##
#.*  .L
#.. ..#
#.....#
#.* \.#
#######