#######
#**.\.#
##\ \##
L*#...#
#*. R.#
#\.  .#
#######