#######
##...\#
#.**..#
#\* # #
#*.   #
#*..R #
#L#####