#L#####
##.. .#
# \*.R#
#..*.\#
#.##..#
#* .  #
#######