#######
#. #. #
# ... #
#..  .#
#.R ..#
#*....#
#####L#