##L####
#...* #
# . ..#
#*R.#.#
#.##.\#
#.#*..#
#######