#######
#.  ..#
LR# . #
#. #. #
# ..* #
#.. ..#
#######