#####L#
#.... #
#.R\.*#
#. #.\#
#\*.*##
# .. .#
#######