#######
#.....#
# ##..#
#. R. L
#.#...#
#... ##
#######