#######
#.....#
#... .#
#.  . #
#.*.R.L
#..#.*#
#######