#L#####
#.... #
#..  .#
# .. R#
# .*..#
# ## .#
#######