##L####
# ....#
#....##
# *.###
# \#..#
#.R...#
#######