#######
#*..R.#
#....##
#  #*.#
#.  *.#
#.**#*L
#######