#######
# ** .#
# .#..L
#\.\R##
#...#.#
##..#*#
#######