#####L#
#*#.# #
#...*.#
#* R.*#
#*.#**#
##.*..#
#######