#######
#.. \.#
#. R..#
#.**\\#
#.... #
# L#\.#
#####L#