#######
#* *..#
#...#*L
#. ...#
#*..###
#....R#
#######