#######
#....##
#...###
#.**R.#
##\#. #
#*..\.#
#L#####