#######
#. .\.L
# ....#
#.#...#
#R.* .#
#.*..*#
#######