###L###
##. ..#
# ....#
#..R#.#
#.# #.#
#... .#
#######