#######
#R ...#
#  ...#
#. ...#
#*.#..#
#.\...#
###L###