#####L#
#..\# #
#.. ..#
## ...#
#*.#*.#
#\. R #
#######