#######
#...\*#
###.R.#
#* ...#
#....##
#.#.#.#
####L##