#####L#
#. .R #
##***##
#*   ##
#.....#
#...#.#
#######