##L####
##....#
#R ..\#
##  . #
#.*..*#
#.....#
#######