#######
#.\R#.#
#.*.# #
#.#.**#
#..**.#
##..#*#
#L#####