#######
#... .#
#*... L
# .  .#
#..\* #
#*. .R#
#######