#######
# ...*#
#.\...#
#..**.#
#*...#L
#R ...#
#######