#######
#.. .\#
#.*#R.#
##*.#*#
#... .L
#..*.##
#######