#######
#... R#
#.....L
#.*#..#
#.... #
##*# ##
#######