#######
#. .#\L
#...*\#
#  . ##
#.....#
#\..R #
#######