#######
#...  #
# ....#
## ...L
#*  .R#
# #.*.#
#######