#######
#. ..#L
#*  . #
#*#.# #
##... #
#...R.#
#######