#######
#..#*.#
#..#..#
#.  .*L
#**. .#
#....R#
#######