#######
#. ..*#
# .#..#
##.*..#
L*.R#.#
#.\.**#
#######