#######
#.* ..#
#\ #..#
#.#R.\#
#*  ..#
#... *L
#######