#######
#*#.*.#
#..*.\#
#.# \.#
##*..\#
#R..  #
#####L#