#######
#\ .\.#
# # . #
#.*#..#
#..R..#
# ....#
#####L#