#######
# ..  #
LR  ..#
#\..*##
#\.#*.#
#*...*#
#######