#L#####
#*... #
#\*.* #
#*#.#.#
# R.*\#
##.#.##
#######