#######
#   . #
##. #\#
#..#\.#
#  .R #
# .# .#
###L###