#######
#..*.##
#**#.*#
#*.R *#
#.*...#
# #.#*#
#L#####