#######
###.* #
#.* .*#
#**.R.#
#.** ##
#.....#
###L###