#######
#.....#
#* .*R#
#.*...#
#.\.. #
#. ...#
####L##