#######
#..*.R#
#*# .\#
#..# *#
#....##
L..*..#
#######