#######
#  .R #
##... #
#.#...#
#.  \*#
#.... #
#####L#