#######
#..*.*#
L ....#
##.#  #
#...#.#
#.*.R##
#######