#######
#.  ..#
#...  #
#.. ..#
#.\R .#
#.\...#
####L##