#######
#....\#
L...*.#
#..# R#
#..#L.#
#. # .#
#######