#######
# . \*L
#.. *##
#*R ..#
#...  #
#*\. .#
#######