#######
#*. .R#
#..\* #
# .  .#
#*... L
#... .#
#######