#######
#*..#.#
#.R.\.#
#L..*\#
#... .#
##* ..#
###L###