#######
#.*.*.#
#.  ..#
##..#.#
## . *#
##R. .#
####L##