#######
#.. ..#
#.. ..#
#.#R#.#
#\. ..#
#.#*..#
###L###