#######
L. *# #
#...#.#
#. #*\#
#.....#
# . R.#
#######