#####L#
#.... #
#.  \*#
#.#...#
##... #
#  .R #
#######