#####L#
#R....#
##.# *#
#.....#
#*.. .#
# #.\##
#######