#######
#..#.\#
# ..R.#
#. .*.L
#.  .##
# \...#
#######