#L#####
#\*R..#
#..*. #
#....*#
#... .#
#.\*  #
#######