###L###
#..*..#
#.*.R.#
#..**##
#.*.#.#
#.* ..#
#######