#######
#    *#
#*....#
#.R#..#
#**...#
# ..  #
#L#####