#######
# ..R #
# .#. #
# .*#.#
#. ...#
#.. *.#
###L###