#L#####
#....*#
#\.. .#
#...*.#
# .#.*#
#. .R.#
#######