#######
#. *.\#
L *R# #
# ...\#
#.... #
#.. . #
#######