#######
L\#. .#
#\*...#
## .  #
#.....#
# R..\#
#######