#######
#..*#.#
#\.##.#
#.#.R*#
#.. . #
# *...#
####L##