#######
## ...#
# . R#L
#.  ..#
# .#..#
#. ..\#
#######