#####L#
# R...#
#** \.#
##. ..#
#\.. ##
#.#* .#
#######