#######
# ....#
#..#R.#
##* . L
#*\\..#
#. ...#
#######