#######
#R#*..#
#...*##
##..\.#
#..\.##
#..#..#
###L###