#######
#*.*. #
#\.R..#
#..   #
#  .*\#
#. .#*#
#####L#