#L#####
#..*  #
#....*#
# ..#R#
#..# .#
#  .\.#
#######