#######
# ..#\#
#  \..#
L..*.\#
#.#R# #
#.# .*#
#######