#L#####
# ...R#
#.. *\#
# ..\ #
#\.*#.#
#.  #\#
#######