#######
# .#*.#
#..*\ #
#.# \.#
#.R...#
#.. ..#
###L###