#######
#..#. #
# *#R.#
# . ..#
# . .##
#.#.#.#
####L##