#######
# ..\.#
#*.#..#
#. .#*#
L..R###
#. *..#
#######