##L####
#.#.#.#
##....#
#... *#
#.R.###
#*\...#
#######